,Round,Home_Goals,Away_Goals,Home_Match_Outcome,Home_Points,Away_Match_Outcome,Away_Points,Total_Home_Goals_So_Far,Total_Away_Goals_So_Far,Cumulative_Home_Goals,Cumulative_Away_Goals,Total_Home_Points_So_Far,Total_Away_Points_So_Far,Cumulative_Home_Points,Cumulative_Away_Points
0,1,0,0,2,1,2,1,0,0,0,0,1,1,1,1
1,1,3,0,0,3,1,0,3,0,3,0,3,0,4,1
2,1,1,0,0,3,1,0,1,0,4,0,3,0,7,1
3,1,0,4,1,0,0,3,0,4,4,4,0,3,7,4
4,1,0,0,2,1,2,1,0,0,4,4,1,1,8,5
5,1,2,2,2,1,2,1,2,2,6,6,1,1,9,6
6,1,2,1,0,3,1,0,2,1,8,7,3,0,12,6
7,1,6,0,0,3,1,0,6,0,14,7,3,0,15,6
8,1,1,1,2,1,2,1,1,1,15,8,1,1,16,7
9,1,3,0,0,3,1,0,3,0,18,8,3,0,19,7
10,2,6,0,0,3,1,0,6,0,24,8,3,3,22,7
11,2,2,1,0,3,1,0,2,1,26,9,3,0,25,7
12,2,1,1,2,1,2,1,1,1,27,10,1,1,26,8
13,2,1,2,1,0,0,3,1,2,28,12,0,3,26,11
14,2,1,0,0,3,1,0,1,0,29,12,3,0,29,11
15,2,1,3,1,0,0,3,1,3,30,15,0,3,29,14
16,2,0,6,1,0,0,3,0,10,30,21,0,3,29,17
17,2,6,0,0,3,1,0,6,0,36,21,3,0,32,17
18,2,2,2,2,1,2,1,2,2,38,23,1,1,33,18
19,2,3,0,0,3,1,0,3,0,41,23,3,0,36,18
20,3,1,2,1,0,0,3,2,2,42,25,3,4,36,21
21,3,2,2,2,1,2,1,2,2,44,27,1,2,37,22
22,3,2,0,0,3,1,0,8,0,46,27,6,0,40,22
23,3,0,1,1,0,0,3,0,1,46,28,1,3,40,25
24,3,1,1,2,1,2,1,3,2,47,29,4,1,41,26
25,3,3,0,0,3,1,0,6,0,50,29,6,0,44,26
26,3,2,2,2,1,2,1,2,2,52,31,2,2,45,27
27,3,1,0,0,3,1,0,2,1,53,31,4,0,48,27
28,3,1,0,0,3,1,0,3,2,54,31,4,1,51,27
29,3,1,0,0,3,1,0,4,0,55,31,6,0,54,27
30,4,3,3,2,1,2,1,4,4,58,34,2,2,55,28
31,4,4,1,0,3,1,0,10,1,62,35,6,3,58,28
32,4,2,1,0,3,1,0,4,3,64,36,4,1,61,28
33,4,1,1,2,1,2,1,4,1,65,37,4,1,62,29
34,4,0,2,1,0,0,3,6,2,65,39,3,6,62,32
35,4,1,1,2,1,2,1,2,1,66,40,4,4,63,33
36,4,1,3,1,0,0,3,2,6,67,43,0,6,63,36
37,4,1,1,2,1,2,1,1,11,68,44,1,1,64,37
38,4,0,0,2,1,2,1,2,1,68,44,4,1,65,38
39,4,2,1,0,3,1,0,3,3,70,45,3,0,68,38
40,5,1,1,2,1,2,1,4,4,71,46,4,1,69,39
41,5,1,1,2,1,2,1,5,1,72,47,7,4,70,40
42,5,1,1,2,1,2,1,3,3,73,48,4,3,71,41
43,5,0,1,1,0,0,3,4,5,73,49,2,4,71,44
44,5,3,1,0,3,1,0,3,2,76,50,4,1,74,44
45,5,3,1,0,3,1,0,5,2,79,51,7,2,77,44
46,5,1,1,2,1,2,1,4,3,80,52,5,5,78,45
47,5,3,2,0,3,1,0,9,2,83,54,9,1,81,45
48,5,0,2,1,0,0,3,1,13,83,56,1,4,81,48
49,5,4,0,0,3,1,0,12,0,87,56,9,6,84,48
50,6,1,0,0,3,1,0,5,1,88,56,7,6,87,48
51,6,2,3,1,0,0,3,12,4,90,59,6,3,87,51
52,6,0,0,2,1,2,1,2,1,90,59,5,4,88,52
53,6,1,2,1,0,0,3,3,4,91,61,1,4,88,55
54,6,0,0,2,1,2,1,4,3,91,61,5,1,89,56
55,6,2,2,2,1,2,1,4,3,93,63,5,2,90,57
56,6,1,0,0,3,1,0,3,6,94,63,3,4,93,57
57,6,2,2,2,1,2,1,4,4,96,65,3,3,94,58
58,6,1,2,1,0,0,3,4,4,97,67,4,3,94,61
59,6,1,2,1,0,0,3,7,4,98,69,3,3,94,64
60,7,2,0,0,3,1,0,3,13,100,69,4,1,97,64
61,7,0,2,1,0,0,3,2,3,100,71,5,4,97,67
62,7,1,0,0,3,1,0,5,4,101,71,7,4,100,67
63,7,2,1,0,3,1,0,5,3,103,72,7,3,103,67
64,7,1,1,2,1,2,1,6,3,104,73,8,5,104,68
65,7,1,1,2,1,2,1,4,7,105,74,4,4,105,69
66,7,0,0,2,1,2,1,4,3,105,74,6,4,106,70
67,7,2,1,0,3,1,0,7,2,107,75,10,4,109,70
68,7,1,2,1,0,0,3,5,5,108,77,5,9,109,73
69,7,2,0,0,3,1,0,14,0,110,77,12,5,112,73
70,8,2,1,0,3,1,0,14,5,112,78,9,2,115,73
71,8,2,1,0,3,1,0,6,5,114,79,6,3,118,73
72,8,1,2,1,0,0,3,5,5,115,81,5,7,118,76
73,8,2,2,2,1,2,1,11,4,117,83,10,4,119,77
74,8,2,2,2,1,2,1,9,6,119,85,4,5,120,78
75,8,1,1,2,1,2,1,5,5,120,86,5,2,121,79
76,8,0,0,2,1,2,1,5,1,120,86,8,7,122,80
77,8,2,0,0,3,1,0,6,5,122,86,5,1,125,80
78,8,2,3,1,0,0,3,5,7,124,89,1,7,125,83
79,8,0,0,2,1,2,1,3,3,124,89,5,3,126,84
80,9,1,1,2,1,2,1,6,4,125,90,8,5,127,85
81,9,2,0,0,3,1,0,4,3,127,90,8,9,130,85
82,9,2,0,0,3,1,0,16,0,129,90,15,1,133,85
83,9,1,0,0,3,1,0,5,3,130,90,9,3,136,85
84,9,2,1,0,3,1,0,8,4,132,91,11,4,139,85
85,9,1,1,2,1,2,1,4,14,133,92,5,6,140,86
86,9,1,2,1,0,0,3,5,9,134,94,4,7,140,89
87,9,1,2,1,0,0,3,6,6,135,96,7,7,140,92
88,9,2,1,0,3,1,0,7,6,137,97,8,4,143,92
89,9,0,3,1,0,0,3,7,5,137,100,10,8,143,95
90,10,1,0,0,3,1,0,15,5,138,100,12,2,146,95
91,10,1,2,1,0,0,3,4,5,139,102,5,10,146,98
92,10,1,0,0,3,1,0,7,5,140,102,8,3,149,98
93,10,2,0,0,3,1,0,7,5,142,102,8,5,152,98
94,10,2,1,0,3,1,0,7,6,144,103,8,7,155,98
95,10,2,0,0,3,1,0,13,4,146,103,13,7,158,98
96,10,0,0,2,1,2,1,5,1,146,103,9,3,159,99
97,10,5,1,0,3,1,0,14,7,151,104,7,3,162,99
98,10,0,1,1,0,0,3,6,6,151,105,6,4,162,102
99,10,2,1,0,3,1,0,7,8,153,106,4,4,165,102
100,11,4,2,0,3,1,0,10,8,157,108,9,7,168,102
101,11,2,2,2,1,2,1,6,5,159,110,9,3,169,103
102,11,2,1,0,3,1,0,6,6,161,111,8,5,172,103
103,11,2,2,2,1,2,1,9,10,163,113,5,6,173,104
104,11,1,1,2,1,2,1,8,6,164,114,9,4,174,105
105,11,2,1,0,3,1,0,15,5,166,115,16,1,177,105
106,11,2,0,0,3,1,0,7,3,168,115,12,3,180,105
107,11,0,1,1,0,0,3,15,6,168,116,12,10,180,108
108,11,0,2,1,0,0,3,8,6,168,118,11,10,180,111
109,11,2,0,0,3,1,0,9,6,170,118,11,10,183,111
110,12,3,2,0,3,1,0,9,8,173,120,10,3,186,111
111,12,1,1,2,1,2,1,7,5,174,121,9,4,187,112
112,12,2,2,2,1,2,1,7,11,176,123,5,5,188,113
113,12,1,1,2,1,2,1,5,15,177,124,6,5,189,114
114,12,0,2,1,0,0,3,7,8,177,126,8,11,189,117
115,12,3,2,0,3,1,0,8,3,180,128,12,9,192,117
116,12,1,0,0,3,1,0,17,0,181,128,18,4,195,117
117,12,1,2,1,0,0,3,15,9,182,130,7,7,195,120
118,12,1,1,2,1,2,1,8,6,183,131,9,7,196,121
119,12,0,0,2,1,2,1,7,5,183,131,11,8,197,122
120,13,2,2,2,1,2,1,10,5,185,133,13,9,198,123
121,13,0,0,2,1,2,1,7,5,185,133,12,4,199,124
122,13,0,0,2,1,2,1,15,9,185,133,8,5,200,125
123,13,4,2,0,3,1,0,11,7,189,135,12,7,203,125
124,13,0,0,2,1,2,1,7,11,189,135,6,10,204,126
125,13,1,0,0,3,1,0,6,15,190,135,9,5,207,126
126,13,2,3,1,0,0,3,9,11,192,138,8,10,207,129
127,13,2,0,0,3,1,0,11,8,194,138,13,5,210,129
128,13,1,2,1,0,0,3,9,8,195,140,9,14,210,132
129,13,0,3,1,0,0,3,17,3,195,143,18,7,210,135
130,14,2,3,1,0,0,3,17,9,197,146,12,10,210,138
131,14,1,0,0,3,1,0,7,5,198,146,12,10,213,138
132,14,2,1,0,3,1,0,11,11,200,147,8,1,216,138
133,14,5,1,0,3,1,0,15,9,205,148,12,10,219,138
134,14,2,0,0,3,1,0,17,5,207,148,19,5,222,138
135,14,0,3,1,0,0,3,8,9,207,151,11,6,222,141
136,14,3,0,0,3,1,0,12,6,210,151,14,3,225,141
137,14,2,0,0,3,1,0,8,6,212,151,11,4,228,141
138,14,1,4,1,0,0,3,9,10,213,155,9,13,228,144
139,14,2,2,2,1,2,1,9,5,215,157,13,7,229,145
140,15,2,4,1,0,0,3,12,9,217,161,13,17,229,148
141,15,2,2,2,1,2,1,17,11,219,163,13,11,230,149
142,15,1,4,1,0,0,3,10,12,220,167,9,8,230,152
143,15,1,1,2,1,2,1,10,11,221,168,10,5,231,153
144,15,7,1,0,3,1,0,24,6,228,169,22,7,234,153
145,15,1,1,2,1,2,1,12,9,229,170,14,14,235,154
146,15,3,1,0,3,1,0,10,12,232,171,9,5,238,154
147,15,3,2,0,3,1,0,12,13,235,173,11,7,241,154
148,15,1,1,2,1,2,1,16,10,236,174,9,11,242,155
149,15,2,1,0,3,1,0,13,8,238,175,15,5,245,155
150,16,2,1,0,3,1,0,19,10,240,176,15,5,248,155
151,16,1,1,2,1,2,1,8,6,241,177,13,11,249,156
152,16,3,0,0,3,1,0,11,6,244,177,14,1,252,156
153,16,1,1,2,1,2,1,18,4,245,178,19,8,253,157
154,16,1,0,0,3,1,0,8,5,246,178,15,10,256,157
155,16,2,2,2,1,2,1,8,17,248,180,10,7,257,158
156,16,3,1,0,3,1,0,11,10,251,181,14,10,260,158
157,16,1,0,0,3,1,0,10,5,252,181,16,3,263,158
158,16,3,0,0,3,1,0,15,6,255,181,17,4,266,158
159,16,2,3,1,0,0,3,13,14,257,184,8,12,266,161
160,17,2,1,0,3,1,0,14,10,259,185,16,8,269,161
161,17,0,0,2,1,2,1,10,12,259,185,10,6,270,162
162,17,0,0,2,1,2,1,10,11,259,185,11,8,271,163
163,17,0,1,1,0,0,3,12,10,259,186,14,14,271,166
164,17,1,3,1,0,0,3,11,15,260,189,9,17,271,169
165,17,3,1,0,3,1,0,19,11,263,190,12,5,274,169
166,17,2,1,0,3,1,0,19,12,265,191,16,7,277,169
167,17,1,0,0,3,1,0,13,13,266,191,14,5,280,169
168,17,1,1,2,1,2,1,14,9,267,192,16,12,281,170
169,17,1,0,0,3,1,0,25,6,268,192,25,17,284,170
170,18,1,0,0,3,1,0,11,5,269,192,19,10,287,170
171,18,1,1,2,1,2,1,12,7,270,193,15,4,288,171
172,18,1,2,1,0,0,3,9,7,271,195,15,11,288,174
173,18,1,2,1,0,0,3,9,19,272,197,10,7,288,177
174,18,1,0,0,3,1,0,16,6,273,197,20,5,291,177
175,18,0,2,1,0,0,3,8,8,273,199,13,13,291,180
176,18,1,1,2,1,2,1,12,11,274,200,15,2,292,181
177,18,3,1,0,3,1,0,16,15,277,201,11,11,295,181
178,18,1,0,0,3,1,0,20,10,278,201,18,7,298,181
179,18,2,1,0,3,1,0,20,5,280,202,22,12,301,181
180,19,1,3,1,0,0,3,11,14,281,205,11,7,301,184
181,19,0,2,1,0,0,3,12,9,281,207,15,10,301,187
182,19,2,0,0,3,1,0,21,12,283,207,19,8,304,187
183,19,2,0,0,3,1,0,27,6,285,207,28,8,307,187
184,19,1,3,1,0,0,3,20,14,286,210,12,20,307,190
185,19,1,2,1,0,0,3,14,15,287,212,14,9,307,193
186,19,1,2,1,0,0,3,15,12,288,214,16,14,307,196
187,19,3,1,0,3,1,0,23,11,291,215,21,12,310,196
188,19,2,1,0,3,1,0,18,16,293,216,14,5,313,196
189,19,1,1,2,1,2,1,11,13,294,217,11,6,314,197
190,20,4,0,0,3,1,0,13,7,298,217,18,7,317,197
191,20,0,2,1,0,0,3,12,12,298,219,14,8,317,200
192,20,0,2,1,0,0,3,11,7,298,221,19,17,317,203
193,20,2,0,0,3,1,0,16,9,300,221,19,13,320,203
194,20,1,3,1,0,0,3,13,14,301,224,15,10,320,206
195,20,1,1,2,1,2,1,12,16,302,225,10,12,321,207
196,20,1,1,2,1,2,1,9,9,303,226,14,13,322,208
197,20,1,0,0,3,1,0,21,5,304,226,25,10,325,208
198,20,2,2,2,1,2,1,11,21,306,228,11,18,326,209
199,20,0,1,1,0,0,3,16,7,306,229,20,5,326,212
200,21,1,2,1,0,0,3,14,16,307,231,15,16,326,215
201,21,2,1,0,3,1,0,18,8,309,232,23,10,329,215
202,21,1,0,0,3,1,0,14,7,310,232,21,17,332,215
203,21,2,0,0,3,1,0,14,12,312,232,17,12,335,215
204,21,3,0,0,3,1,0,14,7,315,232,22,10,338,215
205,21,1,0,0,3,1,0,17,9,316,232,22,8,341,215
206,21,2,0,0,3,1,0,14,16,318,232,13,5,344,215
207,21,0,3,1,0,0,3,9,12,318,235,14,21,344,218
208,21,3,3,2,1,2,1,24,8,321,238,26,8,345,219
209,21,0,1,1,0,0,3,11,22,321,239,11,16,345,222
210,22,1,2,1,0,0,3,19,18,322,241,14,9,345,225
211,22,2,1,0,3,1,0,29,7,324,242,31,10,348,225
212,22,3,0,0,3,1,0,14,14,327,242,14,8,351,225
213,22,0,0,2,1,2,1,23,11,327,242,22,21,352,226
214,22,1,0,0,3,1,0,15,15,328,242,17,12,355,226
215,22,0,1,1,0,0,3,15,13,328,243,16,11,355,229
216,22,5,0,0,3,1,0,25,14,333,243,15,7,358,229
217,22,1,1,2,1,2,1,22,13,334,244,20,10,359,230
218,22,3,1,0,3,1,0,15,10,337,245,18,5,362,230
219,22,2,1,0,3,1,0,13,14,339,246,14,14,365,230
220,23,2,0,0,3,1,0,26,8,341,246,29,10,368,230
221,23,4,3,0,3,1,0,18,10,345,249,24,5,371,230
222,23,2,0,0,3,1,0,16,12,347,249,20,10,374,230
223,23,3,2,0,3,1,0,17,18,350,251,18,17,377,230
224,23,1,1,2,1,2,1,12,23,351,252,12,9,378,231
225,23,0,3,1,0,0,3,14,19,351,255,13,24,378,234
226,23,1,1,2,1,2,1,10,13,352,256,15,9,379,235
227,23,1,1,2,1,2,1,15,8,353,257,23,17,380,236
228,23,2,2,2,1,2,1,20,10,355,259,24,13,381,237
229,23,0,0,2,1,2,1,17,9,355,259,23,17,382,238
230,24,0,3,1,0,0,3,15,18,355,262,17,8,382,241
231,24,3,0,0,3,1,0,26,11,358,262,25,10,385,241
232,24,1,2,1,0,0,3,20,20,359,264,14,14,385,244
233,24,2,2,2,1,2,1,15,16,361,266,15,8,386,245
234,24,2,0,0,3,1,0,16,14,363,266,17,10,389,245
235,24,5,0,0,3,1,0,34,7,368,266,34,9,392,245
236,24,1,1,2,1,2,1,26,15,369,267,16,15,393,246
237,24,1,0,0,3,1,0,16,13,370,267,19,21,396,246
238,24,2,0,0,3,1,0,17,10,372,267,21,8,399,246
239,24,0,4,1,0,0,3,22,17,372,271,20,15,399,249
240,25,2,1,0,3,1,0,28,12,374,272,28,13,402,249
241,25,2,4,1,0,0,3,17,12,376,276,23,18,402,252
242,25,3,1,0,3,1,0,37,8,379,277,37,9,405,252
243,25,2,2,2,1,2,1,19,20,381,279,19,11,406,253
244,25,2,2,2,1,2,1,12,15,383,281,16,22,407,254
245,25,1,3,1,0,0,3,21,23,384,284,14,11,407,257
246,25,1,0,0,3,1,0,23,17,385,284,23,5,410,257
247,25,0,1,1,0,0,3,17,11,385,285,21,18,410,260
248,25,1,0,0,3,1,0,17,14,386,285,20,17,413,260
249,25,2,0,0,3,1,0,22,10,388,285,27,10,416,260
250,26,3,2,0,3,1,0,19,14,391,287,23,14,419,260
251,26,2,2,2,1,2,1,18,15,393,289,20,10,420,261
252,26,5,3,0,3,1,0,20,19,398,292,18,17,423,261
253,26,3,0,0,3,1,0,21,10,401,292,27,8,426,261
254,26,4,4,2,1,2,1,30,19,405,296,17,25,427,262
255,26,2,1,0,3,1,0,19,10,407,297,26,10,430,262
256,26,4,3,0,3,1,0,16,26,411,300,15,10,433,262
257,26,2,1,0,3,1,0,17,19,413,301,20,17,436,262
258,26,0,1,1,0,0,3,14,20,413,302,13,12,436,265
259,26,0,1,1,0,0,3,26,9,413,303,29,11,436,268
260,27,2,1,0,3,1,0,39,9,415,304,40,22,439,268
261,27,2,0,0,3,1,0,30,12,417,304,31,5,442,268
262,27,1,0,0,3,1,0,13,15,418,304,19,10,445,268
263,27,0,0,2,1,2,1,17,11,418,304,22,18,446,269
264,27,1,1,2,1,2,1,22,24,419,305,15,10,447,270
265,27,1,1,2,1,2,1,23,11,420,306,28,12,448,271
266,27,3,3,2,1,2,1,22,23,423,309,20,12,449,272
267,27,1,2,1,0,0,3,18,14,424,311,23,21,449,275
268,27,2,0,0,3,1,0,25,17,426,311,26,13,452,275
269,27,0,0,2,1,2,1,17,14,426,311,21,19,453,276
270,28,4,1,0,3,1,0,22,16,430,312,23,10,456,276
271,28,2,0,0,3,1,0,22,19,432,312,21,14,459,276
272,28,1,1,2,1,2,1,31,20,433,313,18,11,460,277
273,28,0,4,1,0,0,3,16,30,433,317,15,20,460,280
274,28,4,0,0,3,1,0,21,19,437,317,23,17,463,280
275,28,3,1,0,3,1,0,17,21,440,318,16,11,466,280
276,28,1,1,2,1,2,1,22,11,441,319,28,11,467,281
277,28,1,1,2,1,2,1,20,15,442,320,24,9,468,282
278,28,3,1,0,3,1,0,29,10,445,321,32,12,471,282
279,28,3,3,2,1,2,1,22,13,448,324,27,26,472,283
280,29,1,3,1,0,0,3,14,18,449,327,19,12,472,286
281,29,0,0,2,1,2,1,30,12,449,327,32,15,473,287
282,29,3,2,0,3,1,0,28,19,452,329,29,10,476,287
283,29,3,2,0,3,1,0,20,16,455,331,24,10,479,287
284,29,1,2,1,0,0,3,32,22,456,333,18,16,479,290
285,29,3,0,0,3,1,0,20,21,459,333,19,10,482,290
286,29,1,0,0,3,1,0,23,11,460,333,31,12,485,290
287,29,3,1,0,3,1,0,26,12,463,334,31,20,488,290
288,29,3,3,2,1,2,1,24,22,466,337,24,22,489,291
289,29,1,3,1,0,0,3,23,27,467,340,15,22,489,294
290,30,0,0,2,1,2,1,22,13,467,340,28,13,490,295
291,30,0,1,1,0,0,3,22,17,467,341,23,8,490,298
292,30,2,2,2,1,2,1,19,13,469,343,23,18,491,299
293,30,1,0,0,3,1,0,40,9,470,343,43,11,494,299
294,30,4,0,0,3,1,0,24,15,474,343,27,18,497,299
295,30,2,2,2,1,2,1,24,25,476,345,21,27,498,300
296,30,2,1,0,3,1,0,18,31,478,346,18,12,501,300
297,30,2,1,0,3,1,0,24,20,480,347,24,11,504,300
298,30,0,2,1,0,0,3,18,16,480,349,23,14,504,303
299,30,2,0,0,3,1,0,31,10,482,349,35,22,507,303
300,31,2,4,1,0,0,3,22,25,484,353,19,23,507,306
301,31,2,1,0,3,1,0,16,19,486,354,22,11,510,306
302,31,2,2,2,1,2,1,26,22,488,356,25,11,511,307
303,31,4,1,0,3,1,0,36,23,492,357,21,8,514,307
304,31,1,1,2,1,2,1,25,16,493,358,28,23,515,308
305,31,2,1,0,3,1,0,26,26,495,359,24,14,518,308
306,31,0,0,2,1,2,1,18,31,495,359,19,23,519,309
307,31,0,0,2,1,2,1,30,12,495,359,33,11,520,310
308,31,3,0,0,3,1,0,23,16,498,359,27,18,523,310
309,31,5,0,0,3,1,0,28,11,503,359,34,15,526,310
310,32,0,3,1,0,0,3,24,25,503,362,24,19,526,313
311,32,1,1,2,1,2,1,20,14,504,363,24,13,527,314
312,32,3,0,0,3,1,0,31,19,507,363,32,13,530,314
313,32,1,0,0,3,1,0,32,10,508,363,38,12,533,314
314,32,2,0,0,3,1,0,42,9,510,363,46,11,536,314
315,32,2,3,1,0,0,3,20,19,512,366,23,15,536,317
316,32,3,2,0,3,1,0,25,15,515,368,31,10,539,317
317,32,1,3,1,0,0,3,24,30,516,371,15,30,539,320
318,32,1,0,0,3,1,0,23,17,517,371,26,18,542,320
319,32,3,0,0,3,1,0,29,12,520,371,34,22,545,320
320,33,2,0,0,3,1,0,18,19,522,371,25,15,548,320
321,33,2,0,0,3,1,0,28,22,524,371,28,11,551,320
322,33,1,3,1,0,0,3,27,29,525,374,24,26,551,323
323,33,1,2,1,0,0,3,23,27,526,376,19,14,551,326
324,33,1,3,1,0,0,3,25,33,527,379,15,15,551,329
325,33,1,1,2,1,2,1,31,13,528,380,34,15,552,330
326,33,0,0,2,1,2,1,36,23,528,380,22,24,553,331
327,33,3,0,0,3,1,0,28,16,531,380,31,8,556,331
328,33,3,0,0,3,1,0,26,16,534,380,30,11,559,331
329,33,1,0,0,3,1,0,29,11,535,380,37,23,562,331
330,34,1,0,0,3,1,0,43,9,536,380,49,19,565,331
331,34,1,1,2,1,2,1,24,18,537,381,27,11,566,332
332,34,1,1,2,1,2,1,26,34,538,382,16,19,567,333
333,34,5,0,0,3,1,0,34,12,543,382,37,13,570,333
334,34,4,2,0,3,1,0,24,21,547,384,26,15,573,333
335,34,2,2,2,1,2,1,27,17,549,386,32,16,574,334
336,34,1,1,2,1,2,1,25,26,550,387,25,12,575,335
337,34,3,0,0,3,1,0,35,10,553,387,41,13,578,335
338,34,2,1,0,3,1,0,33,20,555,388,35,30,581,335
339,34,0,1,1,0,0,3,20,15,555,389,24,25,581,338
340,35,1,0,0,3,1,0,21,15,556,389,27,11,584,338
341,35,0,0,2,1,2,1,26,34,556,389,17,12,585,339
342,35,0,3,1,0,0,3,24,24,556,392,26,15,585,342
343,35,2,1,0,3,1,0,29,30,558,393,27,14,588,342
344,35,1,1,2,1,2,1,19,32,559,394,20,20,589,343
345,35,2,1,0,3,1,0,37,11,561,395,44,23,592,343
346,35,1,1,2,1,2,1,19,20,562,396,26,9,593,344
347,35,3,0,0,3,1,0,37,12,565,396,40,19,596,344
348,35,1,0,0,3,1,0,32,13,566,396,37,24,599,344
349,35,2,1,0,3,1,0,31,12,568,397,40,13,602,344
350,36,1,1,2,1,2,1,25,19,569,398,28,16,603,345
351,36,1,2,1,0,0,3,34,22,570,400,35,18,603,348
352,36,2,1,0,3,1,0,30,23,572,401,31,25,606,348
353,36,2,1,0,3,1,0,38,24,574,402,25,13,609,348
354,36,1,1,2,1,2,1,24,28,575,403,20,12,610,349
355,36,1,1,2,1,2,1,28,18,576,404,33,19,611,350
356,36,3,1,0,3,1,0,28,27,579,405,28,16,614,350
357,36,3,1,0,3,1,0,31,17,582,406,34,30,617,350
358,36,2,1,0,3,1,0,45,10,584,407,52,26,620,350
359,36,2,5,1,0,0,3,28,21,586,412,30,18,620,353
360,37,1,1,2,1,2,1,22,16,587,413,28,25,621,354
361,37,4,3,0,3,1,0,30,37,591,416,20,11,624,354
362,37,1,3,1,0,0,3,25,27,592,419,26,12,624,357
363,37,1,0,0,3,1,0,30,30,593,419,30,20,627,357
364,37,2,2,2,1,2,1,39,13,595,421,45,20,628,358
365,37,1,2,1,0,0,3,33,15,596,423,37,17,628,361
366,37,0,2,1,0,0,3,19,22,596,425,26,18,628,364
367,37,0,2,1,0,0,3,37,14,596,427,40,26,628,367
368,37,3,2,0,3,1,0,22,34,599,429,23,13,631,367
369,37,3,0,0,3,1,0,34,12,602,429,43,12,634,367
370,38,1,0,0,3,1,0,26,19,603,429,31,18,637,367
371,38,0,2,1,0,0,3,34,24,603,431,35,28,637,370
372,38,1,0,0,3,1,0,31,23,604,431,34,26,640,370
373,38,2,2,2,1,2,1,30,23,606,433,31,31,641,371
374,38,4,2,0,3,1,0,49,12,610,435,55,19,644,371
375,38,3,3,2,1,2,1,41,27,613,438,26,17,645,372
376,38,0,1,1,0,0,3,31,18,613,439,34,19,645,375
377,38,2,1,0,3,1,0,30,19,615,440,36,13,648,375
378,38,0,3,1,0,0,3,24,31,615,443,20,21,648,378
379,38,2,3,1,0,0,3,30,30,617,446,28,15,648,381
0,1,1,2,1,0,0,3,23,18,618,448,28,15,648,384
1,1,0,0,2,1,2,1,30,23,618,448,32,18,649,385
2,1,1,1,2,1,2,1,38,15,619,449,41,22,650,386
3,1,0,4,1,0,0,3,0,4,619,453,0,14,650,389
4,1,1,1,2,1,2,1,23,35,620,454,24,1,651,390
5,1,0,0,2,1,2,1,41,27,620,454,27,32,652,391
6,1,0,0,2,1,2,1,31,18,620,454,35,27,653,392
7,1,1,2,1,0,0,3,31,32,621,456,30,28,653,395
8,1,4,0,0,3,1,0,38,12,625,456,46,0,656,395
9,1,2,0,0,3,1,0,32,19,627,456,39,20,659,395
10,2,0,1,1,0,0,3,25,28,627,457,26,23,659,398
11,2,0,2,1,0,0,3,33,17,627,459,37,21,659,401
12,2,3,1,0,3,1,0,29,20,630,460,34,15,662,401
13,2,0,1,1,0,0,3,31,24,630,461,34,3,662,404
14,2,0,0,2,1,2,1,0,0,630,461,1,20,663,405
15,2,2,1,0,3,1,0,41,14,632,462,48,17,666,405
16,2,1,1,2,1,2,1,1,1,633,463,1,13,667,406
17,2,2,0,0,3,1,0,32,30,635,463,31,18,670,406
18,2,2,3,1,0,0,3,36,27,637,466,35,31,670,409
19,2,3,0,0,3,1,0,52,12,640,466,58,26,673,409
20,3,0,0,2,1,2,1,29,20,640,466,35,16,674,410
21,3,2,0,0,3,1,0,25,35,642,466,27,3,677,410
22,3,0,1,1,0,0,3,23,19,642,467,28,23,677,413
23,3,3,1,0,3,1,0,44,15,645,468,51,1,680,413
24,3,0,0,2,1,2,1,0,0,645,468,2,23,681,414
25,3,3,1,0,3,1,0,41,16,648,469,44,14,684,414
26,3,2,1,0,3,1,0,43,28,650,470,30,18,687,414
27,3,1,5,1,0,0,3,33,24,651,475,39,34,687,417
28,3,0,1,1,0,0,3,31,33,651,476,30,16,687,420
29,3,8,2,0,3,1,0,60,14,659,478,61,32,690,420
30,4,1,0,0,3,1,0,34,17,660,478,40,0,693,420
31,4,2,2,2,1,2,1,33,26,662,480,35,19,694,421
32,4,3,0,0,3,1,0,41,12,665,480,49,20,697,421
33,4,1,0,0,3,1,0,32,18,666,480,38,21,700,421
34,4,1,2,1,0,0,3,26,30,667,482,26,30,700,424
35,4,0,2,1,0,0,3,32,32,667,484,31,29,700,427
36,4,0,5,1,0,0,3,36,32,667,489,35,31,700,430
37,4,0,1,1,0,0,3,1,2,667,490,1,20,700,433
38,4,1,1,2,1,2,1,31,24,668,491,33,16,701,434
39,4,0,0,2,1,2,1,0,4,668,491,1,24,702,435
40,5,4,3,0,3,1,0,27,22,672,494,31,32,705,435
41,5,1,1,2,1,2,1,30,21,673,495,36,25,706,436
42,5,1,2,1,0,0,3,37,34,674,497,35,4,706,439
43,5,3,1,0,3,1,0,36,27,677,498,38,20,709,439
44,5,3,0,0,3,1,0,3,0,680,498,5,20,712,439
45,5,0,3,1,0,0,3,32,35,680,501,31,6,712,442
46,5,4,0,0,3,1,0,37,24,684,501,42,21,715,442
47,5,2,2,2,1,2,1,33,26,686,503,34,35,716,443
48,5,4,0,0,3,1,0,30,30,690,503,29,16,719,443
49,5,3,1,0,3,1,0,63,15,693,504,64,30,722,443
50,6,2,0,0,3,1,0,43,12,695,504,52,23,725,443
51,6,3,0,0,3,1,0,37,17,698,504,43,14,728,443
52,6,4,1,0,3,1,0,48,16,702,505,54,0,731,443
53,6,2,1,0,3,1,0,43,17,704,506,47,16,734,443
54,6,3,1,0,3,1,0,46,29,707,507,33,16,737,443
55,6,0,0,2,1,2,1,31,33,707,507,31,19,738,444
56,6,1,2,1,0,0,3,26,37,708,509,27,32,738,447
57,6,1,1,2,1,2,1,33,19,709,510,39,32,739,448
58,6,1,1,2,1,2,1,1,5,710,511,2,20,740,449
59,6,2,1,0,3,1,0,3,3,712,512,4,23,743,449
60,7,0,2,1,0,0,3,36,29,712,514,38,24,743,452
61,7,2,0,0,3,1,0,32,21,714,514,39,20,746,452
62,7,0,4,1,0,0,3,27,26,714,518,31,38,746,455
63,7,2,0,0,3,1,0,65,15,716,518,67,4,749,455
64,7,2,2,2,1,2,1,32,32,718,520,30,21,750,456
65,7,1,2,1,0,0,3,33,37,719,522,31,28,750,459
66,7,1,5,1,0,0,3,38,39,720,527,35,33,750,462
67,7,6,0,0,3,1,0,39,26,726,527,37,6,753,462
68,7,2,0,0,3,1,0,5,0,728,527,8,16,756,462
69,7,2,1,0,3,1,0,39,25,730,528,45,32,759,462
70,8,1,1,2,1,2,1,44,18,731,529,48,33,760,463
71,8,4,1,0,3,1,0,47,13,735,530,55,20,763,463
72,8,3,1,0,3,1,0,6,4,738,531,7,0,766,463
73,8,1,1,2,1,2,1,2,6,739,532,3,17,767,464
74,8,2,0,0,3,1,0,35,19,741,532,42,19,770,464
75,8,1,3,1,0,0,3,27,40,742,535,27,17,770,467
76,8,3,1,0,3,1,0,51,17,745,536,57,23,773,467
77,8,2,0,0,3,1,0,33,33,747,536,34,16,776,467
78,8,2,1,0,3,1,0,39,18,749,537,46,23,779,467
79,8,2,2,2,1,2,1,48,31,751,539,34,33,780,468
80,9,2,2,2,1,2,1,35,39,753,541,32,1,781,469
81,9,1,2,1,0,0,3,33,23,754,543,39,24,781,472
82,9,0,2,1,0,0,3,38,41,754,545,35,26,781,475
83,9,1,0,0,3,1,0,49,31,755,545,37,20,784,475
84,9,1,1,2,1,2,1,45,19,756,546,49,5,785,476
85,9,3,1,0,3,1,0,42,19,759,547,49,16,788,476
86,9,1,3,1,0,0,3,40,29,760,550,37,26,788,479
87,9,1,6,1,0,0,3,66,21,761,556,67,41,788,482
88,9,1,2,1,0,0,3,28,28,762,558,31,36,788,485
89,9,1,0,0,3,1,0,3,6,763,558,6,33,791,485
90,10,0,1,1,0,0,3,36,30,763,559,38,36,791,488
91,10,3,5,1,0,0,3,54,22,766,564,57,35,791,491
92,10,3,1,0,3,1,0,50,14,769,565,58,16,794,491
93,10,3,3,2,1,2,1,9,7,772,568,8,18,795,492
94,10,2,2,2,1,2,1,34,34,774,570,31,21,796,493
95,10,3,1,0,3,1,0,8,1,777,571,11,17,799,493
96,10,0,2,1,0,0,3,27,42,777,573,27,22,799,496
97,10,0,2,1,0,0,3,33,35,777,575,34,27,799,499
98,10,3,1,0,3,1,0,42,26,780,576,48,6,802,499
99,10,1,3,1,0,0,3,36,22,781,579,42,31,802,502
100,11,2,1,0,3,1,0,51,32,783,580,40,26,805,502
101,11,3,0,0,3,1,0,45,19,786,580,52,24,808,502
102,11,3,2,0,3,1,0,36,25,789,582,42,5,811,502
103,11,0,1,1,0,0,3,28,29,789,583,31,36,811,505
104,11,0,0,2,1,2,1,45,19,789,583,50,2,812,506
105,11,1,0,0,3,1,0,67,21,790,583,70,26,815,506
106,11,2,3,1,0,0,3,5,9,792,586,6,44,815,509
107,11,3,1,0,3,1,0,38,40,795,587,35,20,818,509
108,11,5,0,0,3,1,0,43,41,800,587,38,16,821,509
109,11,1,3,1,0,0,3,41,32,801,590,37,39,821,512
110,12,1,2,1,0,0,3,10,9,802,592,8,38,821,515
111,12,2,1,0,3,1,0,38,31,804,593,41,16,824,515
112,12,3,1,0,3,1,0,53,15,807,594,61,31,827,515
113,12,2,3,1,0,0,3,38,25,809,597,42,9,827,518
114,12,0,0,2,1,2,1,34,34,809,597,32,23,828,519
115,12,2,1,0,3,1,0,35,36,811,598,37,17,831,519
116,12,3,3,2,1,2,1,30,45,814,601,28,19,832,520
117,12,0,1,1,0,0,3,8,2,814,602,11,39,832,523
118,12,1,2,1,0,0,3,55,24,815,604,57,30,832,526
119,12,2,0,0,3,1,0,44,26,817,604,51,21,835,526
120,13,3,1,0,3,1,0,41,26,820,605,45,19,838,526
121,13,0,2,1,0,0,3,43,43,820,607,38,29,838,529
122,13,3,0,0,3,1,0,58,24,823,607,60,16,841,529
123,13,1,1,2,1,2,1,68,22,824,608,71,32,842,530
124,13,2,1,0,3,1,0,12,10,826,609,11,9,845,530
125,13,1,2,1,0,0,3,35,36,827,611,32,23,845,533
126,13,1,3,1,0,0,3,36,39,828,614,37,42,845,536
127,13,1,1,2,1,2,1,46,20,829,615,53,24,846,537
128,13,0,0,2,1,2,1,8,2,829,615,12,22,847,538
129,13,1,1,2,1,2,1,46,20,830,616,51,45,848,539
130,14,0,3,1,0,0,3,51,35,830,619,40,39,848,542
131,14,4,2,0,3,1,0,32,31,834,621,34,2,851,542
132,14,5,1,0,3,1,0,58,16,839,622,64,5,854,542
133,14,1,1,2,1,2,1,6,10,840,623,7,25,855,543
134,14,3,0,0,3,1,0,47,26,843,623,54,17,858,543
135,14,0,4,1,0,0,3,30,49,843,627,28,41,858,546
136,14,0,1,1,0,0,3,36,26,843,628,42,42,858,549
137,14,0,1,1,0,0,3,38,32,843,629,41,19,858,552
138,14,2,1,0,3,1,0,40,41,845,630,38,26,861,552
139,14,1,0,0,3,1,0,42,32,846,630,40,30,864,552
140,15,1,0,0,3,1,0,47,20,847,630,56,29,867,552
141,15,1,2,1,0,0,3,44,45,848,632,38,25,867,555
142,15,1,0,0,3,1,0,47,20,849,632,54,9,870,555
143,15,4,1,0,3,1,0,72,23,853,633,74,16,873,555
144,15,4,2,0,3,1,0,16,12,857,635,14,32,876,555
145,15,2,0,0,3,1,0,10,2,859,635,15,24,879,555
146,15,1,2,1,0,0,3,37,41,860,637,37,26,879,558
147,15,2,1,0,3,1,0,37,37,862,638,35,19,882,558
148,15,2,1,0,3,1,0,43,27,864,639,48,42,885,558
149,15,2,1,0,3,1,0,60,25,866,640,63,45,888,558
150,16,1,2,1,0,0,3,33,33,867,642,34,28,888,561
151,16,1,1,2,1,2,1,39,33,868,643,42,6,889,562
152,16,2,0,0,3,1,0,44,32,870,643,43,17,892,562
153,16,0,0,2,1,2,1,51,35,870,643,41,3,893,563
154,16,1,2,1,0,0,3,41,43,871,645,38,22,893,566
155,16,1,1,2,1,2,1,31,50,872,646,29,40,894,567
156,16,0,2,1,0,0,3,6,12,872,648,7,45,894,570
157,16,0,2,1,0,0,3,36,28,872,650,42,33,894,573
158,16,1,0,0,3,1,0,48,26,873,650,57,26,897,573
159,16,1,0,0,3,1,0,59,16,874,650,67,41,900,573
160,17,2,2,2,1,2,1,43,45,876,652,39,7,901,574
161,17,1,2,1,0,0,3,34,35,877,654,34,20,901,577
162,17,1,2,1,0,0,3,37,30,878,656,42,44,901,580
163,17,3,0,0,3,1,0,62,16,881,656,70,22,904,580
164,17,2,3,1,0,0,3,53,38,883,659,41,31,904,583
165,17,0,0,2,1,2,1,31,50,883,659,30,34,905,584
166,17,2,3,1,0,0,3,8,15,885,662,7,29,905,587
167,17,1,0,0,3,1,0,40,33,886,662,45,3,908,587
168,17,0,5,1,0,0,3,44,37,886,667,43,48,908,590
169,17,1,1,2,1,2,1,49,27,887,668,58,41,909,591
170,18,1,1,2,1,2,1,61,26,888,669,64,25,910,592
171,18,0,2,1,0,0,3,44,47,888,671,38,35,910,595
172,18,1,1,2,1,2,1,48,21,889,672,55,20,911,596
173,18,5,0,0,3,1,0,77,23,894,672,77,26,914,596
174,18,1,1,2,1,2,1,38,38,895,673,36,30,915,597
175,18,0,0,2,1,2,1,37,41,895,673,38,46,916,598
176,18,0,0,2,1,2,1,43,27,895,673,49,26,917,599
177,18,1,1,2,1,2,1,48,21,896,674,57,17,918,600
178,18,1,1,2,1,2,1,11,3,897,675,16,10,919,601
179,18,0,2,1,0,0,3,16,14,897,677,14,45,919,604
180,19,3,1,0,3,1,0,51,22,900,678,58,35,922,604
181,19,2,3,1,0,0,3,79,26,902,681,77,23,922,607
182,19,1,0,0,3,1,0,49,21,903,681,60,10,925,607
183,19,1,1,2,1,2,1,45,48,904,682,39,18,926,608
184,19,1,3,1,0,0,3,62,29,905,685,64,29,926,611
185,19,1,1,2,1,2,1,17,15,906,686,15,26,927,612
186,19,2,2,2,1,2,1,45,29,908,688,50,27,928,613
187,19,1,1,2,1,2,1,12,4,909,689,17,46,929,614
188,19,0,1,1,0,0,3,37,42,909,690,38,33,929,617
189,19,1,0,0,3,1,0,39,38,910,690,39,46,932,617
190,20,0,2,1,0,0,3,37,32,910,692,42,6,932,620
191,20,1,2,1,0,0,3,35,37,911,694,34,25,932,623
192,20,1,2,1,0,0,3,9,17,912,696,7,10,932,626
193,20,1,2,1,0,0,3,44,47,913,698,39,44,932,629
194,20,2,1,0,3,1,0,46,38,915,699,46,44,935,629
195,20,1,0,0,3,1,0,50,27,916,699,61,31,938,629
196,20,1,4,1,0,0,3,32,54,917,703,30,32,938,632
197,20,3,0,0,3,1,0,65,16,920,703,73,34,941,632
198,20,1,2,1,0,0,3,41,35,921,705,45,23,941,635
199,20,3,0,0,3,1,0,56,38,924,705,44,48,944,635
200,21,1,1,2,1,2,1,38,33,925,706,43,34,945,636
201,21,3,1,0,3,1,0,38,38,928,707,37,26,948,636
202,21,1,0,0,3,1,0,63,29,929,707,67,32,951,636
203,21,0,0,2,1,2,1,51,22,929,707,59,26,952,637
204,21,3,0,0,3,1,0,82,26,932,707,80,23,955,637
205,21,1,1,2,1,2,1,51,28,933,708,62,19,956,638
206,21,1,2,1,0,0,3,38,44,934,710,38,13,956,641
207,21,1,0,0,3,1,0,57,38,935,710,47,10,959,641
208,21,3,2,0,3,1,0,15,6,938,712,20,44,962,641
209,21,0,1,1,0,0,3,32,55,938,713,30,49,962,644
210,22,0,0,2,1,2,1,17,15,938,713,16,45,963,645
211,22,1,1,2,1,2,1,42,36,939,714,46,24,964,646
212,22,5,2,0,3,1,0,51,40,944,716,49,35,967,646
213,22,3,1,0,3,1,0,12,18,947,717,10,27,970,646
214,22,1,2,1,0,0,3,46,31,948,719,50,34,970,649
215,22,2,0,0,3,1,0,41,38,950,719,42,6,973,649
216,22,2,3,1,0,0,3,46,50,952,722,39,32,973,652
217,22,3,1,0,3,1,0,48,49,955,723,42,34,976,652
218,22,3,2,0,3,1,0,68,18,958,725,76,46,979,652
219,22,1,2,1,0,0,3,50,23,959,727,60,51,979,655
220,23,1,1,2,1,2,1,16,7,960,728,21,46,980,656
221,23,3,1,0,3,1,0,54,29,963,729,65,27,983,656
222,23,0,3,1,0,0,3,46,53,963,732,39,37,983,659
223,23,2,0,0,3,1,0,84,26,965,732,83,26,986,659
224,23,1,0,0,3,1,0,43,36,966,732,49,49,989,659
225,23,2,2,2,1,2,1,40,35,968,734,44,11,990,660
226,23,3,0,0,3,1,0,44,38,971,734,45,13,993,660
227,23,0,0,2,1,2,1,48,49,971,734,43,45,994,661
228,23,1,1,2,1,2,1,52,41,972,735,50,35,995,662
229,23,0,2,1,0,0,3,38,40,972,737,37,38,995,665
230,24,7,1,0,3,1,0,57,24,979,738,63,24,998,665
231,24,2,0,0,3,1,0,19,15,981,738,19,23,1001,665
232,24,1,2,1,0,0,3,13,20,982,740,10,22,1001,668
233,24,0,1,1,0,0,3,46,32,982,741,50,35,1001,671
234,24,1,2,1,0,0,3,39,46,983,743,38,9,1001,674
235,24,1,1,2,1,2,1,33,56,984,744,31,35,1002,675
236,24,3,0,0,3,1,0,71,18,987,744,79,26,1005,675
237,24,2,1,0,3,1,0,59,39,989,745,50,32,1008,675
238,24,3,3,2,1,2,1,66,32,992,748,68,52,1009,676
239,24,0,0,2,1,2,1,51,22,992,748,60,47,1010,677
240,25,2,1,0,3,1,0,86,27,994,749,86,37,1013,677
241,25,3,2,0,3,1,0,41,42,997,751,40,11,1016,677
242,25,1,2,1,0,0,3,49,51,998,753,43,30,1016,680
243,25,2,0,0,3,1,0,45,36,1000,753,52,46,1019,680
244,25,2,1,0,3,1,0,54,42,1002,754,53,26,1022,680
245,25,1,2,1,0,0,3,45,40,1003,756,45,48,1022,683
246,25,2,3,1,0,0,3,18,10,1005,759,21,16,1022,686
247,25,5,0,0,3,1,0,59,29,1010,759,68,38,1025,686
248,25,1,5,1,0,0,3,47,58,1011,764,39,38,1025,689
249,25,0,1,1,0,0,3,40,36,1011,765,44,52,1025,692
250,26,3,0,0,3,1,0,69,32,1014,765,71,23,1028,692
251,26,2,2,2,1,2,1,61,41,1016,767,51,23,1029,693
252,26,0,1,1,0,0,3,13,21,1016,768,10,29,1029,696
253,26,4,0,0,3,1,0,43,46,1020,768,41,35,1032,696
254,26,0,0,2,1,2,1,33,56,1020,768,32,33,1033,697
255,26,3,0,0,3,1,0,74,18,1023,768,82,24,1036,697
256,26,5,2,0,3,1,0,62,26,1028,770,66,47,1039,697
257,26,1,2,1,0,0,3,20,17,1029,772,19,55,1039,700
258,26,2,0,0,3,1,0,48,32,1031,772,53,9,1042,700
259,26,3,0,0,3,1,0,54,22,1034,772,63,35,1045,700
260,27,1,2,1,0,0,3,55,24,1035,774,63,51,1045,703
261,27,1,1,2,1,2,1,42,43,1036,775,41,34,1046,704
262,27,2,0,0,3,1,0,76,18,1038,775,85,23,1049,704
263,27,1,1,2,1,2,1,14,22,1039,776,11,36,1050,705
264,27,1,0,0,3,1,0,49,32,1040,776,56,16,1053,705
265,27,1,0,0,3,1,0,44,46,1041,776,44,46,1056,705
266,27,0,2,1,0,0,3,33,58,1041,778,32,12,1056,708
267,27,1,1,2,1,2,1,62,42,1042,779,52,36,1057,709
268,27,5,0,0,3,1,0,59,42,1047,779,56,23,1060,709
269,27,1,3,1,0,0,3,60,32,1048,782,68,58,1060,712
270,28,2,1,0,3,1,0,51,52,1050,783,46,11,1063,712
271,28,1,0,0,3,1,0,41,36,1051,783,47,29,1066,712
272,28,1,0,0,3,1,0,70,32,1052,783,74,26,1069,712
273,28,1,0,0,3,1,0,46,40,1053,783,48,37,1072,712
274,28,0,2,1,0,0,3,47,60,1053,785,39,27,1072,715
275,28,1,0,0,3,1,0,46,36,1054,785,55,47,1075,715
276,28,2,0,0,3,1,0,88,27,1056,785,89,38,1078,715
277,28,1,0,0,3,1,0,19,10,1057,785,24,52,1081,715
278,28,1,1,2,1,2,1,21,18,1058,786,20,31,1082,716
279,28,2,1,0,3,1,0,64,27,1060,787,69,38,1085,716
280,29,1,1,2,1,2,1,34,59,1061,788,33,39,1086,717
281,29,0,3,1,0,0,3,59,45,1061,791,56,15,1086,720
282,29,0,5,1,0,0,3,47,65,1061,796,39,61,1086,723
283,29,1,0,0,3,1,0,63,42,1062,796,55,16,1089,723
284,29,2,0,0,3,1,0,44,43,1064,796,44,36,1092,723
285,29,2,1,0,3,1,0,78,19,1066,797,88,46,1095,723
286,29,1,1,2,1,2,1,61,33,1067,798,69,27,1096,724
287,29,0,1,1,0,0,3,46,37,1067,799,55,54,1096,727
288,29,3,2,0,3,1,0,17,24,1070,801,14,37,1099,727
289,29,1,2,1,0,0,3,42,38,1071,803,47,26,1099,730
290,30,0,0,2,1,2,1,70,32,1071,803,75,48,1100,731
291,30,3,0,0,3,1,0,67,27,1074,803,72,34,1103,731
292,30,2,1,0,3,1,0,53,53,1076,804,49,27,1106,731
293,30,1,2,1,0,0,3,56,26,1077,806,63,34,1106,734
294,30,2,1,0,3,1,0,23,19,1079,807,23,23,1109,734
295,30,3,1,0,3,1,0,49,41,1082,808,51,11,1112,734
296,30,0,2,1,0,0,3,19,12,1082,810,24,39,1112,737
297,30,1,1,2,1,2,1,50,33,1083,811,57,53,1113,738
298,30,1,3,1,0,0,3,45,49,1084,814,44,41,1113,741
299,30,1,0,0,3,1,0,89,27,1085,814,92,29,1116,741
300,31,2,4,1,0,0,3,44,42,1087,818,47,49,1116,744
301,31,2,0,0,3,1,0,48,37,1089,818,58,39,1119,744
302,31,2,1,0,3,1,0,61,46,1091,819,59,16,1122,744
303,31,3,3,2,1,2,1,81,22,1094,822,89,37,1123,745
304,31,2,1,0,3,1,0,19,25,1096,823,17,54,1126,745
305,31,2,0,0,3,1,0,36,59,1098,823,36,27,1129,745
306,31,2,3,1,0,0,3,49,68,1100,826,39,29,1129,748
307,31,2,0,0,3,1,0,65,42,1102,826,58,37,1132,748
308,31,3,1,0,3,1,0,64,34,1105,827,72,15,1135,748
309,31,0,2,1,0,0,3,44,45,1105,829,44,64,1135,751
310,32,0,2,1,0,0,3,19,14,1105,831,24,44,1135,754
311,32,0,0,2,1,2,1,49,41,1105,831,52,49,1136,755
312,32,0,3,1,0,0,3,53,56,1105,834,49,32,1136,758
313,32,2,1,0,3,1,0,72,33,1107,835,78,34,1139,758
314,32,1,1,2,1,2,1,57,27,1108,836,64,35,1140,759
315,32,2,2,2,1,2,1,25,21,1110,838,24,40,1141,760
316,32,3,0,0,3,1,0,48,49,1113,838,47,27,1144,760
317,32,2,1,0,3,1,0,52,34,1115,839,60,23,1147,760
318,32,2,0,0,3,1,0,91,27,1117,839,95,11,1150,760
319,32,1,0,0,3,1,0,68,27,1118,839,75,53,1153,760
320,33,4,0,0,3,1,0,52,37,1122,839,61,37,1156,760
321,33,2,0,0,3,1,0,67,42,1124,839,61,29,1159,760
322,33,1,2,1,0,0,3,65,36,1125,841,72,19,1159,763
323,33,1,1,2,1,2,1,45,43,1126,842,48,28,1160,764
324,33,1,1,2,1,2,1,62,47,1127,843,60,50,1161,765
325,33,2,3,1,0,0,3,46,48,1129,846,44,40,1161,768
326,33,4,0,0,3,1,0,85,22,1133,846,92,39,1164,768
327,33,1,0,0,3,1,0,37,59,1134,846,39,64,1167,768
328,33,0,3,1,0,0,3,49,71,1134,849,39,57,1167,771
329,33,3,0,0,3,1,0,22,25,1137,849,20,15,1170,771
330,34,1,6,1,0,0,3,26,27,1138,855,24,56,1170,774
331,34,0,0,2,1,2,1,49,41,1138,855,53,24,1171,775
332,34,3,0,0,3,1,0,22,14,1141,855,27,27,1174,775
333,34,1,0,0,3,1,0,49,49,1142,855,50,11,1177,775
334,34,4,0,0,3,1,0,95,27,1146,855,98,35,1180,775
335,34,1,2,1,0,0,3,69,29,1147,857,75,37,1180,778
336,34,0,1,1,0,0,3,57,28,1147,858,64,35,1180,781
337,34,1,1,2,1,2,1,53,35,1148,859,61,41,1181,782
338,34,0,2,1,0,0,3,72,35,1148,861,78,47,1181,785
339,34,1,4,1,0,0,3,54,60,1149,865,49,52,1181,788
340,35,0,0,2,1,2,1,69,29,1149,865,76,51,1182,789
341,35,0,0,2,1,2,1,45,43,1149,865,49,38,1183,790
342,35,2,0,0,3,1,0,48,48,1151,865,47,19,1186,790
343,35,1,1,2,1,2,1,55,61,1152,866,50,16,1187,791
344,35,2,1,0,3,1,0,64,48,1154,867,63,37,1190,791
345,35,3,0,0,3,1,0,70,42,1157,867,64,28,1193,791
346,35,1,0,0,3,1,0,23,25,1158,867,23,52,1196,791
347,35,4,4,2,1,2,1,99,31,1162,871,99,42,1197,792
348,35,0,1,1,0,0,3,57,29,1162,872,64,42,1197,795
349,35,0,2,1,0,0,3,49,73,1162,874,39,59,1197,798
350,36,4,0,0,3,1,0,56,37,1166,874,64,35,1200,798
351,36,1,1,2,1,2,1,54,36,1167,875,62,58,1201,799
352,36,2,2,2,1,2,1,51,43,1169,877,54,30,1202,800
353,36,4,4,2,1,2,1,26,18,1173,881,28,25,1203,801
354,36,0,0,2,1,2,1,49,49,1173,881,51,36,1204,802
355,36,4,0,0,3,1,0,41,59,1177,881,42,47,1207,802
356,36,0,3,1,0,0,3,26,30,1177,884,24,43,1207,805
357,36,6,1,0,3,1,0,78,36,1183,885,81,11,1210,805
358,36,2,0,0,3,1,0,67,36,1185,885,75,27,1213,805
359,36,1,0,0,3,1,0,86,22,1186,885,95,64,1216,805
360,37,3,3,2,1,2,1,72,32,1189,888,77,20,1217,806
361,37,0,2,1,0,0,3,70,44,1189,890,64,62,1217,809
362,37,1,1,2,1,2,1,46,44,1190,891,50,53,1218,810
363,37,2,2,2,1,2,1,57,63,1192,893,51,43,1219,811
364,37,2,1,0,3,1,0,66,49,1194,894,66,38,1222,811
365,37,1,0,0,3,1,0,24,25,1195,894,26,28,1225,811
366,37,0,0,2,1,2,1,49,73,1195,894,40,43,1226,812
367,37,2,0,0,3,1,0,101,31,1197,894,102,16,1229,812
368,37,0,1,1,0,0,3,48,49,1197,895,47,40,1229,815
369,37,4,1,0,3,1,0,61,30,1201,896,67,51,1232,815
370,38,2,1,0,3,1,0,80,37,1203,897,84,27,1235,815
371,38,3,1,0,3,1,0,59,38,1206,898,67,47,1238,815
372,38,3,2,0,3,1,0,89,24,1209,900,98,11,1241,815
373,38,2,0,0,3,1,0,28,30,1211,900,27,36,1244,815
374,38,2,2,2,1,2,1,56,38,1213,902,63,31,1245,816
375,38,0,1,1,0,0,3,51,44,1213,903,54,67,1245,819
376,38,1,0,0,3,1,0,27,18,1214,903,31,43,1248,819
377,38,2,0,0,3,1,0,69,36,1216,903,78,35,1251,819
378,38,2,3,1,0,0,3,51,52,1218,906,51,61,1251,822
379,38,3,2,0,3,1,0,44,61,1221,908,45,25,1254,822
0,1,0,0,2,1,2,1,72,32,1221,908,78,39,1255,823
1,1,5,0,0,3,1,0,71,49,1226,908,69,20,1258,823
2,1,0,5,1,0,0,3,24,30,1226,913,26,19,1258,826
3,1,1,1,2,1,2,1,1,1,1227,914,1,29,1259,827
4,1,3,0,0,3,1,0,54,52,1230,914,54,43,1262,827
5,1,1,0,0,3,1,0,25,31,1231,914,23,36,1265,827
6,1,2,1,0,3,1,0,72,45,1233,915,67,53,1268,827
7,1,0,2,1,0,0,3,44,63,1233,917,45,54,1268,830
8,1,3,2,0,3,1,0,92,26,1236,919,101,0,1271,830
9,1,1,0,0,3,1,0,60,38,1237,919,70,67,1274,830
10,2,3,0,0,3,1,0,30,18,1240,919,34,13,1277,830
11,2,1,3,1,0,0,3,47,47,1241,922,50,46,1277,833
12,2,1,1,2,1,2,1,29,31,1242,923,28,12,1278,834
13,2,0,2,1,0,0,3,0,2,1242,925,0,43,1278,837
14,2,1,1,2,1,2,1,70,37,1243,926,79,44,1279,838
15,2,3,2,0,3,1,0,104,33,1246,928,105,35,1282,838
16,2,2,0,0,3,1,0,82,37,1248,928,87,47,1285,838
17,2,0,0,2,1,2,1,56,38,1248,928,64,62,1286,839
18,2,2,2,2,1,2,1,63,32,1250,930,68,63,1287,840
19,2,3,0,0,3,1,0,54,44,1253,930,57,0,1290,840
20,3,4,2,0,3,1,0,86,39,1257,932,90,0,1293,840
21,3,3,0,0,3,1,0,28,31,1260,932,26,35,1296,840
22,3,2,2,2,1,2,1,32,20,1262,934,35,40,1297,841
23,3,1,1,2,1,2,1,71,38,1263,935,80,21,1298,842
24,3,2,0,0,3,1,0,56,52,1265,935,57,46,1301,842
25,3,2,2,2,1,2,1,46,65,1267,937,46,30,1302,843
26,3,3,1,0,3,1,0,95,27,1270,938,104,12,1305,843
27,3,0,2,1,0,0,3,63,34,1270,940,68,65,1305,846
28,3,1,1,2,1,2,1,73,46,1271,941,68,37,1306,847
29,3,2,3,1,0,0,3,2,5,1273,944,0,70,1306,850
30,4,0,0,2,1,2,1,29,31,1273,944,29,14,1307,851
31,4,6,1,0,3,1,0,78,33,1279,945,81,0,1310,851
32,4,2,0,0,3,1,0,49,47,1281,945,53,19,1313,851
33,4,3,0,0,3,1,0,74,49,1284,945,72,44,1316,851
34,4,4,0,0,3,1,0,108,33,1288,945,108,43,1319,851
35,4,0,0,2,1,2,1,24,30,1288,945,27,55,1320,852
36,4,1,1,2,1,2,1,57,39,1289,946,65,64,1321,853
37,4,1,1,2,1,2,1,55,45,1290,947,58,44,1322,854
38,4,1,3,1,0,0,3,2,4,1291,950,1,56,1322,857
39,4,2,2,2,1,2,1,62,40,1293,952,71,48,1323,858
40,5,0,3,1,0,0,3,32,23,1293,955,35,49,1323,861
41,5,1,0,0,3,1,0,87,39,1294,955,93,30,1326,861
42,5,4,1,0,3,1,0,6,6,1298,956,3,37,1329,861
43,5,1,0,0,3,1,0,57,52,1299,956,60,0,1332,861
44,5,1,1,2,1,2,1,29,32,1300,957,27,41,1333,862
45,5,1,2,1,0,0,3,47,67,1301,959,46,38,1333,865
46,5,1,2,1,0,0,3,64,36,1302,961,68,73,1333,868
47,5,1,0,0,3,1,0,74,46,1303,961,71,21,1336,868
48,5,1,1,2,1,2,1,96,28,1304,962,105,66,1337,869
49,5,2,1,0,3,1,0,73,39,1306,963,83,12,1340,869
50,6,1,2,1,0,0,3,79,35,1307,965,81,58,1340,872
51,6,3,1,0,3,1,0,65,41,1310,966,74,0,1343,872
52,6,1,2,1,0,0,3,75,51,1311,968,72,67,1343,875
53,6,2,5,1,0,0,3,31,36,1313,973,29,47,1343,878
54,6,2,2,2,1,2,1,4,6,1315,975,2,49,1344,879
55,6,2,0,0,3,1,0,59,39,1317,975,68,19,1347,879
56,6,1,0,0,3,1,0,56,45,1318,975,61,43,1350,879
57,6,2,3,1,0,0,3,110,36,1320,978,108,59,1350,882
58,6,1,1,2,1,2,1,50,48,1321,979,54,45,1351,883
59,6,1,2,1,0,0,3,25,32,1322,981,27,17,1351,886
60,7,3,0,0,3,1,0,99,28,1325,981,108,41,1354,886
61,7,4,1,0,3,1,0,91,40,1329,982,96,21,1357,886
62,7,2,2,2,1,2,1,34,25,1331,984,36,1,1358,887
63,7,3,2,0,3,1,0,60,54,1334,986,63,12,1361,887
64,7,2,2,2,1,2,1,49,69,1336,988,47,50,1362,888
65,7,1,3,1,0,0,3,30,35,1337,991,27,69,1362,891
66,7,2,2,2,1,2,1,8,8,1339,993,4,39,1363,892
67,7,0,0,2,1,2,1,64,36,1339,993,69,31,1364,893
68,7,2,0,0,3,1,0,75,39,1341,993,86,37,1367,893
69,7,0,3,1,0,0,3,74,49,1341,996,71,76,1367,896
70,8,2,4,1,0,0,3,77,43,1343,1000,86,61,1367,899
71,8,1,0,0,3,1,0,76,51,1344,1000,75,37,1370,899
72,8,1,0,0,3,1,0,65,36,1345,1000,72,1,1373,899
73,8,4,2,0,3,1,0,114,38,1349,1002,111,31,1376,899
74,8,2,1,0,3,1,0,36,26,1351,1003,39,43,1379,899
75,8,1,2,1,0,0,3,61,56,1352,1005,63,70,1379,902
76,8,4,1,0,3,1,0,34,36,1356,1006,30,0,1382,902
77,8,1,0,0,3,1,0,32,36,1357,1006,32,69,1385,902
78,8,1,1,2,1,2,1,57,46,1358,1007,62,50,1386,903
79,8,1,1,2,1,2,1,26,33,1359,1008,28,51,1387,904
80,9,1,1,2,1,2,1,51,49,1360,1009,55,22,1388,905
81,9,1,0,0,3,1,0,80,35,1361,1009,84,12,1391,905
82,9,3,3,2,1,2,1,7,9,1364,1012,3,40,1392,906
83,9,0,0,2,1,2,1,59,39,1364,1012,69,42,1393,907
84,9,2,1,0,3,1,0,51,70,1366,1013,50,17,1396,907
85,9,1,0,0,3,1,0,100,28,1367,1013,111,19,1399,907
86,9,2,2,2,1,2,1,67,43,1369,1015,75,48,1400,908
87,9,2,1,0,3,1,0,76,50,1371,1016,74,45,1403,908
88,9,1,2,1,0,0,3,9,10,1372,1018,4,62,1403,911
89,9,2,3,1,0,0,3,93,43,1374,1021,96,79,1403,914
90,10,2,1,0,3,1,0,116,39,1376,1022,114,69,1406,914
91,10,2,2,2,1,2,1,78,53,1378,1024,76,52,1407,915
92,10,1,0,0,3,1,0,33,36,1379,1024,35,31,1410,915
93,10,0,1,1,0,0,3,57,47,1379,1025,62,40,1410,918
94,10,1,1,2,1,2,1,37,27,1380,1026,40,62,1411,919
95,10,0,1,1,0,0,3,77,44,1380,1027,86,46,1411,922
96,10,0,0,2,1,2,1,34,36,1380,1027,31,71,1412,923
97,10,1,1,2,1,2,1,27,34,1381,1028,29,2,1413,924
98,10,1,1,2,1,2,1,66,37,1382,1029,73,51,1414,925
99,10,2,0,0,3,1,0,63,56,1384,1029,66,0,1417,925
100,11,3,3,2,1,2,1,83,38,1387,1032,85,41,1418,926
101,11,2,1,0,3,1,0,69,44,1389,1033,78,42,1421,926
102,11,0,0,2,1,2,1,7,9,1389,1033,4,23,1422,927
103,11,1,1,2,1,2,1,10,11,1390,1034,5,20,1423,928
104,11,1,0,0,3,1,0,60,39,1391,1034,72,12,1426,928
105,11,1,2,1,0,0,3,52,72,1392,1036,50,48,1426,931
106,11,2,3,1,0,0,3,53,52,1394,1039,55,82,1426,934
107,11,2,1,0,3,1,0,102,29,1396,1040,114,62,1429,934
108,11,0,1,1,0,0,3,76,51,1396,1041,74,20,1429,937
109,11,1,1,2,1,2,1,94,44,1397,1042,97,49,1430,938
110,12,5,2,0,3,1,0,88,40,1402,1044,88,62,1433,938
111,12,3,0,0,3,1,0,69,37,1405,1044,76,46,1436,938
112,12,5,0,0,3,1,0,107,29,1410,1044,117,40,1439,938
113,12,1,2,1,0,0,3,77,53,1411,1046,74,23,1439,941
114,12,1,3,1,0,0,3,28,37,1412,1049,29,3,1439,944
115,12,2,1,0,3,1,0,9,10,1414,1050,7,52,1442,944
116,12,2,1,0,3,1,0,65,57,1416,1051,69,62,1445,944
117,12,1,0,0,3,1,0,34,36,1417,1051,38,82,1448,944
118,12,1,3,1,0,0,3,79,56,1418,1054,76,45,1448,947
119,12,1,1,2,1,2,1,35,37,1419,1055,32,32,1449,948
120,13,2,4,1,0,0,3,59,51,1421,1059,62,51,1449,951
121,13,1,1,2,1,2,1,70,45,1422,1060,79,24,1450,952
122,13,3,1,0,3,1,0,119,40,1425,1061,117,12,1453,952
123,13,1,0,0,3,1,0,61,39,1426,1061,75,41,1456,952
124,13,3,2,0,3,1,0,55,74,1429,1063,53,2,1459,952
125,13,0,0,2,1,2,1,53,52,1429,1063,56,70,1460,953
126,13,0,0,2,1,2,1,37,27,1429,1063,41,50,1461,954
127,13,2,0,0,3,1,0,12,11,1431,1063,8,51,1464,954
128,13,0,0,2,1,2,1,94,44,1431,1063,98,72,1465,955
129,13,3,1,0,3,1,0,80,45,1434,1064,89,20,1468,955
130,14,0,0,2,1,2,1,59,51,1434,1064,63,13,1469,956
131,14,1,0,0,3,1,0,54,52,1435,1064,59,2,1472,956
132,14,1,1,2,1,2,1,13,12,1436,1065,9,25,1473,957
133,14,2,1,0,3,1,0,63,40,1438,1066,78,51,1476,957
134,14,3,1,0,3,1,0,40,28,1441,1067,44,51,1479,957
135,14,2,1,0,3,1,0,82,46,1443,1068,92,50,1482,957
136,14,0,0,2,1,2,1,94,44,1443,1068,99,42,1483,958
137,14,1,1,2,1,2,1,71,46,1444,1069,80,71,1484,959
138,14,1,0,0,3,1,0,120,40,1445,1069,120,20,1487,959
139,14,0,2,1,0,0,3,55,76,1445,1071,53,75,1487,962
140,15,3,1,0,3,1,0,38,38,1448,1072,35,62,1490,962
141,15,0,2,1,0,0,3,88,42,1448,1074,88,26,1490,965
142,15,0,3,1,0,0,3,79,59,1448,1077,76,65,1490,968
143,15,1,0,0,3,1,0,70,37,1449,1077,79,3,1493,968
144,15,1,1,2,1,2,1,108,30,1450,1078,118,53,1494,969
145,15,1,1,2,1,2,1,29,38,1451,1079,30,41,1495,970
146,15,0,1,1,0,0,3,65,58,1451,1080,69,35,1495,973
147,15,3,4,1,0,0,3,12,14,1454,1084,7,85,1495,976
148,15,2,1,0,3,1,0,36,37,1456,1085,41,45,1498,976
149,15,3,0,0,3,1,0,80,53,1459,1085,77,46,1501,976
150,16,2,0,0,3,1,0,90,42,1461,1085,91,51,1504,976
151,16,0,0,2,1,2,1,54,52,1461,1085,60,36,1505,977
152,16,1,0,0,3,1,0,14,12,1462,1085,12,2,1508,977
153,16,1,3,1,0,0,3,60,54,1463,1088,63,65,1508,980
154,16,3,4,1,0,0,3,43,32,1466,1092,44,28,1508,983
155,16,2,2,2,1,2,1,57,78,1468,1094,54,14,1509,984
156,16,2,3,1,0,0,3,110,33,1470,1097,118,88,1509,987
157,16,2,1,0,3,1,0,73,47,1472,1098,83,65,1512,987
158,16,2,3,1,0,0,3,40,41,1474,1101,35,53,1512,990
159,16,2,1,0,3,1,0,81,60,1476,1102,79,51,1515,990
160,17,1,3,1,0,0,3,81,56,1477,1105,77,78,1515,993
161,17,1,3,1,0,0,3,71,40,1478,1108,79,44,1515,996
162,17,3,1,0,3,1,0,123,41,1481,1109,123,45,1518,996
163,17,2,1,0,3,1,0,38,38,1483,1110,44,46,1521,996
164,17,2,1,0,3,1,0,31,39,1485,1111,33,42,1524,996
165,17,1,1,2,1,2,1,64,41,1486,1112,79,54,1525,997
166,17,1,0,0,3,1,0,83,46,1487,1112,95,26,1528,997
167,17,0,0,2,1,2,1,65,58,1487,1112,70,21,1529,998
168,17,2,5,1,0,0,3,14,19,1489,1117,7,74,1529,1001
169,17,2,2,2,1,2,1,96,46,1491,1119,100,4,1530,1002
170,18,0,1,1,0,0,3,57,79,1491,1120,54,77,1530,1005
171,18,1,0,0,3,1,0,111,33,1492,1120,121,2,1533,1005
172,18,1,0,0,3,1,0,82,56,1493,1120,80,14,1536,1005
173,18,0,1,1,0,0,3,14,13,1493,1121,12,48,1536,1008
174,18,0,0,2,1,2,1,83,46,1493,1121,96,37,1537,1009
175,18,2,1,0,3,1,0,67,59,1495,1122,73,28,1540,1009
176,18,1,2,1,0,0,3,41,43,1496,1124,35,57,1540,1012
177,18,4,0,0,3,1,0,75,40,1500,1124,82,42,1543,1012
178,18,1,1,2,1,2,1,44,33,1501,1125,45,89,1544,1013
179,18,8,0,0,3,1,0,104,46,1509,1125,103,44,1547,1013
180,19,2,1,0,3,1,0,75,48,1511,1126,86,46,1550,1013
181,19,1,1,2,1,2,1,82,61,1512,1127,80,5,1551,1014
182,19,4,3,0,3,1,0,127,44,1516,1130,126,51,1554,1014
183,19,0,1,1,0,0,3,38,39,1516,1131,44,68,1554,1017
184,19,1,2,1,0,0,3,32,41,1517,1133,33,54,1554,1020
185,19,0,0,2,1,2,1,14,19,1517,1133,8,27,1555,1021
186,19,1,0,0,3,1,0,61,54,1518,1133,66,78,1558,1021
187,19,0,4,1,0,0,3,54,56,1518,1137,60,68,1558,1024
188,19,3,1,0,3,1,0,67,42,1521,1138,82,53,1561,1024
189,19,5,1,0,3,1,0,95,43,1526,1139,94,21,1564,1024
190,20,1,2,1,0,0,3,62,56,1527,1141,66,71,1564,1027
191,20,3,3,2,1,2,1,70,45,1530,1144,83,6,1565,1028
192,20,1,0,0,3,1,0,15,19,1531,1144,11,21,1568,1028
193,20,3,4,1,0,0,3,41,43,1534,1148,44,81,1568,1031
194,20,2,0,0,3,1,0,129,44,1536,1148,129,54,1571,1031
195,20,1,2,1,0,0,3,83,63,1537,1150,80,30,1571,1034
196,20,0,3,1,0,0,3,54,59,1537,1153,60,49,1571,1037
197,20,7,3,0,3,1,0,102,46,1544,1156,97,51,1574,1037
198,20,1,2,1,0,0,3,76,50,1545,1158,86,71,1574,1040
199,20,0,3,1,0,0,3,32,44,1545,1161,33,56,1574,1043
200,21,1,2,1,0,0,3,68,61,1546,1163,73,45,1574,1046
201,21,3,0,0,3,1,0,114,33,1549,1163,124,37,1577,1046
202,21,2,2,2,1,2,1,46,35,1551,1165,46,45,1578,1047
203,21,3,1,0,3,1,0,86,47,1554,1166,99,2,1581,1047
204,21,2,1,0,3,1,0,43,44,1556,1167,38,28,1584,1047
205,21,0,4,1,0,0,3,57,83,1556,1171,54,92,1584,1050
206,21,1,1,2,1,2,1,15,14,1557,1172,13,78,1585,1051
207,21,0,1,1,0,0,3,104,47,1557,1173,103,17,1585,1054
208,21,3,0,0,3,1,0,78,40,1560,1173,85,48,1588,1054
209,21,1,2,1,0,0,3,83,58,1561,1175,80,60,1588,1057
210,22,0,0,2,1,2,1,32,44,1561,1175,34,72,1589,1058
211,22,0,1,1,0,0,3,54,60,1561,1176,60,9,1589,1061
212,22,0,0,2,1,2,1,76,50,1561,1176,87,31,1590,1062
213,22,1,1,2,1,2,1,84,64,1562,1177,81,50,1591,1063
214,22,0,0,2,1,2,1,41,43,1562,1177,45,52,1592,1064
215,22,3,2,0,3,1,0,18,21,1565,1179,14,54,1595,1064
216,22,0,4,1,0,0,3,70,49,1565,1183,83,74,1595,1067
217,22,3,0,0,3,1,0,65,56,1568,1183,69,21,1598,1067
218,22,2,1,0,3,1,0,131,45,1570,1184,132,56,1601,1067
219,22,0,2,1,0,0,3,102,48,1570,1186,97,84,1601,1070
220,23,5,0,0,3,1,0,83,40,1575,1186,88,28,1604,1070
221,23,2,0,0,3,1,0,116,33,1577,1186,127,45,1607,1070
222,23,1,2,1,0,0,3,84,60,1578,1188,80,5,1607,1073
223,23,3,1,0,3,1,0,49,36,1581,1189,49,37,1610,1073
224,23,1,1,2,1,2,1,44,45,1582,1190,39,18,1611,1074
225,23,2,3,1,0,0,3,59,86,1584,1193,54,51,1611,1077
226,23,2,2,2,1,2,1,70,63,1586,1195,74,46,1612,1078
227,23,2,1,0,3,1,0,106,48,1588,1196,106,78,1615,1078
228,23,1,1,2,1,2,1,87,48,1589,1197,100,93,1616,1079
229,23,0,0,2,1,2,1,15,14,1589,1197,14,61,1617,1080
230,24,1,2,1,0,0,3,55,62,1590,1199,60,55,1617,1083
231,24,0,0,2,1,2,1,32,44,1590,1199,35,85,1618,1084
232,24,2,2,2,1,2,1,72,51,1592,1201,84,51,1619,1085
233,24,0,0,2,1,2,1,65,56,1592,1201,70,32,1620,1086
234,24,1,1,2,1,2,1,42,44,1593,1202,46,73,1621,1087
235,24,2,2,2,1,2,1,104,50,1595,1204,98,57,1622,1088
236,24,2,1,0,3,1,0,78,51,1597,1205,90,54,1625,1088
237,24,2,2,2,1,2,1,20,23,1599,1207,15,75,1626,1089
238,24,3,1,0,3,1,0,87,65,1602,1208,84,21,1629,1089
239,24,2,1,0,3,1,0,133,46,1604,1209,135,9,1632,1089
240,25,0,0,2,1,2,1,32,44,1604,1209,36,29,1633,1090
241,25,1,0,0,3,1,0,105,50,1605,1209,101,37,1636,1090
242,25,3,3,2,1,2,1,81,54,1608,1212,91,47,1637,1091
243,25,3,2,0,3,1,0,87,62,1611,1214,83,75,1640,1091
244,25,2,1,0,3,1,0,22,24,1613,1215,18,51,1643,1091
245,25,1,0,0,3,1,0,45,45,1614,1215,42,32,1646,1091
246,25,2,2,2,1,2,1,61,88,1616,1217,55,10,1647,1092
247,25,0,1,1,0,0,3,87,66,1616,1218,84,96,1647,1095
248,25,0,1,1,0,0,3,70,64,1616,1219,74,76,1647,1098
249,25,2,2,2,1,2,1,118,35,1618,1221,128,58,1648,1099
250,26,2,1,0,3,1,0,89,49,1620,1222,103,55,1651,1099
251,26,4,1,0,3,1,0,110,49,1624,1223,109,51,1654,1099
252,26,0,0,2,1,2,1,42,44,1624,1223,47,46,1655,1100
253,26,2,1,0,3,1,0,74,52,1626,1224,87,5,1658,1100
254,26,0,1,1,0,0,3,65,57,1626,1225,70,81,1658,1103
255,26,4,1,0,3,1,0,53,37,1630,1226,52,18,1661,1103
256,26,3,1,0,3,1,0,18,15,1633,1227,17,85,1664,1103
257,26,2,1,0,3,1,0,57,63,1635,1228,63,21,1667,1103
258,26,2,0,0,3,1,0,135,46,1637,1228,138,61,1670,1103
259,26,0,2,1,0,0,3,83,42,1637,1230,88,57,1670,1106
260,27,5,0,0,3,1,0,88,42,1642,1230,91,32,1673,1106
261,27,1,0,0,3,1,0,88,66,1643,1230,87,37,1676,1106
262,27,2,1,0,3,1,0,107,51,1645,1231,104,47,1679,1106
263,27,2,1,0,3,1,0,44,45,1647,1232,50,61,1682,1106
264,27,0,2,1,0,0,3,32,46,1647,1234,36,99,1682,1109
265,27,0,3,1,0,0,3,22,27,1647,1237,18,54,1682,1112
266,27,2,1,0,3,1,0,72,65,1649,1238,77,51,1685,1112
267,27,2,0,0,3,1,0,120,35,1651,1238,131,75,1688,1112
268,27,4,2,0,3,1,0,91,64,1655,1240,86,10,1691,1112
269,27,2,3,1,0,0,3,47,48,1657,1243,42,79,1691,1115
270,28,1,0,0,3,1,0,111,49,1658,1243,112,57,1694,1115
271,28,3,1,0,3,1,0,84,55,1661,1244,94,5,1697,1115
272,28,4,0,0,3,1,0,139,46,1665,1244,141,29,1700,1115
273,28,1,2,1,0,0,3,19,17,1666,1246,17,21,1700,1118
274,28,0,1,1,0,0,3,74,53,1666,1247,87,24,1700,1121
275,28,2,2,2,1,2,1,67,59,1668,1249,71,47,1701,1122
276,28,1,0,0,3,1,0,54,37,1669,1249,55,55,1704,1122
277,28,0,4,1,0,0,3,61,92,1669,1253,55,61,1704,1125
278,28,2,1,0,3,1,0,91,50,1671,1254,106,81,1707,1125
279,28,0,1,1,0,0,3,57,64,1671,1255,63,88,1707,1128
280,29,3,1,0,3,1,0,35,47,1674,1256,39,51,1710,1128
281,29,0,0,2,1,2,1,44,45,1674,1256,51,11,1711,1129
282,29,1,2,1,0,0,3,23,29,1675,1258,18,50,1711,1132
283,29,2,1,0,3,1,0,74,66,1677,1259,80,32,1714,1132
284,29,2,1,0,3,1,0,93,65,1679,1260,89,37,1717,1132
285,29,3,2,0,3,1,0,91,44,1682,1262,94,79,1720,1132
286,29,0,0,2,1,2,1,107,51,1682,1262,105,62,1721,1133
287,29,1,0,0,3,1,0,121,35,1683,1262,134,54,1724,1133
288,29,2,2,2,1,2,1,49,50,1685,1264,43,100,1725,1134
289,29,0,3,1,0,0,3,88,69,1685,1267,87,78,1725,1137
290,30,2,0,0,3,1,0,86,55,1687,1267,97,88,1728,1137
291,30,3,2,0,3,1,0,60,66,1690,1269,66,21,1731,1137
292,30,3,1,0,3,1,0,22,18,1693,1270,20,61,1734,1137
293,30,0,0,2,1,2,1,74,53,1693,1270,88,58,1735,1138
294,30,0,2,1,0,0,3,54,39,1693,1272,55,84,1735,1141
295,30,1,0,0,3,1,0,140,46,1694,1272,144,5,1738,1141
296,30,1,1,2,1,2,1,68,60,1695,1273,72,30,1739,1142
297,30,0,1,1,0,0,3,91,51,1695,1274,106,50,1739,1145
298,30,2,0,0,3,1,0,113,49,1697,1274,115,24,1742,1145
299,30,2,1,0,3,1,0,63,93,1699,1275,58,55,1745,1145
300,31,0,1,1,0,0,3,68,61,1699,1276,72,103,1745,1148
301,31,4,1,0,3,1,0,111,52,1703,1277,108,5,1748,1148
302,31,4,0,0,3,1,0,125,35,1707,1277,137,55,1751,1148
303,31,2,1,0,3,1,0,24,19,1709,1278,23,78,1754,1148
304,31,1,2,1,0,0,3,55,41,1710,1280,55,82,1754,1151
305,31,3,1,0,3,1,0,52,51,1713,1281,46,58,1757,1151
306,31,1,0,0,3,1,0,64,93,1714,1281,61,30,1760,1151
307,31,1,0,0,3,1,0,87,55,1715,1281,100,37,1763,1151
308,31,1,2,1,0,0,3,61,68,1716,1283,66,64,1763,1154
309,31,3,2,0,3,1,0,91,71,1719,1285,90,21,1766,1154
310,32,0,2,1,0,0,3,23,31,1719,1287,18,14,1766,1157
311,32,2,2,2,1,2,1,46,47,1721,1289,52,33,1767,1158
312,32,1,3,1,0,0,3,75,56,1722,1292,88,53,1767,1161
313,32,1,2,1,0,0,3,75,68,1723,1294,80,87,1767,1164
314,32,0,0,2,1,2,1,91,44,1723,1294,95,25,1768,1165
315,32,2,2,2,1,2,1,93,53,1725,1296,107,63,1769,1166
316,32,2,1,0,3,1,0,115,50,1727,1297,118,51,1772,1166
317,32,1,0,0,3,1,0,94,65,1728,1297,92,50,1775,1166
318,32,1,1,2,1,2,1,36,48,1729,1298,40,55,1776,1167
319,32,1,2,1,0,0,3,141,48,1730,1300,144,91,1776,1170
320,33,3,1,0,3,1,0,114,53,1733,1301,111,30,1779,1170
321,33,1,1,2,1,2,1,62,69,1734,1302,67,51,1780,1171
322,33,2,0,0,3,1,0,89,55,1736,1302,103,21,1783,1171
323,33,0,0,2,1,2,1,23,31,1736,1302,19,65,1784,1172
324,33,1,1,2,1,2,1,25,20,1737,1303,24,26,1785,1173
325,33,0,3,1,0,0,3,94,68,1737,1306,92,54,1785,1176
326,33,0,2,1,0,0,3,75,58,1737,1308,88,106,1785,1179
327,33,1,0,0,3,1,0,126,35,1738,1308,140,58,1788,1179
328,33,2,3,1,0,0,3,66,96,1740,1311,61,36,1788,1182
329,33,2,2,2,1,2,1,117,52,1742,1313,119,83,1789,1183
330,34,0,1,1,0,0,3,91,72,1742,1314,90,90,1789,1186
331,34,2,1,0,3,1,0,48,48,1744,1315,55,5,1792,1186
332,34,0,2,1,0,0,3,36,50,1744,1317,40,40,1792,1189
333,34,1,0,0,3,1,0,69,61,1745,1317,75,63,1795,1189
334,34,0,0,2,1,2,1,55,41,1745,1317,56,15,1796,1190
335,34,1,1,2,1,2,1,76,69,1746,1318,81,56,1797,1191
336,34,2,0,0,3,1,0,54,51,1748,1318,49,55,1800,1191
337,34,3,1,0,3,1,0,96,54,1751,1319,110,91,1803,1191
338,34,2,2,2,1,2,1,93,46,1753,1321,96,79,1804,1192
339,34,3,0,0,3,1,0,144,48,1756,1321,147,53,1807,1192
340,35,2,1,0,3,1,0,128,36,1758,1322,143,26,1810,1192
341,35,1,0,0,3,1,0,90,55,1759,1322,106,51,1813,1192
342,35,0,3,1,0,0,3,25,23,1759,1325,24,61,1813,1195
343,35,1,0,0,3,1,0,76,58,1760,1325,91,30,1816,1195
344,35,2,2,2,1,2,1,68,98,1762,1327,62,84,1817,1196
345,35,0,6,1,0,0,3,94,74,1762,1333,92,68,1817,1199
346,35,0,0,2,1,2,1,23,31,1762,1333,20,22,1818,1200
347,35,2,0,0,3,1,0,119,52,1764,1333,122,36,1821,1200
348,35,1,1,2,1,2,1,115,54,1765,1334,112,107,1822,1201
349,35,6,1,0,3,1,0,68,70,1771,1335,70,54,1825,1201
350,36,2,4,1,0,0,3,93,76,1773,1339,90,8,1825,1204
351,36,1,2,1,0,0,3,49,50,1774,1341,55,56,1825,1207
352,36,0,0,2,1,2,1,55,41,1774,1341,57,92,1826,1208
353,36,0,0,2,1,2,1,54,51,1774,1341,50,57,1827,1209
354,36,2,3,1,0,0,3,78,72,1776,1344,81,58,1827,1212
355,36,1,0,0,3,1,0,97,54,1777,1344,113,15,1830,1212
356,36,0,1,1,0,0,3,36,51,1777,1345,40,93,1830,1215
357,36,0,0,2,1,2,1,93,46,1777,1345,97,64,1831,1216
358,36,0,1,1,0,0,3,144,49,1777,1346,147,82,1831,1219
359,36,1,1,2,1,2,1,70,62,1778,1347,76,41,1832,1220
360,37,1,2,1,0,0,3,69,72,1779,1349,70,85,1832,1223
361,37,1,2,1,0,0,3,77,60,1780,1351,91,87,1832,1226
362,37,1,3,1,0,0,3,94,79,1781,1354,90,71,1832,1229
363,37,1,2,1,0,0,3,37,53,1782,1356,40,60,1832,1232
364,37,1,1,2,1,2,1,71,63,1783,1357,77,16,1833,1233
365,37,4,0,0,3,1,0,53,50,1787,1357,58,61,1836,1233
366,37,2,0,0,3,1,0,92,55,1789,1357,109,26,1839,1233
367,37,2,1,0,3,1,0,146,50,1791,1358,150,36,1842,1233
368,37,4,1,0,3,1,0,119,55,1795,1359,115,58,1845,1233
369,37,0,2,1,0,0,3,23,33,1795,1361,20,95,1845,1236
370,38,2,1,0,3,1,0,121,53,1797,1362,125,64,1848,1236
371,38,1,0,0,3,1,0,94,46,1798,1362,100,22,1851,1236
372,38,2,3,1,0,0,3,130,39,1800,1365,143,33,1851,1239
373,38,0,1,1,0,0,3,94,75,1800,1366,92,96,1851,1242
374,38,1,1,2,1,2,1,26,24,1801,1367,25,42,1852,1243
375,38,0,3,1,0,0,3,55,44,1801,1370,57,54,1852,1246
376,38,1,0,0,3,1,0,98,54,1802,1370,116,54,1855,1246
377,38,5,5,2,1,2,1,83,77,1807,1375,82,108,1856,1247
378,38,4,2,0,3,1,0,58,53,1811,1377,53,8,1859,1247
379,38,2,2,2,1,2,1,70,100,1813,1379,63,57,1860,1248
0,1,1,0,0,3,1,0,95,46,1814,1379,103,42,1863,1248
1,1,1,3,1,0,0,3,120,58,1815,1382,115,60,1863,1251
2,1,2,2,2,1,2,1,55,52,1817,1384,59,65,1864,1252
3,1,0,1,1,0,0,3,71,64,1817,1385,77,57,1864,1255
4,1,0,1,1,0,0,3,83,78,1817,1386,82,19,1864,1258
5,1,2,0,0,3,1,0,60,53,1819,1386,56,0,1867,1258
6,1,1,4,1,0,0,3,56,48,1820,1390,57,111,1867,1261
7,1,0,1,1,0,0,3,0,1,1820,1391,0,90,1867,1264
8,1,2,0,0,3,1,0,123,53,1822,1391,128,0,1870,1264
9,1,4,0,0,3,1,0,134,39,1826,1391,146,60,1873,1264
10,2,1,3,1,0,0,3,95,82,1827,1394,90,99,1873,1267
11,2,0,0,2,1,2,1,92,55,1827,1394,110,62,1874,1268
12,2,1,0,0,3,1,0,1,0,1828,1394,3,33,1877,1268
13,2,0,0,2,1,2,1,94,75,1828,1394,93,27,1878,1269
14,2,1,1,2,1,2,1,27,25,1829,1395,26,55,1879,1270
15,2,2,1,0,3,1,0,79,61,1831,1396,94,0,1882,1270
16,2,0,1,1,0,0,3,69,73,1831,1397,70,74,1882,1273
17,2,3,2,0,3,1,0,3,2,1834,1399,3,95,1885,1273
18,2,1,0,0,3,1,0,99,54,1835,1399,119,36,1888,1273
19,2,0,0,2,1,2,1,146,50,1835,1399,151,86,1889,1274
20,3,2,1,0,3,1,0,125,54,1837,1400,131,60,1892,1274
21,3,2,0,0,3,1,0,136,39,1839,1400,149,0,1895,1274
22,3,0,0,2,1,2,1,3,2,1839,1400,4,66,1896,1275
23,3,1,0,0,3,1,0,95,75,1840,1400,96,57,1899,1275
24,3,1,0,0,3,1,0,56,52,1841,1400,62,19,1902,1275
25,3,0,1,1,0,0,3,60,54,1841,1401,56,45,1902,1278
26,3,3,1,0,3,1,0,3,2,1844,1402,3,55,1905,1278
27,3,1,0,0,3,1,0,96,46,1845,1402,106,111,1908,1278
28,3,0,2,1,0,0,3,83,80,1845,1404,82,39,1908,1281
29,3,1,0,0,3,1,0,121,58,1846,1404,118,90,1911,1281
30,4,2,0,0,3,1,0,148,50,1848,1404,154,0,1914,1281
31,4,1,2,1,0,0,3,70,75,1849,1406,70,63,1914,1284
32,4,1,1,2,1,2,1,96,83,1850,1407,91,63,1915,1285
33,4,1,1,2,1,2,1,2,1,1851,1408,4,1,1916,1286
34,4,0,0,2,1,2,1,79,61,1851,1408,95,96,1917,1287
35,4,1,3,1,0,0,3,72,67,1852,1411,77,102,1917,1290
36,4,2,0,0,3,1,0,101,54,1854,1411,122,33,1920,1290
37,4,1,0,0,3,1,0,93,55,1855,1411,113,86,1923,1290
38,4,0,0,2,1,2,1,27,25,1855,1411,27,28,1924,1291
39,4,2,2,2,1,2,1,58,50,1857,1413,58,75,1925,1292
40,5,0,1,1,0,0,3,56,53,1857,1414,62,63,1925,1295
41,5,2,3,1,0,0,3,97,78,1859,1417,96,3,1925,1298
42,5,0,1,1,0,0,3,96,47,1859,1418,106,22,1925,1301
43,5,3,0,0,3,1,0,86,80,1862,1418,85,55,1928,1301
44,5,2,3,1,0,0,3,62,57,1864,1421,56,69,1928,1304
45,5,2,0,0,3,1,0,127,54,1866,1421,134,57,1931,1304
46,5,3,1,0,3,1,0,124,59,1869,1422,121,45,1934,1304
47,5,0,2,1,0,0,3,3,4,1869,1424,3,42,1934,1307
48,5,0,1,1,0,0,3,3,3,1869,1425,4,93,1934,1310
49,5,4,1,0,3,1,0,140,40,1873,1426,152,111,1937,1310
50,6,1,1,2,1,2,1,102,55,1874,1427,123,87,1938,1311
51,6,3,2,0,3,1,0,73,77,1877,1429,73,96,1941,1311
52,6,1,2,1,0,0,3,97,85,1878,1431,91,4,1941,1314
53,6,1,0,0,3,1,0,3,1,1879,1431,7,28,1944,1314
54,6,1,2,1,0,0,3,149,52,1880,1433,154,66,1944,1317
55,6,2,0,0,3,1,0,29,25,1882,1433,30,0,1947,1317
56,6,1,2,1,0,0,3,59,52,1883,1435,58,105,1947,1320
57,6,0,1,1,0,0,3,79,62,1883,1436,95,36,1947,1323
58,6,1,3,1,0,0,3,73,70,1884,1439,77,78,1947,1326
59,6,3,2,0,3,1,0,96,57,1887,1441,116,63,1950,1326
60,7,3,1,0,3,1,0,143,41,1890,1442,155,69,1953,1326
61,7,1,2,1,0,0,3,4,5,1891,1444,4,66,1953,1329
62,7,1,0,0,3,1,0,98,85,1892,1444,94,45,1956,1329
63,7,0,0,2,1,2,1,3,1,1892,1444,8,64,1957,1330
64,7,3,1,0,3,1,0,99,48,1895,1445,109,0,1960,1330
65,7,1,2,1,0,0,3,74,72,1896,1447,77,114,1960,1333
66,7,1,3,1,0,0,3,57,56,1897,1450,62,90,1960,1336
67,7,2,0,0,3,1,0,31,25,1899,1450,33,42,1963,1336
68,7,0,3,1,0,0,3,102,58,1899,1453,123,31,1963,1339
69,7,1,1,2,1,2,1,87,81,1900,1454,86,106,1964,1340
70,8,2,2,2,1,2,1,99,80,1902,1456,97,79,1965,1341
71,8,4,1,0,3,1,0,128,60,1906,1457,124,36,1968,1341
72,8,4,1,0,3,1,0,131,55,1910,1458,137,4,1971,1341
73,8,2,1,0,3,1,0,98,58,1912,1459,119,3,1974,1341
74,8,1,1,2,1,2,1,150,53,1913,1460,155,23,1975,1342
75,8,0,0,2,1,2,1,79,62,1913,1460,96,67,1976,1343
76,8,4,0,0,3,1,0,63,52,1917,1460,61,55,1979,1343
77,8,1,3,1,0,0,3,63,60,1918,1463,56,99,1979,1346
78,8,0,2,1,0,0,3,73,79,1918,1465,73,96,1979,1349
79,8,1,4,1,0,0,3,4,8,1919,1469,3,60,1979,1352
80,9,0,2,1,0,0,3,4,10,1919,1471,3,109,1979,1355
81,9,0,2,1,0,0,3,73,81,1919,1473,73,72,1979,1358
82,9,4,1,0,3,1,0,103,49,1923,1474,112,67,1982,1358
83,9,3,2,0,3,1,0,153,55,1926,1476,158,45,1985,1358
84,9,0,0,2,1,2,1,57,56,1926,1476,63,5,1986,1359
85,9,2,0,0,3,1,0,33,25,1928,1476,36,60,1989,1359
86,9,2,1,0,3,1,0,76,73,1930,1477,80,66,1992,1359
87,9,2,1,0,3,1,0,133,56,1932,1478,140,99,1995,1359
88,9,0,0,2,1,2,1,63,52,1932,1478,62,32,1996,1360
89,9,1,0,0,3,1,0,103,58,1933,1478,126,3,1999,1360
90,10,2,0,0,3,1,0,101,80,1935,1478,100,90,2002,1360
91,10,1,3,1,0,0,3,99,88,1936,1481,94,117,2002,1363
92,10,1,0,0,3,1,0,4,1,1937,1481,11,55,2005,1363
93,10,7,0,0,3,1,0,150,41,1944,1481,158,36,2008,1363
94,10,1,1,2,1,2,1,80,63,1945,1482,97,24,2009,1364
95,10,2,0,0,3,1,0,89,81,1947,1482,89,0,2012,1364
96,10,0,0,2,1,2,1,63,60,1947,1482,57,65,2013,1365
97,10,2,0,0,3,1,0,130,60,1949,1482,127,79,2016,1365
98,10,0,0,2,1,2,1,98,58,1949,1482,120,97,2017,1366
99,10,1,0,0,3,1,0,5,5,1950,1482,7,42,2020,1366
100,11,2,0,0,3,1,0,75,81,1952,1482,76,5,2023,1366
101,11,2,2,2,1,2,1,135,58,1954,1484,141,68,2024,1367
102,11,0,0,2,1,2,1,4,10,1954,1484,4,73,2025,1368
103,11,4,0,0,3,1,0,107,49,1958,1484,115,60,2028,1368
104,11,4,1,0,3,1,0,37,26,1962,1485,39,3,2031,1368
105,11,3,1,0,3,1,0,60,57,1965,1486,66,32,2034,1368
106,11,0,1,1,0,0,3,103,59,1965,1487,126,69,2034,1371
107,11,1,0,0,3,1,0,77,73,1966,1487,83,99,2037,1371
108,11,1,0,0,3,1,0,154,55,1967,1487,161,109,2040,1371
109,11,3,3,2,1,2,1,66,55,1970,1490,63,46,2041,1372
110,12,3,3,2,1,2,1,101,61,1973,1493,121,80,2042,1373
111,12,2,0,0,3,1,0,132,60,1975,1493,130,24,2045,1373
112,12,1,2,1,0,0,3,100,90,1976,1495,94,45,2045,1376
113,12,0,1,1,0,0,3,4,2,1976,1496,11,3,2045,1379
114,12,2,1,0,3,1,0,103,81,1978,1497,103,36,2048,1379
115,12,2,0,0,3,1,0,82,63,1980,1497,100,55,2051,1379
116,12,0,3,1,0,0,3,63,63,1980,1500,57,93,2051,1382
117,12,6,0,0,3,1,0,156,41,1986,1500,161,97,2054,1382
118,12,2,2,2,1,2,1,7,7,1988,1502,8,118,2055,1383
119,12,2,2,2,1,2,1,91,83,1990,1504,90,66,2056,1384
120,13,0,0,2,1,2,1,75,81,1990,1504,77,56,2057,1385
121,13,0,3,1,0,0,3,7,10,1990,1507,8,112,2057,1388
122,13,4,0,0,3,1,0,105,61,1994,1507,124,46,2060,1388
123,13,1,0,0,3,1,0,61,57,1995,1507,69,3,2063,1388
124,13,3,0,0,3,1,0,66,63,1998,1507,60,60,2066,1388
125,13,2,1,0,3,1,0,105,82,2000,1508,106,68,2069,1388
126,13,2,2,2,1,2,1,105,61,2002,1510,127,119,2070,1389
127,13,3,1,0,3,1,0,7,3,2005,1511,14,80,2073,1389
128,13,3,1,0,3,1,0,138,59,2008,1512,144,24,2076,1389
129,13,3,0,0,3,1,0,159,41,2011,1512,164,45,2079,1389
130,14,1,0,0,3,1,0,5,10,2012,1512,7,32,2082,1389
131,14,2,0,0,3,1,0,134,60,2014,1512,133,3,2085,1389
132,14,0,1,1,0,0,3,154,56,2014,1513,161,76,2085,1392
133,14,2,3,1,0,0,3,39,29,2016,1516,39,69,2085,1395
134,14,0,0,2,1,2,1,82,63,2016,1516,101,6,2086,1396
135,14,3,4,1,0,0,3,80,77,2019,1520,83,96,2086,1399
136,14,3,0,0,3,1,0,69,55,2022,1520,66,69,2089,1399
137,14,5,1,0,3,1,0,112,50,2027,1521,118,36,2092,1399
138,14,2,3,1,0,0,3,93,86,2029,1524,90,102,2092,1402
139,14,1,2,1,0,0,3,101,92,2030,1526,94,100,2092,1405
140,15,0,1,1,0,0,3,154,57,2030,1527,161,72,2092,1408
141,15,2,0,0,3,1,0,7,10,2032,1527,10,6,2095,1408
142,15,4,1,0,3,1,0,116,51,2036,1528,121,32,2098,1408
143,15,1,1,2,1,2,1,40,30,2037,1529,40,103,2099,1409
144,15,3,2,0,3,1,0,85,65,2040,1531,104,96,2102,1409
145,15,0,2,1,0,0,3,93,88,2040,1533,90,39,2102,1412
146,15,1,2,1,0,0,3,81,79,2041,1535,83,103,2102,1415
147,15,2,0,0,3,1,0,103,92,2043,1535,97,69,2105,1415
148,15,1,1,2,1,2,1,135,61,2044,1536,134,77,2106,1416
149,15,1,1,2,1,2,1,70,56,2045,1537,67,4,2107,1417
150,16,6,3,0,3,1,0,165,44,2051,1540,167,112,2110,1417
151,16,1,0,0,3,1,0,8,10,2052,1540,11,68,2113,1417
152,16,2,1,0,3,1,0,140,60,2054,1541,147,3,2116,1417
153,16,4,1,0,3,1,0,109,62,2058,1542,127,60,2119,1417
154,16,1,1,2,1,2,1,106,83,2059,1543,107,25,2120,1418
155,16,0,0,2,1,2,1,66,63,2059,1543,61,57,2121,1419
156,16,0,0,2,1,2,1,7,3,2059,1543,15,47,2122,1420
157,16,0,3,1,0,0,3,75,84,2059,1546,77,122,2122,1423
158,16,1,1,2,1,2,1,62,58,2060,1547,70,46,2123,1424
159,16,0,5,1,0,0,3,105,66,2060,1552,127,83,2123,1427
160,17,3,1,0,3,1,0,119,52,2063,1553,124,6,2126,1427
161,17,0,3,1,0,0,3,7,13,2063,1556,10,75,2126,1430
162,17,2,4,1,0,0,3,105,96,2065,1560,97,106,2126,1433
163,17,3,1,0,3,1,0,157,58,2068,1561,164,32,2129,1433
164,17,2,1,0,3,1,0,87,66,2070,1562,107,69,2132,1433
165,17,0,0,2,1,2,1,81,79,2070,1562,84,40,2133,1434
166,17,1,1,2,1,2,1,94,89,2071,1563,91,5,2134,1435
167,17,2,3,1,0,0,3,42,33,2073,1566,40,106,2134,1438
168,17,1,2,1,0,0,3,71,58,2074,1568,67,80,2134,1441
169,17,0,0,2,1,2,1,135,61,2074,1568,135,97,2135,1442
170,18,2,3,1,0,0,3,9,6,2076,1571,15,125,2135,1445
171,18,0,1,1,0,0,3,75,85,2076,1572,77,6,2135,1448
172,18,0,3,1,0,0,3,8,13,2076,1575,11,28,2135,1451
173,18,1,0,0,3,1,0,141,60,2077,1575,150,46,2138,1451
174,18,0,1,1,0,0,3,109,63,2077,1576,127,60,2138,1454
175,18,5,1,0,3,1,0,111,84,2082,1577,110,47,2141,1454
176,18,1,2,1,0,0,3,63,60,2083,1579,70,63,2141,1457
177,18,1,1,2,1,2,1,106,67,2084,1580,128,69,2142,1458
178,18,1,3,1,0,0,3,67,66,2085,1583,61,115,2142,1461
179,18,2,1,0,3,1,0,167,45,2087,1584,170,83,2145,1461
180,19,3,3,2,1,2,1,70,69,2090,1587,62,70,2146,1462
181,19,1,1,2,1,2,1,76,86,2091,1588,78,47,2147,1463
182,19,6,0,0,3,1,0,15,6,2097,1588,18,63,2150,1463
183,19,1,0,0,3,1,0,168,45,2098,1588,173,6,2153,1463
184,19,0,1,1,0,0,3,63,61,2098,1589,70,128,2153,1466
185,19,2,2,2,1,2,1,10,15,2100,1591,12,61,2154,1467
186,19,2,1,0,3,1,0,111,64,2102,1592,130,28,2157,1467
187,19,0,1,1,0,0,3,111,85,2102,1593,110,118,2157,1470
188,19,2,1,0,3,1,0,143,61,2104,1594,153,83,2160,1470
189,19,3,0,0,3,1,0,109,67,2107,1594,131,47,2163,1470
190,20,2,3,1,0,0,3,73,61,2109,1597,67,109,2163,1473
191,20,0,1,1,0,0,3,81,80,2109,1598,84,72,2163,1476
192,20,2,0,0,3,1,0,137,61,2111,1598,138,6,2166,1476
193,20,0,3,1,0,0,3,42,36,2111,1601,40,100,2166,1479
194,20,1,1,2,1,2,1,88,67,2112,1602,108,81,2167,1480
195,20,2,0,0,3,1,0,121,52,2114,1602,127,5,2170,1480
196,20,1,0,0,3,1,0,95,89,2115,1602,94,75,2173,1480
197,20,1,1,2,1,2,1,8,14,2116,1603,11,41,2174,1481
198,20,2,1,0,3,1,0,107,97,2118,1604,100,32,2177,1481
199,20,1,2,1,0,0,3,158,60,2119,1606,164,109,2177,1484
200,21,0,2,1,0,0,3,15,8,2119,1608,18,103,2177,1487
201,21,2,0,0,3,1,0,111,67,2121,1608,134,6,2180,1487
202,21,2,0,0,3,1,0,113,64,2123,1608,133,41,2183,1487
203,21,1,4,1,0,0,3,108,101,2124,1612,100,64,2183,1490
204,21,1,0,0,3,1,0,43,36,2125,1612,43,70,2186,1490
205,21,0,2,1,0,0,3,10,17,2125,1614,12,35,2186,1493
206,21,2,0,0,3,1,0,160,60,2127,1614,167,47,2189,1493
207,21,0,2,1,0,0,3,111,87,2127,1616,110,112,2189,1496
208,21,3,5,1,0,0,3,91,72,2130,1621,108,86,2189,1499
209,21,1,2,1,0,0,3,77,88,2131,1623,78,121,2189,1502
210,22,2,2,2,1,2,1,83,82,2133,1625,85,29,2190,1503
211,22,4,2,0,3,1,0,172,47,2137,1627,176,6,2193,1503
212,22,2,0,0,3,1,0,139,61,2139,1627,141,63,2196,1503
213,22,1,0,0,3,1,0,64,61,2140,1627,73,5,2199,1503
214,22,1,3,1,0,0,3,71,72,2141,1630,62,78,2199,1506
215,22,1,0,0,3,1,0,9,14,2142,1630,14,47,2202,1506
216,22,2,2,2,1,2,1,123,54,2144,1632,128,73,2203,1507
217,22,1,3,1,0,0,3,74,64,2145,1635,67,112,2203,1510
218,22,3,1,0,3,1,0,146,62,2148,1636,156,128,2206,1510
219,22,1,1,2,1,2,1,96,90,2149,1637,95,82,2207,1511
220,23,2,2,2,1,2,1,45,38,2151,1639,44,122,2208,1512
221,23,2,0,0,3,1,0,162,60,2153,1639,170,6,2211,1512
222,23,2,0,0,3,1,0,76,64,2155,1639,70,63,2214,1512
223,23,0,0,2,1,2,1,64,61,2155,1639,74,79,2215,1513
224,23,4,0,0,3,1,0,127,54,2159,1639,131,82,2218,1513
225,23,1,0,0,3,1,0,10,14,2160,1639,17,5,2221,1513
226,23,1,5,1,0,0,3,112,72,2161,1644,134,115,2221,1516
227,23,1,0,0,3,1,0,84,82,2162,1644,88,47,2224,1516
228,23,4,3,0,3,1,0,81,91,2166,1647,81,70,2227,1516
229,23,0,0,2,1,2,1,146,62,2166,1647,157,36,2228,1517
230,24,2,0,0,3,1,0,73,72,2168,1647,65,47,2231,1517
231,24,0,3,1,0,0,3,111,90,2168,1650,110,67,2231,1520
232,24,2,1,0,3,1,0,115,65,2170,1651,136,73,2234,1520
233,24,2,1,0,3,1,0,93,73,2172,1652,111,128,2237,1520
234,24,2,1,0,3,1,0,12,18,2174,1653,15,41,2240,1520
235,24,0,3,1,0,0,3,108,104,2174,1656,100,32,2240,1523
236,24,1,1,2,1,2,1,16,9,2175,1657,19,113,2241,1524
237,24,1,1,2,1,2,1,97,91,2176,1658,96,87,2242,1525
238,24,2,0,0,3,1,0,141,61,2178,1658,144,6,2245,1525
239,24,0,1,1,0,0,3,172,48,2178,1659,176,106,2245,1528
240,25,5,1,0,3,1,0,132,55,2183,1660,134,122,2248,1528
241,25,0,2,1,0,0,3,84,84,2183,1662,88,8,2248,1531
242,25,0,0,2,1,2,1,64,61,2183,1662,75,116,2249,1532
243,25,3,0,0,3,1,0,149,62,2186,1662,160,79,2252,1532
244,25,2,2,2,1,2,1,47,40,2188,1664,45,48,2253,1533
245,25,3,1,0,3,1,0,13,15,2191,1665,20,70,2256,1533
246,25,0,2,1,0,0,3,81,93,2191,1667,81,39,2256,1536
247,25,3,0,0,3,1,0,79,64,2194,1667,73,6,2259,1536
248,25,1,0,0,3,1,0,113,72,2195,1667,137,82,2262,1536
249,25,2,2,2,1,2,1,164,62,2197,1669,171,64,2263,1537
250,26,0,0,2,1,2,1,12,18,2197,1669,16,74,2264,1538
251,26,2,0,0,3,1,0,75,72,2199,1669,68,41,2267,1538
252,26,0,1,1,0,0,3,16,10,2199,1670,19,35,2267,1541
253,26,1,1,2,1,2,1,98,92,2200,1671,97,107,2268,1542
254,26,0,0,2,1,2,1,141,61,2200,1671,145,129,2269,1543
255,26,0,4,1,0,0,3,111,94,2200,1675,110,116,2269,1546
256,26,2,3,1,0,0,3,110,107,2202,1678,100,90,2269,1549
257,26,1,1,2,1,2,1,94,74,2203,1679,112,48,2270,1550
258,26,2,3,1,0,0,3,117,68,2205,1682,136,9,2270,1553
259,26,2,2,2,1,2,1,174,50,2207,1684,177,68,2271,1554
260,27,1,0,0,3,1,0,150,62,2208,1684,163,82,2274,1554
261,27,1,1,2,1,2,1,99,93,2209,1685,98,65,2275,1555
262,27,0,4,1,0,0,3,12,22,2209,1689,16,11,2275,1558
263,27,3,1,0,3,1,0,78,73,2212,1690,71,35,2278,1558
264,27,1,0,0,3,1,0,175,50,2213,1690,180,48,2281,1558
265,27,4,1,0,3,1,0,145,62,2217,1691,148,68,2284,1558
266,27,0,2,1,0,0,3,13,17,2217,1693,20,132,2284,1561
267,27,1,0,0,3,1,0,112,94,2218,1693,113,74,2287,1561
268,27,4,3,0,3,1,0,136,58,2222,1696,137,48,2290,1561
269,27,1,0,0,3,1,0,65,61,2223,1696,78,116,2293,1561
270,28,1,0,0,3,1,0,95,74,2224,1696,115,122,2296,1561
271,28,1,3,1,0,0,3,111,110,2225,1699,100,110,2296,1564
272,28,1,4,1,0,0,3,17,14,2226,1703,19,82,2296,1567
273,28,1,0,0,3,1,0,118,68,2227,1703,139,39,2299,1567
274,28,0,3,1,0,0,3,47,43,2227,1706,45,93,2299,1570
275,28,1,0,0,3,1,0,114,72,2228,1706,140,6,2302,1570
276,28,1,1,2,1,2,1,80,65,2229,1707,74,10,2303,1571
277,28,4,1,0,3,1,0,85,94,2233,1708,84,41,2306,1571
278,28,0,3,1,0,0,3,164,65,2233,1711,171,119,2306,1574
279,28,2,0,0,3,1,0,86,84,2235,1711,91,70,2309,1574
280,29,0,3,1,0,0,3,99,96,2235,1714,98,135,2309,1577
281,29,3,1,0,3,1,0,15,23,2238,1715,19,65,2312,1577
282,29,0,1,1,0,0,3,13,18,2238,1716,20,38,2312,1580
283,29,1,1,2,1,2,1,66,62,2239,1717,79,49,2313,1581
284,29,4,0,0,3,1,0,154,62,2243,1717,166,116,2316,1581
285,29,0,3,1,0,0,3,112,97,2243,1720,113,85,2316,1584
286,29,2,2,2,1,2,1,147,64,2245,1722,149,49,2317,1585
287,29,2,1,0,3,1,0,80,74,2247,1723,74,11,2320,1585
288,29,2,1,0,3,1,0,138,59,2249,1724,140,68,2323,1585
289,29,4,0,0,3,1,0,179,50,2253,1724,183,74,2326,1585
290,30,0,2,1,0,0,3,17,16,2253,1726,19,122,2326,1588
291,30,2,1,0,3,1,0,120,69,2255,1727,142,6,2329,1588
292,30,0,0,2,1,2,1,86,84,2255,1727,92,11,2330,1589
293,30,1,0,0,3,1,0,112,110,2256,1727,103,82,2333,1589
294,30,4,2,0,3,1,0,51,45,2260,1729,48,41,2336,1589
295,30,1,2,1,0,0,3,81,67,2261,1731,74,73,2336,1592
296,30,3,1,0,3,1,0,98,75,2264,1732,118,39,2339,1592
297,30,1,0,0,3,1,0,86,94,2265,1732,87,110,2342,1592
298,30,0,3,1,0,0,3,164,68,2265,1735,171,96,2342,1595
299,30,0,1,1,0,0,3,114,73,2265,1736,140,125,2342,1598
300,31,6,0,0,3,1,0,160,62,2271,1736,169,125,2345,1598
301,31,1,0,0,3,1,0,113,97,2272,1736,116,11,2348,1598
302,31,5,0,0,3,1,0,184,50,2277,1736,186,65,2351,1598
303,31,3,6,1,0,0,3,18,29,2280,1742,19,99,2351,1601
304,31,2,0,0,3,1,0,68,62,2282,1742,82,68,2354,1601
305,31,3,2,0,3,1,0,123,71,2285,1744,145,49,2357,1601
306,31,2,0,0,3,1,0,19,16,2287,1744,22,73,2360,1601
307,31,0,2,1,0,0,3,80,76,2287,1746,74,138,2360,1604
308,31,3,2,0,3,1,0,117,75,2290,1748,143,38,2363,1604
309,31,1,4,1,0,0,3,87,98,2291,1752,87,52,2363,1607
310,32,4,1,0,3,1,0,168,69,2295,1753,174,74,2366,1607
311,32,3,3,2,1,2,1,102,99,2298,1756,99,7,2367,1608
312,32,1,0,0,3,1,0,14,18,2299,1756,23,110,2370,1608
313,32,1,0,0,3,1,0,99,75,2300,1756,121,11,2373,1608
314,32,4,0,0,3,1,0,55,45,2304,1756,51,82,2376,1608
315,32,3,0,0,3,1,0,84,67,2307,1756,77,41,2379,1608
316,32,1,1,2,1,2,1,148,65,2308,1757,150,123,2380,1609
317,32,1,3,1,0,0,3,113,113,2309,1760,103,88,2380,1612
318,32,4,0,0,3,1,0,142,59,2313,1760,143,116,2383,1612
319,32,1,2,1,0,0,3,87,86,2314,1762,92,42,2383,1615
320,33,4,1,0,3,1,0,188,51,2318,1763,189,38,2386,1615
321,33,0,3,1,0,0,3,18,32,2318,1766,19,14,2386,1618
322,33,1,2,1,0,0,3,88,100,2319,1768,87,68,2386,1621
323,33,0,4,1,0,0,3,113,101,2319,1772,116,141,2386,1624
324,33,1,0,0,3,1,0,20,16,2320,1772,25,49,2389,1624
325,33,0,1,1,0,0,3,68,63,2320,1773,82,76,2389,1627
326,33,3,0,0,3,1,0,163,62,2323,1773,172,52,2392,1627
327,33,3,0,0,3,1,0,126,71,2326,1773,148,125,2395,1627
328,33,1,2,1,0,0,3,81,78,2327,1775,74,102,2395,1630
329,33,5,1,0,3,1,0,122,76,2332,1776,146,68,2398,1630
330,34,1,0,0,3,1,0,15,18,2333,1776,26,74,2401,1630
331,34,0,1,1,0,0,3,55,46,2333,1777,51,10,2401,1633
332,34,0,1,1,0,0,3,87,87,2333,1778,92,91,2401,1636
333,34,1,0,0,3,1,0,100,75,2334,1778,124,82,2404,1636
334,34,1,0,0,3,1,0,114,113,2335,1778,106,41,2407,1636
335,34,3,3,2,1,2,1,105,102,2338,1781,100,117,2408,1637
336,34,3,2,0,3,1,0,145,61,2341,1783,146,123,2411,1637
337,34,0,1,1,0,0,3,84,68,2341,1784,77,113,2411,1640
338,34,3,1,0,3,1,0,151,66,2344,1785,153,42,2414,1640
339,34,3,1,0,3,1,0,171,70,2347,1786,177,11,2417,1640
340,35,3,1,0,3,1,0,125,77,2350,1787,149,68,2420,1640
341,35,0,0,2,1,2,1,88,100,2350,1787,88,39,2421,1641
342,35,1,1,2,1,2,1,19,33,2351,1788,20,53,2422,1642
343,35,1,2,1,0,0,3,114,103,2352,1790,116,52,2422,1645
344,35,0,1,1,0,0,3,81,79,2352,1791,74,17,2422,1648
345,35,1,2,1,0,0,3,164,64,2353,1793,172,71,2422,1651
346,35,2,3,1,0,0,3,70,66,2355,1796,82,105,2422,1654
347,35,0,3,1,0,0,3,20,19,2355,1799,25,128,2422,1657
348,35,2,0,0,3,1,0,128,71,2357,1799,151,141,2425,1657
349,35,3,1,0,3,1,0,191,52,2360,1800,192,76,2428,1657
350,36,2,0,0,3,1,0,57,46,2362,1800,54,91,2431,1657
351,36,4,1,0,3,1,0,88,69,2366,1801,80,74,2434,1657
352,36,2,2,2,1,2,1,116,115,2368,1803,107,12,2435,1658
353,36,0,1,1,0,0,3,100,76,2368,1804,124,120,2435,1661
354,36,1,0,0,3,1,0,106,102,2369,1804,103,42,2438,1661
355,36,4,0,0,3,1,0,175,70,2373,1804,180,41,2441,1661
356,36,4,0,0,3,1,0,91,87,2377,1804,95,10,2444,1661
357,36,0,2,1,0,0,3,145,63,2377,1806,146,116,2444,1664
358,36,0,2,1,0,0,3,15,20,2377,1808,26,126,2444,1667
359,36,3,0,0,3,1,0,154,66,2380,1808,156,82,2447,1667
360,37,2,0,0,3,1,0,83,79,2382,1808,77,120,2450,1667
361,37,3,0,0,3,1,0,117,103,2385,1808,119,10,2453,1667
362,37,4,1,0,3,1,0,104,77,2389,1809,127,68,2456,1667
363,37,3,1,0,3,1,0,91,101,2392,1810,91,12,2459,1667
364,37,0,1,1,0,0,3,88,70,2392,1811,80,42,2459,1670
365,37,0,1,1,0,0,3,175,71,2392,1812,180,74,2459,1673
366,37,2,3,1,0,0,3,130,74,2394,1815,151,129,2459,1676
367,37,1,0,0,3,1,0,155,66,2395,1815,159,76,2462,1676
368,37,0,0,2,1,2,1,164,64,2395,1815,173,42,2463,1677
369,37,3,3,2,1,2,1,18,23,2398,1818,27,106,2464,1678
370,38,0,2,1,0,0,3,70,68,2398,1820,82,131,2464,1681
371,38,3,0,0,3,1,0,128,77,2401,1820,152,74,2467,1681
372,38,1,2,1,0,0,3,20,35,2402,1822,20,119,2467,1684
373,38,2,2,2,1,2,1,118,117,2404,1824,108,18,2468,1685
374,38,0,2,1,0,0,3,20,21,2404,1826,25,94,2468,1688
375,38,1,1,2,1,2,1,58,47,2405,1827,55,142,2469,1689
376,38,2,1,0,3,1,0,147,64,2407,1828,149,82,2472,1689
377,38,1,2,1,0,0,3,107,104,2408,1830,103,56,2472,1692
378,38,1,3,1,0,0,3,92,90,2409,1833,95,55,2472,1695
379,38,2,0,0,3,1,0,193,52,2411,1833,195,42,2475,1695
0,1,1,2,1,0,0,3,176,73,2412,1835,180,58,2475,1698
1,1,2,2,2,1,2,1,2,2,2414,1837,1,95,2476,1699
2,1,0,1,1,0,0,3,37,54,2414,1838,40,15,2476,1702
3,1,0,1,1,0,0,3,104,78,2414,1839,127,77,2476,1705
4,1,2,2,2,1,2,1,109,106,2416,1841,104,75,2477,1706
5,1,0,1,1,0,0,3,83,80,2416,1842,77,123,2477,1709
6,1,2,1,0,3,1,0,157,67,2418,1843,162,18,2480,1709
7,1,2,1,0,3,1,0,149,65,2420,1844,152,42,2483,1709
8,1,0,2,1,0,0,3,117,105,2420,1846,119,132,2483,1712
9,1,1,3,1,0,0,3,1,3,2421,1849,0,122,2483,1715
10,2,0,0,2,1,2,1,91,101,2421,1849,92,83,2484,1716
11,2,2,0,0,3,1,0,166,64,2423,1849,176,0,2487,1716
12,2,1,3,1,0,0,3,19,26,2424,1852,27,45,2487,1719
13,2,0,0,2,1,2,1,58,47,2424,1852,56,77,2488,1720
14,2,1,0,0,3,1,0,89,70,2425,1852,83,0,2491,1720
15,2,2,2,2,1,2,1,132,76,2427,1854,152,132,2492,1721
16,2,1,1,2,1,2,1,21,22,2428,1855,26,57,2493,1722
17,2,4,0,0,3,1,0,132,77,2432,1855,155,22,2496,1722
18,2,1,1,2,1,2,1,93,91,2433,1856,96,143,2497,1723
19,2,3,1,0,3,1,0,196,53,2436,1857,198,106,2500,1723
20,3,0,0,2,1,2,1,1,3,2436,1857,1,144,2501,1724
21,3,0,1,1,0,0,3,196,54,2436,1858,198,60,2501,1727
22,3,3,3,2,1,2,1,120,108,2439,1861,120,19,2502,1728
23,3,1,0,0,3,1,0,38,54,2440,1861,43,75,2505,1728
24,3,3,0,0,3,1,0,92,70,2443,1861,86,77,2508,1728
25,3,1,3,1,0,0,3,84,83,2444,1864,77,45,2508,1731
26,3,3,6,1,0,0,3,135,82,2447,1870,152,125,2508,1734
27,3,2,1,0,3,1,0,93,102,2449,1871,95,15,2511,1734
28,3,0,3,1,0,0,3,132,80,2449,1874,155,109,2511,1737
29,3,1,1,2,1,2,1,3,3,2450,1875,2,133,2512,1738
30,4,2,2,2,1,2,1,159,69,2452,1877,163,133,2513,1739
31,4,4,2,0,3,1,0,170,66,2456,1879,179,58,2516,1739
32,4,0,0,2,1,2,1,19,26,2456,1879,28,1,2517,1740
33,4,4,0,0,3,1,0,62,47,2460,1879,59,83,2520,1740
34,4,0,1,1,0,0,3,104,79,2460,1880,127,3,2520,1743
35,4,2,2,2,1,2,1,95,93,2462,1882,97,124,2521,1744
36,4,0,2,1,0,0,3,109,108,2462,1884,104,98,2521,1747
37,4,0,1,1,0,0,3,149,66,2462,1885,152,80,2521,1750
38,4,4,0,0,3,1,0,180,73,2466,1885,183,22,2524,1750
39,4,2,2,2,1,2,1,23,24,2468,1887,27,46,2525,1751
40,5,2,2,2,1,2,1,40,56,2470,1889,44,61,2526,1752
41,5,0,3,1,0,0,3,93,105,2470,1892,95,136,2526,1755
42,5,0,0,2,1,2,1,1,3,2470,1892,2,76,2527,1756
43,5,2,2,2,1,2,1,122,110,2472,1894,121,16,2528,1757
44,5,0,1,1,0,0,3,92,71,2472,1895,86,48,2528,1760
45,5,3,1,0,3,1,0,87,84,2475,1896,80,109,2531,1760
46,5,5,3,0,3,1,0,8,6,2480,1899,5,144,2534,1760
47,5,0,1,1,0,0,3,132,81,2480,1900,155,80,2534,1763
48,5,2,3,1,0,0,3,137,85,2482,1903,152,22,2534,1766
49,5,1,1,2,1,2,1,197,55,2483,1904,199,126,2535,1767
50,6,1,1,2,1,2,1,150,67,2484,1905,153,99,2536,1768
51,6,3,0,0,3,1,0,173,66,2487,1905,182,80,2539,1768
52,6,2,0,0,3,1,0,21,26,2489,1905,31,3,2542,1768
53,6,2,4,1,0,0,3,25,28,2491,1909,27,136,2542,1771
54,6,2,1,0,3,1,0,182,74,2493,1910,186,46,2545,1771
55,6,2,1,0,3,1,0,64,48,2495,1911,62,22,2548,1771
56,6,0,0,2,1,2,1,95,93,2495,1911,98,59,2549,1772
57,6,1,1,2,1,2,1,160,70,2496,1912,164,125,2550,1773
58,6,4,0,0,3,1,0,113,108,2500,1912,107,1,2553,1773
59,6,1,0,0,3,1,0,105,79,2501,1912,130,83,2556,1773
60,7,2,0,0,3,1,0,27,28,2503,1912,30,22,2559,1773
61,7,2,2,2,1,2,1,10,8,2505,1914,6,2,2560,1774
62,7,2,1,0,3,1,0,152,68,2507,1915,156,80,2563,1774
63,7,3,1,0,3,1,0,98,94,2510,1916,101,61,2566,1774
64,7,2,2,2,1,2,1,94,73,2512,1918,87,84,2567,1775
65,7,0,2,1,0,0,3,93,107,2512,1920,95,139,2567,1778
66,7,2,1,0,3,1,0,184,75,2514,1921,189,99,2570,1778
67,7,1,0,0,3,1,0,133,81,2515,1921,158,48,2573,1778
68,7,2,0,0,3,1,0,175,66,2517,1921,185,136,2576,1778
69,7,2,0,0,3,1,0,89,84,2519,1921,83,22,2579,1778
70,8,4,1,0,3,1,0,201,56,2523,1922,202,125,2582,1778
71,8,2,2,2,1,2,1,162,72,2525,1924,165,17,2583,1779
72,8,1,3,1,0,0,3,2,6,2526,1927,2,49,2583,1782
73,8,1,2,1,0,0,3,22,28,2527,1929,31,129,2583,1785
74,8,3,0,0,3,1,0,140,85,2530,1929,155,80,2586,1785
75,8,8,0,0,3,1,0,72,48,2538,1929,65,76,2589,1785
76,8,1,0,0,3,1,0,123,110,2539,1929,124,3,2592,1785
77,8,2,3,1,0,0,3,42,59,2541,1932,44,112,2592,1788
78,8,2,1,0,3,1,0,107,80,2543,1933,133,59,2595,1788
79,8,2,2,2,1,2,1,115,110,2545,1935,108,145,2596,1789
80,9,2,1,0,3,1,0,91,85,2547,1936,86,139,2599,1789
81,9,0,0,2,1,2,1,152,68,2547,1936,157,18,2600,1790
82,9,1,0,0,3,1,0,73,48,2548,1936,68,61,2603,1790
83,9,0,2,1,0,0,3,98,96,2548,1938,101,139,2603,1793
84,9,2,2,2,1,2,1,117,112,2550,1940,109,23,2604,1794
85,9,2,0,0,3,1,0,96,73,2552,1940,90,3,2607,1794
86,9,1,3,1,0,0,3,3,9,2553,1943,2,102,2607,1797
87,9,1,2,1,0,0,3,134,83,2554,1945,158,87,2607,1800
88,9,1,1,2,1,2,1,185,76,2555,1946,190,130,2608,1801
89,9,2,0,0,3,1,0,44,59,2557,1946,47,80,2611,1801
90,10,1,0,0,3,1,0,124,110,2558,1946,127,112,2614,1801
91,10,3,0,0,3,1,0,165,72,2561,1946,168,2,2617,1801
92,10,2,1,0,3,1,0,177,67,2563,1947,188,22,2620,1801
93,10,0,0,2,1,2,1,140,85,2563,1947,156,60,2621,1802
94,10,0,1,1,0,0,3,27,29,2563,1948,30,51,2621,1805
95,10,0,1,1,0,0,3,10,9,2563,1949,6,83,2621,1808
96,10,2,2,2,1,2,1,109,82,2565,1951,134,50,2622,1809
97,10,1,0,0,3,1,0,202,56,2566,1951,205,145,2625,1809
98,10,1,2,1,0,0,3,94,109,2567,1953,95,128,2625,1812
99,10,1,3,1,0,0,3,23,31,2568,1956,31,79,2625,1815
100,11,1,2,1,0,0,3,153,70,2569,1958,157,133,2625,1818
101,11,1,0,0,3,1,0,4,9,2570,1958,5,18,2628,1818
102,11,1,0,0,3,1,0,186,76,2571,1958,193,23,2631,1818
103,11,2,0,0,3,1,0,75,48,2573,1958,71,3,2634,1818
104,11,0,0,2,1,2,1,91,85,2573,1958,87,81,2635,1819
105,11,2,2,2,1,2,1,46,61,2575,1960,48,140,2636,1820
106,11,1,1,2,1,2,1,99,97,2576,1961,102,103,2637,1821
107,11,1,2,1,0,0,3,135,85,2577,1963,158,64,2637,1824
108,11,0,2,1,0,0,3,117,114,2577,1965,109,90,2637,1827
109,11,2,1,0,3,1,0,98,74,2579,1966,93,139,2640,1827
110,12,2,0,0,3,1,0,179,67,2581,1966,191,83,2643,1827
111,12,2,1,0,3,1,0,142,86,2583,1967,159,50,2646,1827
112,12,0,0,2,1,2,1,10,9,2583,1967,7,80,2647,1828
113,12,2,1,0,3,1,0,204,57,2585,1968,208,60,2650,1828
114,12,1,0,0,3,1,0,125,110,2586,1968,130,22,2653,1828
115,12,1,2,1,0,0,3,110,84,2587,1970,134,5,2653,1831
116,12,1,2,1,0,0,3,166,74,2588,1972,168,148,2653,1834
117,12,3,1,0,3,1,0,26,32,2591,1973,34,112,2656,1834
118,12,1,2,1,0,0,3,28,31,2592,1975,30,131,2656,1837
119,12,1,1,2,1,2,1,95,110,2593,1976,96,52,2657,1838
120,13,0,1,1,0,0,3,117,115,2593,1977,109,142,2657,1841
121,13,1,1,2,1,2,1,5,10,2594,1978,6,82,2658,1842
122,13,1,0,0,3,1,0,154,70,2595,1978,160,64,2661,1842
123,13,3,0,0,3,1,0,189,76,2598,1978,196,18,2664,1842
124,13,3,2,0,3,1,0,49,63,2601,1980,51,3,2667,1842
125,13,1,1,2,1,2,1,99,75,2602,1981,94,24,2668,1843
126,13,1,0,0,3,1,0,92,85,2603,1981,90,90,2671,1843
127,13,0,0,2,1,2,1,99,97,2603,1981,103,134,2672,1844
128,13,0,3,1,0,0,3,75,51,2603,1984,71,143,2672,1847
129,13,2,1,0,3,1,0,137,86,2605,1985,161,103,2675,1847
130,14,1,1,2,1,2,1,6,11,2606,1986,7,91,2676,1848
131,14,1,3,1,0,0,3,11,12,2607,1989,7,115,2676,1851
132,14,2,1,0,3,1,0,191,77,2609,1990,199,64,2679,1851
133,14,2,0,0,3,1,0,101,75,2611,1990,97,22,2682,1851
134,14,0,1,1,0,0,3,26,33,2611,1991,34,85,2682,1854
135,14,1,2,1,0,0,3,118,117,2612,1993,109,53,2682,1857
136,14,1,0,0,3,1,0,167,74,2613,1993,171,52,2685,1857
137,14,3,0,0,3,1,0,182,67,2616,1993,194,131,2688,1857
138,14,1,1,2,1,2,1,143,87,2617,1994,160,19,2689,1858
139,14,1,4,1,0,0,3,100,101,2618,1998,103,146,2689,1861
140,15,2,1,0,3,1,0,127,111,2620,1999,133,134,2692,1861
141,15,0,0,2,1,2,1,28,31,2620,1999,31,84,2693,1862
142,15,0,0,2,1,2,1,154,70,2620,1999,161,81,2694,1863
143,15,2,0,0,3,1,0,51,63,2622,1999,54,5,2697,1863
144,15,3,2,0,3,1,0,113,86,2625,2001,137,142,2700,1863
145,15,0,0,2,1,2,1,137,86,2625,2001,162,25,2701,1864
146,15,1,0,0,3,1,0,205,57,2626,2001,211,103,2704,1864
147,15,3,1,0,3,1,0,95,86,2629,2002,93,60,2707,1864
148,15,2,1,0,3,1,0,97,111,2631,2003,99,3,2710,1864
149,15,1,2,1,0,0,3,76,53,2632,2005,71,151,2710,1867
150,16,1,0,0,3,1,0,7,11,2633,2005,10,52,2713,1867
151,16,2,0,0,3,1,0,184,67,2635,2005,197,19,2716,1867
152,16,1,1,2,1,2,1,27,34,2636,2006,35,65,2717,1868
153,16,0,1,1,0,0,3,11,13,2636,2007,7,149,2717,1871
154,16,1,1,2,1,2,1,101,102,2637,2008,104,54,2718,1872
155,16,1,0,0,3,1,0,119,117,2638,2008,112,85,2721,1872
156,16,4,1,0,3,1,0,171,75,2642,2009,174,91,2724,1872
157,16,3,0,0,3,1,0,194,77,2645,2009,202,115,2727,1872
158,16,1,2,1,0,0,3,102,77,2646,2011,97,134,2727,1875
159,16,3,1,0,3,1,0,146,88,2649,2012,163,22,2730,1875
160,17,3,0,0,3,1,0,208,57,2652,2012,214,25,2733,1875
161,17,1,1,2,1,2,1,98,112,2653,2013,100,152,2734,1876
162,17,0,1,1,0,0,3,28,32,2653,2014,31,63,2734,1879
163,17,3,2,0,3,1,0,54,65,2656,2016,57,84,2737,1879
164,17,3,0,0,3,1,0,79,53,2659,2016,74,103,2740,1879
165,17,2,1,0,3,1,0,139,87,2661,2017,165,5,2743,1879
166,17,2,0,0,3,1,0,97,86,2663,2017,96,3,2746,1879
167,17,0,1,1,0,0,3,127,112,2663,2018,133,84,2746,1882
168,17,2,2,2,1,2,1,156,72,2665,2020,162,143,2747,1883
169,17,0,2,1,0,0,3,113,88,2665,2022,137,137,2747,1886
170,18,2,0,0,3,1,0,186,67,2667,2022,200,54,2750,1886
171,18,0,1,1,0,0,3,7,12,2667,2023,10,118,2750,1889
172,18,1,3,1,0,0,3,28,37,2668,2026,35,55,2750,1892
173,18,0,1,1,0,0,3,146,89,2668,2027,163,68,2750,1895
174,18,1,2,1,0,0,3,12,15,2669,2029,7,137,2750,1898
175,18,3,1,0,3,1,0,197,78,2672,2030,205,91,2753,1898
176,18,1,3,1,0,0,3,102,105,2673,2033,104,22,2753,1901
177,18,1,0,0,3,1,0,103,77,2674,2033,100,85,2756,1901
178,18,1,3,1,0,0,3,120,120,2675,2036,112,152,2756,1904
179,18,2,1,0,3,1,0,173,76,2677,2037,177,22,2759,1904
180,19,0,0,2,1,2,1,139,87,2677,2037,166,153,2760,1905
181,19,1,1,2,1,2,1,80,54,2678,2038,75,138,2761,1906
182,19,0,0,2,1,2,1,98,112,2678,2038,101,85,2762,1907
183,19,0,1,1,0,0,3,28,33,2678,2039,31,6,2762,1910
184,19,2,2,2,1,2,1,210,59,2680,2041,215,6,2763,1911
185,19,0,0,2,1,2,1,54,65,2680,2041,58,26,2764,1912
186,19,2,0,0,3,1,0,115,88,2682,2041,140,84,2767,1912
187,19,1,2,1,0,0,3,98,88,2683,2043,96,146,2767,1915
188,19,3,2,0,3,1,0,130,114,2686,2045,136,103,2770,1915
189,19,4,1,0,3,1,0,160,73,2690,2046,165,63,2773,1915
190,20,1,1,2,1,2,1,116,89,2691,2047,141,154,2774,1916
191,20,2,0,0,3,1,0,82,54,2693,2047,78,146,2777,1916
192,20,3,3,2,1,2,1,133,117,2696,2050,137,7,2778,1917
193,20,2,2,2,1,2,1,162,75,2698,2052,166,7,2779,1918
194,20,1,1,2,1,2,1,55,66,2699,2053,59,64,2780,1919
195,20,0,0,2,1,2,1,98,112,2699,2053,102,27,2781,1920
196,20,1,1,2,1,2,1,99,89,2700,2054,97,85,2782,1921
197,20,2,0,0,3,1,0,30,33,2702,2054,34,103,2785,1921
198,20,3,2,0,3,1,0,213,61,2705,2056,218,85,2788,1921
199,20,5,3,0,3,1,0,144,90,2710,2059,169,138,2791,1921
200,21,0,1,1,0,0,3,102,106,2710,2060,104,121,2791,1924
201,21,1,0,0,3,1,0,13,15,2711,2060,10,85,2794,1924
202,21,1,0,0,3,1,0,121,120,2712,2060,115,22,2797,1924
203,21,1,1,2,1,2,1,147,90,2713,2061,164,153,2798,1925
204,21,2,0,0,3,1,0,188,67,2715,2061,203,91,2801,1925
205,21,2,1,0,3,1,0,9,13,2717,2062,13,22,2804,1925
206,21,1,1,2,1,2,1,104,78,2718,2063,101,55,2805,1926
207,21,2,1,0,3,1,0,30,38,2720,2064,38,137,2808,1926
208,21,3,0,0,3,1,0,176,76,2723,2064,180,68,2811,1926
209,21,0,1,1,0,0,3,197,79,2723,2065,205,58,2811,1929
210,22,0,5,1,0,0,3,104,83,2723,2070,101,141,2811,1932
211,22,2,3,1,0,0,3,11,16,2725,2073,13,30,2811,1935
212,22,0,2,1,0,0,3,98,114,2725,2075,102,124,2811,1938
213,22,0,2,1,0,0,3,55,68,2725,2077,59,157,2811,1941
214,22,0,1,1,0,0,3,13,16,2725,2078,10,71,2811,1944
215,22,2,1,0,3,1,0,146,91,2727,2079,172,85,2814,1944
216,22,1,2,1,0,0,3,134,119,2728,2081,137,61,2814,1947
217,22,3,0,0,3,1,0,102,89,2731,2081,100,22,2817,1947
218,22,0,2,1,0,0,3,213,63,2731,2083,218,149,2817,1950
219,22,0,0,2,1,2,1,147,90,2731,2083,165,86,2818,1951
220,23,0,3,1,0,0,3,30,36,2731,2086,34,94,2818,1954
221,23,2,0,0,3,1,0,104,106,2733,2086,107,7,2821,1954
222,23,0,1,1,0,0,3,30,39,2733,2087,38,106,2821,1957
223,23,3,1,0,3,1,0,200,80,2736,2088,208,7,2824,1957
224,23,3,1,0,3,1,0,119,90,2739,2089,144,22,2827,1957
225,23,0,3,1,0,0,3,121,123,2739,2092,115,140,2827,1960
226,23,2,0,0,3,1,0,164,75,2741,2092,169,55,2830,1960
227,23,1,1,2,1,2,1,189,68,2742,2093,204,154,2831,1961
228,23,5,0,0,3,1,0,181,76,2747,2093,183,85,2834,1961
229,23,0,1,1,0,0,3,82,55,2747,2094,78,67,2834,1964
230,24,2,1,0,3,1,0,148,92,2749,2095,175,149,2837,1964
231,24,1,2,1,0,0,3,99,116,2750,2097,102,144,2837,1967
232,24,0,1,1,0,0,3,13,17,2750,2098,10,33,2837,1970
233,24,1,1,2,1,2,1,214,64,2751,2099,219,23,2838,1971
234,24,0,1,1,0,0,3,55,69,2751,2100,59,64,2838,1974
235,24,1,1,2,1,2,1,105,84,2752,2101,102,86,2839,1975
236,24,0,0,2,1,2,1,147,90,2752,2101,166,125,2840,1976
237,24,2,2,2,1,2,1,13,18,2754,2103,14,87,2841,1977
238,24,1,1,2,1,2,1,135,120,2755,2104,138,72,2842,1978
239,24,1,1,2,1,2,1,103,90,2756,2105,101,158,2843,1979
240,25,2,0,0,3,1,0,32,36,2758,2105,37,85,2846,1979
241,25,2,1,0,3,1,0,183,77,2760,2106,186,7,2849,1979
242,25,0,2,1,0,0,3,104,108,2760,2108,107,25,2849,1982
243,25,3,2,0,3,1,0,167,77,2763,2110,172,140,2852,1982
244,25,3,1,0,3,1,0,203,81,2766,2111,211,7,2855,1982
245,25,1,0,0,3,1,0,190,68,2767,2111,207,106,2858,1982
246,25,1,4,1,0,0,3,120,94,2768,2115,144,157,2858,1985
247,25,0,0,2,1,2,1,82,55,2768,2115,79,56,2859,1986
248,25,1,1,2,1,2,1,31,40,2769,2116,39,95,2860,1987
249,25,2,0,0,3,1,0,123,123,2771,2116,118,67,2863,1987
250,26,1,2,1,0,0,3,32,42,2772,2118,39,152,2863,1990
251,26,1,1,2,1,2,1,191,69,2773,2119,208,8,2864,1991
252,26,2,1,0,3,1,0,107,85,2775,2120,105,158,2867,1991
253,26,2,1,0,3,1,0,34,37,2777,2121,40,25,2870,1991
254,26,1,2,1,0,0,3,100,118,2778,2123,102,75,2870,1994
255,26,0,0,2,1,2,1,104,108,2778,2123,108,88,2871,1995
256,26,5,0,0,3,1,0,219,64,2783,2123,222,95,2874,1995
257,26,2,2,2,1,2,1,150,94,2785,2125,176,57,2875,1996
258,26,2,2,2,1,2,1,149,92,2787,2127,167,8,2876,1997
259,26,0,2,1,0,0,3,82,57,2787,2129,79,128,2876,2000
260,27,1,3,1,0,0,3,104,93,2788,2132,101,36,2876,2003
261,27,1,0,0,3,1,0,136,120,2789,2132,141,85,2879,2003
262,27,1,0,0,3,1,0,121,94,2790,2132,147,23,2882,2003
263,27,1,0,0,3,1,0,124,123,2791,2132,121,64,2885,2003
264,27,2,0,0,3,1,0,205,81,2793,2132,214,86,2888,2003
265,27,0,1,1,0,0,3,13,19,2793,2133,14,70,2888,2006
266,27,2,1,0,3,1,0,169,78,2795,2134,175,157,2891,2006
267,27,2,0,0,3,1,0,185,77,2797,2134,189,106,2894,2006
268,27,1,2,1,0,0,3,56,71,2798,2136,59,143,2894,2009
269,27,1,3,1,0,0,3,14,20,2799,2139,10,147,2894,2012
270,28,1,1,2,1,2,1,35,38,2800,2140,41,87,2895,2013
271,28,1,0,0,3,1,0,83,57,2801,2140,82,36,2898,2013
272,28,2,1,0,3,1,0,102,119,2803,2141,105,88,2901,2013
273,28,1,2,1,0,0,3,57,73,2804,2143,59,155,2901,2016
274,28,0,1,1,0,0,3,104,94,2804,2144,101,150,2901,2019
275,28,2,0,0,3,1,0,123,94,2806,2144,150,106,2904,2019
276,28,0,1,1,0,0,3,136,121,2806,2145,141,161,2904,2022
277,28,2,0,0,3,1,0,221,64,2808,2145,225,8,2907,2022
278,28,3,2,0,3,1,0,153,96,2811,2147,179,70,2910,2022
279,28,2,0,0,3,1,0,171,78,2813,2147,178,8,2913,2022
280,29,3,1,0,3,1,0,35,43,2816,2148,42,25,2916,2022
281,29,0,4,1,0,0,3,104,112,2816,2152,108,88,2916,2025
282,29,0,0,2,1,2,1,14,20,2816,2152,11,24,2917,2026
283,29,1,0,0,3,1,0,125,123,2817,2152,124,75,2920,2026
284,29,3,0,0,3,1,0,188,77,2820,2152,192,57,2923,2026
285,29,1,0,0,3,1,0,14,19,2821,2152,17,157,2926,2026
286,29,1,1,2,1,2,1,192,70,2822,2153,209,65,2927,2027
287,29,3,0,0,3,1,0,152,92,2825,2153,170,95,2930,2027
288,29,3,0,0,3,1,0,208,81,2828,2153,217,143,2933,2027
289,29,0,1,1,0,0,3,107,86,2828,2154,105,131,2933,2030
290,30,3,0,0,3,1,0,224,64,2831,2154,228,88,2936,2030
291,30,1,2,1,0,0,3,137,123,2832,2156,141,158,2936,2033
292,30,2,0,0,3,1,0,85,57,2834,2156,85,8,2939,2033
293,30,1,2,1,0,0,3,124,96,2835,2158,150,39,2939,2036
294,30,4,3,0,3,1,0,157,99,2839,2161,182,8,2942,2036
295,30,0,1,1,0,0,3,102,120,2839,2162,105,73,2942,2039
296,30,1,0,0,3,1,0,105,94,2840,2162,104,87,2945,2039
297,30,1,2,1,0,0,3,172,80,2841,2164,178,164,2945,2042
298,30,2,3,1,0,0,3,37,41,2843,2167,41,153,2945,2045
299,30,1,2,1,0,0,3,58,75,2844,2169,59,109,2945,2048
300,31,4,1,0,3,1,0,192,78,2848,2170,195,131,2948,2048
301,31,3,1,0,3,1,0,211,82,2851,2171,220,88,2951,2048
302,31,3,1,0,3,1,0,110,87,2854,2172,108,24,2954,2048
303,31,1,4,1,0,0,3,126,127,2855,2176,124,28,2954,2051
304,31,1,0,0,3,1,0,153,92,2856,2176,173,65,2957,2051
305,31,2,1,0,3,1,0,16,21,2858,2177,14,57,2960,2051
306,31,2,1,0,3,1,0,194,71,2860,2178,212,75,2963,2051
307,31,0,0,2,1,2,1,14,19,2860,2178,18,144,2964,2052
308,31,1,0,0,3,1,0,105,112,2861,2178,111,95,2967,2052
309,31,2,1,0,3,1,0,37,44,2863,2179,45,157,2970,2052
310,32,1,1,2,1,2,1,111,88,2864,2180,109,110,2971,2053
311,32,0,1,1,0,0,3,157,100,2864,2181,182,91,2971,2056
312,32,1,4,1,0,0,3,106,116,2865,2185,111,42,2971,2059
313,32,2,0,0,3,1,0,87,57,2867,2185,88,24,2974,2059
314,32,2,3,1,0,0,3,128,130,2869,2188,124,11,2974,2062
315,32,1,1,2,1,2,1,106,95,2870,2189,105,76,2975,2063
316,32,0,1,1,0,0,3,14,20,2870,2190,18,161,2975,2066
317,32,0,1,1,0,0,3,58,76,2870,2191,59,156,2975,2069
318,32,4,2,0,3,1,0,215,84,2874,2193,223,157,2978,2069
319,32,2,0,0,3,1,0,174,80,2876,2193,181,95,2981,2069
320,33,3,3,2,1,2,1,105,123,2879,2196,106,29,2982,2070
321,33,1,0,0,3,1,0,154,92,2880,2196,176,8,2985,2070
322,33,2,1,0,3,1,0,126,97,2882,2197,153,65,2988,2070
323,33,2,0,0,3,1,0,18,21,2884,2197,17,73,2991,2070
324,33,0,2,1,0,0,3,37,46,2884,2199,45,91,2991,2073
325,33,1,0,0,3,1,0,195,71,2885,2199,215,164,2994,2073
326,33,2,0,0,3,1,0,226,64,2887,2199,231,57,2997,2073
327,33,1,3,1,0,0,3,138,126,2888,2202,141,147,2997,2076
328,33,1,0,0,3,1,0,38,41,2889,2202,44,131,3000,2076
329,33,0,0,2,1,2,1,192,78,2889,2202,196,88,3001,2077
330,34,2,2,2,1,2,1,89,59,2891,2204,89,148,3002,2078
331,34,0,2,1,0,0,3,37,48,2891,2206,45,27,3002,2081
332,34,0,1,1,0,0,3,14,21,2891,2207,18,14,3002,2084
333,34,0,0,2,1,2,1,128,130,2891,2207,125,132,3003,2085
334,34,1,1,2,1,2,1,127,98,2892,2208,154,89,3004,2086
335,34,2,3,1,0,0,3,140,129,2894,2211,141,76,3004,2089
336,34,0,0,2,1,2,1,58,76,2894,2211,60,58,3005,2090
337,34,3,2,0,3,1,0,229,66,2897,2213,234,91,3008,2090
338,34,3,0,0,3,1,0,157,92,2900,2213,179,164,3011,2090
339,34,0,0,2,1,2,1,192,78,2900,2213,197,157,3012,2091
340,35,3,0,0,3,1,0,21,21,2903,2213,20,95,3015,2091
341,35,1,0,0,3,1,0,107,95,2904,2213,108,8,3018,2091
342,35,3,2,0,3,1,0,108,125,2907,2215,109,110,3021,2091
343,35,2,1,0,3,1,0,176,81,2909,2216,184,29,3024,2091
344,35,2,1,0,3,1,0,108,117,2911,2217,114,65,3027,2091
345,35,2,0,0,3,1,0,113,88,2913,2217,112,76,3030,2091
346,35,0,1,1,0,0,3,215,85,2913,2218,223,94,3030,2094
347,35,1,0,0,3,1,0,196,71,2914,2218,218,42,3033,2094
348,35,0,1,1,0,0,3,157,101,2914,2219,182,160,3033,2097
349,35,1,3,1,0,0,3,39,44,2915,2222,44,164,3033,2100
350,36,0,2,1,0,0,3,157,94,2915,2224,179,92,3033,2103
351,36,0,1,1,0,0,3,39,45,2915,2225,44,11,3033,2106
352,36,2,0,0,3,1,0,23,21,2917,2225,23,65,3036,2106
353,36,3,0,0,3,1,0,130,98,2920,2225,157,148,3039,2106
354,36,1,1,2,1,2,1,141,130,2921,2226,142,95,3040,2107
355,36,1,0,0,3,1,0,109,125,2922,2226,112,58,3043,2107
356,36,1,2,1,0,0,3,38,50,2923,2228,45,167,3043,2110
357,36,6,0,0,3,1,0,235,66,2929,2228,237,29,3046,2110
358,36,1,1,2,1,2,1,197,72,2930,2229,219,133,3047,2111
359,36,0,1,1,0,0,3,192,79,2930,2230,197,79,3047,2114
360,37,6,1,0,3,1,0,95,60,2936,2231,92,91,3050,2114
361,37,1,2,1,0,0,3,108,97,2937,2233,108,113,3050,2117
362,37,2,0,0,3,1,0,159,101,2939,2233,185,27,3053,2117
363,37,0,0,2,1,2,1,108,117,2939,2233,115,15,3054,2118
364,37,2,1,0,3,1,0,60,77,2941,2234,63,95,3057,2118
365,37,0,0,2,1,2,1,14,21,2941,2234,19,77,3058,2119
366,37,1,3,1,0,0,3,177,84,2942,2237,184,45,3058,2122
367,37,2,4,1,0,0,3,115,92,2944,2241,112,163,3058,2125
368,37,1,1,2,1,2,1,216,86,2945,2242,224,165,3059,2126
369,37,3,0,0,3,1,0,131,130,2948,2242,128,157,3062,2126
370,38,0,1,1,0,0,3,109,126,2948,2243,112,14,3062,2129
371,38,6,1,0,3,1,0,136,99,2954,2244,160,133,3065,2129
372,38,0,0,2,1,2,1,39,45,2954,2244,45,168,3066,2130
373,38,5,1,0,3,1,0,28,22,2959,2245,26,29,3069,2130
374,38,2,0,0,3,1,0,237,66,2961,2245,240,65,3072,2130
375,38,3,1,0,3,1,0,200,73,2964,2246,222,92,3075,2130
376,38,1,0,0,3,1,0,39,50,2965,2246,48,79,3078,2130
377,38,0,1,1,0,0,3,157,95,2965,2247,179,151,3078,2133
378,38,4,1,0,3,1,0,196,80,2969,2248,200,95,3081,2133
379,38,2,0,0,3,1,0,143,130,2971,2248,145,58,3084,2133
0,1,1,0,0,3,1,0,217,86,2972,2248,227,151,3087,2133
1,1,0,1,1,0,0,3,0,1,2972,2249,0,94,3087,2136
2,1,2,2,2,1,2,1,159,97,2974,2251,180,1,3088,2137
3,1,4,2,0,3,1,0,32,24,2978,2253,29,92,3091,2137
4,1,1,3,1,0,0,3,71,71,2979,2256,82,48,3091,2140
5,1,2,2,2,1,2,1,202,75,2981,2258,223,80,3092,2141
6,1,0,2,1,0,0,3,196,82,2981,2260,200,61,3092,2144
7,1,2,2,2,1,2,1,145,132,2983,2262,146,66,3093,2145
8,1,0,1,1,0,0,3,136,100,2983,2263,160,136,3093,2148
9,1,0,3,1,0,0,3,131,133,2983,2266,128,166,3093,2151
10,2,0,1,1,0,0,3,109,127,2983,2267,112,171,3093,2154
11,2,0,3,1,0,0,3,95,63,2983,2270,92,116,3093,2157
12,2,1,3,1,0,0,3,109,120,2984,2273,115,45,3093,2160
13,2,2,0,0,3,1,0,117,92,2986,2273,115,95,3096,2160
14,2,2,2,2,1,2,1,161,103,2988,2275,186,78,3097,2161
15,2,0,0,2,1,2,1,0,0,2988,2275,1,96,3098,2162
16,2,1,2,1,0,0,3,109,99,2989,2277,108,18,3098,2165
17,2,1,2,1,0,0,3,40,52,2990,2279,48,168,3098,2168
18,2,3,0,0,3,1,0,240,66,2993,2279,243,157,3101,2168
19,2,1,0,0,3,1,0,178,84,2994,2279,187,0,3104,2168
20,3,0,0,2,1,2,1,217,86,2994,2279,228,96,3105,2169
21,3,2,1,0,3,1,0,42,53,2996,2280,51,94,3108,2169
22,3,1,1,2,1,2,1,33,25,2997,2281,30,152,3109,2170
23,3,1,1,2,1,2,1,72,72,2998,2282,83,79,3110,2171
24,3,1,1,2,1,2,1,110,121,2999,2283,116,81,3111,2172
25,3,3,4,1,0,0,3,112,103,3002,2287,108,3,3111,2175
26,3,2,3,1,0,0,3,133,136,3004,2290,128,160,3111,2178
27,3,0,2,1,0,0,3,159,99,3004,2292,180,169,3111,2181
28,3,0,0,2,1,2,1,0,0,3004,2292,2,67,3112,2182
29,3,0,0,2,1,2,1,196,82,3004,2292,201,137,3113,2183
30,4,0,1,1,0,0,3,145,133,3004,2293,146,171,3113,2186
31,4,2,2,2,1,2,1,111,129,3006,2295,113,93,3114,2187
32,4,1,1,2,1,2,1,1,2,3007,2296,1,19,3115,2188
33,4,1,2,1,0,0,3,203,77,3008,2298,223,51,3115,2191
34,4,0,3,1,0,0,3,178,87,3008,2301,187,64,3115,2194
35,4,2,0,0,3,1,0,242,66,3010,2301,246,1,3118,2194
36,4,0,1,1,0,0,3,136,101,3010,2302,160,99,3118,2197
37,4,0,0,2,1,2,1,161,103,3010,2302,187,117,3119,2198
38,4,3,0,0,3,1,0,98,63,3013,2302,95,45,3122,2198
39,4,2,1,0,3,1,0,119,93,3015,2303,118,171,3125,2198
40,5,3,1,0,3,1,0,162,100,3018,2304,183,160,3128,2198
41,5,2,0,0,3,1,0,198,82,3020,2304,204,79,3131,2198
42,5,0,1,1,0,0,3,42,54,3020,2305,51,172,3131,2201
43,5,3,1,0,3,1,0,75,73,3023,2306,86,3,3134,2201
44,5,1,0,0,3,1,0,1,0,3024,2306,5,81,3137,2201
45,5,0,0,2,1,2,1,133,136,3024,2306,129,68,3138,2202
46,5,3,1,0,3,1,0,220,87,3027,2307,231,137,3141,2202
47,5,0,1,1,0,0,3,110,122,3027,2308,116,155,3141,2205
48,5,3,2,0,3,1,0,36,27,3030,2310,33,94,3144,2205
49,5,2,0,0,3,1,0,114,103,3032,2310,111,96,3147,2205
50,6,2,0,0,3,1,0,205,77,3034,2310,226,171,3150,2205
51,6,0,1,1,0,0,3,111,130,3034,2311,113,102,3150,2208
52,6,2,0,0,3,1,0,3,2,3036,2311,4,93,3153,2208
53,6,1,2,1,0,0,3,146,135,3037,2313,146,4,3153,2211
54,6,2,2,2,1,2,1,138,103,3039,2315,161,20,3154,2212
55,6,0,0,2,1,2,1,119,93,3039,2315,119,118,3155,2213
56,6,1,2,1,0,0,3,243,68,3040,2317,246,67,3155,2216
57,6,1,0,0,3,1,0,162,103,3041,2317,190,51,3158,2216
58,6,1,1,2,1,2,1,179,88,3042,2318,188,46,3159,2217
59,6,2,3,1,0,0,3,100,66,3044,2321,95,174,3159,2220
60,7,4,1,0,3,1,0,166,104,3048,2322,193,172,3162,2220
61,7,2,5,1,0,0,3,38,32,3050,2327,33,174,3162,2223
62,7,3,2,0,3,1,0,182,90,3053,2329,191,94,3165,2223
63,7,3,0,0,3,1,0,223,87,3056,2329,234,93,3168,2223
64,7,3,1,0,3,1,0,103,67,3059,2330,98,81,3171,2223
65,7,2,1,0,3,1,0,140,104,3061,2331,164,3,3174,2223
66,7,2,2,2,1,2,1,116,105,3063,2333,112,47,3175,2224
67,7,2,2,2,1,2,1,148,137,3065,2335,147,161,3176,2225
68,7,0,1,1,0,0,3,1,1,3065,2336,5,54,3176,2228
69,7,2,3,1,0,0,3,135,139,3067,2339,129,121,3176,2231
70,8,2,0,0,3,1,0,44,54,3069,2339,54,102,3179,2231
71,8,0,1,1,0,0,3,111,131,3069,2340,113,82,3179,2234
72,8,1,1,2,1,2,1,4,3,3070,2341,5,5,3180,2235
73,8,6,1,0,3,1,0,249,69,3076,2342,249,96,3183,2235
74,8,1,2,1,0,0,3,76,75,3077,2344,86,23,3183,2238
75,8,2,2,2,1,2,1,112,124,3079,2346,117,68,3184,2239
76,8,1,3,1,0,0,3,206,80,3080,2349,226,71,3184,2242
77,8,1,1,2,1,2,1,163,101,3081,2350,184,138,3185,2243
78,8,3,0,0,3,1,0,201,82,3084,2350,207,174,3188,2243
79,8,2,2,2,1,2,1,121,95,3086,2352,120,156,3189,2244
80,9,0,0,2,1,2,1,166,104,3086,2352,194,139,3190,2245
81,9,2,0,0,3,1,0,208,80,3088,2352,229,94,3193,2245
82,9,1,3,1,0,0,3,45,57,3089,2355,54,71,3193,2248
83,9,0,3,1,0,0,3,163,104,3089,2358,184,177,3193,2251
84,9,5,1,0,3,1,0,254,70,3094,2359,252,3,3196,2251
85,9,2,2,2,1,2,1,105,69,3096,2361,99,24,3197,2252
86,9,1,0,0,3,1,0,136,139,3097,2361,132,93,3200,2252
87,9,0,3,1,0,0,3,1,4,3097,2364,5,177,3200,2255
88,9,6,2,0,3,1,0,154,139,3103,2366,150,47,3203,2255
89,9,0,1,1,0,0,3,121,96,3103,2367,120,85,3203,2258
90,10,1,2,1,0,0,3,112,133,3104,2369,113,84,3203,2261
91,10,1,0,0,3,1,0,39,32,3105,2369,36,54,3206,2261
92,10,0,1,1,0,0,3,76,76,3105,2370,86,105,3206,2264
93,10,0,2,1,0,0,3,140,106,3105,2372,164,8,3206,2267
94,10,2,1,0,3,1,0,118,106,3107,2373,115,161,3209,2267
95,10,2,1,0,3,1,0,203,83,3109,2374,210,121,3212,2267
96,10,3,0,0,3,1,0,115,124,3112,2374,120,96,3215,2267
97,10,1,5,1,0,0,3,5,8,3113,2379,5,159,3215,2270
98,10,0,0,2,1,2,1,223,87,3113,2379,235,173,3216,2271
99,10,1,1,2,1,2,1,183,91,3114,2380,192,72,3217,2272
100,11,1,3,1,0,0,3,209,83,3115,2383,229,142,3217,2275
101,11,0,0,2,1,2,1,45,57,3115,2383,55,178,3218,2276
102,11,2,1,0,3,1,0,256,71,3117,2384,255,47,3221,2276
103,11,0,0,2,1,2,1,154,139,3117,2384,151,86,3222,2277
104,11,0,3,1,0,0,3,121,99,3117,2387,120,180,3222,2280
105,11,2,0,0,3,1,0,3,4,3119,2387,8,71,3225,2280
106,11,2,3,1,0,0,3,138,142,3121,2390,132,27,3225,2283
107,11,6,2,0,3,1,0,169,106,3127,2392,187,93,3228,2283
108,11,2,0,0,3,1,0,107,69,3129,2392,102,3,3231,2283
109,11,3,1,0,3,1,0,169,105,3132,2393,197,94,3234,2283
110,12,0,1,1,0,0,3,5,9,3132,2394,5,99,3234,2286
111,12,2,1,0,3,1,0,41,33,3134,2395,39,8,3237,2286
112,12,2,0,0,3,1,0,225,87,3136,2395,238,105,3240,2286
113,12,1,0,0,3,1,0,77,76,3137,2395,89,84,3243,2286
114,12,0,1,1,0,0,3,115,125,3137,2396,120,75,3243,2289
115,12,1,1,2,1,2,1,119,107,3138,2397,116,122,3244,2290
116,12,1,0,0,3,1,0,141,106,3139,2397,167,161,3247,2290
117,12,0,0,2,1,2,1,112,133,3139,2397,114,174,3248,2291
118,12,1,1,2,1,2,1,204,84,3140,2398,211,160,3249,2292
119,12,1,2,1,0,0,3,184,93,3141,2400,192,57,3249,2295
120,13,1,2,1,0,0,3,4,6,3142,2402,8,181,3249,2298
121,13,1,0,0,3,1,0,210,83,3143,2402,232,47,3252,2298
122,13,4,0,0,3,1,0,173,106,3147,2402,190,94,3255,2298
123,13,0,3,1,0,0,3,154,142,3147,2405,151,30,3255,2301
124,13,0,1,1,0,0,3,107,70,3147,2406,102,89,3255,2304
125,13,2,2,2,1,2,1,123,101,3149,2408,121,4,3256,2305
126,13,2,1,0,3,1,0,140,143,3151,2409,135,180,3259,2305
127,13,1,4,1,0,0,3,257,75,3152,2413,255,145,3259,2308
128,13,4,1,0,3,1,0,173,106,3156,2414,200,71,3262,2308
129,13,0,1,1,0,0,3,45,58,3156,2415,55,96,3262,2311
130,14,2,3,1,0,0,3,114,136,3158,2418,114,11,3262,2314
131,14,3,3,2,1,2,1,8,12,3161,2421,6,123,3263,2315
132,14,5,1,0,3,1,0,50,59,3166,2422,58,99,3266,2315
133,14,3,1,0,3,1,0,260,76,3169,2423,258,75,3269,2315
134,14,2,0,0,3,1,0,117,125,3171,2423,123,89,3272,2315
135,14,1,1,2,1,2,1,42,34,3172,2424,40,182,3273,2316
136,14,0,0,2,1,2,1,173,106,3172,2424,201,162,3274,2317
137,14,1,1,2,1,2,1,120,108,3173,2425,117,106,3275,2318
138,14,1,0,0,3,1,0,185,93,3174,2425,195,84,3278,2318
139,14,1,1,2,1,2,1,78,77,3175,2426,90,181,3279,2319
140,15,2,0,0,3,1,0,143,106,3177,2426,170,174,3282,2319
141,15,3,1,0,3,1,0,207,85,3180,2427,214,96,3285,2319
142,15,0,0,2,1,2,1,225,87,3180,2427,239,72,3286,2320
143,15,1,1,2,1,2,1,108,71,3181,2428,103,95,3287,2321
144,15,0,3,1,0,0,3,123,104,3181,2431,121,33,3287,2324
145,15,2,0,0,3,1,0,6,6,3183,2431,11,47,3290,2324
146,15,1,1,2,1,2,1,141,144,3184,2432,136,161,3291,2325
147,15,0,1,1,0,0,3,210,84,3184,2433,232,7,3291,2328
148,15,2,0,0,3,1,0,156,142,3186,2433,154,145,3294,2328
149,15,1,1,2,1,2,1,174,107,3187,2434,191,58,3295,2329
150,16,1,1,2,1,2,1,79,78,3188,2435,91,124,3296,2330
151,16,1,0,0,3,1,0,51,59,3189,2435,61,75,3299,2330
152,16,2,1,0,3,1,0,262,77,3191,2436,261,84,3302,2330
153,16,0,1,1,0,0,3,117,126,3191,2437,123,14,3302,2333
154,16,0,0,2,1,2,1,120,108,3191,2437,118,90,3303,2334
155,16,2,1,0,3,1,0,10,13,3193,2438,9,182,3306,2334
156,16,0,2,1,0,0,3,114,138,3193,2440,114,184,3306,2337
157,16,2,2,2,1,2,1,187,95,3195,2442,196,107,3307,2338
158,16,1,2,1,0,0,3,174,108,3196,2444,201,102,3307,2341
159,16,2,1,0,3,1,0,44,35,3198,2445,43,162,3310,2341
160,17,3,1,0,3,1,0,213,85,3201,2446,235,96,3313,2341
161,17,2,3,1,0,0,3,176,110,3203,2449,191,36,3313,2344
162,17,1,2,1,0,0,3,226,89,3204,2451,239,50,3313,2347
163,17,0,2,1,0,0,3,108,73,3204,2453,103,164,3313,2350
164,17,1,2,1,0,0,3,144,108,3205,2455,170,61,3313,2353
165,17,1,2,1,0,0,3,142,146,3206,2457,136,10,3313,2356
166,17,1,1,2,1,2,1,157,143,3207,2458,155,96,3314,2357
167,17,3,0,0,3,1,0,9,6,3210,2458,14,145,3317,2357
168,17,0,0,2,1,2,1,123,104,3210,2458,122,73,3318,2358
169,17,2,1,0,3,1,0,209,86,3212,2459,217,174,3321,2358
170,18,2,0,0,3,1,0,146,108,3214,2459,173,182,3324,2358
171,18,1,1,2,1,2,1,115,139,3215,2460,115,74,3325,2359
172,18,0,0,2,1,2,1,10,13,3215,2460,10,62,3326,2360
173,18,2,2,2,1,2,1,215,87,3217,2462,236,15,3327,2361
174,18,1,0,0,3,1,0,188,95,3218,2462,199,36,3330,2361
175,18,4,1,0,3,1,0,266,78,3222,2463,264,96,3333,2361
176,18,1,0,0,3,1,0,124,104,3223,2463,125,107,3336,2361
177,18,3,0,0,3,1,0,177,108,3226,2463,204,50,3339,2361
178,18,0,1,1,0,0,3,157,144,3226,2464,155,127,3339,2364
179,18,4,0,0,3,1,0,112,73,3230,2464,106,184,3342,2364
180,19,0,0,2,1,2,1,51,59,3230,2464,62,85,3343,2365
181,19,3,4,1,0,0,3,179,114,3233,2468,191,93,3343,2368
182,19,2,0,0,3,1,0,81,78,3235,2468,94,96,3346,2368
183,19,1,2,1,0,0,3,10,8,3236,2470,14,167,3346,2371
184,19,1,0,0,3,1,0,143,146,3237,2470,139,102,3349,2371
185,19,2,0,0,3,1,0,211,86,3239,2470,220,10,3352,2371
186,19,0,0,2,1,2,1,226,89,3239,2470,240,163,3353,2372
187,19,2,1,0,3,1,0,122,109,3241,2471,121,75,3356,2372
188,19,0,0,2,1,2,1,44,35,3241,2471,44,175,3357,2373
189,19,0,1,1,0,0,3,117,127,3241,2472,123,148,3357,2376
190,20,2,0,0,3,1,0,124,109,3243,2472,124,148,3360,2376
191,20,1,0,0,3,1,0,212,86,3244,2472,223,102,3363,2376
192,20,0,0,2,1,2,1,44,35,3244,2472,45,11,3364,2377
193,20,2,1,0,3,1,0,228,90,3246,2473,243,85,3367,2377
194,20,1,0,0,3,1,0,82,78,3247,2473,97,75,3370,2377
195,20,3,1,0,3,1,0,120,128,3250,2474,126,96,3373,2377
196,20,2,1,0,3,1,0,145,147,3252,2475,142,93,3376,2377
197,20,1,2,1,0,0,3,11,10,3253,2477,14,178,3376,2380
198,20,0,3,1,0,0,3,51,62,3253,2480,62,166,3376,2383
199,20,1,1,2,1,2,1,180,115,3254,2481,192,168,3377,2384
200,21,1,0,0,3,1,0,116,139,3255,2481,118,62,3380,2384
201,21,1,3,1,0,0,3,11,16,3256,2484,10,77,3380,2387
202,21,3,3,2,1,2,1,160,147,3259,2487,156,183,3381,2388
203,21,2,4,1,0,0,3,126,108,3261,2491,125,99,3381,2391
204,21,2,2,2,1,2,1,217,89,3263,2493,237,108,3382,2392
205,21,0,0,2,1,2,1,266,78,3263,2493,265,128,3383,2393
206,21,2,0,0,3,1,0,114,73,3265,2493,109,15,3386,2393
207,21,3,1,0,3,1,0,149,109,3268,2494,176,50,3389,2393
208,21,3,3,2,1,2,1,191,98,3271,2497,200,185,3390,2394
209,21,0,1,1,0,0,3,177,109,3271,2498,204,39,3390,2397
210,22,4,1,0,3,1,0,181,110,3275,2499,207,99,3393,2397
211,22,3,0,0,3,1,0,14,16,3278,2499,13,50,3396,2397
212,22,3,3,2,1,2,1,220,92,3281,2502,238,129,3397,2398
213,22,4,0,0,3,1,0,270,78,3285,2502,268,62,3400,2398
214,22,2,1,0,3,1,0,162,148,3287,2503,159,77,3403,2398
215,22,3,0,0,3,1,0,117,73,3290,2503,112,108,3406,2398
216,22,1,1,2,1,2,1,117,140,3291,2504,119,40,3407,2399
217,22,0,1,1,0,0,3,191,99,3291,2505,200,186,3407,2402
218,22,0,0,2,1,2,1,149,109,3291,2505,177,186,3408,2403
219,22,1,0,0,3,1,0,127,108,3292,2505,128,15,3411,2403
220,23,4,5,1,0,0,3,86,83,3296,2510,97,151,3411,2406
221,23,1,3,1,0,0,3,52,65,3297,2513,62,171,3411,2409
222,23,3,0,0,3,1,0,47,35,3300,2513,48,93,3414,2409
223,23,0,1,1,0,0,3,228,91,3300,2514,243,78,3414,2412
224,23,1,1,2,1,2,1,121,129,3301,2515,127,12,3415,2413
225,23,2,1,0,3,1,0,13,11,3303,2516,17,102,3418,2413
226,23,0,0,2,1,2,1,145,147,3303,2516,143,97,3419,2414
227,23,2,2,2,1,2,1,126,111,3305,2518,125,179,3420,2415
228,23,1,2,1,0,0,3,181,117,3306,2520,192,88,3420,2418
229,23,0,1,1,0,0,3,212,87,3306,2521,223,169,3420,2421
230,24,0,0,2,1,2,1,212,87,3306,2521,224,79,3421,2422
231,24,2,0,0,3,1,0,49,35,3308,2521,51,151,3424,2422
232,24,0,3,1,0,0,3,86,86,3308,2524,97,174,3424,2425
233,24,0,1,1,0,0,3,121,130,3308,2525,127,182,3424,2428
234,24,2,0,0,3,1,0,128,111,3310,2525,128,97,3427,2428
235,24,1,2,1,0,0,3,53,67,3311,2527,62,15,3427,2431
236,24,3,0,0,3,1,0,231,91,3314,2527,246,93,3430,2431
237,24,1,1,2,1,2,1,146,148,3315,2528,144,89,3431,2432
238,24,0,0,2,1,2,1,13,11,3315,2528,18,170,3432,2433
239,24,3,0,0,3,1,0,184,117,3318,2528,195,102,3435,2433
240,25,1,3,1,0,0,3,271,81,3319,2531,268,43,3435,2436
241,25,2,0,0,3,1,0,119,140,3321,2531,122,50,3438,2436
242,25,2,2,2,1,2,1,193,101,3323,2533,201,100,3439,2437
243,25,1,0,0,3,1,0,163,148,3324,2533,162,108,3442,2437
244,25,0,3,1,0,0,3,149,112,3324,2536,177,132,3442,2440
245,25,1,1,2,1,2,1,128,109,3325,2537,129,63,3443,2441
246,25,1,0,0,3,1,0,182,110,3326,2537,210,15,3446,2441
247,25,1,0,0,3,1,0,118,73,3327,2537,115,77,3449,2441
248,25,0,2,1,0,0,3,14,18,3327,2539,13,189,3449,2444
249,25,1,1,2,1,2,1,221,93,3328,2540,239,187,3450,2445
250,26,2,1,0,3,1,0,123,131,3330,2541,130,187,3453,2445
251,26,1,3,1,0,0,3,15,21,3331,2544,13,96,3453,2448
252,26,1,2,1,0,0,3,54,69,3332,2546,62,18,3453,2451
253,26,0,1,1,0,0,3,184,118,3332,2547,195,111,3453,2454
254,26,2,2,2,1,2,1,88,88,3334,2549,98,78,3454,2455
255,26,0,1,1,0,0,3,128,110,3334,2550,129,82,3454,2458
256,26,5,1,0,3,1,0,226,94,3339,2551,242,102,3457,2458
257,26,2,1,0,3,1,0,214,88,3341,2552,227,43,3460,2458
258,26,0,6,1,0,0,3,119,146,3341,2558,122,154,3460,2461
259,26,1,2,1,0,0,3,272,83,3342,2560,268,177,3460,2464
260,27,1,0,0,3,1,0,129,111,3343,2560,131,100,3463,2464
261,27,1,0,0,3,1,0,50,35,3344,2560,54,50,3466,2464
262,27,1,2,1,0,0,3,119,75,3345,2562,115,173,3466,2467
263,27,2,1,0,3,1,0,151,113,3347,2563,180,97,3469,2467
264,27,0,0,2,1,2,1,13,11,3347,2563,19,16,3470,2468
265,27,3,2,0,3,1,0,149,150,3350,2565,147,63,3473,2468
266,27,3,2,0,3,1,0,234,93,3353,2567,249,189,3476,2468
267,27,2,1,0,3,1,0,184,111,3355,2568,213,89,3479,2468
268,27,1,1,2,1,2,1,164,149,3356,2569,163,183,3480,2469
269,27,4,0,0,3,1,0,197,101,3360,2569,204,132,3483,2469
270,28,1,3,1,0,0,3,120,149,3361,2572,122,135,3483,2472
271,28,2,0,0,3,1,0,17,21,3363,2572,16,82,3486,2472
272,28,2,2,2,1,2,1,52,37,3365,2574,55,112,3487,2473
273,28,1,2,1,0,0,3,89,90,3366,2576,98,176,3487,2476
274,28,2,2,2,1,2,1,125,133,3368,2578,131,64,3488,2477
275,28,1,2,1,0,0,3,215,90,3369,2580,227,92,3488,2480
276,28,1,0,0,3,1,0,130,111,3370,2580,134,177,3491,2480
277,28,1,0,0,3,1,0,152,113,3371,2580,183,102,3494,2480
278,28,3,0,0,3,1,0,200,101,3374,2580,207,183,3497,2480
279,28,1,0,0,3,1,0,235,93,3375,2580,252,18,3500,2480
280,29,2,2,2,1,2,1,186,113,3377,2582,214,190,3501,2481
281,29,1,1,2,1,2,1,227,95,3378,2583,243,97,3502,2482
282,29,2,3,1,0,0,3,186,121,3380,2586,195,81,3502,2485
283,29,4,0,0,3,1,0,276,83,3384,2586,271,97,3505,2485
284,29,1,3,1,0,0,3,165,152,3385,2589,163,19,3505,2488
285,29,1,1,2,1,2,1,120,76,3386,2590,116,101,3506,2489
286,29,1,0,0,3,1,0,129,110,3387,2590,132,50,3509,2489
287,29,0,1,1,0,0,3,13,12,3387,2591,19,46,3509,2492
288,29,1,2,1,0,0,3,55,71,3388,2593,62,157,3509,2495
289,29,1,0,0,3,1,0,150,150,3389,2593,150,187,3512,2495
290,30,0,0,2,1,2,1,89,90,3389,2593,99,184,3513,2496
291,30,3,2,0,3,1,0,20,23,3392,2595,19,92,3516,2496
292,30,1,2,1,0,0,3,153,115,3393,2597,183,85,3516,2499
293,30,0,2,1,0,0,3,120,151,3393,2599,122,180,3516,2502
294,30,1,0,0,3,1,0,53,37,3394,2599,58,102,3519,2502
295,30,3,1,0,3,1,0,133,112,3397,2600,137,18,3522,2502
296,30,2,0,0,3,1,0,237,93,3399,2600,255,64,3525,2502
297,30,2,0,0,3,1,0,217,90,3401,2600,230,112,3528,2502
298,30,3,0,0,3,1,0,128,133,3404,2600,134,135,3531,2502
299,30,1,1,2,1,2,1,201,102,3405,2601,208,177,3532,2503
300,31,0,2,1,0,0,3,186,123,3405,2603,195,193,3532,2506
301,31,2,2,2,1,2,1,229,97,3407,2605,244,82,3533,2507
302,31,0,1,1,0,0,3,55,72,3407,2606,62,49,3533,2510
303,31,1,2,1,0,0,3,14,14,3408,2608,19,100,3533,2513
304,31,0,1,1,0,0,3,150,151,3408,2609,150,53,3533,2516
305,31,1,0,0,3,1,0,130,110,3409,2609,135,97,3536,2516
306,31,1,1,2,1,2,1,166,153,3410,2610,164,102,3537,2517
307,31,3,2,0,3,1,0,123,78,3413,2612,119,157,3540,2517
308,31,0,1,1,0,0,3,276,84,3413,2613,271,190,3540,2520
309,31,3,0,0,3,1,0,189,113,3416,2613,217,19,3543,2520
310,32,0,4,1,0,0,3,120,155,3416,2617,122,180,3543,2523
311,32,4,0,0,3,1,0,221,90,3420,2617,233,18,3546,2523
312,32,0,4,1,0,0,3,20,27,3420,2621,19,187,3546,2526
313,32,3,2,0,3,1,0,92,92,3423,2623,102,102,3549,2526
314,32,2,2,2,1,2,1,155,117,3425,2625,184,93,3550,2527
315,32,0,0,2,1,2,1,128,133,3425,2625,135,113,3551,2528
316,32,2,2,2,1,2,1,135,114,3427,2627,138,65,3552,2529
317,32,1,1,2,1,2,1,202,103,3428,2628,209,181,3553,2530
318,32,1,0,0,3,1,0,54,37,3429,2628,61,85,3556,2530
319,32,1,0,0,3,1,0,238,93,3430,2628,258,135,3559,2530
320,33,3,3,2,1,2,1,138,117,3433,2631,139,194,3560,2531
321,33,1,2,1,0,0,3,121,157,3434,2633,122,22,3560,2534
322,33,1,0,0,3,1,0,56,72,3435,2633,65,53,3563,2534
323,33,3,1,0,3,1,0,126,79,3438,2634,122,102,3566,2534
324,33,1,0,0,3,1,0,131,110,3439,2634,138,180,3569,2534
325,33,1,1,2,1,2,1,15,15,3440,2635,20,136,3570,2535
326,33,2,1,0,3,1,0,278,85,3442,2636,274,113,3573,2535
327,33,0,2,1,0,0,3,128,135,3442,2638,135,52,3573,2538
328,33,4,1,0,3,1,0,206,104,3446,2639,212,100,3576,2538
329,33,3,0,0,3,1,0,192,113,3449,2639,220,190,3579,2538
330,34,0,3,1,0,0,3,92,95,3449,2642,102,105,3579,2541
331,34,1,1,2,1,2,1,187,124,3450,2643,196,86,3580,2542
332,34,1,0,0,3,1,0,239,93,3451,2643,261,97,3583,2542
333,34,3,0,0,3,1,0,169,153,3454,2643,167,93,3586,2542
334,34,0,1,1,0,0,3,150,152,3454,2644,150,21,3586,2545
335,34,0,3,1,0,0,3,229,100,3454,2647,244,190,3586,2548
336,34,1,2,1,0,0,3,21,29,3455,2649,19,160,3586,2551
337,34,2,2,2,1,2,1,56,39,3457,2651,62,83,3587,2552
338,34,1,1,2,1,2,1,222,91,3458,2652,234,66,3588,2553
339,34,0,4,1,0,0,3,155,121,3458,2656,184,184,3588,2556
340,35,0,0,2,1,2,1,56,72,3458,2656,66,137,3589,2557
341,35,4,0,0,3,1,0,282,85,3462,2656,277,100,3592,2557
342,35,2,4,1,0,0,3,123,161,3464,2660,122,89,3592,2560
343,35,1,4,1,0,0,3,22,33,3465,2664,19,183,3592,2563
344,35,2,2,2,1,2,1,208,106,3467,2666,213,103,3593,2564
345,35,0,0,2,1,2,1,128,135,3467,2666,136,195,3594,2565
346,35,4,0,0,3,1,0,60,39,3471,2666,65,93,3597,2565
347,35,1,1,2,1,2,1,193,114,3472,2667,221,114,3598,2566
348,35,3,2,0,3,1,0,141,119,3475,2669,142,190,3601,2566
349,35,4,2,0,3,1,0,96,97,3479,2671,105,21,3604,2566
350,36,2,1,0,3,1,0,189,125,3481,2672,199,22,3607,2566
351,36,1,0,0,3,1,0,170,153,3482,2672,170,66,3610,2566
352,36,1,1,2,1,2,1,156,122,3483,2673,185,106,3611,2567
353,36,3,2,0,3,1,0,18,17,3486,2675,23,97,3614,2567
354,36,0,3,1,0,0,3,150,155,3486,2678,150,86,3614,2570
355,36,1,0,0,3,1,0,223,91,3487,2678,237,53,3617,2570
356,36,3,1,0,3,1,0,134,111,3490,2679,141,160,3620,2570
357,36,1,1,2,1,2,1,240,94,3491,2680,262,53,3621,2571
358,36,4,2,0,3,1,0,130,81,3495,2682,125,190,3624,2571
359,36,2,2,2,1,2,1,231,102,3497,2684,245,185,3625,2572
360,37,0,1,1,0,0,3,96,98,3497,2685,105,193,3625,2575
361,37,0,0,2,1,2,1,123,161,3497,2685,123,104,3626,2576
362,37,1,1,2,1,2,1,23,34,3498,2686,20,115,3627,2577
363,37,2,1,0,3,1,0,58,73,3500,2687,69,100,3630,2577
364,37,3,2,0,3,1,0,131,137,3503,2689,139,183,3633,2577
365,37,1,4,1,0,0,3,142,123,3504,2693,142,96,3633,2580
366,37,3,1,0,3,1,0,63,40,3507,2694,68,137,3636,2580
367,37,1,2,1,0,0,3,194,116,3508,2696,221,92,3636,2583
368,37,2,0,0,3,1,0,210,106,3510,2696,216,21,3639,2583
369,37,2,2,2,1,2,1,284,87,3512,2698,278,196,3640,2584
370,38,4,0,0,3,1,0,227,91,3516,2698,240,97,3643,2584
371,38,1,1,2,1,2,1,232,103,3517,2699,246,54,3644,2585
372,38,3,0,0,3,1,0,192,125,3520,2699,202,53,3647,2585
373,38,5,1,0,3,1,0,175,154,3525,2700,173,185,3650,2585
374,38,4,1,0,3,1,0,134,82,3529,2701,128,66,3653,2585
375,38,2,1,0,3,1,0,158,123,3531,2702,188,86,3656,2585
376,38,1,1,2,1,2,1,135,112,3532,2703,142,191,3657,2586
377,38,2,2,2,1,2,1,20,19,3534,2705,24,107,3658,2587
378,38,1,1,2,1,2,1,151,156,3535,2706,151,161,3659,2588
379,38,3,1,0,3,1,0,243,95,3538,2707,265,22,3662,2588
0,1,2,1,0,3,1,0,41,46,3540,2708,48,54,3665,2588
1,1,0,1,1,0,0,3,14,22,3540,2709,19,99,3665,2591
2,1,0,1,1,0,0,3,58,74,3540,2710,69,118,3665,2594
3,1,1,1,2,1,2,1,193,126,3541,2711,203,186,3666,2595
4,1,1,1,2,1,2,1,1,1,3542,2712,1,101,3667,2596
5,1,1,1,2,1,2,1,135,83,3543,2713,129,22,3668,2597
6,1,2,1,0,3,1,0,286,88,3545,2714,281,107,3671,2597
7,1,1,3,1,0,0,3,24,37,3546,2717,20,196,3671,2600
8,1,3,4,1,0,0,3,230,95,3549,2721,240,164,3671,2603
9,1,2,1,0,3,1,0,234,104,3551,2722,249,86,3674,2603
10,2,2,0,0,3,1,0,245,95,3553,2722,268,92,3677,2603
11,2,1,4,1,0,0,3,159,127,3554,2726,188,194,3677,2606
12,2,2,0,0,3,1,0,16,22,3556,2726,22,164,3680,2606
13,2,0,2,1,0,0,3,135,114,3556,2728,142,30,3680,2609
14,2,1,0,0,3,1,0,195,116,3557,2728,224,66,3683,2609
15,2,1,2,1,0,0,3,21,21,3558,2730,24,186,3683,2612
16,2,1,2,1,0,0,3,152,158,3559,2732,151,140,3683,2615
17,2,0,0,2,1,2,1,63,40,3559,2732,69,197,3684,2616
18,2,1,2,1,0,0,3,132,139,3560,2734,139,3,3684,2619
19,2,1,0,0,3,1,0,143,123,3561,2734,145,22,3687,2619
20,3,1,1,2,1,2,1,196,117,3562,2735,225,165,3688,2620
21,3,3,0,0,3,1,0,237,104,3565,2735,252,14,3691,2620
22,3,1,1,2,1,2,1,59,75,3566,2736,70,23,3692,2621
23,3,1,0,0,3,1,0,194,126,3567,2736,206,101,3695,2621
24,3,2,1,0,3,1,0,65,41,3569,2737,72,99,3698,2621
25,3,1,1,2,1,2,1,136,84,3570,2738,130,108,3699,2622
26,3,1,3,1,0,0,3,22,24,3571,2741,24,200,3699,2625
27,3,0,1,1,0,0,3,41,47,3571,2742,48,199,3699,2628
28,3,0,0,2,1,2,1,152,158,3571,2742,152,4,3700,2629
29,3,3,1,0,3,1,0,289,89,3574,2743,284,86,3703,2629
30,4,1,2,1,0,0,3,246,97,3575,2745,268,197,3703,2632
31,4,1,0,0,3,1,0,25,37,3576,2745,23,118,3706,2632
32,4,2,1,0,3,1,0,232,96,3578,2746,243,92,3709,2632
33,4,1,1,2,1,2,1,17,23,3579,2747,23,31,3710,2633
34,4,1,2,1,0,0,3,2,3,3580,2749,1,69,3710,2636
35,4,0,4,1,0,0,3,159,131,3580,2753,188,189,3710,2639
36,4,2,4,1,0,0,3,145,127,3582,2757,145,25,3710,2642
37,4,4,1,0,3,1,0,214,107,3586,2758,219,54,3713,2642
38,4,2,2,2,1,2,1,137,116,3588,2760,143,187,3714,2643
39,4,0,3,1,0,0,3,132,142,3588,2763,139,143,3714,2646
40,5,1,2,1,0,0,3,238,106,3589,2765,252,168,3714,2649
41,5,1,4,1,0,0,3,42,51,3590,2769,48,203,3714,2652
42,5,3,0,0,3,1,0,68,41,3593,2769,75,14,3717,2652
43,5,4,0,0,3,1,0,293,89,3597,2769,287,23,3720,2652
44,5,4,2,0,3,1,0,156,160,3601,2771,155,86,3723,2652
45,5,3,1,0,3,1,0,197,127,3604,2772,209,4,3726,2652
46,5,3,1,0,3,1,0,25,25,3607,2773,27,199,3729,2652
47,5,4,1,0,3,1,0,63,76,3611,2774,73,101,3732,2652
48,5,1,0,0,3,1,0,137,84,3612,2774,133,99,3735,2652
49,5,1,0,0,3,1,0,197,117,3613,2774,228,108,3738,2652
50,6,4,1,0,3,1,0,250,98,3617,2775,271,54,3741,2652
51,6,1,0,0,3,1,0,26,37,3618,2775,26,143,3744,2652
52,6,5,1,0,3,1,0,219,108,3623,2776,222,31,3747,2652
53,6,1,2,1,0,0,3,3,5,3624,2778,1,192,3747,2655
54,6,1,1,2,1,2,1,160,132,3625,2779,189,119,3748,2656
55,6,2,3,1,0,0,3,134,145,3627,2782,139,72,3748,2659
56,6,1,3,1,0,0,3,138,119,3628,2785,143,200,3748,2662
57,6,3,0,0,3,1,0,235,96,3631,2785,246,187,3751,2662
58,6,0,3,1,0,0,3,145,130,3631,2788,145,95,3751,2665
59,6,2,0,0,3,1,0,19,23,3633,2788,26,25,3754,2665
60,7,1,1,2,1,2,1,198,128,3634,2789,210,73,3755,2666
61,7,1,2,1,0,0,3,139,121,3635,2791,143,171,3755,2669
62,7,0,2,1,0,0,3,42,53,3635,2793,48,190,3755,2672
63,7,1,1,2,1,2,1,135,146,3636,2794,140,120,3756,2673
64,7,2,2,2,1,2,1,27,27,3638,2796,28,24,3757,2674
65,7,1,1,2,1,2,1,146,131,3639,2797,146,5,3758,2675
66,7,1,1,2,1,2,1,251,99,3640,2798,272,102,3759,2676
67,7,0,0,2,1,2,1,68,41,3640,2798,76,96,3760,2677
68,7,2,0,0,3,1,0,199,117,3642,2798,231,200,3763,2677
69,7,0,1,1,0,0,3,19,24,3642,2799,26,206,3763,2680
70,8,3,0,0,3,1,0,241,106,3645,2799,255,54,3766,2680
71,8,6,1,0,3,1,0,32,38,3651,2800,29,31,3769,2680
72,8,3,2,0,3,1,0,238,98,3654,2802,249,99,3772,2680
73,8,1,1,2,1,2,1,294,90,3655,2803,288,144,3773,2681
74,8,2,0,0,3,1,0,162,132,3657,2803,192,108,3776,2681
75,8,1,1,2,1,2,1,157,161,3658,2804,156,193,3777,2682
76,8,0,1,1,0,0,3,63,77,3658,2805,73,89,3777,2685
77,8,0,1,1,0,0,3,3,6,3658,2806,1,28,3777,2688
78,8,3,1,0,3,1,0,140,85,3661,2807,136,14,3780,2688
79,8,0,0,2,1,2,1,219,108,3661,2807,223,200,3781,2689
80,9,0,0,2,1,2,1,32,38,3661,2807,30,194,3782,2690
81,9,0,0,2,1,2,1,238,98,3661,2807,250,6,3783,2691
82,9,2,1,0,3,1,0,21,25,3663,2808,29,144,3786,2691
83,9,0,2,1,0,0,3,42,55,3663,2810,48,105,3786,2694
84,9,3,1,0,3,1,0,71,42,3666,2811,79,73,3789,2694
85,9,0,0,2,1,2,1,139,121,3666,2811,144,29,3790,2695
86,9,1,0,0,3,1,0,147,131,3667,2811,149,108,3793,2695
87,9,2,1,0,3,1,0,221,109,3669,2812,226,120,3796,2695
88,9,1,1,2,1,2,1,295,91,3670,2813,289,97,3797,2696
89,9,4,0,0,3,1,0,245,106,3674,2813,258,200,3800,2696
90,10,1,4,1,0,0,3,136,150,3675,2817,140,209,3800,2699
91,10,0,0,2,1,2,1,251,99,3675,2817,273,15,3801,2700
92,10,2,0,0,3,1,0,5,6,3677,2817,4,24,3804,2700
93,10,1,1,2,1,2,1,200,118,3678,2818,232,55,3805,2701
94,10,1,0,0,3,1,0,28,27,3679,2818,31,31,3808,2701
95,10,0,4,1,0,0,3,157,165,3679,2822,156,203,3808,2704
96,10,2,4,1,0,0,3,65,81,3681,2826,73,174,3808,2707
97,10,2,0,0,3,1,0,200,128,3683,2826,213,89,3811,2707
98,10,0,2,1,0,0,3,140,87,3683,2828,136,193,3811,2710
99,10,3,1,0,3,1,0,165,133,3686,2829,195,99,3814,2710
100,11,1,2,1,0,0,3,33,40,3687,2831,30,111,3814,2713
101,11,3,2,0,3,1,0,24,27,3690,2833,32,73,3817,2713
102,11,1,1,2,1,2,1,296,92,3691,2834,290,7,3818,2714
103,11,1,1,2,1,2,1,148,132,3692,2835,150,106,3819,2715
104,11,5,0,0,3,1,0,250,106,3697,2835,261,144,3822,2715
105,11,1,1,2,1,2,1,239,99,3698,2836,251,195,3823,2716
106,11,2,1,0,3,1,0,44,56,3700,2837,51,97,3826,2716
107,11,6,1,0,3,1,0,227,110,3706,2838,229,29,3829,2716
108,11,1,3,1,0,0,3,140,124,3707,2841,144,203,3829,2719
109,11,1,2,1,0,0,3,72,44,3708,2843,79,123,3829,2722
110,12,1,1,2,1,2,1,252,100,3709,2844,274,210,3830,2723
111,12,1,2,1,0,0,3,66,83,3710,2846,73,206,3830,2726
112,12,1,1,2,1,2,1,201,129,3711,2847,214,100,3831,2727
113,12,0,0,2,1,2,1,140,87,3711,2847,137,175,3832,2728
114,12,0,1,1,0,0,3,165,134,3711,2848,195,27,3832,2731
115,12,3,0,0,3,1,0,139,150,3714,2848,143,31,3835,2731
116,12,2,1,0,3,1,0,30,28,3716,2849,34,55,3838,2731
117,12,3,2,0,3,1,0,203,120,3719,2851,235,89,3841,2731
118,12,0,1,1,0,0,3,5,7,3719,2852,4,196,3841,2734
119,12,4,0,0,3,1,0,161,165,3723,2852,159,15,3844,2734
120,13,1,2,1,0,0,3,25,29,3724,2854,32,209,3844,2737
121,13,1,1,2,1,2,1,45,57,3725,2855,52,124,3845,2738
122,13,2,2,2,1,2,1,74,46,3727,2857,80,8,3846,2739
123,13,2,0,0,3,1,0,229,110,3729,2857,232,111,3849,2739
124,13,5,4,0,3,1,0,145,128,3734,2861,147,73,3852,2739
125,13,2,1,0,3,1,0,252,107,3736,2862,264,195,3855,2739
126,13,0,1,1,0,0,3,30,29,3736,2863,34,109,3855,2742
127,13,3,1,0,3,1,0,242,100,3739,2864,254,27,3858,2742
128,13,1,1,2,1,2,1,253,101,3740,2865,275,90,3859,2743
129,13,1,0,0,3,1,0,141,87,3741,2865,140,144,3862,2743
130,14,1,3,1,0,0,3,297,95,3742,2868,290,199,3862,2746
131,14,3,0,0,3,1,0,69,83,3745,2868,76,97,3865,2746
132,14,2,0,0,3,1,0,167,134,3747,2868,198,15,3868,2746
133,14,2,1,0,3,1,0,141,151,3749,2869,146,55,3871,2746
134,14,5,0,0,3,1,0,208,120,3754,2869,238,100,3874,2746
135,14,3,1,0,3,1,0,164,166,3757,2870,162,29,3877,2746
136,14,1,5,1,0,0,3,149,137,3758,2875,150,213,3877,2749
137,14,4,3,0,3,1,0,37,43,3762,2878,33,175,3880,2749
138,14,1,1,2,1,2,1,202,130,3763,2879,215,204,3881,2750
139,14,1,0,0,3,1,0,6,7,3764,2879,7,31,3884,2750
140,15,3,2,0,3,1,0,33,31,3767,2881,37,144,3887,2750
141,15,3,1,0,3,1,0,245,101,3770,2882,257,109,3890,2750
142,15,3,2,0,3,1,0,28,31,3773,2884,35,27,3893,2750
143,15,3,3,2,1,2,1,48,60,3776,2887,53,74,3894,2751
144,15,3,0,0,3,1,0,148,128,3779,2887,150,111,3897,2751
145,15,4,2,0,3,1,0,78,48,3783,2889,83,209,3900,2751
146,15,1,0,0,3,1,0,253,107,3784,2889,267,124,3903,2751
147,15,1,0,0,3,1,0,254,101,3785,2889,278,195,3906,2751
148,15,1,0,0,3,1,0,142,87,3786,2889,143,8,3909,2751
149,15,2,2,2,1,2,1,231,112,3788,2891,233,91,3910,2752
150,16,2,1,0,3,1,0,204,131,3790,2892,218,213,3913,2752
151,16,1,0,0,3,1,0,38,43,3791,2892,36,55,3916,2752
152,16,0,3,1,0,0,3,6,10,3791,2895,7,178,3916,2755
153,16,0,1,1,0,0,3,141,152,3791,2896,146,202,3916,2758
154,16,1,0,0,3,1,0,150,137,3792,2896,153,15,3919,2758
155,16,1,2,1,0,0,3,70,85,3793,2898,76,207,3919,2761
156,16,3,1,0,3,1,0,167,167,3796,2899,165,100,3922,2761
157,16,2,0,0,3,1,0,299,95,3798,2899,293,29,3925,2761
158,16,0,0,2,1,2,1,167,134,3798,2899,199,98,3926,2762
159,16,3,0,0,3,1,0,211,120,3801,2899,241,31,3929,2762
160,17,0,1,1,0,0,3,70,86,3801,2900,76,205,3929,2765
161,17,3,0,0,3,1,0,9,10,3804,2900,10,100,3932,2765
162,17,2,2,2,1,2,1,169,136,3806,2902,200,56,3933,2766
163,17,1,0,0,3,1,0,142,152,3807,2902,149,29,3936,2766
164,17,1,0,0,3,1,0,151,137,3808,2902,156,31,3939,2766
165,17,0,2,1,0,0,3,167,169,3808,2904,165,210,3939,2769
166,17,1,3,1,0,0,3,39,46,3809,2907,36,101,3939,2772
167,17,2,1,0,3,1,0,301,96,3811,2908,296,213,3942,2772
168,17,2,1,0,3,1,0,213,121,3813,2909,244,15,3945,2772
169,17,0,1,1,0,0,3,204,132,3813,2910,218,181,3945,2775
170,18,1,1,2,1,2,1,34,32,3814,2911,38,75,3946,2776
171,18,1,0,0,3,1,0,246,101,3815,2911,260,124,3949,2776
172,18,1,0,0,3,1,0,29,31,3816,2911,38,8,3952,2776
173,18,3,0,0,3,1,0,256,107,3819,2911,270,27,3955,2776
174,18,0,2,1,0,0,3,78,50,3819,2913,83,147,3955,2779
175,18,3,1,0,3,1,0,257,102,3822,2914,281,111,3958,2779
176,18,1,4,1,0,0,3,149,132,3823,2918,150,94,3958,2782
177,18,0,3,1,0,0,3,48,63,3823,2921,53,212,3958,2785
178,18,4,1,0,3,1,0,235,113,3827,2922,236,109,3961,2785
179,18,1,4,1,0,0,3,143,91,3828,2926,143,198,3961,2788
180,19,2,2,2,1,2,1,50,65,3830,2928,54,148,3962,2789
181,19,4,1,0,3,1,0,33,32,3834,2929,41,111,3965,2789
182,19,4,2,0,3,1,0,260,109,3838,2931,273,109,3968,2789
183,19,1,0,0,3,1,0,79,50,3839,2931,86,94,3971,2789
184,19,2,1,0,3,1,0,259,103,3841,2932,284,8,3974,2789
185,19,1,2,1,0,0,3,144,93,3842,2934,143,127,3974,2792
186,19,0,3,1,0,0,3,149,135,3842,2937,150,30,3974,2795
187,19,1,0,0,3,1,0,236,113,3843,2937,239,212,3977,2795
188,19,1,4,1,0,0,3,35,36,3844,2941,38,201,3977,2798
189,19,2,0,0,3,1,0,248,101,3846,2941,263,75,3980,2798
190,20,0,0,2,1,2,1,9,10,3846,2941,11,57,3981,2799
191,20,3,0,0,3,1,0,207,132,3849,2941,221,101,3984,2799
192,20,2,1,0,3,1,0,303,97,3851,2942,299,15,3987,2799
193,20,2,2,2,1,2,1,144,154,3853,2944,150,182,3988,2800
194,20,3,1,0,3,1,0,170,170,3856,2945,168,31,3991,2800
195,20,0,2,1,0,0,3,151,139,3856,2947,156,213,3991,2803
196,20,3,3,2,1,2,1,42,49,3859,2950,37,214,3992,2804
197,20,1,2,1,0,0,3,71,88,3860,2952,76,103,3992,2807
198,20,2,0,0,3,1,0,171,136,3862,2952,203,29,3995,2807
199,20,2,0,0,3,1,0,215,121,3864,2952,247,205,3998,2807
200,21,4,0,0,3,1,0,219,121,3868,2952,250,127,4001,2807
201,21,1,0,0,3,1,0,34,32,3869,2952,44,101,4004,2807
202,21,3,1,0,3,1,0,53,66,3872,2953,57,30,4007,2807
203,21,1,3,1,0,0,3,145,157,3873,2956,150,112,4007,2810
204,21,0,4,1,0,0,3,149,139,3873,2960,150,217,4007,2813
205,21,0,0,2,1,2,1,35,36,3873,2960,39,9,4008,2814
206,21,3,0,0,3,1,0,154,139,3876,2960,159,75,4011,2814
207,21,0,3,1,0,0,3,79,53,3876,2963,86,208,4011,2817
208,21,4,0,0,3,1,0,211,132,3880,2963,224,212,4014,2817
209,21,1,1,2,1,2,1,260,104,3881,2964,285,183,4015,2818
210,22,2,3,1,0,0,3,238,116,3883,2967,239,106,4015,2821
211,22,2,2,2,1,2,1,44,51,3885,2969,38,30,4016,2822
212,22,0,1,1,0,0,3,71,89,3885,2970,76,151,4016,2825
213,22,1,3,1,0,0,3,10,13,3886,2973,11,97,4016,2828
214,22,1,1,2,1,2,1,172,137,3887,2974,204,214,4017,2829
215,22,2,0,0,3,1,0,172,170,3889,2974,171,111,4020,2829
216,22,2,2,2,1,2,1,305,99,3891,2976,300,202,4021,2830
217,22,3,0,0,3,1,0,147,93,3894,2976,146,57,4024,2830
218,22,2,1,0,3,1,0,250,102,3896,2977,266,15,4027,2830
219,22,2,0,0,3,1,0,262,109,3898,2977,276,31,4030,2830
220,23,0,2,1,0,0,3,44,53,3898,2979,38,78,4030,2833
221,23,1,2,1,0,0,3,251,104,3899,2981,266,33,4030,2836
222,23,1,0,0,3,1,0,35,32,3900,2981,47,57,4033,2836
223,23,1,1,2,1,2,1,11,14,3901,2982,12,128,4034,2837
224,23,0,0,2,1,2,1,145,157,3901,2982,151,203,4035,2838
225,23,2,1,0,3,1,0,151,140,3903,2983,153,101,4038,2838
226,23,1,1,2,1,2,1,239,117,3904,2984,240,209,4039,2839
227,23,0,4,1,0,0,3,154,143,3904,2988,159,215,4039,2842
228,23,0,0,2,1,2,1,260,104,3904,2988,286,32,4040,2843
229,23,1,1,2,1,2,1,173,138,3905,2989,205,152,4041,2844
230,24,3,1,0,3,1,0,265,110,3908,2990,279,217,4044,2844
231,24,0,4,1,0,0,3,71,93,3908,2994,76,114,4044,2847
232,24,6,3,0,3,1,0,217,135,3914,2997,227,30,4047,2847
233,24,2,0,0,3,1,0,55,66,3916,2997,60,183,4050,2847
234,24,1,3,1,0,0,3,148,96,3917,3000,146,100,4050,2850
235,24,2,1,0,3,1,0,37,37,3919,3001,42,15,4053,2850
236,24,1,0,0,3,1,0,173,170,3920,3001,174,112,4056,2850
237,24,1,0,0,3,1,0,220,121,3921,3001,253,9,4059,2850
238,24,2,1,0,3,1,0,307,100,3923,3002,303,106,4062,2850
239,24,0,3,1,0,0,3,79,56,3923,3005,86,217,4062,2853
240,25,2,0,0,3,1,0,253,104,3925,3005,269,32,4065,2853
241,25,2,0,0,3,1,0,262,104,3927,3005,289,33,4068,2853
242,25,0,0,2,1,2,1,11,14,3927,3005,13,153,4069,2854
243,25,1,0,0,3,1,0,174,138,3928,3005,208,78,4072,2854
244,25,0,4,1,0,0,3,145,161,3928,3009,151,104,4072,2857
245,25,2,2,2,1,2,1,156,145,3930,3011,160,129,4073,2858
246,25,2,0,0,3,1,0,241,117,3932,3011,243,203,4076,2858
247,25,1,1,2,1,2,1,36,33,3933,3012,48,210,4077,2859
248,25,2,0,0,3,1,0,153,140,3935,3012,156,57,4080,2859
249,25,0,2,1,0,0,3,44,55,3935,3014,38,218,4080,2862
250,26,3,1,0,3,1,0,268,111,3938,3015,282,106,4083,2862
251,26,1,0,0,3,1,0,72,93,3939,3015,79,9,4086,2862
252,26,2,0,0,3,1,0,219,135,3941,3015,230,114,4089,2862
253,26,1,1,2,1,2,1,56,67,3942,3016,61,16,4090,2863
254,26,2,1,0,3,1,0,175,171,3944,3017,177,30,4093,2863
255,26,1,1,2,1,2,1,38,38,3945,3018,43,101,4094,2864
256,26,4,0,0,3,1,0,224,121,3949,3018,256,112,4097,2864
257,26,3,1,0,3,1,0,82,57,3952,3019,89,183,4100,2864
258,26,0,0,2,1,2,1,307,100,3952,3019,304,218,4101,2865
259,26,0,2,1,0,0,3,148,98,3952,3021,146,220,4101,2868
260,27,1,1,2,1,2,1,263,105,3953,3022,290,31,4102,2869
261,27,3,1,0,3,1,0,85,58,3956,3023,92,32,4105,2869
262,27,2,0,0,3,1,0,176,138,3958,3023,211,9,4108,2869
263,27,3,2,0,3,1,0,156,142,3961,3025,159,16,4111,2869
264,27,3,4,1,0,0,3,41,42,3964,3029,43,107,4111,2872
265,27,0,2,1,0,0,3,175,173,3964,3031,177,81,4111,2875
266,27,3,1,0,3,1,0,244,118,3967,3032,246,220,4114,2875
267,27,3,2,0,3,1,0,227,123,3970,3034,259,153,4117,2875
268,27,0,2,1,0,0,3,145,163,3970,3036,151,221,4117,2878
269,27,1,2,1,0,0,3,157,147,3971,3038,160,213,4117,2881
270,28,0,0,2,1,2,1,307,100,3971,3038,305,113,4118,2882
271,28,3,2,0,3,1,0,47,57,3974,3040,41,101,4121,2882
272,28,3,0,0,3,1,0,222,135,3977,3040,233,129,4124,2882
273,28,2,1,0,3,1,0,58,68,3979,3041,64,106,4127,2882
274,28,2,1,0,3,1,0,246,119,3981,3042,249,16,4130,2882
275,28,1,0,0,3,1,0,254,104,3982,3042,272,57,4133,2882
276,28,1,0,0,3,1,0,12,14,3983,3042,16,114,4136,2882
277,28,0,1,1,0,0,3,72,94,3983,3043,79,206,4136,2885
278,28,4,3,0,3,1,0,272,114,3987,3046,285,33,4139,2885
279,28,0,0,2,1,2,1,148,98,3987,3046,147,219,4140,2886
280,29,3,1,0,3,1,0,178,174,3990,3047,180,220,4143,2886
281,29,1,0,0,3,1,0,73,94,3991,3047,82,33,4146,2886
282,29,4,0,0,3,1,0,226,135,3995,3047,236,32,4149,2886
283,29,1,2,1,0,0,3,177,140,3996,3049,211,216,4149,2889
284,29,0,0,2,1,2,1,145,163,3996,3049,152,17,4150,2890
285,29,2,3,1,0,0,3,159,150,3998,3052,160,60,4150,2893
286,29,2,0,0,3,1,0,49,57,4000,3052,44,106,4153,2893
287,29,1,3,1,0,0,3,13,17,4001,3055,16,222,4153,2896
288,29,2,1,0,3,1,0,229,124,4003,3056,262,107,4156,2896
289,29,1,1,2,1,2,1,308,101,4004,3057,306,184,4157,2897
290,30,3,1,0,3,1,0,249,120,4007,3058,252,153,4160,2897
291,30,0,2,1,0,0,3,36,35,4007,3060,48,209,4160,2900
292,30,1,2,1,0,0,3,273,116,4008,3062,285,84,4160,2903
293,30,2,1,0,3,1,0,60,69,4010,3063,67,101,4163,2903
294,30,2,0,0,3,1,0,87,58,4012,3063,95,113,4166,2903
295,30,0,0,2,1,2,1,263,105,4012,3063,291,130,4167,2904
296,30,1,0,0,3,1,0,42,42,4013,3063,46,114,4170,2904
297,30,0,0,2,1,2,1,148,98,4013,3063,148,32,4171,2905
298,30,0,0,2,1,2,1,156,142,4013,3063,160,10,4172,2906
299,30,2,2,2,1,2,1,256,106,4015,3065,273,222,4173,2907
300,31,1,0,0,3,1,0,37,35,4016,3065,51,113,4176,2907
301,31,2,0,0,3,1,0,89,58,4018,3065,98,114,4179,2907
302,31,2,0,0,3,1,0,44,42,4020,3065,49,130,4182,2907
303,31,1,1,2,1,2,1,264,106,4021,3066,292,154,4183,2908
304,31,3,0,0,3,1,0,259,106,4024,3066,276,101,4186,2908
305,31,4,2,0,3,1,0,64,71,4028,3068,70,10,4189,2908
306,31,1,3,1,0,0,3,157,145,4029,3071,160,212,4189,2911
307,31,3,1,0,3,1,0,151,99,4032,3072,151,84,4192,2911
308,31,2,1,0,3,1,0,275,117,4034,3073,288,222,4195,2911
309,31,2,2,2,1,2,1,251,122,4036,3075,253,33,4196,2912
310,32,4,0,0,3,1,0,233,124,4040,3075,265,33,4199,2912
311,32,3,1,0,3,1,0,311,102,4043,3076,309,32,4202,2912
312,32,0,0,2,1,2,1,13,17,4043,3076,17,18,4203,2913
313,32,1,2,1,0,0,3,178,142,4044,3078,211,187,4203,2916
314,32,0,1,1,0,0,3,178,175,4044,3079,180,110,4203,2919
315,32,1,0,0,3,1,0,160,150,4045,3079,163,106,4206,2919
316,32,1,3,1,0,0,3,50,60,4046,3082,44,219,4206,2922
317,32,0,3,1,0,0,3,145,166,4046,3085,152,225,4206,2925
318,32,4,2,0,3,1,0,230,137,4050,3087,239,60,4209,2925
319,32,3,0,0,3,1,0,76,94,4053,3087,85,220,4212,2925
320,33,4,0,0,3,1,0,237,124,4057,3087,268,33,4215,2925
321,33,2,2,2,1,2,1,78,96,4059,3089,86,61,4216,2926
322,33,3,1,0,3,1,0,233,138,4062,3090,242,18,4219,2926
323,33,3,1,0,3,1,0,181,143,4065,3091,214,32,4222,2926
324,33,2,2,2,1,2,1,147,168,4067,3093,153,102,4223,2927
325,33,1,0,0,3,1,0,45,42,4068,3093,52,106,4226,2927
326,33,0,3,1,0,0,3,151,102,4068,3096,151,225,4226,2930
327,33,0,1,1,0,0,3,178,176,4068,3097,180,190,4226,2933
328,33,2,0,0,3,1,0,266,106,4070,3097,295,219,4229,2933
329,33,1,2,1,0,0,3,14,19,4071,3099,17,223,4229,2936
330,34,4,0,0,3,1,0,54,60,4075,3099,47,10,4232,2936
331,34,2,0,0,3,1,0,66,71,4077,3099,73,33,4235,2936
332,34,2,0,0,3,1,0,159,145,4079,3099,163,113,4238,2936
333,34,0,0,2,1,2,1,160,150,4079,3099,164,155,4239,2937
334,34,0,2,1,0,0,3,37,37,4079,3101,51,228,4239,2940
335,34,1,2,1,0,0,3,252,124,4080,3103,253,87,4239,2943
336,34,4,2,0,3,1,0,279,119,4084,3105,291,110,4242,2943
337,34,2,0,0,3,1,0,261,106,4086,3105,279,114,4245,2943
338,34,3,1,0,3,1,0,314,103,4089,3106,312,130,4248,2943
339,34,1,6,1,0,0,3,90,64,4090,3112,98,215,4248,2946
340,35,0,0,2,1,2,1,151,102,4090,3112,152,33,4249,2947
341,35,0,0,2,1,2,1,181,143,4090,3112,215,103,4250,2948
342,35,0,1,1,0,0,3,147,169,4090,3113,153,36,4250,2951
343,35,0,1,1,0,0,3,178,177,4090,3114,180,64,4250,2954
344,35,0,2,1,0,0,3,78,98,4090,3116,86,21,4250,2957
345,35,1,1,2,1,2,1,267,107,4091,3117,296,107,4251,2958
346,35,0,3,1,0,0,3,233,141,4091,3120,242,222,4251,2961
347,35,2,2,2,1,2,1,16,21,4093,3122,18,226,4252,2962
348,35,2,0,0,3,1,0,239,124,4095,3122,271,223,4255,2962
349,35,0,1,1,0,0,3,45,43,4095,3123,52,193,4255,2965
350,36,1,0,0,3,1,0,161,150,4096,3123,167,215,4258,2965
351,36,5,0,0,3,1,0,319,103,4101,3123,315,87,4261,2965
352,36,2,2,2,1,2,1,56,62,4103,3125,48,114,4262,2966
353,36,2,2,2,1,2,1,39,39,4105,3127,52,131,4263,2967
354,36,0,2,1,0,0,3,66,73,4105,3129,73,117,4263,2970
355,36,3,0,0,3,1,0,93,64,4108,3129,101,33,4266,2970
356,36,1,0,0,3,1,0,160,145,4109,3129,166,155,4269,2970
357,36,0,0,2,1,2,1,252,124,4109,3129,254,111,4270,2971
358,36,2,0,0,3,1,0,263,106,4111,3129,282,228,4273,2971
359,36,3,0,0,3,1,0,282,119,4114,3129,294,10,4276,2971
360,37,1,0,0,3,1,0,234,141,4115,3129,245,33,4279,2971
361,37,0,1,1,0,0,3,178,178,4115,3130,180,225,4279,2974
362,37,2,1,0,3,1,0,321,104,4117,3131,318,64,4282,2974
363,37,2,1,0,3,1,0,58,63,4119,3132,51,21,4285,2974
364,37,1,2,1,0,0,3,17,23,4120,3134,18,114,4285,2977
365,37,0,2,1,0,0,3,147,171,4120,3136,153,110,4285,2980
366,37,1,4,1,0,0,3,182,147,4121,3140,215,226,4285,2983
367,37,4,0,0,3,1,0,82,98,4125,3140,89,33,4288,2983
368,37,0,4,1,0,0,3,161,154,4125,3144,167,196,4288,2986
369,37,2,1,0,3,1,0,241,125,4127,3145,274,228,4291,2986
370,38,3,1,0,3,1,0,266,107,4130,3146,285,155,4294,2986
371,38,1,2,1,0,0,3,40,41,4131,3148,52,106,4294,2989
372,38,5,1,0,3,1,0,287,120,4136,3149,297,117,4297,2989
373,38,1,7,1,0,0,3,67,80,4137,3156,73,218,4297,2992
374,38,1,1,2,1,2,1,94,65,4138,3157,102,37,4298,2993
375,38,3,0,0,3,1,0,255,124,4141,3157,257,10,4301,2993
376,38,2,0,0,3,1,0,269,107,4143,3157,299,87,4304,2993
377,38,0,1,1,0,0,3,151,103,4143,3158,152,117,4304,2996
378,38,2,1,0,3,1,0,162,146,4145,3159,169,131,4307,2996
379,38,0,5,1,0,0,3,45,48,4145,3164,52,229,4307,2999
0,1,4,3,0,3,1,0,270,110,4149,3167,288,64,4310,2999
1,1,3,3,2,1,2,1,48,51,4152,3170,53,197,4311,3000
2,1,2,3,1,0,0,3,289,123,4154,3173,297,24,4311,3003
3,1,0,3,1,0,0,3,82,101,4154,3176,89,3,4311,3006
4,1,1,0,0,3,1,0,235,141,4155,3176,248,117,4314,3006
5,1,0,0,2,1,2,1,151,103,4155,3176,153,111,4315,3007
6,1,1,0,0,3,1,0,179,178,4156,3176,183,37,4318,3007
7,1,0,2,1,0,0,3,0,2,4156,3178,0,232,4318,3010
8,1,0,2,1,0,0,3,175,156,4156,3180,173,221,4318,3013
9,1,4,0,0,3,1,0,273,107,4160,3180,302,106,4321,3013
10,2,0,4,1,0,0,3,162,150,4160,3184,169,231,4321,3016
11,2,0,2,1,0,0,3,58,65,4160,3186,51,36,4321,3019
12,2,0,1,1,0,0,3,40,42,4160,3187,52,134,4321,3022
13,2,2,0,0,3,1,0,96,65,4162,3187,105,0,4324,3022
14,2,1,0,0,3,1,0,256,124,4163,3187,260,87,4327,3022
15,2,3,2,0,3,1,0,154,105,4166,3189,156,106,4330,3022
16,2,1,0,0,3,1,0,183,147,4167,3189,218,226,4333,3022
17,2,1,0,0,3,1,0,1,0,4168,3189,3,104,4336,3022
18,2,1,2,1,0,0,3,242,127,4169,3191,274,228,4336,3025
19,2,1,1,2,1,2,1,322,105,4170,3192,319,156,4337,3026
20,3,1,2,1,0,0,3,59,67,4171,3194,51,235,4337,3029
21,3,0,2,1,0,0,3,82,103,4171,3196,89,114,4337,3032
22,3,0,0,2,1,2,1,1,0,4171,3196,4,115,4338,3033
23,3,3,0,0,3,1,0,178,156,4174,3196,176,106,4341,3033
24,3,0,0,2,1,2,1,48,51,4174,3196,54,1,4342,3034
25,3,2,0,0,3,1,0,275,107,4176,3196,305,64,4345,3034
26,3,2,0,0,3,1,0,291,123,4178,3196,300,156,4348,3034
27,3,1,1,2,1,2,1,180,179,4179,3197,184,118,4349,3035
28,3,4,0,0,3,1,0,260,124,4183,3197,263,226,4352,3035
29,3,1,1,2,1,2,1,243,128,4184,3198,275,25,4353,3036
30,4,5,0,0,3,1,0,327,105,4189,3198,322,197,4356,3036
31,4,3,0,0,3,1,0,273,110,4192,3198,291,37,4359,3036
32,4,3,1,0,3,1,0,3,3,4195,3199,3,134,4362,3036
33,4,0,3,1,0,0,3,235,144,4195,3202,248,224,4362,3039
34,4,1,2,1,0,0,3,97,67,4196,3204,105,231,4362,3042
35,4,0,2,1,0,0,3,154,107,4196,3206,156,39,4362,3045
36,4,2,2,2,1,2,1,185,149,4198,3208,219,232,4363,3046
37,4,1,0,0,3,1,0,41,42,4199,3208,55,87,4366,3046
38,4,0,1,1,0,0,3,162,151,4199,3209,169,107,4366,3049
39,4,2,0,0,3,1,0,163,154,4201,3209,170,3,4369,3049
40,5,2,1,0,3,1,0,61,68,4203,3210,54,1,4372,3049
41,5,0,1,1,0,0,3,82,104,4203,3211,89,118,4372,3052
42,5,1,1,2,1,2,1,2,1,4204,3212,5,65,4373,3053
43,5,1,1,2,1,2,1,261,125,4205,3213,264,26,4374,3054
44,5,2,1,0,3,1,0,180,157,4207,3214,179,118,4377,3054
45,5,0,6,1,0,0,3,48,57,4207,3220,54,238,4377,3057
46,5,0,0,2,1,2,1,180,179,4207,3220,185,107,4378,3058
47,5,0,0,2,1,2,1,243,128,4207,3220,276,115,4379,3059
48,5,0,0,2,1,2,1,291,123,4207,3220,301,227,4380,3060
49,5,4,0,0,3,1,0,279,107,4211,3220,308,156,4383,3060
50,6,2,3,1,0,0,3,165,157,4213,3223,170,227,4383,3063
51,6,0,0,2,1,2,1,41,42,4213,3223,56,4,4384,3064
52,6,2,1,0,3,1,0,237,145,4215,3224,251,37,4387,3064
53,6,5,0,0,3,1,0,332,105,4220,3224,325,87,4390,3064
54,6,0,1,1,0,0,3,154,108,4220,3225,156,235,4390,3067
55,6,0,4,1,0,0,3,185,153,4220,3229,219,234,4390,3070
56,6,1,2,1,0,0,3,163,153,4221,3231,169,42,4390,3073
57,6,2,3,1,0,0,3,99,70,4223,3234,105,200,4390,3076
58,6,1,0,0,3,1,0,4,3,4224,3234,6,107,4393,3076
59,6,2,0,0,3,1,0,275,110,4226,3234,294,134,4396,3076
60,7,0,4,1,0,0,3,2,5,4226,3238,5,230,4396,3079
61,7,0,0,2,1,2,1,61,68,4226,3238,55,66,4397,3080
62,7,4,0,0,3,1,0,283,107,4230,3238,311,87,4400,3080
63,7,2,1,0,3,1,0,187,154,4232,3239,222,118,4403,3080
64,7,2,2,2,1,2,1,182,181,4234,3241,186,43,4404,3081
65,7,1,0,0,3,1,0,166,157,4235,3241,173,115,4407,3081
66,7,0,1,1,0,0,3,291,124,4235,3242,301,241,4407,3084
67,7,2,0,0,3,1,0,277,110,4237,3242,297,1,4410,3084
68,7,0,1,1,0,0,3,237,146,4237,3243,251,29,4410,3087
69,7,1,1,2,1,2,1,181,158,4238,3244,180,201,4411,3088
70,8,0,0,2,1,2,1,261,125,4238,3244,265,236,4412,3089
71,8,1,1,2,1,2,1,42,43,4239,3245,57,108,4413,3090
72,8,2,1,0,3,1,0,84,105,4241,3246,92,234,4416,3090
73,8,7,2,0,3,1,0,339,107,4248,3248,328,118,4419,3090
74,8,2,0,0,3,1,0,165,153,4250,3248,172,4,4422,3090
75,8,1,0,0,3,1,0,244,128,4251,3248,279,37,4425,3090
76,8,2,1,0,3,1,0,50,58,4253,3249,57,227,4428,3090
77,8,1,1,2,1,2,1,5,4,4254,3250,7,157,4429,3091
78,8,2,2,2,1,2,1,156,110,4256,3252,157,108,4430,3092
79,8,1,1,2,1,2,1,100,71,4257,3253,106,135,4431,3093
80,9,0,3,1,0,0,3,166,160,4257,3256,173,4,4431,3096
81,9,4,2,0,3,1,0,295,126,4261,3258,304,43,4434,3096
82,9,2,1,0,3,1,0,4,6,4263,3259,8,236,4437,3096
83,9,3,0,0,3,1,0,342,107,4266,3259,331,29,4440,3096
84,9,1,0,0,3,1,0,182,158,4267,3259,183,87,4443,3096
85,9,1,2,1,0,0,3,188,156,4268,3261,222,40,4443,3099
86,9,1,2,1,0,0,3,166,155,4269,3263,172,69,4443,3102
87,9,1,0,0,3,1,0,157,110,4270,3263,160,135,4446,3102
88,9,2,5,1,0,0,3,239,151,4272,3268,251,230,4446,3105
89,9,4,1,0,3,1,0,248,129,4276,3269,282,201,4449,3105
90,10,1,0,0,3,1,0,284,107,4277,3269,314,230,4452,3105
91,10,2,1,0,3,1,0,279,111,4279,3270,300,115,4455,3105
92,10,2,2,2,1,2,1,86,107,4281,3272,93,109,4456,3106
93,10,3,0,0,3,1,0,264,125,4284,3272,268,4,4459,3106
94,10,0,1,1,0,0,3,50,59,4284,3273,57,121,4459,3109
95,10,2,3,1,0,0,3,184,184,4286,3276,186,244,4459,3112
96,10,0,1,1,0,0,3,61,69,4286,3277,55,237,4459,3115
97,10,1,1,2,1,2,1,6,5,4287,3278,8,119,4460,3116
98,10,2,0,0,3,1,0,102,71,4289,3278,109,157,4463,3116
99,10,1,0,0,3,1,0,43,43,4290,3278,60,108,4466,3116
100,11,2,2,2,1,2,1,190,158,4292,3280,223,70,4467,3117
101,11,1,0,0,3,1,0,5,6,4293,3280,11,135,4470,3117
102,11,0,1,1,0,0,3,182,159,4293,3281,183,43,4470,3120
103,11,0,1,1,0,0,3,157,111,4293,3282,160,32,4470,3123
104,11,0,1,1,0,0,3,166,156,4293,3283,172,7,4470,3126
105,11,1,4,1,0,0,3,167,164,4294,3287,173,204,4470,3129
106,11,1,0,0,3,1,0,249,129,4295,3287,285,87,4473,3129
107,11,3,1,0,3,1,0,345,108,4298,3288,334,230,4476,3129
108,11,1,0,0,3,1,0,296,126,4299,3288,307,236,4479,3129
109,11,3,2,0,3,1,0,242,153,4302,3290,254,43,4482,3129
110,12,2,0,0,3,1,0,281,111,4304,3290,303,230,4485,3129
111,12,4,0,0,3,1,0,65,69,4308,3290,58,4,4488,3129
112,12,2,0,0,3,1,0,45,43,4310,3290,63,115,4491,3129
113,12,2,2,2,1,2,1,88,109,4312,3292,94,158,4492,3130
114,12,0,2,1,0,0,3,102,73,4312,3294,109,247,4492,3133
115,12,3,0,0,3,1,0,267,125,4315,3294,271,119,4495,3133
116,12,0,4,1,0,0,3,184,188,4315,3298,186,240,4495,3136
117,12,4,1,0,3,1,0,288,108,4319,3299,317,108,4498,3136
118,12,2,0,0,3,1,0,52,59,4321,3299,60,109,4501,3136
119,12,2,2,2,1,2,1,8,7,4323,3301,9,122,4502,3137
120,13,1,1,2,1,2,1,168,165,4324,3302,174,71,4503,3138
121,13,2,1,0,3,1,0,90,110,4326,3303,97,122,4506,3138
122,13,1,0,0,3,1,0,289,108,4327,3303,320,7,4509,3138
123,13,0,3,1,0,0,3,182,162,4327,3306,183,46,4509,3141
124,13,0,0,2,1,2,1,166,156,4327,3306,173,44,4510,3142
125,13,1,1,2,1,2,1,250,130,4328,3307,286,136,4511,3143
126,13,1,1,2,1,2,1,268,126,4329,3308,272,241,4512,3144
127,13,4,1,0,3,1,0,161,112,4333,3309,163,158,4515,3144
128,13,0,1,1,0,0,3,45,44,4333,3310,63,233,4515,3147
129,13,1,2,1,0,0,3,6,8,4334,3312,11,250,4515,3150
130,14,0,0,2,1,2,1,8,7,4334,3312,10,88,4516,3151
131,14,2,1,0,3,1,0,104,74,4336,3313,112,230,4519,3151
132,14,2,4,1,0,0,3,54,63,4338,3317,60,239,4519,3154
133,14,2,2,2,1,2,1,186,190,4340,3319,187,109,4520,3155
134,14,5,0,0,3,1,0,286,111,4345,3319,306,4,4523,3155
135,14,1,2,1,0,0,3,66,71,4346,3321,58,35,4523,3158
136,14,1,0,0,3,1,0,297,126,4347,3321,310,115,4526,3158
137,14,4,0,0,3,1,0,246,153,4351,3321,257,109,4529,3158
138,14,2,1,0,3,1,0,347,109,4353,3322,337,119,4532,3158
139,14,0,3,1,0,0,3,190,161,4353,3325,223,207,4532,3161
140,15,3,1,0,3,1,0,300,127,4356,3326,313,109,4535,3161
141,15,1,5,1,0,0,3,9,12,4357,3331,10,210,4535,3164
142,15,2,0,0,3,1,0,248,153,4359,3331,260,4,4538,3164
143,15,1,0,0,3,1,0,105,74,4360,3331,115,35,4541,3164
144,15,2,1,0,3,1,0,192,162,4362,3332,226,115,4544,3164
145,15,1,1,2,1,2,1,55,64,4363,3333,61,231,4545,3165
146,15,0,0,2,1,2,1,186,190,4363,3333,188,89,4546,3166
147,15,1,3,1,0,0,3,287,114,4364,3336,306,242,4546,3169
148,15,1,1,2,1,2,1,67,72,4365,3337,59,120,4547,3170
149,15,2,1,0,3,1,0,349,110,4367,3338,340,109,4550,3170
150,16,1,0,0,3,1,0,169,165,4368,3338,177,241,4553,3170
151,16,1,0,0,3,1,0,46,44,4369,3338,66,46,4556,3170
152,16,2,2,2,1,2,1,92,112,4371,3340,98,45,4557,3171
153,16,2,0,0,3,1,0,8,8,4373,3340,14,7,4560,3171
154,16,1,0,0,3,1,0,167,156,4374,3340,176,136,4563,3171
155,16,5,1,0,3,1,0,255,131,4379,3341,289,122,4566,3171
156,16,2,3,1,0,0,3,184,165,4381,3344,183,74,4566,3174
157,16,1,1,2,1,2,1,162,113,4382,3345,164,234,4567,3175
158,16,1,1,2,1,2,1,269,127,4383,3346,273,159,4568,3176
159,16,1,2,1,0,0,3,290,110,4384,3348,320,253,4568,3179
160,17,1,0,0,3,1,0,47,44,4385,3348,69,122,4571,3179
161,17,1,3,1,0,0,3,9,11,4386,3351,14,244,4571,3182
162,17,2,1,0,3,1,0,94,113,4388,3352,101,46,4574,3182
163,17,0,4,1,0,0,3,167,160,4388,3356,176,256,4574,3185
164,17,0,1,1,0,0,3,184,166,4388,3357,183,162,4574,3188
165,17,1,4,1,0,0,3,163,117,4389,3361,164,77,4574,3191
166,17,0,0,2,1,2,1,169,165,4389,3361,178,235,4575,3192
167,17,1,0,0,3,1,0,291,110,4390,3361,323,45,4578,3192
168,17,2,0,0,3,1,0,257,131,4392,3361,292,7,4581,3192
169,17,0,0,2,1,2,1,269,127,4392,3361,274,137,4582,3193
170,18,0,3,1,0,0,3,105,77,4392,3364,115,92,4582,3196
171,18,1,0,0,3,1,0,288,114,4393,3364,309,109,4585,3196
172,18,0,0,2,1,2,1,9,12,4393,3364,11,36,4586,3197
173,18,1,0,0,3,1,0,301,127,4394,3364,316,120,4589,3197
174,18,1,4,1,0,0,3,56,68,4395,3368,61,7,4589,3200
175,18,0,3,1,0,0,3,192,165,4395,3371,226,112,4589,3203
176,18,4,1,0,3,1,0,353,111,4399,3372,343,231,4592,3203
177,18,1,2,1,0,0,3,187,192,4400,3374,188,245,4592,3206
178,18,0,4,1,0,0,3,67,76,4400,3378,59,213,4592,3209
179,18,3,1,0,3,1,0,251,154,4403,3379,263,115,4595,3209
180,19,3,3,2,1,2,1,291,117,4406,3382,310,214,4596,3210
181,19,0,0,2,1,2,1,251,154,4406,3382,264,245,4597,3211
182,19,1,0,0,3,1,0,10,12,4407,3382,14,46,4600,3211
183,19,4,0,0,3,1,0,357,111,4411,3382,346,45,4603,3211
184,19,1,1,2,1,2,1,164,118,4412,3383,165,8,4604,3212
185,19,3,1,0,3,1,0,195,166,4415,3384,229,137,4607,3212
186,19,1,1,2,1,2,1,168,161,4416,3385,177,93,4608,3213
187,19,2,3,1,0,0,3,171,168,4418,3388,178,112,4608,3216
188,19,0,3,1,0,0,3,47,47,4418,3391,69,234,4608,3219
189,19,2,2,2,1,2,1,107,79,4420,3393,116,246,4609,3220
190,20,5,2,0,3,1,0,262,133,4425,3395,295,120,4612,3220
191,20,3,3,2,1,2,1,70,79,4428,3398,60,113,4613,3221
192,20,2,0,0,3,1,0,303,127,4430,3398,319,7,4616,3221
193,20,1,1,2,1,2,1,10,12,4431,3399,15,123,4617,3222
194,20,2,2,2,1,2,1,293,112,4433,3401,324,37,4618,3223
195,20,2,1,0,3,1,0,58,69,4435,3402,64,77,4621,3223
196,20,0,0,2,1,2,1,187,192,4435,3402,189,163,4622,3224
197,20,5,0,0,3,1,0,274,127,4440,3402,277,115,4625,3224
198,20,0,1,1,0,0,3,184,167,4440,3403,183,259,4625,3227
199,20,2,3,1,0,0,3,96,116,4442,3406,101,238,4625,3230
200,21,2,1,0,3,1,0,72,80,4444,3407,63,163,4628,3230
201,21,5,0,0,3,1,0,308,127,4449,3407,322,123,4631,3230
202,21,0,0,2,1,2,1,10,12,4449,3407,16,38,4632,3231
203,21,2,1,0,3,1,0,276,128,4451,3408,280,77,4635,3231
204,21,0,0,2,1,2,1,184,167,4451,3408,184,8,4636,3232
205,21,1,2,1,0,0,3,59,71,4452,3410,64,118,4636,3235
206,21,0,0,2,1,2,1,293,112,4452,3410,325,121,4637,3236
207,21,0,0,2,1,2,1,96,116,4452,3410,102,260,4638,3237
208,21,1,1,2,1,2,1,188,193,4453,3411,190,239,4639,3238
209,21,1,1,2,1,2,1,263,134,4454,3412,296,114,4640,3239
210,22,2,2,2,1,2,1,12,14,4456,3414,15,46,4641,3240
211,22,1,2,1,0,0,3,48,49,4457,3416,69,217,4641,3243
212,22,3,0,0,3,1,0,110,79,4460,3416,119,8,4644,3243
213,22,0,1,1,0,0,3,195,167,4460,3417,229,115,4644,3246
214,22,0,2,1,0,0,3,251,156,4460,3419,264,249,4644,3249
215,22,1,2,1,0,0,3,165,120,4461,3421,165,96,4644,3252
216,22,0,2,1,0,0,3,168,163,4461,3423,177,237,4644,3255
217,22,2,1,0,3,1,0,173,169,4463,3424,181,137,4647,3255
218,22,3,1,0,3,1,0,360,112,4466,3425,349,46,4650,3255
219,22,2,2,2,1,2,1,293,119,4468,3427,311,246,4651,3256
220,23,0,0,2,1,2,1,308,127,4468,3427,323,78,4652,3257
221,23,1,0,0,3,1,0,97,116,4469,3427,105,38,4655,3257
222,23,1,4,1,0,0,3,11,16,4470,3431,16,117,4655,3260
223,23,1,1,2,1,2,1,185,168,4471,3432,185,119,4656,3261
224,23,2,2,2,1,2,1,61,73,4473,3434,65,122,4657,3262
225,23,2,0,0,3,1,0,190,193,4475,3434,193,8,4660,3262
226,23,4,0,0,3,1,0,267,134,4479,3434,299,163,4663,3262
227,23,2,1,0,3,1,0,74,81,4481,3435,66,239,4666,3262
228,23,4,3,0,3,1,0,280,131,4485,3438,283,260,4669,3262
229,23,3,0,0,3,1,0,296,112,4488,3438,328,123,4672,3262
230,24,0,4,1,0,0,3,12,18,4488,3442,15,249,4672,3265
231,24,4,1,0,3,1,0,297,120,4492,3443,314,96,4675,3265
232,24,0,1,1,0,0,3,48,50,4492,3444,69,252,4675,3268
233,24,1,1,2,1,2,1,252,157,4493,3445,265,138,4676,3269
234,24,2,0,0,3,1,0,112,79,4495,3445,122,46,4679,3269
235,24,2,0,0,3,1,0,197,167,4497,3445,232,8,4682,3269
236,24,1,1,2,1,2,1,174,170,4498,3446,182,47,4683,3270
237,24,3,1,0,3,1,0,363,113,4501,3447,352,115,4686,3270
238,24,1,1,2,1,2,1,166,121,4502,3448,166,238,4687,3271
239,24,1,0,0,3,1,0,169,163,4503,3448,180,217,4690,3271
240,25,1,1,2,1,2,1,175,171,4504,3449,183,97,4691,3272
241,25,3,1,0,3,1,0,172,164,4507,3450,183,239,4694,3272
242,25,0,3,1,0,0,3,11,19,4507,3453,16,220,4694,3275
243,25,0,3,1,0,0,3,308,130,4507,3456,323,50,4694,3278
244,25,2,1,0,3,1,0,254,158,4509,3457,268,78,4697,3278
245,25,1,1,2,1,2,1,186,169,4510,3458,186,39,4698,3279
246,25,1,1,2,1,2,1,167,122,4511,3459,167,9,4699,3280
247,25,3,0,0,3,1,0,366,113,4514,3459,355,138,4702,3280
248,25,0,0,2,1,2,1,197,167,4514,3459,233,47,4703,3281
249,25,2,0,0,3,1,0,269,134,4516,3459,302,252,4706,3281
250,26,1,1,2,1,2,1,49,51,4517,3460,70,261,4707,3282
251,26,2,1,0,3,1,0,76,82,4519,3461,69,123,4710,3282
252,26,3,1,0,3,1,0,15,19,4522,3462,18,117,4713,3282
253,26,1,1,2,1,2,1,113,80,4523,3463,123,120,4714,3283
254,26,2,0,0,3,1,0,298,112,4525,3463,331,8,4717,3283
255,26,2,3,1,0,0,3,192,196,4527,3466,193,125,4717,3286
256,26,5,1,0,3,1,0,302,121,4532,3467,317,163,4720,3286
257,26,1,1,2,1,2,1,98,117,4533,3468,106,116,4721,3287
258,26,2,2,2,1,2,1,282,133,4535,3470,284,239,4722,3288
259,26,4,1,0,3,1,0,65,74,4539,3471,68,249,4725,3288
260,27,1,0,0,3,1,0,270,134,4540,3471,305,239,4728,3288
261,27,1,1,2,1,2,1,198,168,4541,3472,234,10,4729,3289
262,27,3,1,0,3,1,0,257,159,4544,3473,271,97,4732,3289
263,27,1,0,0,3,1,0,173,164,4545,3473,186,39,4735,3289
264,27,2,0,0,3,1,0,177,171,4547,3473,186,47,4738,3289
265,27,5,1,0,3,1,0,371,114,4552,3474,358,78,4741,3289
266,27,4,1,0,3,1,0,15,20,4556,3475,19,50,4744,3289
267,27,1,0,0,3,1,0,187,169,4557,3475,189,252,4747,3289
268,27,0,2,1,0,0,3,167,124,4557,3477,167,223,4747,3292
269,27,3,0,0,3,1,0,311,130,4560,3477,326,138,4750,3292
270,28,1,1,2,1,2,1,114,81,4561,3478,124,124,4751,3293
271,28,2,2,2,1,2,1,78,84,4563,3480,70,117,4752,3294
272,28,4,1,0,3,1,0,19,20,4567,3481,21,120,4755,3294
273,28,1,1,2,1,2,1,50,52,4568,3482,71,126,4756,3295
274,28,4,1,0,3,1,0,286,134,4572,3483,287,117,4759,3295
275,28,1,2,1,0,0,3,193,198,4573,3485,193,11,4759,3298
276,28,1,0,0,3,1,0,66,74,4574,3485,71,163,4762,3298
277,28,0,1,1,0,0,3,98,118,4574,3486,106,242,4762,3301
278,28,2,1,0,3,1,0,300,113,4576,3487,334,249,4765,3301
279,28,0,3,1,0,0,3,302,124,4576,3490,317,264,4765,3304
280,29,2,1,0,3,1,0,52,53,4578,3491,74,163,4768,3304
281,29,1,1,2,1,2,1,115,82,4579,3492,125,51,4769,3305
282,29,0,0,2,1,2,1,167,124,4579,3492,168,125,4770,3306
283,29,4,1,0,3,1,0,177,165,4583,3493,189,117,4773,3306
284,29,2,0,0,3,1,0,272,134,4585,3493,308,11,4776,3306
285,29,1,0,0,3,1,0,67,74,4586,3493,74,138,4779,3306
286,29,2,0,0,3,1,0,288,134,4588,3493,290,117,4782,3306
287,29,2,1,0,3,1,0,21,21,4590,3494,24,239,4785,3306
288,29,1,0,0,3,1,0,372,114,4591,3494,361,249,4788,3306
289,29,2,3,1,0,0,3,100,121,4593,3497,106,255,4788,3309
290,30,2,1,0,3,1,0,302,114,4595,3498,337,223,4791,3309
291,30,2,0,0,3,1,0,259,159,4597,3498,274,10,4794,3309
292,30,0,0,2,1,2,1,15,20,4597,3498,20,121,4795,3310
293,30,3,0,0,3,1,0,190,169,4600,3498,192,126,4798,3310
294,30,1,4,1,0,0,3,194,202,4601,3502,193,81,4798,3313
295,30,0,3,1,0,0,3,177,174,4601,3505,186,42,4798,3316
296,30,2,1,0,3,1,0,313,131,4603,3506,329,97,4801,3316
297,30,3,0,0,3,1,0,305,124,4606,3506,320,47,4804,3316
298,30,1,4,1,0,0,3,79,88,4607,3510,70,245,4804,3319
299,30,0,2,1,0,0,3,198,170,4607,3512,234,267,4804,3322
300,31,2,1,0,3,1,0,81,89,4609,3513,73,138,4807,3322
301,31,0,2,1,0,0,3,15,22,4609,3515,20,100,4807,3325
302,31,1,2,1,0,0,3,199,172,4610,3517,234,166,4807,3328
303,31,5,0,0,3,1,0,293,134,4615,3517,293,47,4810,3328
304,31,1,2,1,0,0,3,53,55,4616,3519,74,252,4810,3331
305,31,0,1,1,0,0,3,177,166,4616,3520,189,129,4810,3334
306,31,3,1,0,3,1,0,118,83,4619,3521,128,239,4813,3334
307,31,3,1,0,3,1,0,375,115,4622,3522,364,10,4816,3334
308,31,1,0,0,3,1,0,273,134,4623,3522,311,117,4819,3334
309,31,0,0,2,1,2,1,177,174,4623,3522,187,256,4820,3335
310,32,1,2,1,0,0,3,101,123,4624,3524,106,226,4820,3338
311,32,0,2,1,0,0,3,21,23,4624,3526,24,84,4820,3341
312,32,2,0,0,3,1,0,304,114,4626,3526,340,121,4823,3341
313,32,1,0,0,3,1,0,191,169,4627,3526,195,11,4826,3341
314,32,3,0,0,3,1,0,180,174,4630,3526,190,129,4829,3341
315,32,2,2,2,1,2,1,69,76,4632,3528,75,52,4830,3342
316,32,1,2,1,0,0,3,195,204,4633,3530,193,45,4830,3345
317,32,1,3,1,0,0,3,260,162,4634,3533,274,270,4830,3348
318,32,3,0,0,3,1,0,308,124,4637,3533,323,125,4833,3348
319,32,1,3,1,0,0,3,314,134,4638,3536,329,248,4833,3351
320,33,0,0,2,1,2,1,260,162,4638,3536,275,227,4834,3352
321,33,2,2,2,1,2,1,83,91,4640,3538,74,101,4835,3353
322,33,1,1,2,1,2,1,22,24,4641,3539,25,12,4836,3354
323,33,1,2,1,0,0,3,119,85,4642,3541,128,120,4836,3357
324,33,1,2,1,0,0,3,200,174,4643,3543,234,251,4836,3360
325,33,1,2,1,0,0,3,70,78,4644,3545,75,48,4836,3363
326,33,1,1,2,1,2,1,196,205,4645,3546,194,122,4837,3364
327,33,2,3,1,0,0,3,377,118,4647,3549,364,259,4837,3367
328,33,3,2,0,3,1,0,311,126,4650,3551,326,129,4840,3367
329,33,1,1,2,1,2,1,315,135,4651,3552,330,118,4841,3368
330,34,2,3,1,0,0,3,169,127,4653,3555,168,255,4841,3371
331,34,2,1,0,3,1,0,55,56,4655,3556,77,84,4844,3371
332,34,3,2,0,3,1,0,104,125,4658,3558,109,10,4847,3371
333,34,1,0,0,3,1,0,16,22,4659,3558,23,47,4850,3371
334,34,1,1,2,1,2,1,178,167,4660,3559,190,167,4851,3372
335,34,3,0,0,3,1,0,296,134,4663,3559,296,52,4854,3372
336,34,1,3,1,0,0,3,274,137,4664,3562,311,273,4854,3375
337,34,2,1,0,3,1,0,193,170,4666,3563,198,239,4857,3375
338,34,0,1,1,0,0,3,304,115,4666,3564,340,141,4857,3378
339,34,1,1,2,1,2,1,181,175,4667,3565,191,126,4858,3379
340,35,1,1,2,1,2,1,23,25,4668,3566,26,252,4859,3380
341,35,0,2,1,0,0,3,83,93,4668,3568,74,262,4859,3383
342,35,0,0,2,1,2,1,119,85,4668,3568,129,130,4860,3384
343,35,2,2,2,1,2,1,198,207,4670,3570,195,228,4861,3385
344,35,0,0,2,1,2,1,70,78,4670,3570,76,102,4862,3386
345,35,4,1,0,3,1,0,315,127,4674,3571,329,118,4865,3386
346,35,1,1,2,1,2,1,201,175,4675,3572,235,49,4866,3387
347,35,5,0,0,3,1,0,382,118,4680,3572,367,122,4869,3387
348,35,1,0,0,3,1,0,261,162,4681,3572,278,120,4872,3387
349,35,1,1,2,1,2,1,316,136,4682,3573,331,13,4873,3388
350,36,0,0,2,1,2,1,296,134,4682,3573,297,127,4874,3389
351,36,0,0,2,1,2,1,55,56,4682,3573,78,11,4875,3390
352,36,5,0,0,3,1,0,109,125,4687,3573,112,84,4878,3390
353,36,0,2,1,0,0,3,16,24,4687,3575,23,170,4878,3393
354,36,0,1,1,0,0,3,193,171,4687,3576,198,144,4878,3396
355,36,2,1,0,3,1,0,171,128,4689,3577,171,52,4881,3396
356,36,0,1,1,0,0,3,178,168,4689,3578,190,258,4881,3399
357,36,1,4,1,0,0,3,182,179,4690,3582,191,276,4881,3402
358,36,2,1,0,3,1,0,306,116,4692,3583,343,239,4884,3402
359,36,2,0,0,3,1,0,276,137,4694,3583,314,47,4887,3402
360,37,1,0,0,3,1,0,24,25,4695,3583,29,262,4890,3402
361,37,1,2,1,0,0,3,202,177,4696,3585,235,105,4890,3405
362,37,1,0,0,3,1,0,84,93,4697,3585,77,122,4893,3405
363,37,0,2,1,0,0,3,119,87,4697,3587,129,121,4893,3408
364,37,2,1,0,3,1,0,72,79,4699,3588,79,120,4896,3408
365,37,1,0,0,3,1,0,199,207,4700,3588,198,252,4899,3408
366,37,1,1,2,1,2,1,262,163,4701,3589,279,131,4900,3409
367,37,0,0,2,1,2,1,382,118,4701,3589,368,14,4901,3410
368,37,5,0,0,3,1,0,320,127,4706,3589,332,49,4904,3410
369,37,1,0,0,3,1,0,317,136,4707,3589,334,228,4907,3410
370,38,1,2,1,0,0,3,56,58,4708,3591,78,55,4907,3413
371,38,2,0,0,3,1,0,111,125,4710,3591,115,144,4910,3413
372,38,0,1,1,0,0,3,16,25,4710,3592,23,242,4910,3416
373,38,4,0,0,3,1,0,300,134,4714,3592,300,11,4913,3416
374,38,1,0,0,3,1,0,307,116,4715,3592,346,47,4916,3416
375,38,3,0,0,3,1,0,196,171,4718,3592,201,258,4919,3416
376,38,0,1,1,0,0,3,171,129,4718,3593,171,279,4919,3419
377,38,1,2,1,0,0,3,179,170,4719,3595,190,130,4919,3422
378,38,5,4,0,3,1,0,281,141,4724,3599,317,84,4922,3422
379,38,3,1,0,3,1,0,185,180,4727,3600,194,170,4925,3422
0,1,2,1,0,3,1,0,309,117,4729,3601,349,84,4928,3422
1,1,1,2,1,0,0,3,197,173,4730,3603,201,255,4928,3425
2,1,2,0,0,3,1,0,86,93,4732,3603,80,10,4931,3425
3,1,0,2,1,0,0,3,118,119,4732,3605,108,108,4931,3428
4,1,2,0,0,3,1,0,74,79,4734,3605,82,11,4934,3428
5,1,0,3,1,0,0,3,16,28,4734,3608,23,261,4934,3431
6,1,2,2,2,1,2,1,51,75,4736,3610,41,171,4935,3432
7,1,0,0,2,1,2,1,171,129,4736,3610,172,50,4936,3433
8,1,4,0,0,3,1,0,304,134,4740,3610,303,121,4939,3433
9,1,0,2,1,0,0,3,320,129,4740,3612,332,282,4939,3436
10,2,0,0,2,1,2,1,20,35,4740,3612,21,121,4940,3437
11,2,2,1,0,3,1,0,264,164,4742,3613,282,131,4943,3437
12,2,2,0,0,3,1,0,121,87,4744,3613,132,25,4946,3437
13,2,3,1,0,3,1,0,284,142,4747,3614,320,68,4949,3437
14,2,1,2,1,0,0,3,186,182,4748,3616,194,58,4949,3440
15,2,3,2,0,3,1,0,320,138,4751,3618,337,242,4952,3440
16,2,1,3,1,0,0,3,57,61,4752,3621,78,50,4952,3443
17,2,6,1,0,3,1,0,388,119,4758,3622,371,14,4955,3443
18,2,3,2,0,3,1,0,27,27,4761,3624,32,262,4958,3443
19,2,0,2,1,0,0,3,111,127,4761,3626,115,231,4958,3446
20,3,1,1,2,1,2,1,52,76,4762,3627,42,283,4959,3447
21,3,3,1,0,3,1,0,323,130,4765,3628,335,121,4962,3447
22,3,2,2,2,1,2,1,88,95,4767,3630,81,172,4963,3448
23,3,0,0,2,1,2,1,16,28,4767,3630,24,11,4964,3449
24,3,1,2,1,0,0,3,172,131,4768,3632,172,87,4964,3452
25,3,1,0,0,3,1,0,305,134,4769,3632,306,11,4967,3452
26,3,2,1,0,3,1,0,76,80,4771,3633,85,108,4970,3452
27,3,4,2,0,3,1,0,122,121,4775,3635,111,50,4973,3452
28,3,1,2,1,0,0,3,198,175,4776,3637,201,264,4973,3455
29,3,0,3,1,0,0,3,309,120,4776,3640,349,258,4973,3458
30,4,1,2,1,0,0,3,122,89,4777,3642,132,234,4973,3461
31,4,2,2,2,1,2,1,29,29,4779,3644,33,69,4974,3462
32,4,2,0,0,3,1,0,322,138,4781,3644,340,58,4977,3462
33,4,0,2,1,0,0,3,111,129,4781,3646,115,134,4977,3465
34,4,1,1,2,1,2,1,265,165,4782,3647,283,15,4978,3466
35,4,0,1,1,0,0,3,186,183,4782,3648,194,28,4978,3469
36,4,2,1,0,3,1,0,390,120,4784,3649,374,121,4981,3469
37,4,2,3,1,0,0,3,22,38,4786,3652,21,245,4981,3472
38,4,0,2,1,0,0,3,57,63,4786,3654,78,265,4981,3475
39,4,2,1,0,3,1,0,78,81,4788,3655,88,258,4984,3475
40,5,1,2,1,0,0,3,285,144,4789,3657,320,237,4984,3478
41,5,4,2,0,3,1,0,92,97,4793,3659,84,87,4987,3478
42,5,4,1,0,3,1,0,326,139,4797,3660,343,11,4990,3478
43,5,0,1,1,0,0,3,16,29,4797,3661,24,111,4990,3481
44,5,3,0,0,3,1,0,393,120,4800,3661,377,69,4993,3481
45,5,1,2,1,0,0,3,199,177,4801,3663,201,248,4993,3484
46,5,1,2,1,0,0,3,79,83,4802,3665,88,268,4993,3487
47,5,1,0,0,3,1,0,53,76,4803,3665,45,50,4996,3487
48,5,1,3,1,0,0,3,266,168,4804,3668,283,124,4996,3490
49,5,2,2,2,1,2,1,174,133,4806,3670,173,12,4997,3491
50,6,1,1,2,1,2,1,123,122,4807,3671,112,51,4998,3492
51,6,4,0,0,3,1,0,61,63,4811,3671,81,58,5001,3492
52,6,0,5,1,0,0,3,22,43,4811,3676,21,286,5001,3495
53,6,0,0,2,1,2,1,111,129,4811,3676,116,122,5002,3496
54,6,3,1,0,3,1,0,125,90,4814,3677,135,15,5005,3496
55,6,3,0,0,3,1,0,308,134,4817,3677,309,134,5008,3496
56,6,1,1,2,1,2,1,310,121,4818,3678,350,29,5009,3497
57,6,1,2,1,0,0,3,30,31,4819,3680,33,261,5009,3500
58,6,0,0,2,1,2,1,186,183,4819,3680,195,265,5010,3501
59,6,2,0,0,3,1,0,325,130,4821,3680,338,172,5013,3501
60,7,3,1,0,3,1,0,189,184,4824,3681,198,268,5016,3501
61,7,2,0,0,3,1,0,327,130,4826,3681,341,51,5019,3501
62,7,3,0,0,3,1,0,269,168,4829,3681,286,69,5022,3501
63,7,0,2,1,0,0,3,16,31,4829,3683,24,264,5022,3504
64,7,2,0,0,3,1,0,395,120,4831,3683,380,12,5025,3504
65,7,0,2,1,0,0,3,199,179,4831,3685,201,90,5025,3507
66,7,2,0,0,3,1,0,55,76,4833,3685,48,134,5028,3507
67,7,1,1,2,1,2,1,327,140,4834,3686,344,238,5029,3508
68,7,1,2,1,0,0,3,23,45,4835,3688,21,53,5029,3511
69,7,2,1,0,3,1,0,94,98,4837,3689,87,111,5032,3511
70,8,1,0,0,3,1,0,31,31,4838,3689,36,124,5035,3511
71,8,1,1,2,1,2,1,62,64,4839,3690,82,16,5036,3512
72,8,0,1,1,0,0,3,111,130,4839,3691,116,32,5036,3515
73,8,1,2,1,0,0,3,126,92,4840,3693,135,175,5036,3518
74,8,1,0,0,3,1,0,286,144,4841,3693,323,11,5039,3518
75,8,0,4,1,0,0,3,79,87,4841,3697,88,61,5039,3521
76,8,3,2,0,3,1,0,313,123,4844,3699,353,122,5042,3521
77,8,1,5,1,0,0,3,124,127,4845,3704,112,251,5042,3524
78,8,0,3,1,0,0,3,174,136,4845,3707,173,268,5042,3527
79,8,0,0,2,1,2,1,308,134,4845,3707,310,287,5043,3528
80,9,2,2,2,1,2,1,329,142,4847,3709,345,269,5044,3529
81,9,0,2,1,0,0,3,55,78,4847,3711,48,54,5044,3532
82,9,0,1,1,0,0,3,189,185,4847,3712,198,267,5044,3535
83,9,0,1,1,0,0,3,199,180,4847,3713,201,15,5044,3538
84,9,0,0,2,1,2,1,94,98,4847,3713,88,135,5045,3539
85,9,4,2,0,3,1,0,27,47,4851,3715,24,69,5048,3539
86,9,5,0,0,3,1,0,400,120,4856,3715,383,53,5051,3539
87,9,0,1,1,0,0,3,16,32,4856,3716,24,241,5051,3542
88,9,2,0,0,3,1,0,271,168,4858,3716,289,111,5054,3542
89,9,3,1,0,3,1,0,330,131,4861,3717,344,90,5057,3542
90,10,1,0,0,3,1,0,32,31,4862,3717,39,32,5060,3542
91,10,0,3,1,0,0,3,124,130,4862,3720,112,64,5060,3545
92,10,4,1,0,3,1,0,312,135,4866,3721,313,11,5063,3545
93,10,0,0,2,1,2,1,174,136,4866,3721,174,123,5064,3546
94,10,3,0,0,3,1,0,82,87,4869,3721,91,16,5067,3546
95,10,1,1,2,1,2,1,127,93,4870,3722,136,125,5068,3547
96,10,0,4,1,0,0,3,62,68,4870,3726,82,271,5068,3550
97,10,2,2,2,1,2,1,113,132,4872,3728,117,252,5069,3551
98,10,2,1,0,3,1,0,315,124,4874,3729,356,175,5072,3551
99,10,0,1,1,0,0,3,286,145,4874,3730,323,290,5072,3554
100,11,1,2,1,0,0,3,95,100,4875,3732,88,272,5072,3557
101,11,0,1,1,0,0,3,27,48,4875,3733,24,93,5072,3560
102,11,3,1,0,3,1,0,274,169,4878,3734,292,15,5075,3560
103,11,1,0,0,3,1,0,200,180,4879,3734,204,54,5078,3560
104,11,4,2,0,3,1,0,193,187,4883,3736,201,53,5081,3560
105,11,1,1,2,1,2,1,331,132,4884,3737,345,242,5082,3561
106,11,2,3,1,0,0,3,57,81,4886,3740,48,270,5082,3564
107,11,6,1,0,3,1,0,406,121,4892,3741,386,135,5085,3564
108,11,3,1,0,3,1,0,332,143,4895,3742,348,111,5088,3564
109,11,1,0,0,3,1,0,17,32,4896,3742,27,69,5091,3564
110,12,2,1,0,3,1,0,29,49,4898,3743,27,15,5094,3564
111,12,1,1,2,1,2,1,18,33,4899,3744,28,126,5095,3565
112,12,0,0,2,1,2,1,127,93,4899,3744,137,54,5096,3566
113,12,2,1,0,3,1,0,202,181,4901,3745,207,64,5099,3566
114,12,1,1,2,1,2,1,175,137,4902,3746,175,55,5100,3567
115,12,0,1,1,0,0,3,113,133,4902,3747,117,273,5100,3570
116,12,2,0,0,3,1,0,314,135,4904,3747,316,69,5103,3570
117,12,0,0,2,1,2,1,332,143,4904,3747,349,176,5104,3571
118,12,1,1,2,1,2,1,332,133,4905,3748,346,33,5105,3572
119,12,3,1,0,3,1,0,409,122,4908,3749,389,272,5108,3572
120,13,1,1,2,1,2,1,33,32,4909,3750,40,94,5109,3573
121,13,1,0,0,3,1,0,275,169,4910,3750,295,11,5112,3573
122,13,3,2,0,3,1,0,127,132,4913,3752,115,135,5115,3573
123,13,0,0,2,1,2,1,315,124,4913,3752,357,112,5116,3574
124,13,0,3,1,0,0,3,82,90,4913,3755,91,245,5116,3577
125,13,0,4,1,0,0,3,193,191,4913,3759,201,293,5116,3580
126,13,3,1,0,3,1,0,289,146,4916,3760,326,271,5119,3580
127,13,1,2,1,0,0,3,96,102,4917,3762,88,255,5119,3583
128,13,0,2,1,0,0,3,57,83,4917,3764,48,19,5119,3586
129,13,1,2,1,0,0,3,63,70,4918,3766,82,126,5119,3589
130,14,2,1,0,3,1,0,31,50,4920,3767,30,33,5122,3589
131,14,2,0,0,3,1,0,115,133,4922,3767,120,54,5125,3589
132,14,1,2,1,0,0,3,19,35,4923,3769,28,18,5125,3592
133,14,2,0,0,3,1,0,129,93,4925,3769,140,55,5128,3592
134,14,3,1,0,3,1,0,412,123,4928,3770,392,64,5131,3592
135,14,0,3,1,0,0,3,202,184,4928,3773,207,129,5131,3595
136,14,2,2,2,1,2,1,177,139,4930,3775,176,273,5132,3596
137,14,2,0,0,3,1,0,334,143,4932,3775,352,69,5135,3596
138,14,4,2,0,3,1,0,336,135,4936,3777,349,273,5138,3596
139,14,1,0,0,3,1,0,315,135,4937,3777,319,176,5141,3596
140,15,2,1,0,3,1,0,98,103,4939,3778,91,19,5144,3596
141,15,3,1,0,3,1,0,36,33,4942,3779,43,112,5147,3596
142,15,3,1,0,3,1,0,196,192,4945,3780,204,11,5150,3596
143,15,1,2,1,0,0,3,83,92,4946,3782,91,296,5150,3599
144,15,1,3,1,0,0,3,64,73,4947,3785,82,248,5150,3602
145,15,1,1,2,1,2,1,128,133,4948,3786,116,95,5151,3603
146,15,2,1,0,3,1,0,59,84,4950,3787,51,271,5154,3603
147,15,1,1,2,1,2,1,276,170,4951,3788,296,127,5155,3604
148,15,2,2,2,1,2,1,317,126,4953,3790,358,256,5156,3605
149,15,3,1,0,3,1,0,292,147,4956,3791,329,135,5159,3605
150,16,0,4,1,0,0,3,98,107,4956,3795,91,251,5159,3608
151,16,1,0,0,3,1,0,337,135,4957,3795,352,19,5162,3608
152,16,1,0,0,3,1,0,65,73,4958,3795,85,18,5165,3608
153,16,1,0,0,3,1,0,32,50,4959,3795,33,135,5168,3608
154,16,4,1,0,3,1,0,321,127,4963,3796,361,69,5171,3608
155,16,3,2,0,3,1,0,199,194,4966,3798,207,112,5174,3608
156,16,2,0,0,3,1,0,336,143,4968,3798,355,296,5177,3608
157,16,0,2,1,0,0,3,129,95,4968,3800,140,276,5177,3611
158,16,1,2,1,0,0,3,203,186,4969,3802,207,36,5177,3614
159,16,2,2,2,1,2,1,278,172,4971,3804,297,56,5178,3615
160,17,3,1,0,3,1,0,415,124,4974,3805,395,176,5181,3615
161,17,1,0,0,3,1,0,116,133,4975,3805,123,95,5184,3615
162,17,0,1,1,0,0,3,19,36,4975,3806,28,130,5184,3618
163,17,1,0,0,3,1,0,293,147,4976,3806,332,54,5187,3618
164,17,3,2,0,3,1,0,86,94,4979,3808,94,11,5190,3618
165,17,2,0,0,3,1,0,61,84,4981,3808,54,64,5193,3618
166,17,0,2,1,0,0,3,128,135,4981,3810,116,132,5193,3621
167,17,1,2,1,0,0,3,37,35,4982,3812,43,274,5193,3624
168,17,3,2,0,3,1,0,180,141,4985,3814,179,256,5196,3624
169,17,3,1,0,3,1,0,318,136,4988,3815,322,273,5199,3624
170,18,0,2,1,0,0,3,61,86,4988,3817,54,254,5199,3627
171,18,3,1,0,3,1,0,340,136,4991,3818,355,54,5202,3627
172,18,2,0,0,3,1,0,100,107,4993,3818,94,18,5205,3627
173,18,0,1,1,0,0,3,336,144,4993,3819,355,98,5205,3630
174,18,1,3,1,0,0,3,20,39,4994,3822,28,138,5205,3633
175,18,2,3,1,0,0,3,417,127,4996,3825,395,115,5205,3636
176,18,0,0,2,1,2,1,203,186,4996,3825,208,70,5206,3637
177,18,0,2,1,0,0,3,199,196,4996,3827,207,59,5206,3640
178,18,1,5,1,0,0,3,33,55,4997,3832,33,276,5206,3643
179,18,2,6,1,0,0,3,280,178,4999,3838,297,279,5206,3646
180,19,1,1,2,1,2,1,129,136,5000,3839,117,37,5207,3647
181,19,1,5,1,0,0,3,66,78,5001,3844,85,179,5207,3650
182,19,0,0,2,1,2,1,116,133,5001,3844,124,12,5208,3651
183,19,2,1,0,3,1,0,131,96,5003,3845,143,296,5211,3651
184,19,4,0,0,3,1,0,322,136,5007,3845,325,130,5214,3651
185,19,3,1,0,3,1,0,324,128,5010,3846,364,19,5217,3651
186,19,5,0,0,3,1,0,298,147,5015,3846,335,64,5220,3651
187,19,1,1,2,1,2,1,38,36,5016,3847,44,257,5221,3652
188,19,1,2,1,0,0,3,87,96,5017,3849,94,277,5221,3655
189,19,1,2,1,0,0,3,181,143,5018,3851,179,135,5221,3658
190,20,1,0,0,3,1,0,39,36,5019,3851,47,179,5224,3658
191,20,1,0,0,3,1,0,130,136,5020,3851,120,19,5227,3658
192,20,0,1,1,0,0,3,131,97,5020,3852,143,15,5227,3661
193,20,1,3,1,0,0,3,299,150,5021,3855,335,40,5227,3664
194,20,1,1,2,1,2,1,88,97,5022,3856,95,131,5228,3665
195,20,5,1,0,3,1,0,327,137,5027,3857,328,257,5231,3665
196,20,0,1,1,0,0,3,116,134,5027,3858,124,280,5231,3668
197,20,2,0,0,3,1,0,68,78,5029,3858,88,135,5234,3668
198,20,1,3,1,0,0,3,182,146,5030,3861,179,299,5234,3671
199,20,4,1,0,3,1,0,328,129,5034,3862,367,64,5237,3671
200,21,0,1,1,0,0,3,280,179,5034,3863,297,101,5237,3674
201,21,4,1,0,3,1,0,344,137,5038,3864,358,70,5240,3674
202,21,0,3,1,0,0,3,33,58,5038,3867,33,282,5240,3677
203,21,0,0,2,1,2,1,336,144,5038,3867,356,139,5241,3678
204,21,1,2,1,0,0,3,21,41,5039,3869,28,57,5241,3681
205,21,2,2,2,1,2,1,201,198,5041,3871,208,19,5242,3682
206,21,0,2,1,0,0,3,61,88,5041,3873,54,118,5242,3685
207,21,3,3,2,1,2,1,103,110,5044,3876,95,60,5243,3686
208,21,0,2,1,0,0,3,203,188,5044,3878,208,279,5243,3689
209,21,2,1,0,3,1,0,419,128,5046,3879,398,254,5246,3689
210,22,1,0,0,3,1,0,202,198,5047,3879,211,257,5249,3689
211,22,0,1,1,0,0,3,39,37,5047,3880,47,257,5249,3692
212,22,2,1,0,3,1,0,70,79,5049,3881,91,70,5252,3692
213,22,0,0,2,1,2,1,33,58,5049,3881,34,20,5253,3693
214,22,1,2,1,0,0,3,117,136,5050,3883,124,63,5253,3696
215,22,1,2,1,0,0,3,132,99,5051,3885,143,142,5253,3699
216,22,2,1,0,3,1,0,338,145,5053,3886,359,131,5256,3699
217,22,2,0,0,3,1,0,282,179,5055,3886,300,64,5259,3699
218,22,0,1,1,0,0,3,299,151,5055,3887,335,282,5259,3702
219,22,3,0,0,3,1,0,422,128,5058,3887,401,40,5262,3702
220,23,4,3,0,3,1,0,65,91,5062,3890,57,101,5265,3702
221,23,2,0,0,3,1,0,105,110,5064,3890,98,135,5268,3702
222,23,4,3,0,3,1,0,331,140,5068,3893,331,118,5271,3702
223,23,2,1,0,3,1,0,330,130,5070,3894,370,19,5274,3702
224,23,3,0,0,3,1,0,206,188,5073,3894,211,15,5277,3702
225,23,2,1,0,3,1,0,184,147,5075,3895,182,179,5280,3702
226,23,0,0,2,1,2,1,88,97,5075,3895,96,58,5281,3703
227,23,2,0,0,3,1,0,346,137,5077,3895,361,280,5284,3703
228,23,0,3,1,0,0,3,21,44,5077,3898,28,302,5284,3706
229,23,1,2,1,0,0,3,131,138,5078,3900,120,285,5284,3709
230,24,2,1,0,3,1,0,348,138,5080,3901,364,15,5287,3709
231,24,4,2,0,3,1,0,135,140,5084,3903,123,19,5290,3709
232,24,0,1,1,0,0,3,21,45,5084,3904,28,182,5290,3712
233,24,3,0,0,3,1,0,68,91,5087,3904,60,135,5293,3712
234,24,2,2,2,1,2,1,332,132,5089,3906,371,59,5294,3713
235,24,2,1,0,3,1,0,208,189,5091,3907,214,302,5297,3713
236,24,4,0,0,3,1,0,109,110,5095,3907,101,280,5300,3713
237,24,1,1,2,1,2,1,185,148,5096,3908,183,119,5301,3714
238,24,1,1,2,1,2,1,332,141,5097,3909,332,102,5302,3715
239,24,2,1,0,3,1,0,301,152,5099,3910,338,63,5305,3715
240,25,1,0,0,3,1,0,302,152,5100,3910,341,131,5308,3715
241,25,0,0,2,1,2,1,39,37,5100,3910,48,64,5309,3716
242,25,1,1,2,1,2,1,71,80,5101,3911,92,143,5310,3717
243,25,5,0,0,3,1,0,343,145,5106,3911,362,20,5313,3717
244,25,2,0,0,3,1,0,119,136,5108,3911,127,70,5316,3717
245,25,1,3,1,0,0,3,283,182,5109,3914,300,43,5316,3720
246,25,2,0,0,3,1,0,35,58,5111,3914,37,64,5319,3720
247,25,0,1,1,0,0,3,132,100,5111,3915,143,285,5319,3723
248,25,3,1,0,3,1,0,425,129,5114,3916,404,257,5322,3723
249,25,1,1,2,1,2,1,203,199,5115,3917,212,258,5323,3724
250,26,0,3,1,0,0,3,135,143,5115,3920,123,288,5323,3727
251,26,1,1,2,1,2,1,120,137,5116,3921,128,136,5324,3728
252,26,1,2,1,0,0,3,22,47,5117,3923,28,260,5324,3731
253,26,3,0,0,3,1,0,335,141,5120,3923,335,64,5327,3731
254,26,1,2,1,0,0,3,186,150,5121,3925,183,18,5327,3734
255,26,1,0,0,3,1,0,89,97,5122,3925,99,182,5330,3734
256,26,1,3,1,0,0,3,40,40,5123,3928,48,62,5330,3737
257,26,3,1,0,3,1,0,305,153,5126,3929,344,102,5333,3737
258,26,6,0,0,3,1,0,431,129,5132,3929,407,280,5336,3737
259,26,1,1,2,1,2,1,69,92,5133,3930,61,132,5337,3738
260,27,0,2,1,0,0,3,283,184,5133,3932,300,305,5337,3741
261,27,1,5,1,0,0,3,36,63,5134,3937,37,67,5337,3744
262,27,3,1,0,3,1,0,206,200,5137,3938,215,70,5340,3744
263,27,2,1,0,3,1,0,73,81,5139,3939,95,285,5343,3744
264,27,1,1,2,1,2,1,110,111,5140,3940,102,44,5344,3745
265,27,2,0,0,3,1,0,210,189,5142,3940,217,20,5347,3745
266,27,1,4,1,0,0,3,133,104,5143,3944,143,122,5347,3748
267,27,2,0,0,3,1,0,350,138,5145,3944,367,143,5350,3748
268,27,0,0,2,1,2,1,332,132,5145,3944,372,259,5351,3749
269,27,3,0,0,3,1,0,346,145,5148,3944,365,19,5354,3749
270,28,0,3,1,0,0,3,36,66,5148,3947,37,185,5354,3752
271,28,1,0,0,3,1,0,23,47,5149,3947,31,44,5357,3752
272,28,2,1,0,3,1,0,135,105,5151,3948,146,19,5360,3752
273,28,2,0,0,3,1,0,212,189,5153,3948,220,62,5363,3752
274,28,5,1,0,3,1,0,355,139,5158,3949,370,64,5366,3752
275,28,2,0,0,3,1,0,188,150,5160,3949,186,70,5369,3752
276,28,1,3,1,0,0,3,121,140,5161,3952,128,291,5369,3755
277,28,2,0,0,3,1,0,348,145,5163,3952,368,285,5372,3755
278,28,5,0,0,3,1,0,340,141,5168,3952,338,67,5375,3755
279,28,1,0,0,3,1,0,432,129,5169,3952,410,136,5378,3755
280,29,1,1,2,1,2,1,306,154,5170,3953,345,261,5379,3756
281,29,0,1,1,0,0,3,110,112,5170,3954,102,308,5379,3759
282,29,1,0,0,3,1,0,41,40,5171,3954,51,20,5382,3759
283,29,1,3,1,0,0,3,74,84,5172,3957,95,125,5382,3762
284,29,3,2,0,3,1,0,335,134,5175,3959,375,143,5385,3762
285,29,2,0,0,3,1,0,71,92,5177,3959,64,18,5388,3762
286,29,2,0,0,3,1,0,208,200,5179,3959,218,132,5391,3762
287,29,2,1,0,3,1,0,91,98,5181,3960,102,102,5394,3762
288,29,1,2,1,0,0,3,136,145,5182,3962,123,283,5394,3765
289,29,0,0,2,1,2,1,283,184,5182,3962,301,260,5395,3766
290,30,1,2,1,0,0,3,122,142,5183,3964,128,22,5395,3769
291,30,2,0,0,3,1,0,38,66,5185,3964,40,136,5398,3769
292,30,0,2,1,0,0,3,23,49,5185,3966,31,67,5398,3772
293,30,3,1,0,3,1,0,138,106,5188,3967,149,70,5401,3772
294,30,3,2,0,3,1,0,215,191,5191,3969,223,185,5404,3772
295,30,2,1,0,3,1,0,190,151,5193,3970,189,285,5407,3772
296,30,3,1,0,3,1,0,435,130,5196,3971,413,67,5410,3772
297,30,4,2,0,3,1,0,344,143,5200,3973,341,62,5413,3772
298,30,1,1,2,1,2,1,349,146,5201,3974,369,45,5414,3773
299,30,2,0,0,3,1,0,357,139,5203,3974,373,291,5417,3773
300,31,2,2,2,1,2,1,112,114,5205,3976,103,133,5418,3774
301,31,1,2,1,0,0,3,75,86,5206,3978,95,105,5418,3777
302,31,4,3,0,3,1,0,212,203,5210,3981,221,20,5421,3777
303,31,1,2,1,0,0,3,137,147,5211,3983,123,263,5421,3780
304,31,2,0,0,3,1,0,285,184,5213,3983,304,283,5424,3780
305,31,2,0,0,3,1,0,308,154,5215,3983,348,125,5427,3780
306,31,0,2,1,0,0,3,41,42,5215,3985,51,21,5427,3783
307,31,1,1,2,1,2,1,92,99,5216,3986,103,144,5428,3784
308,31,3,1,0,3,1,0,74,93,5219,3987,67,261,5431,3784
309,31,0,2,1,0,0,3,335,136,5219,3989,375,311,5431,3787
310,32,0,2,1,0,0,3,137,149,5219,3991,123,314,5431,3790
311,32,0,1,1,0,0,3,41,43,5219,3992,51,147,5431,3793
312,32,2,0,0,3,1,0,77,86,5221,3992,98,45,5434,3793
313,32,2,0,0,3,1,0,124,142,5223,3992,131,20,5437,3793
314,32,2,0,0,3,1,0,140,106,5225,3992,152,67,5440,3793
315,32,2,1,0,3,1,0,337,137,5227,3993,378,67,5443,3793
316,32,0,2,1,0,0,3,212,205,5227,3995,221,188,5443,3796
317,32,1,2,1,0,0,3,39,68,5228,3997,40,286,5443,3799
318,32,2,1,0,3,1,0,346,144,5230,3998,344,285,5446,3799
319,32,2,0,0,3,1,0,359,139,5232,3998,376,133,5449,3799
320,33,4,1,0,3,1,0,96,100,5236,3999,106,70,5452,3799
321,33,2,1,0,3,1,0,76,94,5238,4000,70,291,5455,3799
322,33,2,0,0,3,1,0,437,130,5240,4000,416,21,5458,3799
323,33,1,3,1,0,0,3,191,154,5241,4003,189,266,5458,3802
324,33,1,3,1,0,0,3,113,117,5242,4006,103,65,5458,3805
325,33,1,4,1,0,0,3,24,53,5243,4010,31,108,5458,3808
326,33,0,1,1,0,0,3,215,192,5243,4011,223,128,5458,3811
327,33,1,0,0,3,1,0,286,184,5244,4011,307,261,5461,3811
328,33,2,0,0,3,1,0,351,146,5246,4011,372,136,5464,3811
329,33,1,0,0,3,1,0,309,154,5247,4011,351,22,5467,3811
330,34,0,1,1,0,0,3,140,107,5247,4012,152,136,5467,3814
331,34,4,0,0,3,1,0,313,154,5251,4012,354,20,5470,3814
332,34,0,5,1,0,0,3,41,48,5251,4017,51,70,5470,3817
333,34,2,0,0,3,1,0,79,86,5253,4017,101,21,5473,3817
334,34,2,0,0,3,1,0,139,149,5255,4017,126,188,5476,3817
335,34,3,1,0,3,1,0,194,155,5258,4018,192,45,5479,3817
336,34,2,1,0,3,1,0,339,138,5260,4019,381,136,5482,3817
337,34,1,3,1,0,0,3,125,145,5261,4022,131,317,5482,3820
338,34,2,0,0,3,1,0,348,144,5263,4022,347,286,5485,3820
339,34,0,1,1,0,0,3,96,101,5263,4023,106,264,5485,3823
340,35,1,0,0,3,1,0,438,130,5264,4023,419,285,5488,3823
341,35,0,1,1,0,0,3,113,118,5264,4024,103,73,5488,3826
342,35,1,2,1,0,0,3,25,55,5265,4026,31,70,5488,3829
343,35,2,2,2,1,2,1,214,207,5267,4028,222,109,5489,3830
344,35,0,0,2,1,2,1,76,94,5267,4028,71,23,5490,3831
345,35,3,1,0,3,1,0,218,193,5270,4029,226,147,5493,3831
346,35,4,0,0,3,1,0,290,184,5274,4029,310,291,5496,3831
347,35,2,3,1,0,0,3,361,142,5276,4032,376,131,5496,3834
348,35,0,2,1,0,0,3,39,70,5276,4034,40,269,5496,3837
349,35,2,2,2,1,2,1,353,148,5278,4036,373,66,5497,3838
350,36,5,0,0,3,1,0,353,144,5283,4036,350,20,5500,3838
351,36,0,1,1,0,0,3,313,155,5283,4037,354,139,5500,3841
352,36,0,0,2,1,2,1,125,145,5283,4037,132,189,5501,3842
353,36,1,0,0,3,1,0,140,149,5284,4037,129,21,5504,3842
354,36,3,3,2,1,2,1,197,158,5287,4040,193,71,5505,3843
355,36,1,2,1,0,0,3,97,103,5288,4042,106,48,5505,3846
356,36,1,1,2,1,2,1,42,49,5289,4043,52,137,5506,3847
357,36,3,0,0,3,1,0,143,107,5292,4043,155,264,5509,3847
358,36,0,1,1,0,0,3,79,87,5292,4044,101,320,5509,3850
359,36,1,1,2,1,2,1,340,139,5293,4045,382,287,5510,3851
360,37,2,0,0,3,1,0,292,184,5295,4045,313,66,5513,3851
361,37,1,0,0,3,1,0,114,118,5296,4045,106,285,5516,3851
362,37,3,0,0,3,1,0,217,207,5299,4045,225,147,5519,3851
363,37,1,0,0,3,1,0,77,94,5300,4045,74,73,5522,3851
364,37,2,3,1,0,0,3,41,73,5302,4048,40,134,5522,3854
365,37,2,3,1,0,0,3,220,196,5304,4051,226,272,5522,3857
366,37,3,0,0,3,1,0,356,148,5307,4051,376,70,5525,3857
367,37,1,1,2,1,2,1,26,56,5308,4052,32,292,5526,3858
368,37,1,1,2,1,2,1,362,143,5309,4053,377,24,5527,3859
369,37,1,0,0,3,1,0,439,130,5310,4053,422,109,5530,3859
370,38,1,4,1,0,0,3,43,53,5311,4057,52,323,5530,3862
371,38,1,3,1,0,0,3,80,90,5312,4060,101,267,5530,3865
372,38,5,3,0,3,1,0,130,148,5317,4063,135,71,5533,3865
373,38,0,4,1,0,0,3,140,153,5317,4067,129,140,5533,3868
374,38,0,0,2,1,2,1,143,107,5317,4067,156,288,5534,3869
375,38,2,0,0,3,1,0,355,144,5319,4067,353,48,5537,3869
376,38,0,2,1,0,0,3,340,141,5319,4069,382,24,5537,3872
377,38,1,1,2,1,2,1,198,159,5320,4070,194,21,5538,3873
378,38,2,2,2,1,2,1,315,157,5322,4072,355,190,5539,3874
379,38,1,4,1,0,0,3,98,107,5323,4076,106,142,5539,3877
0,1,4,1,0,3,1,0,359,145,5327,4077,356,53,5542,3877
1,1,0,5,1,0,0,3,217,212,5327,4082,225,326,5542,3880
2,1,1,1,2,1,2,1,115,119,5328,4083,107,1,5543,3881
3,1,3,0,0,3,1,0,83,90,5331,4083,104,147,5546,3881
4,1,0,0,2,1,2,1,130,148,5331,4083,136,191,5547,3882
5,1,0,3,1,0,0,3,98,110,5331,4086,106,27,5547,3885
6,1,3,1,0,3,1,0,318,158,5334,4087,358,97,5550,3885
7,1,0,0,2,1,2,1,143,107,5334,4087,157,49,5551,3886
8,1,0,1,1,0,0,3,220,197,5334,4088,226,270,5551,3889
9,1,4,0,0,3,1,0,344,141,5338,4088,385,288,5554,3889
10,2,2,1,0,3,1,0,364,144,5340,4089,380,66,5557,3889
11,2,1,2,1,0,0,3,124,163,5341,4091,123,74,5557,3892
12,2,1,1,2,1,2,1,44,54,5342,4092,53,143,5558,3893
13,2,1,0,0,3,1,0,293,184,5343,4092,316,70,5561,3893
14,2,3,1,0,3,1,0,99,99,5346,4093,108,140,5564,3893
15,2,1,2,1,0,0,3,199,161,5347,4095,194,275,5564,3896
16,2,2,2,2,1,2,1,441,132,5349,4097,423,286,5565,3897
17,2,1,0,0,3,1,0,1,0,5350,4097,3,134,5568,3897
18,2,1,1,2,1,2,1,357,149,5351,4098,377,110,5569,3898
19,2,1,1,2,1,2,1,78,95,5352,4099,75,293,5570,3899
20,3,2,0,0,3,1,0,126,163,5354,4099,126,191,5573,3899
21,3,2,3,1,0,0,3,101,102,5356,4102,108,291,5573,3902
22,3,0,2,1,0,0,3,44,56,5356,4104,53,150,5573,3905
23,3,1,2,1,0,0,3,345,143,5357,4106,385,137,5573,3908
24,3,1,2,1,0,0,3,2,2,5358,4108,3,113,5573,3911
25,3,1,3,1,0,0,3,99,113,5359,4111,106,146,5573,3914
26,3,3,1,0,3,1,0,362,146,5362,4112,359,270,5576,3914
27,3,1,3,1,0,0,3,116,122,5363,4115,107,329,5576,3917
28,3,0,1,1,0,0,3,318,159,5363,4116,358,143,5576,3920
29,3,1,1,2,1,2,1,79,96,5364,4117,76,67,5577,3921
30,4,1,1,2,1,2,1,200,162,5365,4118,195,294,5578,3922
31,4,2,2,2,1,2,1,359,151,5367,4120,378,2,5579,3923
32,4,1,0,0,3,1,0,131,148,5368,4120,139,97,5582,3923
33,4,3,1,0,3,1,0,146,108,5371,4121,160,74,5585,3923
34,4,4,0,0,3,1,0,445,132,5375,4121,426,27,5588,3923
35,4,1,1,2,1,2,1,221,198,5376,4122,227,71,5589,3924
36,4,2,0,0,3,1,0,219,212,5378,4122,228,53,5592,3924
37,4,0,3,1,0,0,3,83,93,5378,4125,104,278,5592,3927
38,4,3,2,0,3,1,0,296,186,5381,4127,319,49,5595,3927
39,4,2,2,2,1,2,1,366,146,5383,4129,381,287,5596,3928
40,5,3,1,0,3,1,0,365,147,5386,4130,362,143,5599,3928
41,5,1,1,2,1,2,1,45,57,5387,4131,54,68,5600,3929
42,5,1,0,0,3,1,0,346,143,5388,4131,388,113,5603,3929
43,5,0,1,1,0,0,3,2,3,5388,4132,3,153,5603,3932
44,5,4,0,0,3,1,0,322,159,5392,4132,361,137,5606,3932
45,5,2,5,1,0,0,3,81,101,5394,4137,76,294,5606,3935
46,5,3,2,0,3,1,0,104,104,5397,4139,111,329,5609,3935
47,5,3,1,0,3,1,0,119,123,5400,4140,110,191,5612,3935
48,5,2,2,2,1,2,1,101,115,5402,4142,107,271,5613,3936
49,5,0,0,2,1,2,1,126,163,5402,4142,127,147,5614,3937
50,6,1,3,1,0,0,3,201,165,5403,4145,195,77,5614,3940
51,6,2,1,0,3,1,0,148,109,5405,4146,163,287,5617,3940
52,6,2,0,0,3,1,0,85,93,5407,4146,107,53,5620,3940
53,6,0,2,1,0,0,3,296,188,5407,4148,319,5,5620,3943
54,6,8,0,0,3,1,0,453,132,5415,4148,429,71,5623,3943
55,6,0,0,2,1,2,1,221,198,5415,4148,228,28,5624,3944
56,6,1,1,2,1,2,1,132,149,5416,4149,140,50,5625,3945
57,6,2,0,0,3,1,0,221,212,5418,4149,231,294,5628,3945
58,6,3,2,0,3,1,0,369,148,5421,4151,384,97,5631,3945
59,6,1,2,1,0,0,3,360,153,5422,4153,378,281,5631,3948
60,7,0,1,1,0,0,3,2,4,5422,4154,3,284,5631,3951
61,7,2,2,2,1,2,1,128,165,5424,4156,128,69,5632,3952
62,7,2,2,2,1,2,1,121,125,5426,4158,111,148,5633,3953
63,7,2,0,0,3,1,0,362,153,5428,4158,381,28,5636,3953
64,7,2,0,0,3,1,0,134,149,5430,4158,143,53,5639,3953
65,7,2,1,0,3,1,0,324,160,5432,4159,364,153,5642,3953
66,7,2,0,0,3,1,0,83,101,5434,4159,79,71,5645,3953
67,7,1,3,1,0,0,3,297,191,5435,4162,319,332,5645,3956
68,7,5,0,0,3,1,0,153,109,5440,4162,166,143,5648,3956
69,7,1,1,2,1,2,1,347,144,5441,4163,389,272,5649,3957
70,8,3,0,0,3,1,0,48,57,5444,4163,57,287,5652,3957
71,8,1,0,0,3,1,0,86,93,5445,4163,110,191,5655,3957
72,8,2,1,0,3,1,0,367,148,5447,4164,365,113,5658,3957
73,8,1,5,1,0,0,3,105,109,5448,4169,111,100,5658,3960
74,8,0,0,2,1,2,1,101,115,5448,4169,108,6,5659,3961
75,8,1,2,1,0,0,3,222,214,5449,4171,231,140,5659,3964
76,8,1,0,0,3,1,0,370,148,5450,4171,387,77,5662,3964
77,8,0,2,1,0,0,3,453,134,5450,4173,429,53,5662,3967
78,8,1,4,1,0,0,3,202,169,5451,4177,195,297,5662,3970
79,8,1,0,0,3,1,0,222,198,5452,4177,231,294,5665,3970
80,9,2,0,0,3,1,0,299,191,5454,4177,322,148,5668,3970
81,9,2,1,0,3,1,0,130,166,5456,4178,131,28,5671,3970
82,9,0,0,2,1,2,1,121,125,5456,4178,112,54,5672,3971
83,9,1,0,0,3,1,0,363,153,5457,4178,384,143,5675,3971
84,9,2,1,0,3,1,0,155,110,5459,4179,169,69,5678,3971
85,9,1,1,2,1,2,1,325,161,5460,4180,365,72,5679,3972
86,9,1,1,2,1,2,1,84,102,5461,4181,80,154,5680,3973
87,9,0,2,1,0,0,3,134,151,5461,4183,143,335,5680,3976
88,9,1,1,2,1,2,1,348,145,5462,4184,390,285,5681,3977
89,9,1,0,0,3,1,0,3,4,5463,4184,6,272,5684,3977
90,10,0,9,1,0,0,3,202,178,5463,4193,195,116,5684,3980
91,10,3,0,0,3,1,0,456,134,5466,4193,432,100,5687,3980
92,10,3,2,0,3,1,0,51,59,5469,4195,60,191,5690,3980
93,10,0,0,2,1,2,1,101,115,5469,4195,109,78,5691,3981
94,10,1,1,2,1,2,1,223,215,5470,4196,232,7,5692,3982
95,10,2,4,1,0,0,3,88,97,5472,4200,110,300,5692,3985
96,10,1,1,2,1,2,1,223,199,5473,4201,232,54,5693,3986
97,10,2,2,2,1,2,1,372,150,5475,4203,388,141,5694,3987
98,10,2,1,0,3,1,0,369,149,5477,4204,368,287,5697,3987
99,10,1,3,1,0,0,3,106,112,5478,4207,111,297,5697,3990
100,11,1,0,0,3,1,0,122,125,5479,4207,115,297,5700,3990
101,11,1,1,2,1,2,1,373,151,5480,4208,389,55,5701,3991
102,11,1,2,1,0,0,3,131,168,5481,4210,131,288,5701,3994
103,11,2,0,0,3,1,0,53,59,5483,4210,63,54,5704,3994
104,11,2,1,0,3,1,0,458,135,5485,4211,435,154,5707,3994
105,11,3,0,0,3,1,0,6,4,5488,4211,9,69,5710,3994
106,11,2,3,1,0,0,3,225,218,5490,4214,232,146,5710,3997
107,11,1,2,1,0,0,3,102,117,5491,4216,109,303,5710,4000
108,11,0,2,1,0,0,3,134,153,5491,4218,143,119,5710,4003
109,11,1,1,2,1,2,1,300,192,5492,4219,323,288,5711,4004
110,12,0,2,1,0,0,3,106,114,5492,4221,111,75,5711,4007
111,12,2,0,0,3,1,0,365,153,5494,4221,387,141,5714,4007
112,12,3,0,0,3,1,0,91,97,5497,4221,113,148,5717,4007
113,12,2,1,0,3,1,0,225,200,5499,4222,235,78,5720,4007
114,12,1,2,1,0,0,3,203,180,5500,4224,195,194,5720,4010
115,12,1,1,2,1,2,1,326,162,5501,4225,366,8,5721,4011
116,12,2,0,0,3,1,0,157,110,5503,4225,172,272,5724,4011
117,12,3,1,0,3,1,0,351,146,5506,4226,393,28,5727,4011
118,12,2,1,0,3,1,0,86,103,5508,4227,83,100,5730,4011
119,12,3,1,0,3,1,0,372,150,5511,4228,371,335,5733,4011
120,13,2,3,1,0,0,3,227,221,5513,4231,232,291,5733,4014
121,13,2,2,2,1,2,1,375,153,5515,4233,390,155,5734,4015
122,13,1,2,1,0,0,3,123,127,5516,4235,115,58,5734,4018
123,13,0,2,1,0,0,3,53,61,5516,4237,63,122,5734,4021
124,13,1,2,1,0,0,3,135,155,5517,4239,143,291,5734,4024
125,13,0,2,1,0,0,3,300,194,5517,4241,323,57,5734,4027
126,13,0,3,1,0,0,3,102,120,5517,4244,109,72,5734,4030
127,13,2,1,0,3,1,0,460,136,5519,4245,438,303,5737,4030
128,13,3,3,2,1,2,1,9,7,5522,4248,10,298,5738,4031
129,13,2,0,0,3,1,0,133,168,5524,4248,134,146,5741,4031
130,14,2,2,2,1,2,1,227,202,5526,4250,236,336,5742,4032
131,14,0,2,1,0,0,3,91,99,5526,4252,113,144,5742,4035
132,14,0,1,1,0,0,3,365,154,5526,4253,387,151,5742,4038
133,14,2,1,0,3,1,0,374,151,5528,4254,374,28,5745,4038
134,14,3,2,0,3,1,0,329,164,5531,4256,369,78,5748,4038
135,14,2,1,0,3,1,0,205,181,5533,4257,198,75,5751,4038
136,14,2,2,2,1,2,1,108,116,5535,4259,112,273,5752,4039
137,14,1,1,2,1,2,1,87,104,5536,4260,84,9,5753,4040
138,14,2,1,0,3,1,0,159,111,5538,4261,175,194,5756,4040
139,14,2,2,2,1,2,1,353,148,5540,4263,394,101,5757,4041
140,15,1,0,0,3,1,0,136,155,5541,4263,146,78,5760,4041
141,15,1,4,1,0,0,3,92,103,5542,4267,113,339,5760,4044
142,15,2,0,0,3,1,0,161,111,5544,4267,178,75,5763,4044
143,15,2,0,0,3,1,0,89,104,5546,4267,87,151,5766,4044
144,15,2,1,0,3,1,0,355,149,5548,4268,397,291,5769,4044
145,15,2,1,0,3,1,0,367,155,5550,4269,390,101,5772,4044
146,15,2,1,0,3,1,0,207,182,5552,4270,201,57,5775,4044
147,15,5,2,0,3,1,0,379,153,5557,4272,377,194,5778,4044
148,15,0,2,1,0,0,3,9,9,5557,4274,10,149,5778,4047
149,15,1,2,1,0,0,3,376,155,5558,4276,390,31,5778,4050
150,16,3,1,0,3,1,0,303,195,5561,4277,326,303,5781,4050
151,16,0,3,1,0,0,3,123,130,5561,4280,115,294,5781,4053
152,16,5,0,0,3,1,0,334,164,5566,4280,372,72,5784,4053
153,16,0,0,2,1,2,1,102,120,5566,4280,110,145,5785,4054
154,16,1,2,1,0,0,3,461,138,5567,4282,438,301,5785,4057
155,16,1,4,1,0,0,3,134,172,5568,4286,134,125,5785,4060
156,16,2,1,0,3,1,0,229,203,5570,4287,239,155,5788,4060
157,16,1,2,1,0,0,3,109,118,5571,4289,112,12,5788,4063
158,16,2,2,2,1,2,1,55,63,5573,4291,64,59,5789,4064
159,16,1,3,1,0,0,3,228,224,5574,4294,232,276,5789,4067
160,17,2,0,0,3,1,0,381,153,5576,4294,380,75,5792,4067
161,17,1,0,0,3,1,0,93,103,5577,4294,116,149,5795,4067
162,17,0,1,1,0,0,3,367,156,5577,4295,390,81,5795,4070
163,17,1,1,2,1,2,1,162,112,5578,4296,179,58,5796,4071
164,17,2,0,0,3,1,0,11,9,5580,4296,13,101,5799,4071
165,17,0,1,1,0,0,3,207,183,5580,4297,201,154,5799,4074
166,17,1,1,2,1,2,1,356,150,5581,4298,398,195,5800,4075
167,17,1,2,1,0,0,3,90,106,5582,4300,87,294,5800,4078
168,17,0,3,1,0,0,3,376,158,5582,4303,390,342,5800,4081
169,17,1,1,2,1,2,1,137,156,5583,4304,147,32,5801,4082
170,18,0,0,2,1,2,1,303,195,5583,4304,327,277,5802,4083
171,18,1,3,1,0,0,3,135,175,5584,4307,134,158,5802,4086
172,18,0,1,1,0,0,3,123,131,5584,4308,115,75,5802,4089
173,18,0,1,1,0,0,3,55,64,5584,4309,64,15,5802,4092
174,18,1,0,0,3,1,0,230,203,5585,4309,242,145,5805,4092
175,18,1,2,1,0,0,3,110,120,5586,4311,112,62,5805,4095
176,18,3,1,0,3,1,0,464,139,5589,4312,441,125,5808,4095
177,18,2,0,0,3,1,0,104,120,5591,4312,113,301,5811,4095
178,18,0,2,1,0,0,3,334,166,5591,4314,372,306,5811,4098
179,18,0,2,1,0,0,3,228,226,5591,4316,232,297,5811,4101
180,19,2,1,0,3,1,0,336,167,5593,4317,375,32,5814,4101
181,19,1,0,0,3,1,0,136,175,5594,4317,137,58,5817,4101
182,19,1,1,2,1,2,1,124,132,5595,4318,116,278,5818,4102
183,19,0,2,1,0,0,3,367,158,5595,4320,390,161,5818,4105
184,19,2,1,0,3,1,0,139,157,5597,4321,150,154,5821,4105
185,19,1,0,0,3,1,0,304,195,5598,4321,330,75,5824,4105
186,19,1,1,2,1,2,1,12,10,5599,4322,14,76,5825,4106
187,19,4,1,0,3,1,0,360,151,5603,4323,401,149,5828,4106
188,19,0,4,1,0,0,3,162,116,5603,4327,179,300,5828,4109
189,19,3,2,0,3,1,0,93,108,5606,4329,90,342,5831,4109
190,20,2,0,0,3,1,0,57,64,5608,4329,67,81,5834,4109
191,20,1,2,1,0,0,3,231,205,5609,4331,242,198,5834,4112
192,20,1,1,2,1,2,1,208,184,5610,4332,202,146,5835,4113
193,20,3,0,0,3,1,0,107,120,5613,4332,116,101,5838,4113
194,20,2,2,2,1,2,1,112,122,5615,4334,113,295,5839,4114
195,20,1,2,1,0,0,3,229,228,5616,4336,232,128,5839,4117
196,20,0,2,1,0,0,3,93,105,5616,4338,116,304,5839,4120
197,20,1,2,1,0,0,3,377,160,5617,4340,390,309,5839,4123
198,20,1,0,0,3,1,0,382,153,5618,4340,383,62,5842,4123
199,20,2,0,0,3,1,0,466,139,5620,4340,444,15,5845,4123
200,21,1,1,2,1,2,1,58,65,5621,4341,68,310,5846,4124
201,21,1,2,1,0,0,3,94,107,5622,4343,116,104,5846,4127
202,21,0,3,1,0,0,3,231,208,5622,4346,242,131,5846,4130
203,21,1,0,0,3,1,0,209,184,5623,4346,205,295,5849,4130
204,21,2,1,0,3,1,0,109,121,5625,4347,119,62,5852,4130
205,21,2,1,0,3,1,0,468,140,5627,4348,447,198,5855,4130
206,21,1,1,2,1,2,1,113,123,5628,4349,114,147,5856,4131
207,21,4,0,0,3,1,0,233,228,5632,4349,235,81,5859,4131
208,21,2,0,0,3,1,0,379,160,5634,4349,393,304,5862,4131
209,21,2,0,0,3,1,0,384,153,5636,4349,386,15,5865,4131
210,22,1,0,0,3,1,0,13,10,5637,4349,17,154,5868,4131
211,22,1,1,2,1,2,1,140,158,5638,4350,151,279,5869,4132
212,22,3,0,0,3,1,0,370,158,5641,4350,393,75,5872,4132
213,22,1,0,0,3,1,0,305,195,5642,4350,333,32,5875,4132
214,22,1,2,1,0,0,3,163,118,5643,4352,179,164,5875,4135
215,22,4,0,0,3,1,0,364,151,5647,4352,404,58,5878,4135
216,22,1,1,2,1,2,1,94,109,5648,4353,91,150,5879,4136
217,22,0,1,1,0,0,3,336,168,5648,4354,375,303,5879,4139
218,22,0,3,1,0,0,3,124,135,5648,4357,116,79,5879,4142
219,22,1,6,1,0,0,3,137,181,5649,4363,137,345,5879,4145
220,23,0,0,2,1,2,1,109,121,5649,4363,120,296,5880,4146
221,23,1,1,2,1,2,1,380,161,5650,4364,394,16,5881,4147
222,23,1,1,2,1,2,1,59,66,5651,4365,69,105,5882,4148
223,23,2,2,2,1,2,1,470,142,5653,4367,448,148,5883,4149
224,23,1,0,0,3,1,0,114,123,5654,4367,117,81,5886,4149
225,23,2,3,1,0,0,3,211,187,5656,4370,205,65,5886,4152
226,23,1,1,2,1,2,1,234,229,5657,4371,236,199,5887,4153
227,23,1,0,0,3,1,0,232,208,5658,4371,245,310,5890,4153
228,23,2,1,0,3,1,0,96,108,5660,4372,119,131,5893,4153
229,23,2,0,0,3,1,0,386,153,5662,4372,389,304,5896,4153
230,24,2,1,0,3,1,0,139,182,5664,4373,140,79,5899,4153
231,24,3,1,0,3,1,0,127,136,5667,4374,119,32,5902,4153
232,24,2,2,2,1,2,1,307,197,5669,4376,334,151,5903,4154
233,24,0,1,1,0,0,3,13,11,5669,4377,17,348,5903,4157
234,24,0,2,1,0,0,3,140,160,5669,4379,151,167,5903,4160
235,24,2,2,2,1,2,1,372,160,5671,4381,394,280,5904,4161
236,24,4,1,0,3,1,0,167,119,5675,4382,182,154,5907,4161
237,24,2,1,0,3,1,0,338,169,5677,4383,378,58,5910,4161
238,24,0,2,1,0,0,3,364,153,5677,4385,404,78,5910,4164
239,24,1,2,1,0,0,3,95,111,5678,4387,91,306,5910,4167
240,25,2,2,2,1,2,1,169,121,5680,4389,183,311,5911,4168
241,25,2,1,0,3,1,0,129,137,5682,4390,122,105,5914,4168
242,25,0,1,1,0,0,3,140,161,5682,4391,151,19,5914,4171
243,25,4,0,0,3,1,0,390,153,5686,4391,392,167,5917,4171
244,25,0,0,2,1,2,1,232,208,5686,4391,246,59,5918,4172
245,25,2,3,1,0,0,3,111,124,5688,4394,120,202,5918,4175
246,25,3,3,2,1,2,1,237,232,5691,4397,237,33,5919,4176
247,25,0,0,2,1,2,1,364,153,5691,4397,405,66,5920,4177
248,25,0,0,2,1,2,1,96,108,5691,4397,120,281,5921,4178
249,25,2,0,0,3,1,0,340,169,5693,4397,381,348,5924,4178
250,26,3,1,0,3,1,0,310,198,5696,4398,337,148,5927,4178
251,26,1,1,2,1,2,1,60,67,5697,4399,70,80,5928,4179
252,26,2,1,0,3,1,0,15,12,5699,4400,20,81,5931,4179
253,26,0,0,2,1,2,1,95,111,5699,4400,92,132,5932,4180
254,26,1,2,1,0,0,3,212,189,5700,4402,205,81,5932,4183
255,26,0,1,1,0,0,3,114,124,5700,4403,117,309,5932,4186
256,26,2,3,1,0,0,3,141,185,5702,4406,140,299,5932,4189
257,26,4,0,0,3,1,0,384,161,5706,4406,397,151,5935,4189
258,26,0,2,1,0,0,3,372,162,5706,4408,394,307,5935,4192
259,26,2,0,0,3,1,0,472,142,5708,4408,451,154,5938,4192
260,27,2,1,0,3,1,0,374,163,5710,4409,397,299,5941,4192
261,27,3,0,0,3,1,0,99,108,5713,4409,123,81,5944,4192
262,27,1,0,0,3,1,0,141,161,5714,4409,154,151,5947,4192
263,27,1,1,2,1,2,1,16,13,5715,4410,21,34,5948,4193
264,27,2,0,0,3,1,0,214,189,5717,4410,208,105,5951,4193
265,27,0,1,1,0,0,3,169,122,5717,4411,183,351,5951,4196
266,27,3,0,0,3,1,0,367,153,5720,4411,408,80,5954,4196
267,27,3,0,0,3,1,0,98,111,5723,4411,95,59,5957,4196
268,27,3,2,0,3,1,0,387,163,5726,4413,400,202,5960,4196
269,27,3,2,0,3,1,0,393,155,5729,4415,395,154,5963,4196
270,28,1,0,0,3,1,0,115,124,5730,4415,120,132,5966,4196
271,28,0,1,1,0,0,3,60,68,5730,4416,70,151,5966,4199
272,28,2,2,2,1,2,1,131,139,5732,4418,123,312,5967,4200
273,28,0,0,2,1,2,1,232,208,5732,4418,247,82,5968,4201
274,28,3,1,0,3,1,0,240,233,5735,4419,240,167,5971,4201
275,28,3,0,0,3,1,0,114,124,5738,4419,123,309,5974,4201
276,28,1,1,2,1,2,1,311,199,5739,4420,338,308,5975,4202
277,28,2,3,1,0,0,3,342,172,5741,4423,381,69,5975,4205
278,28,0,0,2,1,2,1,141,185,5741,4423,141,20,5976,4206
279,28,3,0,0,3,1,0,475,142,5744,4423,454,281,5979,4206
280,29,2,1,0,3,1,0,395,156,5746,4424,398,81,5982,4206
281,29,1,0,0,3,1,0,388,163,5747,4424,403,154,5985,4206
282,29,1,0,0,3,1,0,142,161,5748,4424,157,80,5988,4206
283,29,1,0,0,3,1,0,17,13,5749,4424,24,59,5991,4206
284,29,0,1,1,0,0,3,214,190,5749,4425,208,154,5991,4209
285,29,0,0,2,1,2,1,98,111,5749,4425,96,35,5992,4210
286,29,1,1,2,1,2,1,100,109,5750,4426,124,300,5993,4211
287,29,4,0,0,3,1,0,378,163,5754,4426,400,202,5996,4211
288,29,2,0,0,3,1,0,369,153,5756,4426,411,351,5999,4211
289,29,4,0,0,3,1,0,173,122,5760,4426,186,105,6002,4211
290,30,0,3,1,0,0,3,115,127,5760,4429,120,170,6002,4214
291,30,1,1,2,1,2,1,343,173,5761,4430,382,309,6003,4215
292,30,1,1,2,1,2,1,115,125,5762,4431,124,133,6004,4216
293,30,2,1,0,3,1,0,62,69,5764,4432,73,281,6007,4216
294,30,0,2,1,0,0,3,240,235,5764,4434,240,72,6007,4219
295,30,0,2,1,0,0,3,131,141,5764,4436,123,154,6007,4222
296,30,3,0,0,3,1,0,235,208,5767,4436,250,20,6010,4222
297,30,1,2,1,0,0,3,142,187,5768,4438,141,315,6010,4225
298,30,0,0,2,1,2,1,311,199,5768,4438,339,310,6011,4226
299,30,5,0,0,3,1,0,480,142,5773,4438,457,82,6014,4226
300,31,0,0,2,1,2,1,173,122,5773,4438,187,36,6015,4227
301,31,2,0,0,3,1,0,345,173,5775,4438,385,154,6018,4227
302,31,3,0,0,3,1,0,372,153,5778,4438,414,20,6021,4227
303,31,1,1,2,1,2,1,236,209,5779,4439,251,106,6022,4228
304,31,0,1,1,0,0,3,115,128,5779,4440,120,205,6022,4231
305,31,1,0,0,3,1,0,99,111,5780,4440,99,81,6025,4231
306,31,4,0,0,3,1,0,399,156,5784,4440,401,154,6028,4231
307,31,1,0,0,3,1,0,101,109,5785,4440,127,80,6031,4231
308,31,0,2,1,0,0,3,214,192,5785,4442,208,284,6031,4234
309,31,2,1,0,3,1,0,380,164,5787,4443,403,351,6034,4234
310,32,0,1,1,0,0,3,142,188,5787,4444,141,75,6034,4237
311,32,1,3,1,0,0,3,116,128,5788,4447,124,173,6034,4240
312,32,0,1,1,0,0,3,142,162,5788,4448,157,85,6034,4243
313,32,0,3,1,0,0,3,62,72,5788,4451,73,312,6034,4246
314,32,4,0,0,3,1,0,392,163,5792,4451,406,59,6037,4246
315,32,1,4,1,0,0,3,132,145,5793,4455,123,157,6037,4249
316,32,2,1,0,3,1,0,313,200,5795,4456,342,133,6040,4249
317,32,3,2,0,3,1,0,243,237,5798,4458,243,315,6043,4249
318,32,3,1,0,3,1,0,20,14,5801,4459,27,300,6046,4249
319,32,4,0,0,3,1,0,484,142,5805,4459,460,310,6049,4249
320,33,0,1,1,0,0,3,115,129,5805,4460,120,39,6049,4252
321,33,3,0,0,3,1,0,176,122,5808,4460,190,154,6052,4252
322,33,5,2,0,3,1,0,377,155,5813,4462,417,81,6055,4252
323,33,0,2,1,0,0,3,99,113,5813,4464,99,287,6055,4255
324,33,3,0,0,3,1,0,383,164,5816,4464,406,80,6058,4255
325,33,1,1,2,1,2,1,102,110,5817,4465,128,21,6059,4256
326,33,2,2,2,1,2,1,238,211,5819,4467,252,155,6060,4257
327,33,2,0,0,3,1,0,401,156,5821,4467,404,106,6063,4257
328,33,1,0,0,3,1,0,215,192,5822,4467,211,351,6066,4257
329,33,1,0,0,3,1,0,346,173,5823,4467,388,205,6069,4257
330,34,2,1,0,3,1,0,118,129,5825,4468,127,59,6072,4257
331,34,2,3,1,0,0,3,144,165,5827,4471,157,318,6072,4260
332,34,1,1,2,1,2,1,393,164,5828,4472,407,134,6073,4261
333,34,5,0,0,3,1,0,489,142,5833,4472,463,157,6076,4261
334,34,1,0,0,3,1,0,21,14,5834,4472,30,75,6079,4261
335,34,0,1,1,0,0,3,243,238,5834,4473,243,88,6079,4264
336,34,1,3,1,0,0,3,63,75,5835,4476,73,313,6079,4267
337,34,0,0,2,1,2,1,132,145,5835,4476,124,301,6080,4268
338,34,1,1,2,1,2,1,314,201,5836,4477,343,174,6081,4269
339,34,0,3,1,0,0,3,142,191,5836,4480,141,315,6081,4272
340,35,2,1,0,3,1,0,120,130,5838,4481,130,157,6084,4272
341,35,0,4,1,0,0,3,115,133,5838,4485,120,158,6084,4275
342,35,1,1,2,1,2,1,402,157,5839,4486,405,89,6085,4276
343,35,3,0,0,3,1,0,24,14,5842,4486,33,318,6088,4276
344,35,0,5,1,0,0,3,63,80,5842,4491,73,354,6088,4279
345,35,3,0,0,3,1,0,102,113,5845,4491,102,205,6091,4279
346,35,2,0,0,3,1,0,144,191,5847,4491,144,154,6094,4279
347,35,2,1,0,3,1,0,348,174,5849,4492,391,287,6097,4279
348,35,4,1,0,3,1,0,136,146,5853,4493,127,134,6100,4279
349,35,2,2,2,1,2,1,379,157,5855,4495,418,175,6101,4280
350,36,1,0,0,3,1,0,384,164,5856,4495,409,59,6104,4280
351,36,1,1,2,1,2,1,103,111,5857,4496,129,76,6105,4281
352,36,2,1,0,3,1,0,491,143,5859,4497,466,81,6108,4281
353,36,1,3,1,0,0,3,239,214,5860,4500,252,304,6108,4284
354,36,2,1,0,3,1,0,395,165,5862,4501,410,313,6111,4284
355,36,1,1,2,1,2,1,315,202,5863,4502,344,107,6112,4285
356,36,2,0,0,3,1,0,178,122,5865,4502,193,21,6115,4285
357,36,0,2,1,0,0,3,144,167,5865,4504,157,318,6115,4288
358,36,1,1,2,1,2,1,216,193,5866,4505,212,40,6116,4289
359,36,3,1,0,3,1,0,246,239,5869,4506,246,80,6119,4289
360,37,0,2,1,0,0,3,115,135,5869,4508,120,92,6119,4292
361,37,0,2,1,0,0,3,136,148,5869,4510,127,178,6119,4295
362,37,3,0,0,3,1,0,351,174,5872,4510,394,134,6122,4295
363,37,0,0,2,1,2,1,63,80,5872,4510,74,158,6123,4296
364,37,0,1,1,0,0,3,24,15,5872,4511,33,208,6123,4299
365,37,2,0,0,3,1,0,104,113,5874,4511,105,154,6126,4299
366,37,0,4,1,0,0,3,120,134,5874,4515,130,357,6126,4302
367,37,1,0,0,3,1,0,145,191,5875,4515,147,287,6129,4302
368,37,1,1,2,1,2,1,380,158,5876,4516,419,159,6130,4303
369,37,5,3,0,3,1,0,407,160,5881,4519,408,318,6133,4303
370,38,3,2,0,3,1,0,398,167,5884,4521,413,80,6136,4303
371,38,1,2,1,0,0,3,104,113,5885,4523,129,43,6136,4306
372,38,2,0,0,3,1,0,386,164,5887,4523,412,76,6139,4306
373,38,1,1,2,1,2,1,145,168,5888,4524,158,305,6140,4307
374,38,1,3,1,0,0,3,316,205,5889,4527,344,84,6140,4310
375,38,0,2,1,0,0,3,178,124,5889,4529,193,321,6140,4313
376,38,5,0,0,3,1,0,496,143,5894,4529,469,59,6143,4313
377,38,1,3,1,0,0,3,240,217,5895,4532,252,316,6143,4316
378,38,3,1,0,3,1,0,219,194,5898,4533,215,21,6146,4316
379,38,1,1,2,1,2,1,247,240,5899,4534,247,108,6147,4317
0,1,0,3,1,0,0,3,140,156,5899,4537,129,290,6147,4320
1,1,1,0,0,3,1,0,146,168,5900,4537,161,178,6150,4320
2,1,4,3,0,3,1,0,411,163,5904,4540,411,0,6153,4320
3,1,0,2,1,0,0,3,247,242,5904,4542,247,161,6153,4323
4,1,0,3,1,0,0,3,199,210,5904,4545,198,137,6153,4326
5,1,0,1,1,0,0,3,351,175,5904,4546,394,211,6153,4329
6,1,0,2,1,0,0,3,24,17,5904,4548,33,79,6153,4332
7,1,1,3,1,0,0,3,64,83,5905,4551,74,321,6153,4335
8,1,0,1,1,0,0,3,104,114,5905,4552,129,324,6153,4338
9,1,2,0,0,3,1,0,498,143,5907,4552,472,108,6156,4338
10,2,5,2,0,3,1,0,321,207,5912,4554,347,144,6159,4338
11,2,4,3,0,3,1,0,4,3,5916,4557,3,73,6162,4338
12,2,1,3,1,0,0,3,381,161,5917,4560,419,157,6162,4341
13,2,2,1,0,3,1,0,400,168,5919,4561,416,159,6165,4341
14,2,2,5,1,0,0,3,221,199,5921,4566,215,308,6165,4344
15,2,0,3,1,0,0,3,240,220,5921,4569,252,46,6165,4347
16,2,0,2,1,0,0,3,386,166,5921,4571,412,319,6165,4350
17,2,4,2,0,3,1,0,182,126,5925,4573,196,92,6168,4350
18,2,1,0,0,3,1,0,146,191,5926,4573,150,21,6171,4350
19,2,1,3,1,0,0,3,105,116,5927,4576,105,360,6171,4353
20,3,2,3,1,0,0,3,66,86,5929,4579,74,327,6171,4356
21,3,1,2,1,0,0,3,147,170,5930,4581,161,214,6171,4359
22,3,3,3,2,1,2,1,202,213,5933,4584,199,322,6172,4360
23,3,0,1,1,0,0,3,104,115,5933,4585,129,181,6172,4363
24,3,0,1,1,0,0,3,24,18,5933,4586,33,3,6172,4366
25,3,1,1,2,1,2,1,352,176,5934,4587,395,162,6173,4367
26,3,2,5,1,0,0,3,500,148,5936,4592,472,140,6173,4370
27,3,4,0,0,3,1,0,251,242,5940,4592,250,79,6176,4370
28,3,0,3,1,0,0,3,140,159,5940,4595,129,111,6176,4373
29,3,3,1,0,3,1,0,414,164,5943,4596,414,290,6179,4373
30,4,4,0,0,3,1,0,390,166,5947,4596,415,157,6182,4373
31,4,4,2,0,3,1,0,325,209,5951,4598,350,46,6185,4373
32,4,1,1,2,1,2,1,5,4,5952,4599,4,361,6186,4374
33,4,3,1,0,3,1,0,243,221,5955,4600,255,92,6189,4374
34,4,0,3,1,0,0,3,182,129,5955,4603,196,162,6189,4377
35,4,2,0,0,3,1,0,223,199,5957,4603,218,144,6192,4377
36,4,2,1,0,3,1,0,402,169,5959,4604,419,21,6195,4377
37,4,1,0,0,3,1,0,106,116,5960,4604,108,73,6198,4377
38,4,1,6,1,0,0,3,382,167,5961,4610,419,311,6198,4380
39,4,7,2,0,3,1,0,153,193,5968,4612,153,319,6201,4380
40,5,2,2,2,1,2,1,327,211,5970,4614,351,320,6202,4381
41,5,3,3,2,1,2,1,393,169,5973,4617,416,182,6203,4382
42,5,1,0,0,3,1,0,501,148,5974,4617,475,290,6206,4382
43,5,1,4,1,0,0,3,244,225,5975,4621,255,330,6206,4385
44,5,1,1,2,1,2,1,25,19,5976,4622,34,74,6207,4386
45,5,1,1,2,1,2,1,148,171,5977,4623,162,47,6208,4387
46,5,3,3,2,1,2,1,355,179,5980,4626,396,163,6209,4388
47,5,0,1,1,0,0,3,182,130,5980,4627,196,114,6209,4391
48,5,0,0,2,1,2,1,202,213,5980,4627,200,93,6210,4392
49,5,0,1,1,0,0,3,5,5,5980,4628,4,82,6210,4395
50,6,0,3,1,0,0,3,153,196,5980,4631,153,6,6210,4398
51,6,1,1,2,1,2,1,252,243,5981,4632,251,362,6211,4399
52,6,1,2,1,0,0,3,141,161,5982,4634,129,160,6211,4402
53,6,0,0,2,1,2,1,382,167,5982,4634,420,323,6212,4403
54,6,2,1,0,3,1,0,416,165,5984,4635,417,21,6215,4403
55,6,2,0,0,3,1,0,225,199,5986,4635,221,214,6218,4403
56,6,1,1,2,1,2,1,107,117,5987,4636,109,163,6219,4404
57,6,0,1,1,0,0,3,402,170,5987,4637,419,143,6219,4407
58,6,1,1,2,1,2,1,67,87,5988,4638,75,145,6220,4408
59,6,0,1,1,0,0,3,104,116,5988,4639,129,314,6220,4411
60,7,2,0,0,3,1,0,109,117,5990,4639,112,160,6223,4411
61,7,0,1,1,0,0,3,25,20,5990,4640,34,365,6223,4414
62,7,0,3,1,0,0,3,104,119,5990,4643,129,326,6223,4417
63,7,2,1,0,3,1,0,418,166,5992,4644,420,163,6226,4417
64,7,3,4,1,0,0,3,156,200,5995,4648,153,185,6226,4420
65,7,2,1,0,3,1,0,246,226,5997,4649,258,214,6229,4420
66,7,0,1,1,0,0,3,382,168,5997,4650,420,293,6229,4423
67,7,2,1,0,3,1,0,357,180,5999,4651,399,47,6232,4423
68,7,2,0,0,3,1,0,143,161,6001,4651,132,145,6235,4423
69,7,1,4,1,0,0,3,6,9,6002,4655,4,146,6235,4426
70,8,0,0,2,1,2,1,67,87,6002,4655,76,94,6236,4427
71,8,2,0,0,3,1,0,227,199,6004,4655,224,163,6239,4427
72,8,1,3,1,0,0,3,328,214,6005,4658,351,333,6239,4430
73,8,4,1,0,3,1,0,152,172,6009,4659,165,6,6242,4430
74,8,4,1,0,3,1,0,397,170,6013,4660,419,21,6245,4430
75,8,1,0,0,3,1,0,253,243,6014,4660,254,74,6248,4430
76,8,0,1,1,0,0,3,202,214,6014,4661,200,317,6248,4433
77,8,1,0,0,3,1,0,183,130,6015,4661,199,82,6251,4433
78,8,1,1,2,1,2,1,502,149,6016,4662,476,321,6252,4434
79,8,0,3,1,0,0,3,402,173,6016,4665,419,117,6252,4437
80,9,0,2,1,0,0,3,246,228,6016,4667,258,329,6252,4440
81,9,1,2,1,0,0,3,157,202,6017,4669,153,50,6252,4443
82,9,2,0,0,3,1,0,359,180,6019,4669,402,365,6255,4443
83,9,1,0,0,3,1,0,383,168,6020,4669,423,145,6258,4443
84,9,2,3,1,0,0,3,145,164,6022,4672,132,217,6258,4446
85,9,0,1,1,0,0,3,25,21,6022,4673,34,166,6258,4449
86,9,0,0,2,1,2,1,6,9,6022,4673,5,294,6259,4450
87,9,3,0,0,3,1,0,421,166,6025,4673,423,146,6262,4450
88,9,1,0,0,3,1,0,105,119,6026,4673,132,160,6265,4450
89,9,1,1,2,1,2,1,110,118,6027,4674,113,186,6266,4451
90,10,0,2,1,0,0,3,152,174,6027,4676,165,166,6266,4454
91,10,1,1,2,1,2,1,68,88,6028,4677,77,322,6267,4455
92,10,5,0,0,3,1,0,507,149,6033,4677,479,94,6270,4455
93,10,0,1,1,0,0,3,328,215,6033,4678,351,9,6270,4458
94,10,1,0,0,3,1,0,203,214,6034,4678,203,21,6273,4458
95,10,2,3,1,0,0,3,229,202,6036,4681,224,336,6273,4461
96,10,0,0,2,1,2,1,397,170,6036,4681,420,318,6274,4462
97,10,1,2,1,0,0,3,403,175,6037,4683,419,85,6274,4465
98,10,1,2,1,0,0,3,184,132,6038,4685,199,77,6274,4468
99,10,2,1,0,3,1,0,255,244,6040,4686,257,117,6277,4468
100,11,1,1,2,1,2,1,106,120,6041,4687,133,218,6278,4469
101,11,2,0,0,3,1,0,509,149,6043,4687,482,77,6281,4469
102,11,1,3,1,0,0,3,256,247,6044,4690,257,339,6281,4472
103,11,3,1,0,3,1,0,400,171,6047,4691,423,9,6284,4472
104,11,1,5,1,0,0,3,204,219,6048,4696,203,163,6284,4475
105,11,1,2,1,0,0,3,26,23,6049,4698,34,149,6284,4478
106,11,2,0,0,3,1,0,361,180,6051,4698,405,294,6287,4478
107,11,4,0,0,3,1,0,425,166,6055,4698,426,85,6290,4478
108,11,1,2,1,0,0,3,69,90,6056,4700,77,189,6290,4481
109,11,2,0,0,3,1,0,159,202,6058,4700,156,166,6293,4481
110,12,1,2,1,0,0,3,7,11,6059,4702,5,169,6293,4484
111,12,0,1,1,0,0,3,110,119,6059,4703,113,120,6293,4487
112,12,2,1,0,3,1,0,248,229,6061,4704,261,145,6296,4487
113,12,0,0,2,1,2,1,383,168,6061,4704,424,366,6297,4488
114,12,1,0,0,3,1,0,329,215,6062,4704,354,329,6300,4488
115,12,3,0,0,3,1,0,232,202,6065,4704,227,21,6303,4488
116,12,1,1,2,1,2,1,153,175,6066,4705,166,319,6304,4489
117,12,1,1,2,1,2,1,146,165,6067,4706,133,323,6305,4490
118,12,0,1,1,0,0,3,403,176,6067,4707,419,97,6305,4493
119,12,3,0,0,3,1,0,187,132,6070,4707,202,50,6308,4493
120,13,2,1,0,3,1,0,112,120,6072,4708,116,329,6311,4493
121,13,1,1,2,1,2,1,510,150,6073,4709,483,146,6312,4494
122,13,1,1,2,1,2,1,404,177,6074,4710,420,190,6313,4495
123,13,5,2,0,3,1,0,12,13,6079,4712,8,166,6316,4495
124,13,0,2,1,0,0,3,187,134,6079,4714,202,221,6316,4498
125,13,0,0,2,1,2,1,146,165,6079,4714,134,51,6317,4499
126,13,1,1,2,1,2,1,257,248,6080,4715,258,164,6318,4500
127,13,2,1,0,3,1,0,427,167,6082,4716,429,319,6321,4500
128,13,0,0,2,1,2,1,159,202,6082,4716,157,98,6322,4501
129,13,2,3,1,0,0,3,28,26,6084,4719,34,342,6322,4504
130,14,0,7,1,0,0,3,153,182,6084,4726,166,326,6322,4507
131,14,0,1,1,0,0,3,232,203,6084,4727,227,369,6322,4510
132,14,2,1,0,3,1,0,331,216,6086,4728,357,294,6325,4510
133,14,1,1,2,1,2,1,249,230,6087,4729,262,78,6326,4511
134,14,1,1,2,1,2,1,70,91,6088,4730,78,22,6327,4512
135,14,0,2,1,0,0,3,361,182,6088,4732,405,152,6327,4515
136,14,6,2,0,3,1,0,389,170,6094,4734,427,9,6330,4515
137,14,0,3,1,0,0,3,204,222,6094,4737,203,123,6330,4518
138,14,2,1,0,3,1,0,108,121,6096,4738,136,85,6333,4518
139,14,3,0,0,3,1,0,403,171,6099,4738,426,169,6336,4518
140,15,2,2,2,1,2,1,189,136,6101,4740,203,343,6337,4519
141,15,3,0,0,3,1,0,162,202,6104,4740,160,164,6340,4519
142,15,0,0,2,1,2,1,146,165,6104,4740,135,191,6341,4520
143,15,3,1,0,3,1,0,407,178,6107,4741,423,329,6344,4520
144,15,2,0,0,3,1,0,512,150,6109,4741,486,166,6347,4520
145,15,0,1,1,0,0,3,28,27,6109,4742,34,224,6347,4523
146,15,1,0,0,3,1,0,13,13,6110,4742,11,98,6350,4523
147,15,2,2,2,1,2,1,259,250,6112,4744,259,52,6351,4524
148,15,1,1,2,1,2,1,428,168,6113,4745,430,147,6352,4525
149,15,1,1,2,1,2,1,113,121,6114,4746,117,320,6353,4526
150,16,1,1,2,1,2,1,154,183,6115,4747,167,153,6354,4527
151,16,1,1,2,1,2,1,404,172,6116,4748,427,124,6355,4528
152,16,0,1,1,0,0,3,70,92,6116,4749,78,297,6355,4531
153,16,1,0,0,3,1,0,109,121,6117,4749,139,22,6358,4531
154,16,0,0,2,1,2,1,232,203,6117,4749,228,170,6359,4532
155,16,0,5,1,0,0,3,204,227,6117,4754,203,12,6359,4535
156,16,1,0,0,3,1,0,390,170,6118,4754,430,85,6362,4535
157,16,0,0,2,1,2,1,249,230,6118,4754,263,327,6363,4536
158,16,1,1,2,1,2,1,362,183,6119,4755,406,79,6364,4537
159,16,1,3,1,0,0,3,332,219,6120,4758,357,372,6364,4540
160,17,0,1,1,0,0,3,332,220,6120,4759,357,173,6364,4543
161,17,2,1,0,3,1,0,392,171,6122,4760,433,124,6367,4543
162,17,3,0,0,3,1,0,365,183,6125,4760,409,12,6370,4543
163,17,2,0,0,3,1,0,156,183,6127,4760,170,22,6373,4543
164,17,3,3,2,1,2,1,73,95,6130,4763,79,86,6374,4544
165,17,0,4,1,0,0,3,204,231,6130,4767,203,300,6374,4547
166,17,1,2,1,0,0,3,250,232,6131,4769,263,156,6374,4550
167,17,1,3,1,0,0,3,405,175,6132,4772,427,375,6374,4553
168,17,1,0,0,3,1,0,233,203,6133,4772,231,327,6377,4553
169,17,1,1,2,1,2,1,110,122,6134,4773,140,80,6378,4554
170,18,1,0,0,3,1,0,29,27,6135,4773,37,166,6381,4554
171,18,1,2,1,0,0,3,114,123,6136,4775,117,227,6381,4557
172,18,1,0,0,3,1,0,513,150,6137,4775,489,52,6384,4557
173,18,0,0,2,1,2,1,407,178,6137,4775,424,165,6385,4558
174,18,2,1,0,3,1,0,261,251,6139,4776,262,147,6388,4558
175,18,2,0,0,3,1,0,191,136,6141,4776,206,329,6391,4558
176,18,1,2,1,0,0,3,147,167,6142,4778,135,346,6391,4561
177,18,0,1,1,0,0,3,428,169,6142,4779,430,101,6391,4564
178,18,3,0,0,3,1,0,16,13,6145,4779,14,191,6394,4564
179,18,0,2,1,0,0,3,162,204,6145,4781,160,323,6394,4567
180,19,2,3,1,0,0,3,116,126,6147,4784,117,150,6394,4570
181,19,1,0,0,3,1,0,262,251,6148,4784,265,101,6397,4570
182,19,0,1,1,0,0,3,16,14,6148,4785,14,55,6397,4573
183,19,0,1,1,0,0,3,147,168,6148,4786,135,332,6397,4576
184,19,2,0,0,3,1,0,193,136,6150,4786,209,191,6400,4576
185,19,0,0,2,1,2,1,162,204,6150,4786,161,228,6401,4577
186,19,1,3,1,0,0,3,30,30,6151,4789,37,326,6401,4580
187,19,0,0,2,1,2,1,428,169,6151,4789,431,347,6402,4581
188,19,4,0,0,3,1,0,517,150,6155,4789,492,165,6405,4581
189,19,3,0,0,3,1,0,410,178,6158,4789,427,166,6408,4581
190,20,1,2,1,0,0,3,251,234,6159,4791,263,15,6408,4584
191,20,2,3,1,0,0,3,158,186,6161,4794,170,176,6408,4587
192,20,0,5,1,0,0,3,204,236,6161,4799,203,378,6408,4590
193,20,1,3,1,0,0,3,234,206,6162,4802,231,303,6408,4593
194,20,3,2,0,3,1,0,113,124,6165,4804,143,124,6411,4593
195,20,0,0,2,1,2,1,405,175,6165,4804,428,87,6412,4594
196,20,0,0,2,1,2,1,73,95,6165,4804,80,81,6413,4595
197,20,1,1,2,1,2,1,333,221,6166,4805,358,157,6414,4596
198,20,1,2,1,0,0,3,393,173,6167,4807,433,25,6414,4599
199,20,1,3,1,0,0,3,366,186,6168,4810,409,330,6414,4602
200,21,0,2,1,0,0,3,333,223,6168,4812,358,169,6414,4605
201,21,1,0,0,3,1,0,159,186,6169,4812,173,87,6417,4605
202,21,1,0,0,3,1,0,518,150,6170,4812,495,25,6420,4605
203,21,2,2,2,1,2,1,206,238,6172,4814,204,82,6421,4606
204,21,0,0,2,1,2,1,410,178,6172,4814,428,348,6422,4607
205,21,0,1,1,0,0,3,234,207,6172,4815,231,127,6422,4610
206,21,2,0,0,3,1,0,407,175,6174,4815,431,101,6425,4610
207,21,1,3,1,0,0,3,194,139,6175,4818,209,18,6425,4613
208,21,1,3,1,0,0,3,263,254,6176,4821,265,333,6425,4616
209,21,1,0,0,3,1,0,74,95,6177,4821,83,326,6428,4616
210,22,2,1,0,3,1,0,32,31,6179,4822,40,150,6431,4616
211,22,2,1,0,3,1,0,118,127,6181,4823,120,303,6434,4616
212,22,9,0,0,3,1,0,402,173,6190,4823,436,191,6437,4616
213,22,1,2,1,0,0,3,252,236,6191,4825,263,168,6437,4619
214,22,0,2,1,0,0,3,113,126,6191,4827,143,381,6437,4622
215,22,0,2,1,0,0,3,147,170,6191,4829,135,160,6437,4625
216,22,1,2,1,0,0,3,17,16,6192,4831,14,231,6437,4628
217,22,1,3,1,0,0,3,163,207,6193,4834,161,179,6437,4631
218,22,0,1,1,0,0,3,428,170,6193,4835,431,58,6437,4634
219,22,0,1,1,0,0,3,366,187,6193,4836,409,335,6437,4637
220,23,1,0,0,3,1,0,164,207,6194,4836,164,303,6440,4637
221,23,1,1,2,1,2,1,114,127,6195,4837,144,59,6441,4638
222,23,3,2,0,3,1,0,255,238,6198,4839,266,191,6444,4638
223,23,0,0,2,1,2,1,147,170,6198,4839,136,180,6445,4639
224,23,3,3,2,1,2,1,405,176,6201,4842,437,232,6446,4640
225,23,2,0,0,3,1,0,368,187,6203,4842,412,150,6449,4640
226,23,0,0,2,1,2,1,118,127,6203,4842,121,161,6450,4641
227,23,1,4,1,0,0,3,429,174,6204,4846,431,384,6450,4644
228,23,1,2,1,0,0,3,33,33,6205,4848,40,338,6450,4647
229,23,2,0,0,3,1,0,19,16,6207,4848,17,168,6453,4647
230,24,3,1,0,3,1,0,197,140,6210,4849,212,333,6456,4647
231,24,0,3,1,0,0,3,159,189,6210,4852,173,104,6456,4650
232,24,3,0,0,3,1,0,521,150,6213,4852,498,326,6459,4650
233,24,0,0,2,1,2,1,74,95,6213,4852,84,128,6460,4651
234,24,1,2,1,0,0,3,235,209,6214,4854,231,90,6460,4654
235,24,1,1,2,1,2,1,207,239,6215,4855,205,349,6461,4655
236,24,4,2,0,3,1,0,414,180,6219,4857,431,18,6464,4655
237,24,0,2,1,0,0,3,333,225,6219,4859,358,85,6464,4658
238,24,3,0,0,3,1,0,266,254,6222,4859,268,25,6467,4658
239,24,2,0,0,3,1,0,409,175,6224,4859,434,169,6470,4658
240,25,1,0,0,3,1,0,119,127,6225,4859,124,18,6473,4658
241,25,1,1,2,1,2,1,236,210,6226,4860,232,339,6474,4659
242,25,0,0,2,1,2,1,114,127,6226,4860,145,151,6475,4660
243,25,0,2,1,0,0,3,429,176,6226,4862,431,235,6475,4663
244,25,1,0,0,3,1,0,148,170,6227,4862,139,25,6478,4663
245,25,2,1,0,3,1,0,268,255,6229,4863,271,326,6481,4663
246,25,1,2,1,0,0,3,165,209,6230,4865,164,164,6481,4666
247,25,0,1,1,0,0,3,414,181,6230,4866,431,387,6481,4669
248,25,3,1,0,3,1,0,408,177,6233,4867,440,169,6484,4669
249,25,1,2,1,0,0,3,75,97,6234,4869,84,171,6484,4672
250,26,2,1,0,3,1,0,523,151,6236,4870,501,180,6487,4672
251,26,1,0,0,3,1,0,208,239,6237,4870,208,59,6490,4672
252,26,0,1,1,0,0,3,19,17,6237,4871,17,131,6490,4675
253,26,1,1,2,1,2,1,256,239,6238,4872,267,91,6491,4676
254,26,0,0,2,1,2,1,159,189,6238,4872,174,86,6492,4677
255,26,1,3,1,0,0,3,198,143,6239,4875,212,306,6492,4680
256,26,4,0,0,3,1,0,372,187,6243,4875,415,104,6495,4680
257,26,0,0,2,1,2,1,409,175,6243,4875,435,350,6496,4681
258,26,0,2,1,0,0,3,33,35,6243,4877,40,336,6496,4684
259,26,1,0,0,3,1,0,334,225,6244,4877,361,191,6499,4684
260,27,1,1,2,1,2,1,115,128,6245,4878,146,307,6500,4685
261,27,0,2,1,0,0,3,33,37,6245,4880,40,194,6500,4688
262,27,0,0,2,1,2,1,165,209,6245,4880,165,92,6501,4689
263,27,1,2,1,0,0,3,76,99,6246,4882,84,167,6501,4692
264,27,0,0,2,1,2,1,208,239,6246,4882,209,170,6502,4693
265,27,0,1,1,0,0,3,429,177,6246,4883,431,89,6502,4696
266,27,0,2,1,0,0,3,523,153,6246,4885,501,353,6502,4699
267,27,4,1,0,3,1,0,376,188,6250,4886,418,171,6505,4699
268,27,2,0,0,3,1,0,411,175,6252,4886,438,235,6508,4699
269,27,2,0,0,3,1,0,270,255,6254,4886,274,18,6511,4699
270,28,1,1,2,1,2,1,257,240,6255,4887,268,132,6512,4700
271,28,0,0,2,1,2,1,19,17,6255,4887,18,340,6513,4701
272,28,1,0,0,3,1,0,160,189,6256,4887,177,151,6516,4701
273,28,1,2,1,0,0,3,335,227,6257,4889,361,107,6516,4704
274,28,0,3,1,0,0,3,148,173,6257,4892,139,390,6516,4707
275,28,1,2,1,0,0,3,237,212,6258,4894,232,62,6516,4710
276,28,5,0,0,3,1,0,203,143,6263,4894,215,25,6519,4710
277,28,2,1,0,3,1,0,416,182,6265,4895,434,326,6522,4710
278,28,1,0,0,3,1,0,409,177,6266,4895,443,180,6525,4710
279,28,0,1,1,0,0,3,119,128,6266,4896,124,339,6525,4713
280,29,4,1,0,3,1,0,527,154,6270,4897,504,92,6528,4713
281,29,1,1,2,1,2,1,116,129,6271,4898,147,168,6529,4714
282,29,1,0,0,3,1,0,34,37,6272,4898,43,132,6532,4714
283,29,0,0,2,1,2,1,160,189,6272,4898,178,354,6533,4715
284,29,0,1,1,0,0,3,208,240,6272,4899,209,238,6533,4718
285,29,0,1,1,0,0,3,429,178,6272,4900,431,343,6533,4721
286,29,1,2,1,0,0,3,149,175,6273,4902,139,21,6533,4724
287,29,3,0,0,3,1,0,79,99,6276,4902,87,170,6536,4724
288,29,3,3,2,1,2,1,273,258,6279,4905,275,308,6537,4725
289,30,2,5,1,0,0,3,413,180,6281,4910,438,154,6537,4728
290,30,2,1,0,3,1,0,21,18,6283,4911,21,25,6540,4728
291,30,0,2,1,0,0,3,203,145,6283,4913,215,393,6540,4731
292,30,0,3,1,0,0,3,416,185,6283,4916,434,342,6540,4734
293,30,3,2,0,3,1,0,240,214,6286,4918,235,107,6543,4734
294,30,2,2,2,1,2,1,259,242,6288,4920,269,327,6544,4735
295,30,3,1,0,3,1,0,168,210,6291,4921,168,89,6547,4735
296,30,2,1,0,3,1,0,411,178,6293,4922,446,62,6550,4735
297,30,1,1,2,1,2,1,336,228,6294,4923,362,172,6551,4736
298,30,2,3,1,0,0,3,121,131,6296,4926,124,183,6551,4739
299,31,0,1,1,0,0,3,149,176,6296,4927,139,95,6551,4742
300,31,1,2,1,0,0,3,528,156,6297,4929,504,24,6551,4745
301,31,2,1,0,3,1,0,431,179,6299,4930,434,132,6554,4745
302,31,1,4,1,0,0,3,161,193,6300,4934,178,346,6554,4748
303,31,1,2,1,0,0,3,117,131,6301,4936,147,173,6554,4751
304,31,3,2,0,3,1,0,276,260,6304,4938,278,168,6557,4751
305,31,1,3,1,0,0,3,377,191,6305,4941,418,357,6557,4754
306,31,0,3,1,0,0,3,34,40,6305,4944,43,311,6557,4757
307,31,3,0,0,3,1,0,211,240,6308,4944,212,194,6560,4757
308,31,0,0,2,1,2,1,79,99,6308,4944,88,239,6561,4758
0,1,3,2,0,3,1,0,3,2,6311,4946,3,0,6564,4758
1,1,2,1,0,3,1,0,2,1,6313,4947,3,0,6567,4758
2,1,2,2,2,1,2,1,2,2,6315,4949,1,1,6568,4759
3,1,0,1,1,0,0,3,0,1,6315,4950,0,3,6568,4762
4,1,1,4,1,0,0,3,1,4,6316,4954,0,3,6568,4765
5,1,2,0,0,3,1,0,2,0,6318,4954,3,0,6571,4765
6,1,4,1,0,3,1,0,4,1,6322,4955,3,0,6574,4765
7,1,1,3,1,0,0,3,1,3,6323,4958,0,3,6574,4768
8,1,3,2,0,3,1,0,3,2,6326,4960,3,0,6577,4768
9,2,1,0,0,3,1,0,1,0,6327,4960,3,0,6580,4768
10,2,1,0,0,3,1,0,1,0,6328,4960,3,0,6583,4768
11,2,1,0,0,3,1,0,1,0,6329,4960,3,0,6586,4768
12,2,4,1,0,3,1,0,4,1,6333,4961,3,0,6589,4768
13,2,1,2,1,0,0,3,1,2,6334,4963,0,3,6589,4771
14,2,1,2,1,0,0,3,1,2,6335,4965,0,3,6589,4774
15,2,3,1,0,3,1,0,3,1,6338,4966,3,0,6592,4774
16,2,3,0,0,3,1,0,3,0,6341,4966,3,0,6595,4774
17,2,1,2,1,0,0,3,1,2,6342,4968,0,3,6595,4777
18,3,2,0,0,3,1,0,2,1,6344,4968,3,1,6598,4777
19,3,3,2,0,3,1,0,4,5,6347,4970,3,3,6601,4777
20,3,1,2,1,0,0,3,2,6,6348,4972,0,3,6601,4780
21,3,2,1,0,3,1,0,6,2,6350,4973,6,0,6604,4780
22,3,1,0,0,3,1,0,3,1,6351,4973,6,0,6607,4780
23,3,0,2,1,0,0,3,3,4,6351,4975,3,6,6607,4783
24,3,3,1,0,3,1,0,6,3,6354,4976,6,0,6610,4783
25,3,1,1,2,1,2,1,5,2,6355,4977,4,1,6611,4784
26,3,5,5,2,1,2,1,7,5,6360,4982,4,1,6612,4785
27,4,1,0,0,3,1,0,6,2,6361,4982,7,0,6615,4785
28,4,1,1,2,1,2,1,2,3,6362,4983,1,4,6616,4786
29,4,2,3,1,0,0,3,4,5,6364,4986,1,6,6616,4789
30,4,2,1,0,3,1,0,5,1,6366,4987,6,0,6619,4789
31,4,3,1,0,3,1,0,4,1,6369,4988,6,0,6622,4789
32,4,2,2,2,1,2,1,3,2,6371,4990,4,1,6623,4790
33,4,1,2,1,0,0,3,2,4,6372,4992,0,3,6623,4793
34,4,1,0,0,3,1,0,2,2,6373,4992,3,0,6626,4793
35,4,1,0,0,3,1,0,2,0,6374,4992,6,3,6629,4793
36,5,4,0,0,3,1,0,10,3,6378,4992,9,1,6632,4793
37,5,0,0,2,1,2,1,2,1,6378,4992,4,4,6633,4794
38,5,2,0,0,3,1,0,9,5,6380,4992,7,3,6636,4794
39,5,1,3,1,0,0,3,4,4,6381,4995,6,4,6636,4797
40,5,3,1,0,3,1,0,6,5,6384,4996,6,0,6639,4797
41,5,1,0,0,3,1,0,7,2,6385,4996,9,6,6642,4797
42,5,0,0,2,1,2,1,3,1,6385,4996,4,4,6643,4798
43,5,4,1,0,3,1,0,8,6,6389,4997,6,1,6646,4798
44,5,3,0,0,3,1,0,5,6,6392,4997,3,0,6649,4798
45,6,0,1,1,0,0,3,9,6,6392,4998,7,7,6649,4801
46,6,0,2,1,0,0,3,5,3,6392,5000,6,3,6649,4804
47,6,2,0,0,3,1,0,6,5,6394,5000,4,0,6652,4804
48,6,0,1,1,0,0,3,2,3,6394,5001,3,7,6652,4807
49,6,1,0,0,3,1,0,7,2,6395,5001,10,0,6655,4807
50,6,1,2,1,0,0,3,4,4,6396,5003,4,6,6655,4810
51,6,2,0,0,3,1,0,4,3,6398,5003,4,3,6658,4810
52,6,1,0,0,3,1,0,5,1,6399,5003,9,1,6661,4810
53,6,0,1,1,0,0,3,2,5,6399,5004,0,3,6661,4813
54,7,3,1,0,3,1,0,5,2,6402,5005,7,0,6664,4813
55,7,3,0,0,3,1,0,10,2,6405,5005,12,4,6667,4813
56,7,1,1,2,1,2,1,6,7,6406,5006,4,2,6668,4814
57,7,0,2,1,0,0,3,6,7,6406,5008,6,6,6668,4817
58,7,2,3,1,0,0,3,10,9,6408,5011,6,3,6668,4820
59,7,1,0,0,3,1,0,4,1,6409,5011,7,1,6671,4820
60,7,3,2,0,3,1,0,7,6,6412,5013,9,6,6674,4820
61,7,3,2,0,3,1,0,5,2,6415,5015,9,6,6677,4820
62,7,0,0,2,1,2,1,10,3,6415,5015,10,5,6678,4821
63,8,1,0,0,3,1,0,3,5,6416,5015,3,6,6681,4821
64,8,3,0,0,3,1,0,10,2,6419,5015,13,1,6684,4821
65,8,1,1,2,1,2,1,5,4,6420,5016,5,8,6685,4822
66,8,0,2,1,0,0,3,5,5,6420,5018,6,6,6685,4825
67,8,0,1,1,0,0,3,7,7,6420,5019,9,10,6685,4828
68,8,3,1,0,3,1,0,12,7,6423,5020,10,0,6688,4828
69,8,2,1,0,3,1,0,8,6,6425,5021,7,0,6691,4828
70,8,0,0,2,1,2,1,5,1,6425,5021,10,7,6692,4829
71,8,1,3,1,0,0,3,3,6,6426,5024,3,6,6692,4832
72,9,2,0,0,3,1,0,12,3,6428,5024,13,6,6695,4832
73,9,2,1,0,3,1,0,6,5,6430,5025,7,1,6698,4832
74,9,2,0,0,3,1,0,12,9,6432,5025,9,6,6701,4832
75,9,0,0,2,1,2,1,4,1,6432,5025,8,1,6702,4833
76,9,0,1,1,0,0,3,6,8,6432,5026,4,6,6702,4836
77,9,1,1,2,1,2,1,7,8,6433,5027,7,6,6703,4837
78,9,3,0,0,3,1,0,8,2,6436,5027,10,3,6706,4837
79,9,3,0,0,3,1,0,13,2,6439,5027,15,2,6709,4837
80,9,2,0,0,3,1,0,7,2,6441,5027,12,4,6712,4837
81,10,1,2,1,0,0,3,4,8,6442,5029,3,4,6712,4840
82,10,1,2,1,0,0,3,11,4,6443,5031,13,11,6712,4843
83,10,2,0,0,3,1,0,9,7,6445,5031,12,0,6715,4843
84,10,3,1,0,3,1,0,15,4,6448,5032,16,0,6718,4843
85,10,2,4,1,0,0,3,7,9,6450,5036,6,10,6718,4846
86,10,2,1,0,3,1,0,14,8,6452,5037,13,6,6721,4846
87,10,2,1,0,3,1,0,10,7,6454,5038,10,1,6724,4846
88,10,0,3,1,0,0,3,5,4,6454,5041,10,9,6724,4849
89,10,1,0,0,3,1,0,4,5,6455,5041,6,6,6727,4849
90,11,1,0,0,3,1,0,8,8,6456,5041,10,6,6730,4849
91,11,1,0,0,3,1,0,8,2,6457,5041,15,3,6733,4849
92,11,1,2,1,0,0,3,7,10,6458,5043,4,9,6733,4852
93,11,3,0,0,3,1,0,9,5,6461,5043,10,1,6736,4852
94,11,2,0,0,3,1,0,15,2,6463,5043,18,6,6739,4852
95,11,1,0,0,3,1,0,9,2,6464,5043,13,10,6742,4852
96,11,2,1,0,3,1,0,6,2,6466,5044,11,6,6745,4852
97,11,2,1,0,3,1,0,7,5,6468,5045,8,4,6748,4852
98,11,0,0,2,1,2,1,12,9,6468,5045,10,3,6749,4853
99,12,3,0,0,3,1,0,7,5,6471,5045,9,4,6752,4853
100,12,1,1,2,1,2,1,8,10,6472,5046,7,12,6753,4854
101,12,1,1,2,1,2,1,12,5,6473,5047,14,10,6754,4855
102,12,2,1,0,3,1,0,6,9,6475,5048,6,1,6757,4855
103,12,2,1,0,3,1,0,11,8,6477,5049,15,4,6760,4855
104,12,0,0,2,1,2,1,14,8,6477,5049,14,11,6761,4856
105,12,2,2,2,1,2,1,12,9,6479,5051,11,7,6762,4857
106,12,1,2,1,0,0,3,8,12,6480,5053,4,3,6762,4860
107,12,2,0,0,3,1,0,17,4,6482,5053,19,6,6765,4860
108,13,1,0,0,3,1,0,8,5,6483,5053,11,3,6768,4860
109,13,3,0,0,3,1,0,8,4,6486,5053,13,1,6771,4860
110,13,2,0,0,3,1,0,14,9,6488,5053,13,10,6774,4860
111,13,1,4,1,0,0,3,9,12,6489,5057,10,3,6774,4863
112,13,0,4,1,0,0,3,9,6,6489,5061,13,9,6774,4866
113,13,3,1,0,3,1,0,12,6,6492,5062,13,3,6777,4866
114,13,3,3,2,1,2,1,9,5,6495,5065,12,7,6778,4867
115,13,2,1,0,3,1,0,10,3,6497,5066,18,6,6781,4867
116,13,2,2,2,1,2,1,17,4,6499,5068,19,10,6782,4868
117,14,3,0,0,3,1,0,12,12,6502,5068,13,3,6785,4868
118,14,0,2,1,0,0,3,6,11,6502,5070,6,6,6785,4871
119,14,4,1,0,3,1,0,15,9,6506,5071,18,1,6788,4871
120,14,0,2,1,0,0,3,17,6,6506,5073,19,10,6788,4874
121,14,1,3,1,0,0,3,13,12,6507,5076,11,13,6788,4877
122,14,6,0,0,3,1,0,20,8,6513,5076,17,12,6791,4877
123,14,4,0,0,3,1,0,12,10,6517,5076,10,4,6794,4877
124,14,1,0,0,3,1,0,9,12,6518,5076,7,4,6797,4877
125,14,1,0,0,3,1,0,13,5,6519,5076,17,11,6800,4877
126,15,1,3,1,0,0,3,18,7,6520,5079,19,10,6800,4880
127,15,1,2,1,0,0,3,9,6,6521,5081,13,9,6800,4883
128,15,2,2,2,1,2,1,16,11,6523,5083,14,4,6801,4884
129,15,4,0,0,3,1,0,16,6,6527,5083,16,10,6804,4884
130,15,1,4,1,0,0,3,7,15,6528,5087,6,12,6804,4887
131,15,1,0,0,3,1,0,8,5,6529,5087,12,3,6807,4887
132,15,1,0,0,3,1,0,10,5,6530,5087,15,10,6810,4887
133,15,1,1,2,1,2,1,11,4,6531,5088,19,4,6811,4888
134,15,0,1,1,0,0,3,8,6,6531,5089,11,9,6811,4891
135,16,1,0,0,3,1,0,13,10,6532,5089,13,1,6814,4891
136,16,0,0,2,1,2,1,13,5,6532,5089,18,5,6815,4892
137,16,0,0,2,1,2,1,13,12,6532,5089,12,7,6816,4893
138,16,0,0,2,1,2,1,9,6,6532,5089,14,11,6817,4894
139,16,1,2,1,0,0,3,16,11,6533,5091,18,16,6817,4897
140,16,2,1,0,3,1,0,14,13,6535,5092,16,1,6820,4897
141,16,2,0,0,3,1,0,19,6,6537,5092,22,12,6823,4897
142,16,1,1,2,1,2,1,10,13,6538,5093,8,12,6824,4898
143,16,0,0,2,1,2,1,20,8,6538,5093,18,5,6825,4899
144,17,0,1,1,0,0,3,18,8,6538,5094,19,12,6825,4902
145,17,1,3,1,0,0,3,8,18,6539,5097,6,12,6825,4905
146,17,1,1,2,1,2,1,17,7,6540,5098,17,11,6826,4906
147,17,1,0,0,3,1,0,9,5,6541,5098,15,12,6829,4906
148,17,0,1,1,0,0,3,10,6,6541,5099,15,7,6829,4909
149,17,0,4,1,0,0,3,9,10,6541,5103,13,13,6829,4912
150,17,2,1,0,3,1,0,18,12,6543,5104,17,4,6832,4912
151,17,3,1,0,3,1,0,11,7,6546,5105,14,3,6835,4912
152,17,3,1,0,3,1,0,14,5,6549,5106,22,10,6838,4912
153,18,2,1,0,3,1,0,13,8,6551,5107,17,12,6841,4912
154,18,3,1,0,3,1,0,12,6,6554,5108,18,13,6844,4912
155,18,1,3,1,0,0,3,11,9,6555,5111,15,15,6844,4915
156,18,2,0,0,3,1,0,19,7,6557,5111,20,4,6847,4915
157,18,4,1,0,3,1,0,22,9,6561,5112,22,1,6850,4915
158,18,1,1,2,1,2,1,9,19,6562,5113,7,11,6851,4916
159,18,1,3,1,0,0,3,10,13,6563,5116,13,14,6851,4919
160,18,1,1,2,1,2,1,14,11,6564,5117,14,13,6852,4920
161,18,1,0,0,3,1,0,15,5,6565,5117,25,7,6855,4920
162,19,1,1,2,1,2,1,10,7,6566,5118,15,17,6856,4921
163,19,1,1,2,1,2,1,11,14,6567,5119,9,12,6857,4922
164,19,0,1,1,0,0,3,18,13,6567,5120,17,15,6857,4925
165,19,2,1,0,3,1,0,22,9,6569,5121,21,1,6860,4925
166,19,4,2,0,3,1,0,17,14,6573,5123,15,3,6863,4925
167,19,4,2,0,3,1,0,23,8,6577,5125,25,7,6866,4925
168,19,1,0,0,3,1,0,14,5,6578,5125,21,5,6869,4925
169,19,4,0,0,3,1,0,20,11,6582,5125,21,5,6872,4925
170,19,2,0,0,3,1,0,16,13,6584,5125,19,12,6875,4925
171,20,6,0,0,3,1,0,18,6,6590,5125,21,11,6878,4925
172,20,0,1,1,0,0,3,15,6,6590,5126,25,4,6878,4928
173,20,1,1,2,1,2,1,11,14,6591,5127,14,5,6879,4929
174,20,1,1,2,1,2,1,12,10,6592,5128,16,13,6880,4930
175,20,2,2,2,1,2,1,19,16,6594,5130,16,14,6881,4931
176,20,1,3,1,0,0,3,10,22,6595,5133,7,17,6881,4934
177,20,0,2,1,0,0,3,13,10,6595,5135,17,10,6881,4937
178,20,1,0,0,3,1,0,15,11,6596,5135,17,13,6884,4937
179,20,0,1,1,0,0,3,19,8,6596,5136,20,18,6884,4940
180,21,0,2,1,0,0,3,18,15,6596,5138,17,20,6884,4943
181,21,0,0,2,1,2,1,20,11,6596,5138,22,15,6885,4944
182,21,3,3,2,1,2,1,25,12,6599,5141,22,13,6886,4945
183,21,3,0,0,3,1,0,13,7,6602,5141,18,3,6889,4945
184,21,1,2,1,0,0,3,24,10,6603,5143,25,8,6889,4948
185,21,1,0,0,3,1,0,12,14,6604,5143,12,1,6892,4948
186,21,2,1,0,3,1,0,18,14,6606,5144,22,5,6895,4948
187,21,3,1,0,3,1,0,25,10,6609,5145,25,12,6898,4948
188,21,1,1,2,1,2,1,13,11,6610,5146,17,8,6899,4949
189,22,2,0,0,3,1,0,13,14,6612,5146,17,10,6902,4949
190,22,3,3,2,1,2,1,16,13,6615,5149,18,5,6903,4950
191,22,0,0,2,1,2,1,19,8,6615,5149,21,14,6904,4951
192,22,3,1,0,3,1,0,17,6,6618,5150,24,13,6907,4951
193,22,2,1,0,3,1,0,21,17,6620,5151,19,11,6910,4951
194,22,2,2,2,1,2,1,12,24,6622,5153,8,19,6911,4952
195,22,2,6,1,0,0,3,17,17,6624,5159,17,20,6911,4955
196,22,3,1,0,3,1,0,21,7,6627,5160,24,5,6914,4955
197,22,1,0,0,3,1,0,16,6,6628,5160,28,15,6917,4955
198,23,0,2,1,0,0,3,13,13,6628,5162,17,23,6917,4958
199,23,2,0,0,3,1,0,20,14,6630,5162,25,8,6920,4958
200,23,0,2,1,0,0,3,12,16,6630,5164,12,18,6920,4961
201,23,0,1,1,0,0,3,25,11,6630,5165,25,11,6920,4964
202,23,1,3,1,0,0,3,14,10,6631,5168,18,16,6920,4967
203,23,3,0,0,3,1,0,19,6,6634,5168,31,1,6923,4967
204,23,1,2,1,0,0,3,21,13,6635,5170,22,6,6923,4970
205,23,3,1,0,3,1,0,21,16,6638,5171,20,5,6926,4970
206,23,2,2,2,1,2,1,26,12,6640,5173,26,14,6927,4971
207,24,0,0,2,1,2,1,13,14,6640,5173,18,15,6928,4972
208,24,0,1,1,0,0,3,16,14,6640,5174,18,18,6928,4975
209,24,2,1,0,3,1,0,27,13,6642,5175,25,11,6931,4975
210,24,0,5,1,0,0,3,21,22,6642,5180,19,23,6931,4978
211,24,1,1,2,1,2,1,13,25,6643,5181,9,11,6932,4979
212,24,1,1,2,1,2,1,18,7,6644,5182,25,20,6933,4980
213,24,2,1,0,3,1,0,23,8,6646,5183,27,5,6936,4980
214,24,1,4,1,0,0,3,18,21,6647,5187,17,8,6936,4983
215,24,2,1,0,3,1,0,21,9,6649,5188,24,12,6939,4983
216,25,0,2,1,0,0,3,21,18,6649,5190,20,21,6939,4986
217,25,1,1,2,1,2,1,14,14,6650,5191,18,6,6940,4987
218,25,3,1,0,3,1,0,29,13,6653,5192,29,11,6943,4987
219,25,0,5,1,0,0,3,14,15,6653,5197,18,17,6943,4990
220,25,1,1,2,1,2,1,21,15,6654,5198,26,7,6944,4991
221,25,1,2,1,0,0,3,26,13,6655,5200,25,4,6944,4994
222,25,0,0,2,1,2,1,19,6,6655,5200,32,12,6945,4995
223,25,2,1,0,3,1,0,14,17,6657,5201,15,16,6948,4995
224,25,5,2,0,3,1,0,26,11,6662,5203,27,8,6951,4995
225,26,3,1,0,3,1,0,21,22,6665,5204,20,15,6954,4995
226,26,1,2,1,0,0,3,14,16,6666,5206,18,15,6954,4998
227,26,1,2,1,0,0,3,22,15,6667,5208,22,11,6954,5001
228,26,0,0,2,1,2,1,16,14,6667,5208,19,24,6955,5002
229,26,0,0,2,1,2,1,23,8,6667,5208,28,12,6956,5003
230,26,1,3,1,0,0,3,22,25,6668,5211,19,23,6956,5006
231,26,0,3,1,0,0,3,13,28,6668,5214,9,21,6956,5009
232,26,2,0,0,3,1,0,29,13,6670,5214,28,5,6959,5009
233,26,0,2,1,0,0,3,18,9,6670,5216,25,26,6959,5012
234,27,1,1,2,1,2,1,15,18,6671,5217,16,27,6960,5013
235,27,1,0,0,3,1,0,27,13,6672,5217,28,8,6963,5013
236,27,5,1,0,3,1,0,19,15,6677,5218,21,7,6966,5013
237,27,1,3,1,0,0,3,22,21,6678,5221,20,19,6966,5016
238,27,2,0,0,3,1,0,28,11,6680,5221,30,6,6969,5016
239,27,2,2,2,1,2,1,18,16,6682,5223,20,5,6970,5017
240,27,0,0,2,1,2,1,19,6,6682,5223,33,22,6971,5018
241,27,2,2,2,1,2,1,16,17,6684,5225,19,12,6972,5019
242,27,1,0,0,3,1,0,22,15,6685,5225,29,17,6975,5019
243,28,0,2,1,0,0,3,13,30,6685,5227,9,27,6975,5022
244,28,2,2,2,1,2,1,23,24,6687,5229,21,6,6976,5023
245,28,1,2,1,0,0,3,30,15,6688,5231,28,14,6976,5026
246,28,2,1,0,3,1,0,20,10,6690,5232,28,15,6979,5026
247,28,3,0,0,3,1,0,26,8,6693,5232,31,15,6982,5026
248,28,2,0,0,3,1,0,31,13,6695,5232,32,12,6985,5026
249,28,2,1,0,3,1,0,24,26,6697,5233,22,21,6988,5026
250,28,0,2,1,0,0,3,14,18,6697,5235,18,15,6988,5029
251,28,0,1,1,0,0,3,22,16,6697,5236,22,26,6988,5032
252,29,0,0,2,1,2,1,22,21,6697,5236,21,6,6989,5033
253,29,0,0,2,1,2,1,28,11,6697,5236,31,23,6990,5034
254,29,3,2,0,3,1,0,30,15,6700,5238,31,19,6993,5034
255,29,1,2,1,0,0,3,15,20,6701,5240,18,11,6993,5037
256,29,4,0,0,3,1,0,23,15,6705,5240,24,17,6996,5037
257,29,1,1,2,1,2,1,20,7,6706,5241,34,8,6997,5038
258,29,2,0,0,3,1,0,20,16,6708,5241,23,12,7000,5038
259,29,1,1,2,1,2,1,17,18,6709,5242,20,15,7001,5039
260,29,0,2,1,0,0,3,22,17,6709,5244,29,30,7001,5042
261,30,3,0,0,3,1,0,18,18,6712,5244,19,26,7004,5042
262,30,2,1,0,3,1,0,24,17,6714,5245,25,21,7007,5042
263,30,3,0,0,3,1,0,29,8,6717,5245,34,15,7010,5042
264,30,3,1,0,3,1,0,33,16,6720,5246,31,15,7013,5042
265,30,4,0,0,3,1,0,35,13,6724,5246,35,6,7016,5042
266,30,2,0,0,3,1,0,22,10,6726,5246,31,12,7019,5042
267,30,3,3,2,1,2,1,16,33,6729,5249,10,7,7020,5043
268,30,1,5,1,0,0,3,25,31,6730,5254,22,18,7020,5046
269,30,0,1,1,0,0,3,23,25,6730,5255,21,30,7020,5049
270,31,0,0,2,1,2,1,17,18,6730,5255,21,27,7021,5050
271,31,1,2,1,0,0,3,21,9,6731,5257,34,20,7021,5053
272,31,1,1,2,1,2,1,23,22,6732,5258,22,13,7022,5054
273,31,2,1,0,3,1,0,17,21,6734,5259,21,8,7025,5054
274,31,3,0,0,3,1,0,26,15,6737,5259,27,23,7028,5054
275,31,2,0,0,3,1,0,31,8,6739,5259,37,6,7031,5054
276,31,1,2,1,0,0,3,29,13,6740,5261,31,22,7031,5057
277,31,1,1,2,1,2,1,21,17,6741,5262,24,16,7032,5058
278,31,0,1,1,0,0,3,30,16,6741,5263,31,33,7032,5061
279,32,2,2,2,1,2,1,25,27,6743,5265,22,12,7033,5062
280,32,1,2,1,0,0,3,36,15,6744,5267,35,24,7033,5065
281,32,3,0,0,3,1,0,25,17,6747,5267,32,15,7036,5065
282,32,4,0,0,3,1,0,29,31,6751,5267,25,7,7039,5065
283,32,1,0,0,3,1,0,18,18,6752,5267,24,6,7042,5065
284,32,0,4,1,0,0,3,24,21,6752,5271,25,18,7042,5068
285,32,1,0,0,3,1,0,23,10,6753,5271,34,6,7045,5068
286,32,0,0,2,1,2,1,18,18,6753,5271,20,19,7046,5069
287,32,1,1,2,1,2,1,34,17,6754,5272,32,31,7047,5070
288,33,1,3,1,0,0,3,24,25,6755,5275,22,30,7047,5073
289,33,0,2,1,0,0,3,21,11,6755,5277,34,36,7047,5076
290,33,3,1,0,3,1,0,33,17,6758,5278,34,12,7050,5076
291,33,4,2,0,3,1,0,25,19,6762,5280,27,20,7053,5076
292,33,2,1,0,3,1,0,18,34,6764,5281,13,8,7056,5076
293,33,1,4,1,0,0,3,18,25,6765,5285,21,26,7056,5079
294,33,3,1,0,3,1,0,34,9,6768,5286,40,22,7059,5079
295,33,2,1,0,3,1,0,31,14,6770,5287,34,13,7062,5079
296,33,1,1,2,1,2,1,27,16,6771,5288,28,17,7063,5080
297,34,2,1,0,3,1,0,38,16,6773,5289,38,31,7066,5080
298,34,1,1,2,1,2,1,24,11,6774,5290,35,13,7067,5081
299,34,3,1,0,3,1,0,28,18,6777,5291,35,18,7070,5081
300,34,1,1,2,1,2,1,30,32,6778,5292,26,7,7071,5082
301,34,3,2,0,3,1,0,21,20,6781,5294,27,24,7074,5082
302,34,3,2,0,3,1,0,28,29,6784,5296,25,15,7077,5082
303,34,3,1,0,3,1,0,37,18,6787,5297,35,7,7080,5082
304,34,0,1,1,0,0,3,18,19,6787,5298,20,9,7080,5085
305,34,0,2,1,0,0,3,24,23,6787,5300,25,22,7080,5088
0,1,2,1,0,3,1,0,39,19,6789,5301,38,0,7083,5088
1,1,1,1,2,1,2,1,25,24,6790,5302,26,16,7084,5089
2,1,2,3,1,0,0,3,26,14,6792,5305,35,3,7084,5092
3,1,2,0,0,3,1,0,2,0,6794,5305,3,17,7087,5092
4,1,1,0,0,3,1,0,22,11,6795,5305,37,22,7090,5092
5,1,3,2,0,3,1,0,31,31,6798,5307,28,18,7093,5092
6,1,3,1,0,3,1,0,3,1,6801,5308,3,24,7096,5092
7,1,1,2,1,0,0,3,1,2,6802,5310,0,15,7096,5095
8,1,2,0,0,3,1,0,36,9,6804,5310,43,30,7099,5095
9,2,1,0,0,3,1,0,29,18,6805,5310,38,13,7102,5095
10,2,0,0,2,1,2,1,18,19,6805,5310,21,23,7103,5096
11,2,1,2,1,0,0,3,34,19,6806,5312,34,23,7103,5099
12,2,2,1,0,3,1,0,29,17,6808,5313,31,8,7106,5099
13,2,0,4,1,0,0,3,25,23,6808,5317,27,29,7106,5102
14,2,0,2,1,0,0,3,30,34,6808,5319,26,3,7106,5105
15,2,1,1,2,1,2,1,22,21,6809,5320,28,14,7107,5106
16,2,1,1,2,1,2,1,1,1,6810,5321,1,1,7108,5107
17,2,1,1,2,1,2,1,1,1,6811,5322,1,1,7109,5108
18,3,3,1,0,3,1,0,5,1,6814,5323,6,22,7112,5108
19,3,4,1,0,3,1,0,40,10,6818,5324,46,17,7115,5108
20,3,3,0,0,3,1,0,28,23,6821,5324,30,15,7118,5108
21,3,1,0,0,3,1,0,27,14,6822,5324,38,0,7121,5108
22,3,0,5,1,0,0,3,39,24,6822,5329,38,27,7121,5111
23,3,0,2,1,0,0,3,22,13,6822,5331,37,11,7121,5114
24,3,0,0,2,1,2,1,25,24,6822,5331,27,19,7122,5115
25,3,0,3,1,0,0,3,3,4,6822,5334,3,6,7122,5118
26,3,0,0,2,1,2,1,1,2,6822,5334,1,31,7123,5119
27,4,1,3,1,0,0,3,32,34,6823,5337,28,6,7123,5122
28,4,4,0,0,3,1,0,5,1,6827,5337,4,16,7126,5122
29,4,1,2,1,0,0,3,30,20,6828,5339,38,4,7126,5125
30,4,0,2,1,0,0,3,30,36,6828,5341,26,26,7126,5128
31,4,0,1,1,0,0,3,22,22,6828,5342,28,32,7126,5131
32,4,0,0,2,1,2,1,34,19,6828,5342,35,2,7127,5132
33,4,5,0,0,3,1,0,34,17,6833,5342,34,23,7130,5132
34,4,1,1,2,1,2,1,19,20,6834,5343,22,14,7131,5133
35,4,1,1,2,1,2,1,2,2,6835,5344,2,15,7132,5134
36,5,3,0,0,3,1,0,30,14,6838,5344,41,17,7135,5134
37,5,3,1,0,3,1,0,43,11,6841,5345,49,27,7138,5134
38,5,0,0,2,1,2,1,1,2,6841,5345,2,23,7139,5135
39,5,2,1,0,3,1,0,30,24,6843,5346,33,31,7142,5135
40,5,1,1,2,1,2,1,4,5,6844,5347,4,24,7143,5136
41,5,2,0,0,3,1,0,41,24,6846,5347,41,11,7146,5136
42,5,0,4,1,0,0,3,25,28,6846,5351,27,9,7146,5139
43,5,1,2,1,0,0,3,6,3,6847,5353,4,18,7146,5142
44,5,2,1,0,3,1,0,7,2,6849,5354,9,19,7149,5142
45,6,1,4,1,0,0,3,31,24,6850,5358,38,35,7149,5145
46,6,3,0,0,3,1,0,37,19,6853,5358,38,0,7152,5145
47,6,3,1,0,3,1,0,22,21,6856,5359,25,2,7155,5145
48,6,0,0,2,1,2,1,30,36,6856,5359,27,16,7156,5146
49,6,0,4,1,0,0,3,32,38,6856,5363,28,17,7156,5149
50,6,0,0,2,1,2,1,2,2,6856,5363,3,19,7157,5150
51,6,3,1,0,3,1,0,37,18,6859,5364,37,16,7160,5150
52,6,1,0,0,3,1,0,5,5,6860,5364,7,4,7163,5150
53,6,0,0,2,1,2,1,22,13,6860,5364,38,27,7164,5151
54,7,2,1,0,3,1,0,32,15,6862,5365,44,19,7167,5151
55,7,0,0,2,1,2,1,22,22,6862,5365,29,24,7168,5152
56,7,0,0,2,1,2,1,1,2,6862,5365,3,7,7169,5153
57,7,3,3,2,1,2,1,44,27,6865,5368,42,10,7170,5154
58,7,4,2,0,3,1,0,47,13,6869,5370,52,11,7173,5154
59,7,4,2,0,3,1,0,11,4,6873,5372,12,27,7176,5154
60,7,4,1,0,3,1,0,34,25,6877,5373,36,17,7179,5154
61,7,1,1,2,1,2,1,26,29,6878,5374,28,25,7180,5155
62,7,2,1,0,3,1,0,8,4,6880,5375,7,31,7183,5155
63,8,4,1,0,3,1,0,6,3,6884,5376,6,2,7186,5155
64,8,2,4,1,0,0,3,24,17,6886,5380,38,19,7186,5158
65,8,4,2,0,3,1,0,26,23,6890,5382,28,0,7189,5158
66,8,1,1,2,1,2,1,38,20,6891,5383,39,17,7190,5159
67,8,3,1,0,3,1,0,8,6,6894,5384,10,27,7193,5159
68,8,0,4,1,0,0,3,31,28,6894,5388,38,22,7193,5162
69,8,4,0,0,3,1,0,41,18,6898,5388,40,17,7196,5162
70,8,0,0,2,1,2,1,30,36,6898,5388,28,36,7197,5163
71,8,0,2,1,0,0,3,32,40,6898,5390,28,7,7197,5166
72,9,2,3,1,0,0,3,13,7,6900,5393,12,28,7197,5169
73,9,4,1,0,3,1,0,26,23,6904,5394,32,17,7200,5169
74,9,1,1,2,1,2,1,27,30,6905,5395,29,8,7201,5170
75,9,4,2,0,3,1,0,51,15,6909,5397,55,27,7204,5170
76,9,2,0,0,3,1,0,36,25,6911,5397,39,24,7207,5170
77,9,2,1,0,3,1,0,33,29,6913,5398,41,19,7210,5170
78,9,2,0,0,3,1,0,34,15,6915,5398,47,27,7213,5170
79,9,1,1,2,1,2,1,2,3,6916,5399,4,12,7214,5171
80,9,1,4,1,0,0,3,9,8,6917,5403,7,13,7214,5174
81,10,3,1,0,3,1,0,9,4,6920,5404,9,17,7217,5174
82,10,1,0,0,3,1,0,25,17,6921,5404,41,2,7220,5174
83,10,1,3,1,0,0,3,31,39,6922,5407,28,20,7220,5177
84,10,1,4,1,0,0,3,45,31,6923,5411,42,10,7220,5180
85,10,3,5,1,0,0,3,29,28,6926,5416,28,34,7220,5183
86,10,0,1,1,0,0,3,38,21,6926,5417,39,25,7220,5186
87,10,2,4,1,0,0,3,43,22,6928,5421,40,3,7220,5189
88,10,2,2,2,1,2,1,34,42,6930,5423,29,37,7221,5190
89,10,1,1,2,1,2,1,9,7,6931,5424,11,20,7222,5191
90,11,1,0,0,3,1,0,27,23,6932,5424,35,8,7225,5191
91,11,2,0,0,3,1,0,4,3,6934,5424,7,27,7228,5191
92,11,0,2,1,0,0,3,33,31,6934,5426,41,16,7228,5194
93,11,3,1,0,3,1,0,41,22,6937,5427,42,17,7231,5194
94,11,2,0,0,3,1,0,38,25,6939,5427,42,12,7234,5194
95,11,2,0,0,3,1,0,36,15,6941,5427,50,28,7237,5194
96,11,0,1,1,0,0,3,27,31,6941,5428,29,30,7237,5197
97,11,1,1,2,1,2,1,10,9,6942,5429,8,25,7238,5198
98,11,1,3,1,0,0,3,14,10,6943,5432,12,23,7238,5201
99,12,2,0,0,3,1,0,53,15,6945,5432,58,2,7241,5201
100,12,1,1,2,1,2,1,44,23,6946,5433,41,26,7242,5202
101,12,0,0,2,1,2,1,34,42,6946,5433,30,35,7243,5203
102,12,0,2,1,0,0,3,45,33,6946,5435,42,40,7243,5206
103,12,0,2,1,0,0,3,9,9,6946,5437,11,6,7243,5209
104,12,3,0,0,3,1,0,12,4,6949,5437,12,19,7246,5209
105,12,2,1,0,3,1,0,16,11,6951,5438,15,20,7249,5209
106,12,1,1,2,1,2,1,26,18,6952,5439,42,18,7250,5210
107,12,3,1,0,3,1,0,34,40,6955,5440,31,17,7253,5210
108,13,1,0,0,3,1,0,34,31,6956,5440,44,25,7256,5210
109,13,0,2,1,0,0,3,38,27,6956,5442,42,13,7256,5213
110,13,1,1,2,1,2,1,5,4,6957,5443,8,31,7257,5214
111,13,1,0,0,3,1,0,28,23,6958,5443,38,28,7260,5214
112,13,5,1,0,3,1,0,15,10,6963,5444,11,12,7263,5214
113,13,0,3,1,0,0,3,41,25,6963,5447,42,30,7263,5217
114,13,2,5,1,0,0,3,29,36,6965,5452,29,26,7263,5220
115,13,1,1,2,1,2,1,30,29,6966,5453,29,17,7264,5221
116,13,1,3,1,0,0,3,37,18,6967,5456,50,11,7264,5224
117,14,2,1,0,3,1,0,55,16,6969,5457,61,6,7267,5224
118,14,3,2,0,3,1,0,37,44,6972,5459,33,17,7270,5224
119,14,1,2,1,0,0,3,10,11,6973,5461,11,21,7270,5227
120,14,2,2,2,1,2,1,18,13,6975,5463,16,41,7271,5228
121,14,1,3,1,0,0,3,45,26,6976,5466,41,38,7271,5231
122,14,0,2,1,0,0,3,45,35,6976,5468,42,29,7271,5234
123,14,2,2,2,1,2,1,36,42,6978,5470,32,20,7272,5235
124,14,0,0,2,1,2,1,29,36,6978,5470,30,3,7273,5236
125,14,1,2,1,0,0,3,27,20,6979,5472,42,20,7273,5239
126,15,3,0,0,3,1,0,44,25,6982,5472,45,11,7276,5239
127,15,2,1,0,3,1,0,30,24,6984,5473,41,12,7279,5239
128,15,0,1,1,0,0,3,30,30,6984,5474,29,33,7279,5242
129,15,0,0,2,1,2,1,38,27,6984,5474,43,27,7280,5243
130,15,1,3,1,0,0,3,6,7,6985,5477,8,16,7280,5246
131,15,4,3,0,3,1,0,16,7,6989,5480,15,25,7283,5246
132,15,4,0,0,3,1,0,41,18,6993,5480,53,20,7286,5246
133,15,1,2,1,0,0,3,16,12,6994,5482,11,31,7286,5249
134,15,0,1,1,0,0,3,34,32,6994,5483,44,34,7286,5252
135,16,1,2,1,0,0,3,28,22,6995,5485,42,23,7286,5255
136,16,2,2,2,1,2,1,31,38,6997,5487,31,30,7287,5256
137,16,2,5,1,0,0,3,8,12,6999,5492,8,24,7287,5259
138,16,2,1,0,3,1,0,47,27,7001,5493,44,20,7290,5259
139,16,0,2,1,0,0,3,37,46,7001,5495,33,28,7290,5262
140,16,3,1,0,3,1,0,21,14,7004,5496,19,6,7293,5262
141,16,0,0,2,1,2,1,45,35,7004,5496,43,18,7294,5263
142,16,4,0,0,3,1,0,14,11,7008,5496,14,38,7297,5263
143,16,2,1,0,3,1,0,57,17,7010,5497,64,41,7300,5263
144,17,1,1,2,1,2,1,31,25,7011,5498,42,17,7301,5264
145,17,1,0,0,3,1,0,39,27,7012,5498,46,34,7304,5264
146,17,0,1,1,0,0,3,30,31,7012,5499,29,14,7304,5267
147,17,2,0,0,3,1,0,18,7,7014,5499,18,12,7307,5267
148,17,3,0,0,3,1,0,44,18,7017,5499,56,3,7310,5267
149,17,6,0,0,3,1,0,40,32,7023,5499,47,31,7313,5267
150,17,2,2,2,1,2,1,38,44,7025,5501,33,34,7314,5268
151,17,2,2,2,1,2,1,18,14,7027,5503,12,21,7315,5269
152,17,0,2,1,0,0,3,44,27,7027,5505,45,30,7315,5272
153,18,3,1,0,3,1,0,47,28,7030,5506,48,12,7318,5272
154,18,3,0,0,3,1,0,50,27,7033,5506,47,14,7321,5272
155,18,2,0,0,3,1,0,33,25,7035,5506,45,3,7324,5272
156,18,1,1,2,1,2,1,41,33,7036,5507,48,31,7325,5273
157,18,4,0,0,3,1,0,43,27,7040,5507,49,21,7328,5273
158,18,1,0,0,3,1,0,31,31,7041,5507,32,17,7331,5273
159,18,1,1,2,1,2,1,39,45,7042,5508,34,32,7332,5274
160,18,2,1,0,3,1,0,20,15,7044,5509,15,34,7335,5274
161,18,0,0,2,1,2,1,18,7,7044,5509,19,42,7336,5275
162,19,5,0,0,3,1,0,49,18,7049,5509,59,24,7339,5275
163,19,1,1,2,1,2,1,29,23,7050,5510,43,19,7340,5276
164,19,2,3,1,0,0,3,59,20,7052,5513,64,33,7340,5279
165,19,0,2,1,0,0,3,31,40,7052,5515,31,41,7340,5282
166,19,1,3,1,0,0,3,38,49,7053,5518,33,37,7340,5285
167,19,1,1,2,1,2,1,46,36,7054,5519,44,24,7341,5286
168,19,1,1,2,1,2,1,15,12,7055,5520,15,29,7342,5287
169,19,2,2,2,1,2,1,10,14,7057,5522,9,7,7343,5288
170,19,2,0,0,3,1,0,23,14,7059,5522,22,20,7346,5288
171,20,1,2,1,0,0,3,48,30,7060,5524,48,24,7346,5291
172,20,3,2,0,3,1,0,36,27,7063,5526,48,24,7349,5291
173,20,3,1,0,3,1,0,23,16,7066,5527,18,42,7352,5291
174,20,2,1,0,3,1,0,41,46,7068,5528,37,17,7355,5291
175,20,1,1,2,1,2,1,32,32,7069,5529,33,32,7356,5292
176,20,2,1,0,3,1,0,20,8,7071,5530,22,14,7359,5292
177,20,2,1,0,3,1,0,43,34,7073,5531,51,3,7362,5292
178,20,2,1,0,3,1,0,40,50,7075,5532,36,32,7365,5292
179,20,2,0,0,3,1,0,52,27,7077,5532,50,34,7368,5292
180,21,1,1,2,1,2,1,32,41,7078,5533,32,20,7369,5293
181,21,1,1,2,1,2,1,47,37,7079,5534,45,30,7370,5294
182,21,4,0,0,3,1,0,47,27,7083,5534,52,7,7373,5294
183,21,0,0,2,1,2,1,15,12,7083,5534,16,13,7374,5295
184,21,2,1,0,3,1,0,25,15,7085,5535,25,41,7377,5295
185,21,5,1,0,3,1,0,54,19,7090,5536,62,33,7380,5295
186,21,4,2,0,3,1,0,14,16,7094,5538,12,24,7383,5295
187,21,1,1,2,1,2,1,60,21,7095,5539,65,21,7384,5296
188,21,0,0,2,1,2,1,29,23,7095,5539,44,38,7385,5297
189,22,2,2,2,1,2,1,38,29,7097,5541,49,8,7386,5298
190,22,0,1,1,0,0,3,48,31,7097,5542,48,20,7386,5301
191,22,2,0,0,3,1,0,42,50,7099,5542,39,34,7389,5301
192,22,6,1,0,3,1,0,26,9,7105,5543,25,24,7392,5301
193,22,4,2,0,3,1,0,47,36,7109,5545,54,24,7395,5301
194,22,2,1,0,3,1,0,54,28,7111,5546,53,32,7398,5301
195,22,0,0,2,1,2,1,41,46,7111,5546,38,4,7399,5302
196,22,0,0,2,1,2,1,32,32,7111,5546,34,43,7400,5303
197,22,1,1,2,1,2,1,30,24,7112,5547,45,15,7401,5304
198,23,0,1,1,0,0,3,47,28,7112,5548,52,41,7401,5307
199,23,1,2,1,0,0,3,15,18,7113,5550,12,23,7401,5310
200,23,2,0,0,3,1,0,25,16,7115,5550,21,24,7404,5310
201,23,6,2,0,3,1,0,60,21,7121,5552,65,41,7407,5310
202,23,2,0,0,3,1,0,49,37,7123,5552,48,32,7410,5310
203,23,0,0,2,1,2,1,25,15,7123,5552,26,16,7411,5311
204,23,4,2,0,3,1,0,42,31,7127,5554,52,21,7414,5311
205,23,2,1,0,3,1,0,34,42,7129,5555,35,13,7417,5311
206,23,0,0,2,1,2,1,60,21,7129,5555,66,31,7418,5312
207,24,3,3,2,1,2,1,35,35,7132,5558,35,25,7419,5313
208,24,0,2,1,0,0,3,48,33,7132,5560,48,46,7419,5316
209,24,0,2,1,0,0,3,47,38,7132,5562,54,11,7419,5319
210,24,0,3,1,0,0,3,41,49,7132,5565,38,36,7419,5322
211,24,0,5,1,0,0,3,42,55,7132,5570,39,35,7419,5325
212,24,1,0,0,3,1,0,27,9,7133,5570,28,34,7422,5325
213,24,4,3,0,3,1,0,34,27,7137,5573,48,24,7425,5325
214,24,3,2,0,3,1,0,18,14,7140,5575,19,4,7428,5325
215,24,1,1,2,1,2,1,55,29,7141,5576,54,21,7429,5326
216,25,1,0,0,3,1,0,61,21,7142,5576,68,31,7432,5326
217,25,1,1,2,1,2,1,48,29,7143,5577,53,25,7433,5327
218,25,0,0,2,1,2,1,42,31,7143,5577,53,42,7434,5328
219,25,3,1,0,3,1,0,63,22,7146,5578,69,32,7437,5328
220,25,3,1,0,3,1,0,37,43,7149,5579,38,41,7440,5328
221,25,1,1,2,1,2,1,50,38,7150,5580,49,17,7441,5329
222,25,1,5,1,0,0,3,16,23,7151,5585,12,24,7441,5332
223,25,0,0,2,1,2,1,25,16,7151,5585,22,24,7442,5333
224,25,1,0,0,3,1,0,26,15,7152,5585,29,13,7445,5333
225,26,3,0,0,3,1,0,30,9,7155,5585,31,11,7448,5333
226,26,1,3,1,0,0,3,42,52,7156,5588,38,28,7448,5336
227,26,0,0,2,1,2,1,18,14,7156,5588,20,25,7449,5337
228,26,1,4,1,0,0,3,56,33,7157,5592,54,49,7449,5340
229,26,4,0,0,3,1,0,39,35,7161,5592,38,36,7452,5340
230,26,2,1,0,3,1,0,36,28,7163,5593,51,21,7455,5340
231,26,2,1,0,3,1,0,50,34,7165,5594,51,42,7458,5340
232,26,2,2,2,1,2,1,44,57,7167,5596,40,5,7459,5341
233,26,1,1,2,1,2,1,51,39,7168,5597,50,36,7460,5342
234,27,2,1,0,3,1,0,39,44,7170,5598,41,31,7463,5342
235,27,0,1,1,0,0,3,47,39,7170,5599,54,27,7463,5345
236,27,0,1,1,0,0,3,25,17,7170,5600,22,44,7463,5348
237,27,3,0,0,3,1,0,64,21,7173,5600,71,13,7466,5348
238,27,1,1,2,1,2,1,64,23,7174,5601,70,18,7467,5349
239,27,0,0,2,1,2,1,26,15,7174,5601,30,35,7468,5350
240,27,1,2,1,0,0,3,43,33,7175,5603,53,28,7468,5353
241,27,0,1,1,0,0,3,16,24,7175,5604,12,35,7468,5356
242,27,0,4,1,0,0,3,48,33,7175,5608,53,27,7468,5359
243,28,3,0,0,3,1,0,33,9,7178,5608,34,42,7471,5359
244,28,0,1,1,0,0,3,42,53,7178,5609,38,14,7471,5362
245,28,0,0,2,1,2,1,18,14,7178,5609,21,37,7472,5363
246,28,1,1,2,1,2,1,37,29,7179,5610,52,50,7473,5364
247,28,0,1,1,0,0,3,56,34,7179,5611,54,8,7473,5367
248,28,1,1,2,1,2,1,52,40,7180,5612,51,26,7474,5368
249,28,1,1,2,1,2,1,40,36,7181,5613,39,29,7475,5369
250,28,2,0,0,3,1,0,46,57,7183,5613,43,28,7478,5369
251,28,0,0,2,1,2,1,64,23,7183,5613,71,22,7479,5370
252,29,3,0,0,3,1,0,67,21,7186,5613,74,35,7482,5370
253,29,1,0,0,3,1,0,49,33,7187,5613,56,35,7485,5370
254,29,2,1,0,3,1,0,18,25,7189,5614,15,36,7488,5370
255,29,3,3,2,1,2,1,42,47,7192,5617,42,23,7489,5371
256,29,2,2,2,1,2,1,27,19,7194,5619,23,19,7490,5372
257,29,2,0,0,3,1,0,52,34,7196,5619,54,27,7493,5372
258,29,0,0,2,1,2,1,47,39,7196,5619,55,14,7494,5373
259,29,2,2,2,1,2,1,45,35,7198,5621,54,45,7495,5374
260,29,3,3,2,1,2,1,43,39,7201,5624,40,32,7496,5375
261,30,2,1,0,3,1,0,28,16,7203,5625,33,28,7499,5375
262,30,0,1,1,0,0,3,52,41,7203,5626,51,11,7499,5378
263,30,1,0,0,3,1,0,65,23,7204,5626,74,26,7502,5378
264,30,0,0,2,1,2,1,18,14,7204,5626,22,51,7503,5379
265,30,1,1,2,1,2,1,34,10,7205,5627,35,28,7504,5380
266,30,0,2,1,0,0,3,37,31,7205,5629,52,40,7504,5383
267,30,2,1,0,3,1,0,58,35,7207,5630,57,29,7507,5383
268,30,2,0,0,3,1,0,44,53,7209,5630,41,42,7510,5383
269,30,2,0,0,3,1,0,48,57,7211,5630,46,14,7513,5383
270,31,2,1,0,3,1,0,69,22,7213,5631,77,23,7516,5383
271,31,1,0,0,3,1,0,50,33,7214,5631,59,19,7519,5383
272,31,0,5,1,0,0,3,18,30,7214,5636,15,29,7519,5386
273,31,4,0,0,3,1,0,38,10,7218,5636,38,35,7522,5386
274,31,2,0,0,3,1,0,54,34,7220,5636,57,32,7525,5386
275,31,2,2,2,1,2,1,49,41,7222,5638,56,46,7526,5387
276,31,3,1,0,3,1,0,48,36,7225,5639,57,35,7529,5387
277,31,2,1,0,3,1,0,45,40,7227,5640,43,14,7532,5387
278,31,2,1,0,3,1,0,29,20,7229,5641,26,36,7535,5387
279,32,1,1,2,1,2,1,43,48,7230,5642,43,52,7536,5388
280,32,1,1,2,1,2,1,53,42,7231,5643,52,43,7537,5389
281,32,0,0,2,1,2,1,18,14,7231,5643,23,30,7538,5390
282,32,1,1,2,1,2,1,38,32,7232,5644,53,15,7539,5391
283,32,4,1,0,3,1,0,62,36,7236,5645,60,28,7542,5391
284,32,3,0,0,3,1,0,31,16,7239,5645,36,11,7545,5391
285,32,2,1,0,3,1,0,67,24,7241,5646,77,28,7548,5391
286,32,2,0,0,3,1,0,50,57,7243,5646,49,40,7551,5391
287,32,0,3,1,0,0,3,44,56,7243,5649,41,30,7551,5394
288,33,0,2,1,0,0,3,38,12,7243,5651,38,49,7551,5397
289,33,2,0,0,3,1,0,51,41,7245,5651,59,19,7554,5397
290,33,1,1,2,1,2,1,70,23,7246,5652,78,37,7555,5398
291,33,2,1,0,3,1,0,56,35,7248,5653,60,35,7558,5398
292,33,1,0,0,3,1,0,45,56,7249,5653,44,14,7561,5398
293,33,5,4,0,3,1,0,55,37,7254,5657,62,11,7564,5398
294,33,1,0,0,3,1,0,49,36,7255,5657,60,29,7567,5398
295,33,1,0,0,3,1,0,46,40,7256,5657,46,35,7570,5398
296,33,1,0,0,3,1,0,30,20,7257,5657,29,23,7573,5398
297,34,5,0,0,3,1,0,36,16,7262,5657,39,40,7576,5398
298,34,2,1,0,3,1,0,40,33,7264,5658,56,43,7579,5398
299,34,2,1,0,3,1,0,55,43,7266,5659,55,28,7582,5398
300,34,2,2,2,1,2,1,69,26,7268,5661,78,31,7583,5399
301,34,1,2,1,0,0,3,63,38,7269,5663,60,35,7583,5402
302,34,1,1,2,1,2,1,44,49,7270,5664,44,16,7584,5403
303,34,1,0,0,3,1,0,51,57,7271,5664,52,30,7587,5403
304,34,3,1,0,3,1,0,21,15,7274,5665,26,28,7590,5403
305,34,2,2,2,1,2,1,20,32,7276,5667,16,53,7591,5404
0,1,2,2,2,1,2,1,48,42,7278,5669,47,36,7592,5405
1,1,0,0,2,1,2,1,40,33,7278,5669,57,24,7593,5406
2,1,2,2,2,1,2,1,40,18,7280,5671,39,41,7594,5407
3,1,1,0,0,3,1,0,64,38,7281,5671,63,0,7597,5407
4,1,2,1,0,3,1,0,53,42,7283,5672,62,16,7600,5407
5,1,1,4,1,0,0,3,57,39,7284,5676,60,3,7600,5410
6,1,1,1,2,1,2,1,1,1,7285,5677,1,30,7601,5411
7,1,1,0,0,3,1,0,22,15,7286,5677,29,0,7604,5411
8,1,3,3,2,1,2,1,3,3,7289,5680,1,29,7605,5412
9,2,1,1,2,1,2,1,1,1,7290,5681,1,1,7606,5413
10,2,1,2,1,0,0,3,1,2,7291,5683,0,3,7606,5416
11,2,3,0,0,3,1,0,58,43,7294,5683,58,35,7609,5416
12,2,4,0,0,3,1,0,53,36,7298,5683,63,43,7612,5416
13,2,1,1,2,1,2,1,37,17,7299,5684,40,29,7613,5417
14,2,0,1,1,0,0,3,55,38,7299,5685,62,22,7613,5420
15,2,2,0,0,3,1,0,2,0,7301,5685,3,31,7616,5420
16,2,3,1,0,3,1,0,47,50,7304,5686,47,36,7619,5420
17,2,2,2,2,1,2,1,32,22,7306,5688,30,50,7620,5421
18,3,2,1,0,3,1,0,42,19,7308,5689,42,0,7623,5421
19,3,2,1,0,3,1,0,24,16,7310,5690,32,41,7626,5421
20,3,2,0,0,3,1,0,3,1,7312,5690,4,29,7629,5421
21,3,1,3,1,0,0,3,58,42,7313,5693,60,19,7629,5424
22,3,2,0,0,3,1,0,60,43,7315,5693,61,24,7632,5424
23,3,0,0,2,1,2,1,3,3,7315,5693,2,51,7633,5425
24,3,0,1,1,0,0,3,53,43,7315,5694,62,6,7633,5428
25,3,0,2,1,0,0,3,48,44,7315,5696,47,33,7633,5431
26,3,2,0,0,3,1,0,42,33,7317,5696,60,0,7636,5431
27,4,3,0,0,3,1,0,67,38,7320,5696,66,31,7639,5431
28,4,1,3,1,0,0,3,33,25,7321,5699,30,6,7639,5434
29,4,0,1,1,0,0,3,1,2,7321,5700,1,39,7639,5437
30,4,2,1,0,3,1,0,39,18,7323,5701,43,1,7642,5437
31,4,0,3,1,0,0,3,1,5,7323,5704,0,25,7642,5440
32,4,1,3,1,0,0,3,54,39,7324,5707,63,32,7642,5443
33,4,1,0,0,3,1,0,48,50,7325,5707,50,35,7645,5443
34,4,0,1,1,0,0,3,2,1,7325,5708,3,46,7645,5446
35,4,1,2,1,0,0,3,56,40,7326,5710,62,39,7645,5449
36,5,0,0,2,1,2,1,53,43,7326,5710,63,52,7646,5450
37,5,2,1,0,3,1,0,50,45,7328,5711,50,29,7649,5450
38,5,2,2,2,1,2,1,62,45,7330,5713,62,34,7650,5451
39,5,1,0,0,3,1,0,25,16,7331,5713,35,0,7653,5451
40,5,1,1,2,1,2,1,4,2,7332,5714,5,20,7654,5452
41,5,2,0,0,3,1,0,44,19,7334,5714,45,6,7657,5452
42,5,2,1,0,3,1,0,5,4,7336,5715,5,31,7660,5452
43,5,0,1,1,0,0,3,42,34,7336,5716,60,44,7660,5455
44,5,0,0,2,1,2,1,1,2,7336,5716,2,25,7661,5456
45,6,2,1,0,3,1,0,50,51,7338,5717,53,25,7664,5456
46,6,2,1,0,3,1,0,58,41,7340,5718,65,0,7667,5456
47,6,2,0,0,3,1,0,3,5,7342,5718,3,35,7670,5456
48,6,1,1,2,1,2,1,6,5,7343,5719,6,40,7671,5457
49,6,3,0,0,3,1,0,57,39,7346,5719,66,1,7674,5457
50,6,0,1,1,0,0,3,2,2,7346,5720,3,42,7674,5460
51,6,1,1,2,1,2,1,68,39,7347,5721,67,26,7675,5461
52,6,0,1,1,0,0,3,33,26,7347,5722,30,35,7675,5464
53,6,0,0,2,1,2,1,58,42,7347,5722,61,47,7676,5465
54,7,2,1,0,3,1,0,3,3,7349,5723,5,34,7679,5465
55,7,0,1,1,0,0,3,39,19,7349,5724,43,9,7679,5468
56,7,2,1,0,3,1,0,64,46,7351,5725,65,44,7682,5468
57,7,1,2,1,0,0,3,5,4,7352,5727,5,3,7682,5471
58,7,1,0,0,3,1,0,45,19,7353,5727,48,20,7685,5471
59,7,3,0,0,3,1,0,28,16,7356,5727,38,31,7688,5471
60,7,0,2,1,0,0,3,50,47,7356,5729,50,55,7688,5474
61,7,1,1,2,1,2,1,43,35,7357,5730,61,30,7689,5475
62,7,1,2,1,0,0,3,54,45,7358,5732,63,9,7689,5478
63,8,1,2,1,0,0,3,58,41,7359,5734,66,3,7689,5481
64,8,3,0,0,3,1,0,6,5,7362,5734,6,34,7692,5481
65,8,3,0,0,3,1,0,5,2,7365,5734,6,25,7695,5481
66,8,4,0,0,3,1,0,72,39,7369,5734,70,1,7698,5481
67,8,3,1,0,3,1,0,61,42,7372,5735,68,42,7701,5481
68,8,1,1,2,1,2,1,7,6,7373,5736,7,27,7702,5482
69,8,3,1,0,3,1,0,36,27,7376,5737,33,35,7705,5482
70,8,1,1,2,1,2,1,55,46,7377,5738,64,36,7706,5483
71,8,2,2,2,1,2,1,60,44,7379,5740,62,41,7707,5484
72,9,3,0,0,3,1,0,48,19,7382,5740,51,55,7710,5484
73,9,2,2,2,1,2,1,41,21,7384,5742,44,31,7711,5485
74,9,1,1,2,1,2,1,51,52,7385,5743,54,45,7712,5486
75,9,3,0,0,3,1,0,31,16,7388,5743,41,47,7715,5486
76,9,0,1,1,0,0,3,64,47,7388,5744,65,34,7715,5489
77,9,1,1,2,1,2,1,51,48,7389,5745,51,10,7716,5490
78,9,3,1,0,3,1,0,46,36,7392,5746,64,3,7719,5490
79,9,1,0,0,3,1,0,6,4,7393,5746,8,9,7722,5490
80,9,1,1,2,1,2,1,4,4,7394,5747,6,21,7723,5491
81,10,3,1,0,3,1,0,10,7,7397,5748,10,1,7726,5491
82,10,0,2,1,0,0,3,60,46,7397,5750,62,39,7726,5494
83,10,0,2,1,0,0,3,55,48,7397,5752,64,44,7726,5497
84,10,0,2,1,0,0,3,36,29,7397,5754,33,30,7726,5500
85,10,2,3,1,0,0,3,7,5,7399,5757,6,6,7726,5503
86,10,1,1,2,1,2,1,59,42,7400,5758,67,26,7727,5504
87,10,1,0,0,3,1,0,62,42,7401,5758,71,34,7730,5504
88,10,1,1,2,1,2,1,7,6,7402,5759,7,43,7731,5505
89,10,1,1,2,1,2,1,73,40,7403,5760,71,36,7732,5506
90,11,3,3,2,1,2,1,7,7,7406,5763,7,11,7733,5507
91,11,2,0,0,3,1,0,53,48,7408,5763,54,9,7736,5507
92,11,1,0,0,3,1,0,65,47,7409,5763,68,55,7739,5507
93,11,1,1,2,1,2,1,32,17,7410,5764,42,45,7740,5508
94,11,6,1,0,3,1,0,52,37,7416,5765,67,47,7743,5508
95,11,0,2,1,0,0,3,6,6,7416,5767,8,37,7743,5511
96,11,3,2,0,3,1,0,44,23,7419,5769,47,21,7746,5511
97,11,0,1,1,0,0,3,62,43,7419,5770,71,48,7746,5514
98,11,3,1,0,3,1,0,54,53,7422,5771,57,3,7749,5514
99,12,0,0,2,1,2,1,48,19,7422,5771,52,40,7750,5515
100,12,2,1,0,3,1,0,34,18,7424,5772,45,1,7753,5515
101,12,0,2,1,0,0,3,7,7,7424,5774,6,51,7753,5518
102,12,0,2,1,0,0,3,73,42,7424,5776,71,29,7753,5521
103,12,1,2,1,0,0,3,61,48,7425,5778,62,37,7753,5524
104,12,0,2,1,0,0,3,36,31,7425,5780,33,34,7753,5527
105,12,2,2,2,1,2,1,57,50,7427,5782,65,44,7754,5528
106,12,2,0,0,3,1,0,9,6,7429,5782,10,6,7757,5528
107,12,4,1,0,3,1,0,14,8,7433,5783,13,36,7760,5528
108,13,0,0,2,1,2,1,7,7,7433,5783,8,38,7761,5529
109,13,1,1,2,1,2,1,53,38,7434,5784,68,31,7762,5530
110,13,1,6,1,0,0,3,7,12,7435,5790,8,48,7762,5533
111,13,1,1,2,1,2,1,60,43,7436,5791,68,12,7763,5534
112,13,0,0,2,1,2,1,62,43,7436,5791,72,10,7764,5535
113,13,4,2,0,3,1,0,57,50,7440,5793,57,3,7767,5535
114,13,0,1,1,0,0,3,54,54,7440,5794,57,58,7767,5538
115,13,2,0,0,3,1,0,67,47,7442,5794,71,21,7770,5538
116,13,1,1,2,1,2,1,45,24,7443,5795,48,48,7771,5539
117,14,1,0,0,3,1,0,15,8,7444,5795,16,44,7774,5539
118,14,2,1,0,3,1,0,38,32,7446,5796,36,37,7777,5539
119,14,0,2,1,0,0,3,73,44,7446,5798,71,9,7777,5542
120,14,3,0,0,3,1,0,37,18,7449,5798,48,40,7780,5542
121,14,0,1,1,0,0,3,9,7,7449,5799,10,54,7780,5545
122,14,2,1,0,3,1,0,63,49,7451,5800,65,36,7783,5545
123,14,5,2,0,3,1,0,62,52,7456,5802,68,1,7786,5545
124,14,3,3,2,1,2,1,10,10,7459,5805,7,35,7787,5546
125,14,1,0,0,3,1,0,49,19,7460,5805,55,29,7790,5546
126,15,3,1,0,3,1,0,10,8,7463,5806,11,48,7793,5546
127,15,2,2,2,1,2,1,62,45,7465,5808,69,22,7794,5547
128,15,1,3,1,0,0,3,11,13,7466,5811,7,13,7794,5550
129,15,2,2,2,1,2,1,64,45,7468,5813,73,59,7795,5551
130,15,0,1,1,0,0,3,54,55,7468,5814,57,15,7795,5554
131,15,3,1,0,3,1,0,70,48,7471,5815,74,31,7798,5554
132,15,4,1,0,3,1,0,49,25,7475,5816,51,38,7801,5554
133,15,1,1,2,1,2,1,58,51,7476,5817,58,2,7802,5555
134,15,0,4,1,0,0,3,53,42,7476,5821,68,51,7802,5558
135,16,1,1,2,1,2,1,16,9,7477,5822,17,4,7803,5559
136,16,1,0,0,3,1,0,74,44,7478,5822,74,54,7806,5559
137,16,0,0,2,1,2,1,38,32,7478,5822,37,14,7807,5560
138,16,1,3,1,0,0,3,63,55,7479,5825,68,40,7807,5563
139,16,1,0,0,3,1,0,38,18,7480,5825,51,29,7810,5563
140,16,1,2,1,0,0,3,64,51,7481,5827,65,38,7810,5566
141,16,1,2,1,0,0,3,59,53,7482,5829,58,39,7810,5569
142,16,3,1,0,3,1,0,10,13,7485,5830,11,44,7813,5569
143,16,1,1,2,1,2,1,50,20,7486,5831,56,10,7814,5570
144,17,0,0,2,1,2,1,11,13,7486,5831,8,23,7815,5571
145,17,1,1,2,1,2,1,10,8,7487,5832,11,60,7816,5572
146,17,1,0,0,3,1,0,50,25,7488,5832,54,15,7819,5572
147,17,2,1,0,3,1,0,66,46,7490,5833,76,48,7822,5572
148,17,2,2,2,1,2,1,55,44,7492,5835,69,3,7823,5573
149,17,1,0,0,3,1,0,11,8,7493,5835,14,40,7826,5573
150,17,0,2,1,0,0,3,62,47,7493,5837,69,41,7826,5576
151,17,1,2,1,0,0,3,55,57,7494,5839,57,34,7826,5579
152,17,1,2,1,0,0,3,71,50,7495,5841,74,54,7826,5582
153,18,2,0,0,3,1,0,68,46,7497,5841,79,15,7829,5582
154,18,3,1,0,3,1,0,58,58,7500,5842,60,3,7832,5582
155,18,0,1,1,0,0,3,10,9,7500,5843,11,44,7832,5585
156,18,0,1,1,0,0,3,62,48,7500,5844,69,57,7832,5588
157,18,0,3,1,0,0,3,38,35,7500,5847,37,51,7832,5591
158,18,0,3,1,0,0,3,50,28,7500,5850,54,42,7832,5594
159,18,1,1,2,1,2,1,72,51,7501,5851,75,41,7833,5595
160,18,1,1,2,1,2,1,12,14,7502,5852,9,61,7834,5596
161,18,2,2,2,1,2,1,13,10,7504,5854,15,35,7835,5597
162,19,0,1,1,0,0,3,16,10,7504,5855,17,17,7835,5600
163,19,3,0,0,3,1,0,58,44,7507,5855,72,44,7838,5600
164,19,0,0,2,1,2,1,10,13,7507,5855,12,11,7839,5601
165,19,2,1,0,3,1,0,52,21,7509,5856,59,40,7842,5601
166,19,0,0,2,1,2,1,59,53,7509,5856,59,30,7843,5602
167,19,1,1,2,1,2,1,75,45,7510,5857,75,24,7844,5603
168,19,4,2,0,3,1,0,68,53,7514,5859,68,4,7847,5603
169,19,4,0,0,3,1,0,67,55,7518,5859,71,54,7850,5603
170,19,4,3,0,3,1,0,42,21,7522,5862,54,38,7853,5603
171,20,3,1,0,3,1,0,71,47,7525,5863,82,3,7856,5603
172,20,0,0,2,1,2,1,38,35,7525,5863,38,45,7857,5604
173,20,2,2,2,1,2,1,12,11,7527,5865,12,52,7858,5605
174,20,2,1,0,3,1,0,15,11,7529,5866,18,42,7861,5605
175,20,1,2,1,0,0,3,63,50,7530,5868,69,38,7861,5608
176,20,0,0,2,1,2,1,50,28,7530,5868,55,45,7862,5609
177,20,0,2,1,0,0,3,58,60,7530,5870,60,44,7862,5612
178,20,1,5,1,0,0,3,13,19,7531,5875,9,60,7862,5615
179,20,0,1,1,0,0,3,75,46,7531,5876,75,18,7862,5618
180,21,1,1,2,1,2,1,43,22,7532,5877,55,18,7863,5619
181,21,0,2,1,0,0,3,58,46,7532,5879,72,43,7863,5622
182,21,3,0,0,3,1,0,19,10,7535,5879,20,24,7866,5622
183,21,1,3,1,0,0,3,69,56,7536,5882,68,64,7866,5625
184,21,0,0,2,1,2,1,72,51,7536,5882,76,12,7867,5626
185,21,0,2,1,0,0,3,67,57,7536,5884,71,7,7867,5629
186,21,1,3,1,0,0,3,60,56,7537,5887,59,57,7867,5632
187,21,4,1,0,3,1,0,14,14,7541,5888,15,30,7870,5632
188,21,2,2,2,1,2,1,54,23,7543,5890,60,39,7871,5633
189,22,2,0,0,3,1,0,65,50,7545,5890,72,42,7874,5633
190,22,0,1,1,0,0,3,75,47,7545,5891,75,55,7874,5636
191,22,0,1,1,0,0,3,13,20,7545,5892,9,41,7874,5639
192,22,1,1,2,1,2,1,72,48,7546,5893,83,45,7875,5640
193,22,0,1,1,0,0,3,12,12,7546,5894,12,63,7875,5643
194,22,3,1,0,3,1,0,41,36,7549,5895,41,3,7878,5643
195,22,0,0,2,1,2,1,69,56,7549,5895,69,19,7879,5644
196,22,1,0,0,3,1,0,59,60,7550,5895,63,45,7882,5644
197,22,0,1,1,0,0,3,50,29,7550,5896,55,15,7882,5647
198,23,3,0,0,3,1,0,53,29,7553,5896,58,43,7885,5647
199,23,2,2,2,1,2,1,69,59,7555,5898,72,46,7886,5648
200,23,1,1,2,1,2,1,59,47,7556,5899,73,19,7887,5649
201,23,2,0,0,3,1,0,17,11,7558,5899,21,39,7890,5649
202,23,1,1,2,1,2,1,61,57,7559,5900,60,25,7891,5650
203,23,1,2,1,0,0,3,44,24,7560,5902,55,67,7891,5653
204,23,1,1,2,1,2,1,73,52,7561,5903,77,8,7892,5654
205,23,1,3,1,0,0,3,15,17,7562,5906,15,60,7892,5657
206,23,1,0,0,3,1,0,55,23,7563,5906,63,19,7895,5657
207,24,0,1,1,0,0,3,65,51,7563,5907,72,48,7895,5660
208,24,3,0,0,3,1,0,75,48,7566,5907,86,42,7898,5660
209,24,1,3,1,0,0,3,14,23,7567,5910,9,6,7898,5663
210,24,0,0,2,1,2,1,19,10,7567,5910,21,56,7899,5664
211,24,1,0,0,3,1,0,42,36,7568,5910,44,63,7902,5664
212,24,1,1,2,1,2,1,76,48,7569,5911,76,46,7903,5665
213,24,1,1,2,1,2,1,60,61,7570,5912,64,16,7904,5666
214,24,0,1,1,0,0,3,12,13,7570,5913,12,33,7904,5669
215,24,1,0,0,3,1,0,70,56,7571,5913,72,41,7907,5669
216,25,3,2,0,3,1,0,56,31,7574,5915,61,8,7910,5669
217,25,6,1,0,3,1,0,66,62,7580,5916,67,19,7913,5669
218,25,0,1,1,0,0,3,15,18,7580,5917,15,70,7913,5672
219,25,3,0,0,3,1,0,20,11,7583,5917,24,60,7916,5672
220,25,2,1,0,3,1,0,75,53,7585,5918,80,39,7919,5672
221,25,4,2,0,3,1,0,59,25,7589,5920,66,46,7922,5672
222,25,2,1,0,3,1,0,63,58,7591,5921,63,56,7925,5672
223,25,1,0,0,3,1,0,60,47,7592,5921,76,25,7928,5672
224,25,1,1,2,1,2,1,45,25,7593,5922,56,20,7929,5673
225,26,3,0,0,3,1,0,68,51,7596,5922,75,43,7932,5673
226,26,4,2,0,3,1,0,79,50,7600,5924,89,33,7935,5673
227,26,2,1,0,3,1,0,72,57,7602,5925,75,48,7938,5673
228,26,0,0,2,1,2,1,76,48,7602,5925,77,64,7939,5674
229,26,0,1,1,0,0,3,69,60,7602,5926,72,44,7939,5677
230,26,3,0,0,3,1,0,22,10,7605,5926,24,46,7942,5677
231,26,2,2,2,1,2,1,14,15,7607,5928,13,7,7943,5678
232,26,1,1,2,1,2,1,15,24,7608,5929,10,43,7944,5679
233,26,0,2,1,0,0,3,42,38,7608,5931,44,19,7944,5682
234,27,1,1,2,1,2,1,76,54,7609,5932,81,20,7945,5683
235,27,0,1,1,0,0,3,60,48,7609,5933,76,73,7945,5686
236,27,2,1,0,3,1,0,47,26,7611,5934,59,25,7948,5686
237,27,2,0,0,3,1,0,61,25,7613,5934,69,56,7951,5686
238,27,0,1,1,0,0,3,63,59,7613,5935,63,49,7951,5689
239,27,2,1,0,3,1,0,22,12,7615,5936,27,8,7954,5689
240,27,3,0,0,3,1,0,69,62,7618,5936,70,39,7957,5689
241,27,1,1,2,1,2,1,16,19,7619,5937,16,21,7958,5690
242,27,2,2,2,1,2,1,58,33,7621,5939,62,61,7959,5691
243,28,0,3,1,0,0,3,69,63,7621,5942,72,46,7959,5694
244,28,3,0,0,3,1,0,25,10,7624,5942,27,19,7962,5694
245,28,2,1,0,3,1,0,16,16,7626,5943,16,46,7965,5694
246,28,3,2,0,3,1,0,45,40,7629,5945,47,33,7968,5694
247,28,1,4,1,0,0,3,16,28,7630,5949,10,46,7968,5697
248,28,1,1,2,1,2,1,69,52,7631,5950,76,40,7969,5698
249,28,1,1,2,1,2,1,77,49,7632,5951,78,49,7970,5699
250,28,2,1,0,3,1,0,74,58,7634,5952,78,7,7973,5699
251,28,3,0,0,3,1,0,64,25,7637,5952,72,44,7976,5699
252,29,0,0,2,1,2,1,79,50,7637,5952,90,26,7977,5700
253,29,1,1,2,1,2,1,64,60,7638,5953,64,65,7978,5701
254,29,1,3,1,0,0,3,17,22,7639,5956,16,47,7978,5704
255,29,3,1,0,3,1,0,61,34,7642,5957,65,73,7981,5704
256,29,1,1,2,1,2,1,70,63,7643,5958,71,50,7982,5705
257,29,1,0,0,3,1,0,23,12,7644,5958,30,20,7985,5705
258,29,0,0,2,1,2,1,69,52,7644,5958,77,9,7986,5706
259,29,0,2,1,0,0,3,76,56,7644,5960,81,59,7986,5709
260,29,1,1,2,1,2,1,61,49,7645,5961,77,22,7987,5710
261,30,3,0,0,3,1,0,72,63,7648,5961,75,33,7990,5710
262,30,3,0,0,3,1,0,19,16,7651,5961,19,40,7993,5710
263,30,1,2,1,0,0,3,17,30,7652,5963,10,49,7993,5713
264,30,3,0,0,3,1,0,28,10,7655,5963,30,61,7996,5713
265,30,1,2,1,0,0,3,78,51,7656,5965,78,49,7996,5716
266,30,1,0,0,3,1,0,65,25,7657,5965,75,7,7999,5716
267,30,1,1,2,1,2,1,48,27,7658,5966,60,47,8000,5717
268,30,1,0,0,3,1,0,46,40,7659,5966,50,49,8003,5717
269,30,1,1,2,1,2,1,75,59,7660,5967,79,20,8004,5718
270,31,1,0,0,3,1,0,80,50,7661,5967,93,9,8007,5718
271,31,0,1,1,0,0,3,64,61,7661,5968,64,50,8007,5721
272,31,0,1,1,0,0,3,17,23,7661,5969,16,62,8007,5724
273,31,3,1,0,3,1,0,73,64,7664,5970,74,26,8010,5724
274,31,0,0,2,1,2,1,61,49,7664,5970,78,51,8011,5725
275,31,1,1,2,1,2,1,24,13,7665,5971,31,74,8012,5726
276,31,2,3,1,0,0,3,63,37,7667,5974,65,68,8012,5729
277,31,2,2,2,1,2,1,71,54,7669,5976,78,21,8013,5730
278,31,4,2,0,3,1,0,80,58,7673,5978,84,22,8016,5730
279,32,3,2,0,3,1,0,68,27,7676,5980,78,47,8019,5730
280,32,2,1,0,3,1,0,48,41,7678,5981,53,61,8022,5730
281,32,2,1,0,3,1,0,21,17,7680,5982,22,9,8025,5730
282,32,2,1,0,3,1,0,74,64,7682,5983,78,20,8028,5730
283,32,3,1,0,3,1,0,20,24,7685,5984,19,49,8031,5730
284,32,4,1,0,3,1,0,32,11,7689,5985,33,49,8034,5730
285,32,3,0,0,3,1,0,81,51,7692,5985,81,40,8037,5730
286,32,0,0,2,1,2,1,75,59,7692,5985,80,34,8038,5731
287,32,0,0,2,1,2,1,48,27,7692,5985,61,50,8039,5732
288,33,1,2,1,0,0,3,25,15,7693,5987,31,71,8039,5735
289,33,5,1,0,3,1,0,68,38,7698,5988,68,50,8042,5735
290,33,2,0,0,3,1,0,73,54,7700,5988,81,74,8045,5735
291,33,2,1,0,3,1,0,82,51,7702,5989,96,51,8048,5735
292,33,2,1,0,3,1,0,75,65,7704,5990,77,62,8051,5735
293,33,3,0,0,3,1,0,83,58,7707,5990,87,7,8054,5735
294,33,0,1,1,0,0,3,61,50,7707,5991,78,52,8054,5738
295,33,3,0,0,3,1,0,24,17,7710,5991,25,26,8057,5738
296,33,1,3,1,0,0,3,18,33,7711,5994,10,25,8057,5741
297,34,1,1,2,1,2,1,69,28,7712,5995,79,51,8058,5742
298,34,1,2,1,0,0,3,33,13,7713,5997,33,37,8058,5745
299,34,3,0,0,3,1,0,84,51,7716,5997,84,21,8061,5745
300,34,2,2,2,1,2,1,50,29,7718,5999,62,50,8062,5746
301,34,3,1,0,3,1,0,51,42,7721,6000,56,9,8065,5746
302,34,3,2,0,3,1,0,78,61,7724,6002,83,61,8068,5746
303,34,1,2,1,0,0,3,75,66,7725,6004,78,43,8068,5749
304,34,0,3,1,0,0,3,64,64,7725,6007,64,23,8068,5752
305,34,0,1,1,0,0,3,20,25,7725,6008,19,50,8068,5755
0,1,0,0,2,1,2,1,20,25,7725,6008,20,22,8069,5756
1,1,1,2,1,0,0,3,65,66,7726,6010,64,53,8069,5759
2,1,1,0,0,3,1,0,69,38,7727,6010,71,74,8072,5759
3,1,0,1,1,0,0,3,73,55,7727,6011,81,28,8072,5762
4,1,1,1,2,1,2,1,52,43,7728,6012,57,24,8073,5763
5,1,2,0,0,3,1,0,72,23,7730,6012,81,7,8076,5763
6,1,0,1,1,0,0,3,75,66,7730,6013,77,17,8076,5766
7,1,1,2,1,0,0,3,83,53,7731,6015,96,65,8076,5769
8,1,1,0,0,3,1,0,70,26,7732,6015,81,51,8079,5769
9,2,1,1,2,1,2,1,19,35,7733,6016,14,44,8080,5770
10,2,0,2,1,0,0,3,24,19,7733,6018,25,56,8080,5773
11,2,3,1,0,3,1,0,36,14,7736,6019,36,52,8083,5773
12,2,1,0,0,3,1,0,62,50,7737,6019,81,7,8086,5773
13,2,0,0,2,1,2,1,51,57,7737,6019,53,38,8087,5774
14,2,2,1,0,3,1,0,86,52,7739,6020,87,50,8090,5774
15,2,4,0,0,3,1,0,87,58,7743,6020,90,61,8093,5774
16,2,1,1,2,1,2,1,26,16,7744,6021,32,38,8094,5775
17,2,1,1,2,1,2,1,76,67,7745,6022,79,27,8095,5776
18,3,1,2,1,0,0,3,71,28,7746,6024,81,77,8095,5779
19,3,1,0,0,3,1,0,76,66,7747,6024,80,65,8098,5779
20,3,1,3,1,0,0,3,53,46,7748,6027,57,47,8098,5782
21,3,1,1,2,1,2,1,74,56,7749,6028,82,25,8099,5783
22,3,0,2,1,0,0,3,65,68,7749,6030,64,20,8099,5786
23,3,0,1,1,0,0,3,69,39,7749,6031,71,10,8099,5789
24,3,2,2,2,1,2,1,22,27,7751,6033,21,52,8100,5790
25,3,0,1,1,0,0,3,62,51,7751,6034,81,25,8100,5793
26,3,2,1,0,3,1,0,74,24,7753,6035,84,28,8103,5793
27,4,3,3,2,1,2,1,22,38,7756,6038,15,62,8104,5794
28,4,1,2,1,0,0,3,52,59,7757,6040,53,59,8104,5797
29,4,2,2,2,1,2,1,78,69,7759,6042,80,39,8105,5798
30,4,2,1,0,3,1,0,38,15,7761,6043,39,53,8108,5798
31,4,2,0,0,3,1,0,28,16,7763,6043,35,7,8111,5798
32,4,1,0,0,3,1,0,87,52,7764,6043,90,52,8114,5798
33,4,5,1,0,3,1,0,92,59,7769,6044,93,25,8117,5798
34,4,0,3,1,0,0,3,53,49,7769,6047,57,53,8117,5801
35,4,2,1,0,3,1,0,85,54,7771,6048,99,38,8120,5801
36,5,1,1,2,1,2,1,23,28,7772,6049,22,21,8121,5802
37,5,3,2,0,3,1,0,68,70,7775,6051,67,10,8124,5802
38,5,2,1,0,3,1,0,64,52,7777,6052,84,52,8127,5802
39,5,0,0,2,1,2,1,74,24,7777,6052,85,26,8128,5803
40,5,4,0,0,3,1,0,28,19,7781,6052,28,28,8131,5803
41,5,1,0,0,3,1,0,72,28,7782,6052,84,65,8134,5803
42,5,1,1,2,1,2,1,77,67,7783,6053,81,48,8135,5804
43,5,1,0,0,3,1,0,75,56,7784,6053,85,77,8138,5804
44,5,2,1,0,3,1,0,71,40,7786,6054,74,27,8141,5804
45,6,1,1,2,1,2,1,78,68,7787,6055,82,60,8142,5805
46,6,0,2,1,0,0,3,87,54,7787,6057,90,10,8142,5808
47,6,4,2,0,3,1,0,26,40,7791,6059,18,38,8145,5808
48,6,3,2,0,3,1,0,88,56,7794,6061,102,39,8148,5808
49,6,4,2,0,3,1,0,82,71,7798,6063,83,62,8151,5808
50,6,4,1,0,3,1,0,32,17,7802,6064,38,53,8154,5808
51,6,1,1,2,1,2,1,54,50,7803,6065,58,53,8155,5809
52,6,1,1,2,1,2,1,53,60,7804,6066,54,26,8156,5810
53,6,2,2,2,1,2,1,40,17,7806,6068,40,53,8157,5811
54,7,1,0,0,3,1,0,76,56,7807,6068,88,21,8160,5811
55,7,0,0,2,1,2,1,28,19,7807,6068,29,78,8161,5812
56,7,0,2,1,0,0,3,64,54,7807,6070,84,13,8161,5815
57,7,2,1,0,3,1,0,73,41,7809,6071,77,53,8164,5815
58,7,1,0,0,3,1,0,24,28,7810,6071,25,28,8167,5815
59,7,1,1,2,1,2,1,73,29,7811,6072,85,28,8168,5816
60,7,0,2,1,0,0,3,74,26,7811,6074,85,68,8168,5819
61,7,0,1,1,0,0,3,68,71,7811,6075,67,51,8168,5822
62,7,0,4,1,0,0,3,92,63,7811,6079,93,29,8168,5825
63,8,0,0,2,1,2,1,32,17,7811,6079,39,29,8169,5826
64,8,2,4,1,0,0,3,90,60,7813,6083,102,63,8169,5829
65,8,2,0,0,3,1,0,55,60,7815,6083,57,53,8172,5829
66,8,3,1,0,3,1,0,90,55,7818,6084,93,53,8175,5829
67,8,1,2,1,0,0,3,83,73,7819,6086,83,29,8175,5832
68,8,2,1,0,3,1,0,28,41,7821,6087,21,10,8178,5832
69,8,4,1,0,3,1,0,82,69,7825,6088,85,53,8181,5832
70,8,2,2,2,1,2,1,56,52,7827,6090,59,63,8182,5833
71,8,1,1,2,1,2,1,74,42,7828,6091,78,39,8183,5834
72,9,4,2,0,3,1,0,96,65,7832,6093,96,13,8186,5834
73,9,0,1,1,0,0,3,28,20,7832,6094,29,32,8186,5837
74,9,3,0,0,3,1,0,67,54,7835,6094,87,21,8189,5837
75,9,0,0,2,1,2,1,73,29,7835,6094,86,54,8190,5838
76,9,0,3,1,0,0,3,76,59,7835,6097,88,54,8190,5841
77,9,3,0,0,3,1,0,43,17,7838,6097,43,78,8193,5841
78,9,1,0,0,3,1,0,25,28,7839,6097,28,68,8196,5841
79,9,1,2,1,0,0,3,69,73,7840,6099,67,42,8196,5844
80,9,4,0,0,3,1,0,78,26,7844,6099,88,28,8199,5844
81,10,3,0,0,3,1,0,93,60,7847,6099,105,10,8202,5844
82,10,1,2,1,0,0,3,75,44,7848,6101,78,66,8202,5847
83,10,0,3,1,0,0,3,28,44,7848,6104,21,32,8202,5850
84,10,2,0,0,3,1,0,58,52,7850,6104,62,29,8205,5850
85,10,1,2,1,0,0,3,56,62,7851,6106,57,35,8205,5853
86,10,3,1,0,3,1,0,85,70,7854,6107,88,53,8208,5853
87,10,0,0,2,1,2,1,90,55,7854,6107,94,54,8209,5854
88,10,0,1,1,0,0,3,83,74,7854,6108,83,56,8209,5857
89,10,2,1,0,3,1,0,75,30,7856,6109,89,63,8212,5857
90,11,0,0,2,1,2,1,96,65,7856,6109,97,55,8213,5858
91,11,3,0,0,3,1,0,31,20,7859,6109,32,13,8216,5858
92,11,4,2,0,3,1,0,80,61,7863,6111,91,54,8219,5858
93,11,0,0,2,1,2,1,25,28,7863,6111,29,29,8220,5859
94,11,2,1,0,3,1,0,69,55,7865,6112,90,68,8223,5859
95,11,2,4,1,0,0,3,80,30,7867,6116,88,45,8223,5862
96,11,2,2,2,1,2,1,45,19,7869,6118,44,22,8224,5863
97,11,1,2,1,0,0,3,70,75,7870,6120,67,42,8224,5866
98,11,0,0,2,1,2,1,32,17,7870,6120,40,79,8225,5867
99,12,0,1,1,0,0,3,80,31,7870,6121,88,59,8225,5870
100,12,0,0,2,1,2,1,75,44,7870,6121,79,11,8226,5871
101,12,0,1,1,0,0,3,28,45,7870,6122,21,38,8226,5874
102,12,1,6,1,0,0,3,76,36,7871,6128,89,69,8226,5877
103,12,0,0,2,1,2,1,85,70,7871,6128,89,30,8227,5878
104,12,1,0,0,3,1,0,94,60,7872,6128,108,53,8230,5878
105,12,1,0,0,3,1,0,59,52,7873,6128,65,54,8233,5878
106,12,2,1,0,3,1,0,58,63,7875,6129,60,79,8236,5878
107,12,0,0,2,1,2,1,83,74,7875,6129,84,33,8237,5879
108,13,0,1,1,0,0,3,96,66,7875,6130,97,71,8237,5882
109,13,1,0,0,3,1,0,32,20,7876,6130,35,42,8240,5882
110,13,1,1,2,1,2,1,81,62,7877,6131,92,60,8241,5883
111,13,4,1,0,3,1,0,49,20,7881,6132,47,45,8244,5883
112,13,2,6,1,0,0,3,71,61,7883,6138,90,66,8244,5886
113,13,1,3,1,0,0,3,91,58,7884,6141,94,32,8244,5889
114,13,2,0,0,3,1,0,27,28,7886,6141,32,54,8247,5889
115,13,3,1,0,3,1,0,61,64,7889,6142,63,13,8250,5889
116,13,4,0,0,3,1,0,36,17,7893,6142,43,55,8253,5889
117,14,3,0,0,3,1,0,83,31,7896,6142,91,69,8256,5889
118,14,0,4,1,0,0,3,85,74,7896,6146,89,36,8256,5892
119,14,2,0,0,3,1,0,72,75,7898,6146,70,30,8259,5892
120,14,0,0,2,1,2,1,94,60,7898,6146,109,23,8260,5893
121,14,0,1,1,0,0,3,28,46,7898,6147,21,82,8260,5896
122,14,1,0,0,3,1,0,77,36,7899,6147,92,11,8263,5896
123,14,1,0,0,3,1,0,84,74,7900,6147,87,38,8266,5896
124,14,1,1,2,1,2,1,60,53,7901,6148,66,54,8267,5897
125,14,3,0,0,3,1,0,78,44,7904,6148,82,54,8270,5897
126,15,1,4,1,0,0,3,97,70,7905,6152,97,57,8270,5900
127,15,3,2,0,3,1,0,30,30,7908,6154,35,69,8273,5900
128,15,0,2,1,0,0,3,28,48,7908,6156,21,74,8273,5903
129,15,3,0,0,3,1,0,52,20,7911,6156,50,55,8276,5903
130,15,0,1,1,0,0,3,36,18,7911,6157,43,63,8276,5906
131,15,0,1,1,0,0,3,32,21,7911,6158,35,48,8276,5909
132,15,3,0,0,3,1,0,74,61,7914,6158,93,42,8279,5909
133,15,3,0,0,3,1,0,64,64,7917,6158,66,32,8282,5909
134,15,1,0,0,3,1,0,92,58,7918,6158,97,66,8285,5909
135,16,0,2,1,0,0,3,77,38,7918,6160,92,26,8285,5912
136,16,1,3,1,0,0,3,95,63,7919,6163,109,33,8285,5915
137,16,0,3,1,0,0,3,78,47,7919,6166,82,41,8285,5918
138,16,0,2,1,0,0,3,72,77,7919,6168,70,14,8285,5921
139,16,3,2,0,3,1,0,63,55,7922,6170,69,36,8288,5921
140,16,1,0,0,3,1,0,84,31,7923,6170,94,54,8291,5921
141,16,1,1,2,1,2,1,82,63,7924,6171,93,55,8292,5922
142,16,1,2,1,0,0,3,85,76,7925,6173,87,85,8292,5925
143,16,1,2,1,0,0,3,86,76,7926,6175,89,16,8292,5928
144,17,0,2,1,0,0,3,74,63,7926,6177,93,51,8292,5931
145,17,0,0,2,1,2,1,64,64,7926,6177,67,75,8293,5932
146,17,1,1,2,1,2,1,29,49,7927,6178,22,33,8294,5933
147,17,2,0,0,3,1,0,38,18,7929,6178,46,57,8297,5933
148,17,2,1,0,3,1,0,94,59,7931,6179,100,55,8300,5933
149,17,1,2,1,0,0,3,98,72,7932,6181,97,66,8300,5936
150,17,2,4,1,0,0,3,34,25,7934,6185,35,72,8300,5939
151,17,1,3,1,0,0,3,31,33,7935,6188,35,69,8300,5942
152,17,0,1,1,0,0,3,52,21,7935,6189,50,45,8300,5945
153,18,0,1,1,0,0,3,52,22,7935,6190,50,75,8300,5948
154,18,3,1,0,3,1,0,41,19,7938,6191,49,33,8303,5948
155,18,0,0,2,1,2,1,34,25,7938,6191,36,15,8304,5949
156,18,1,3,1,0,0,3,99,75,7939,6194,97,48,8304,5952
157,18,0,4,1,0,0,3,85,80,7939,6198,87,58,8304,5955
158,18,0,0,2,1,2,1,74,63,7939,6198,94,67,8305,5956
159,18,3,3,2,1,2,1,67,67,7942,6201,68,58,8306,5957
160,18,4,1,0,3,1,0,33,50,7946,6202,25,69,8309,5957
161,18,0,2,1,0,0,3,94,61,7946,6204,100,54,8309,5960
162,19,0,2,1,0,0,3,78,49,7946,6206,82,29,8309,5963
163,19,1,0,0,3,1,0,32,33,7947,6206,38,55,8312,5963
164,19,0,0,2,1,2,1,63,55,7947,6206,70,76,8313,5964
165,19,2,2,2,1,2,1,88,78,7949,6208,90,86,8314,5965
166,19,4,2,0,3,1,0,99,65,7953,6210,112,16,8317,5965
167,19,2,3,1,0,0,3,79,41,7955,6213,92,44,8317,5968
168,19,1,0,0,3,1,0,85,31,7956,6213,97,33,8320,5968
169,19,1,0,0,3,1,0,83,63,7957,6213,96,54,8323,5968
170,19,1,2,1,0,0,3,73,79,7958,6215,70,39,8323,5971
171,20,0,1,1,0,0,3,99,76,7958,6216,97,18,8323,5974
172,20,2,2,2,1,2,1,36,27,7960,6218,37,56,8324,5975
173,20,1,2,1,0,0,3,86,82,7961,6220,87,61,8324,5978
174,20,2,1,0,3,1,0,54,23,7963,6221,53,69,8327,5978
175,20,0,0,2,1,2,1,99,65,7963,6221,113,34,8328,5979
176,20,0,1,1,0,0,3,41,20,7963,6222,49,78,8328,5982
177,20,1,1,2,1,2,1,68,68,7964,6223,69,68,8329,5983
178,20,2,2,2,1,2,1,35,52,7966,6225,26,55,8330,5984
179,20,1,1,2,1,2,1,95,62,7967,6226,101,49,8331,5985
180,21,1,1,2,1,2,1,80,42,7968,6227,93,59,8332,5986
181,21,1,1,2,1,2,1,86,32,7969,6228,98,30,8333,5987
182,21,2,0,0,3,1,0,75,79,7971,6228,73,86,8336,5987
183,21,3,2,0,3,1,0,91,80,7974,6230,93,34,8339,5987
184,21,0,1,1,0,0,3,78,50,7974,6231,82,79,8339,5990
185,21,2,2,2,1,2,1,38,29,7976,6233,38,55,8340,5991
186,21,0,1,1,0,0,3,32,34,7976,6234,38,47,8340,5994
187,21,4,0,0,3,1,0,87,63,7980,6234,99,16,8343,5994
188,21,1,0,0,3,1,0,75,63,7981,6234,97,39,8346,5994
189,22,2,0,0,3,1,0,101,65,7983,6234,116,61,8349,5994
190,22,2,3,1,0,0,3,101,79,7985,6237,97,59,8349,5997
191,22,0,2,1,0,0,3,35,54,7985,6239,26,71,8349,6000
192,22,2,2,2,1,2,1,97,64,7987,6241,102,79,8350,6001
193,22,2,1,0,3,1,0,70,69,7989,6242,72,18,8353,6001
194,22,1,2,1,0,0,3,55,25,7990,6244,53,36,8353,6004
195,22,0,0,2,1,2,1,86,82,7990,6244,88,50,8354,6005
196,22,1,2,1,0,0,3,64,57,7991,6246,70,58,8354,6008
197,22,1,1,2,1,2,1,42,21,7992,6247,50,70,8355,6009
198,23,2,0,0,3,1,0,82,42,7994,6247,96,16,8358,6009
199,23,1,0,0,3,1,0,102,79,7995,6247,100,39,8361,6009
200,23,4,1,0,3,1,0,91,64,7999,6248,102,79,8364,6009
201,23,0,0,2,1,2,1,32,34,7999,6248,39,87,8365,6010
202,23,2,2,2,1,2,1,77,65,8001,6250,98,48,8366,6011
203,23,3,2,0,3,1,0,89,34,8004,6252,101,61,8369,6011
204,23,1,0,0,3,1,0,39,29,8005,6252,41,30,8372,6011
205,23,1,1,2,1,2,1,76,80,8006,6253,74,35,8373,6012
206,23,2,1,0,3,1,0,80,51,8008,6254,85,59,8376,6012
207,24,2,1,0,3,1,0,57,26,8010,6255,56,18,8379,6012
208,24,4,0,0,3,1,0,101,64,8014,6255,105,36,8382,6012
209,24,2,1,0,3,1,0,44,22,8016,6256,53,55,8385,6012
210,24,1,1,2,1,2,1,102,66,8017,6257,117,72,8386,6013
211,24,1,0,0,3,1,0,36,54,8018,6257,29,59,8389,6013
212,24,1,0,0,3,1,0,92,80,8019,6257,96,58,8392,6013
213,24,1,1,2,1,2,1,65,58,8020,6258,71,51,8393,6014
214,24,4,0,0,3,1,0,74,69,8024,6258,75,79,8396,6014
215,24,0,2,1,0,0,3,86,84,8024,6260,88,73,8396,6017
216,25,2,1,0,3,1,0,93,65,8026,6261,105,35,8399,6017
217,25,0,2,1,0,0,3,39,31,8026,6263,41,82,8399,6020
218,25,0,1,1,0,0,3,76,81,8026,6264,74,64,8399,6023
219,25,1,0,0,3,1,0,103,79,8027,6264,103,30,8402,6023
220,25,2,2,2,1,2,1,79,67,8029,6266,99,88,8403,6024
221,25,0,2,1,0,0,3,82,44,8029,6268,96,61,8403,6027
222,25,1,1,2,1,2,1,90,35,8030,6269,102,60,8404,6028
223,25,1,0,0,3,1,0,33,34,8031,6269,42,16,8407,6028
224,25,0,0,2,1,2,1,57,26,8031,6269,57,49,8408,6029
225,26,1,1,2,1,2,1,103,67,8032,6270,118,80,8409,6030
226,26,0,1,1,0,0,3,86,85,8032,6271,88,21,8409,6033
227,26,1,1,2,1,2,1,66,59,8033,6272,72,74,8410,6034
228,26,0,0,2,1,2,1,92,80,8033,6272,97,52,8411,6035
229,26,0,0,2,1,2,1,44,22,8033,6272,54,37,8412,6036
230,26,0,0,2,1,2,1,80,51,8033,6272,86,73,8413,6037
231,26,0,1,1,0,0,3,101,65,8033,6273,105,42,8413,6040
232,26,1,1,2,1,2,1,75,70,8034,6274,76,60,8414,6041
233,26,1,3,1,0,0,3,37,57,8035,6277,29,58,8414,6044
234,27,4,1,0,3,1,0,94,36,8039,6278,105,52,8417,6044
235,27,1,1,2,1,2,1,40,32,8040,6279,42,36,8418,6045
236,27,2,1,0,3,1,0,35,35,8042,6280,45,60,8421,6045
237,27,3,0,0,3,1,0,96,65,8045,6280,108,61,8424,6045
238,27,3,0,0,3,1,0,79,81,8048,6280,77,82,8427,6045
239,27,1,1,2,1,2,1,58,27,8049,6281,58,17,8428,6046
240,27,2,0,0,3,1,0,46,22,8051,6281,57,30,8431,6046
241,27,1,2,1,0,0,3,104,81,8052,6283,103,91,8431,6049
242,27,2,1,0,3,1,0,81,68,8054,6284,102,64,8434,6049
243,28,0,0,2,1,2,1,82,44,8054,6284,97,74,8435,6050
244,28,2,2,2,1,2,1,82,53,8056,6286,87,75,8436,6051
245,28,0,0,2,1,2,1,66,59,8056,6286,73,22,8437,6052
246,28,1,0,0,3,1,0,87,85,8057,6286,91,60,8440,6052
247,28,2,2,2,1,2,1,77,72,8059,6288,77,43,8441,6053
248,28,1,3,1,0,0,3,93,83,8060,6291,97,83,8441,6056
249,28,0,1,1,0,0,3,101,66,8060,6292,105,52,8441,6059
250,28,0,0,2,1,2,1,37,57,8060,6292,30,38,8442,6060
251,28,2,0,0,3,1,0,105,67,8062,6292,121,58,8445,6060
252,29,0,0,2,1,2,1,104,81,8062,6292,104,37,8446,6061
253,29,2,1,0,3,1,0,42,33,8064,6293,45,64,8449,6061
254,29,1,2,1,0,0,3,97,67,8065,6295,108,55,8449,6064
255,29,2,0,0,3,1,0,48,22,8067,6295,60,17,8452,6064
256,29,2,3,1,0,0,3,37,38,8069,6298,45,64,8452,6067
257,29,1,1,2,1,2,1,59,28,8070,6299,59,83,8453,6068
258,29,0,3,1,0,0,3,101,69,8070,6302,105,33,8453,6071
259,29,3,2,0,3,1,0,84,70,8073,6304,105,60,8456,6071
260,29,0,0,2,1,2,1,79,81,8073,6304,78,76,8457,6072
261,30,1,2,1,0,0,3,106,69,8074,6306,121,55,8457,6075
262,30,2,3,1,0,0,3,84,56,8076,6309,87,46,8457,6078
263,30,1,2,1,0,0,3,80,83,8077,6311,78,86,8457,6081
264,30,2,1,0,3,1,0,96,37,8079,6312,108,60,8460,6081
265,30,0,0,2,1,2,1,37,57,8079,6312,31,34,8461,6082
266,30,3,1,0,3,1,0,85,45,8082,6313,100,38,8464,6082
267,30,0,3,1,0,0,3,93,86,8082,6316,97,25,8464,6085
268,30,2,1,0,3,1,0,89,86,8084,6317,94,58,8467,6085
269,30,4,2,0,3,1,0,70,61,8088,6319,76,91,8470,6085
270,31,1,1,2,1,2,1,105,82,8089,6320,105,65,8471,6086
271,31,0,3,1,0,0,3,37,41,8089,6323,45,58,8471,6089
272,31,2,0,0,3,1,0,86,70,8091,6323,108,37,8474,6089
273,31,2,1,0,3,1,0,103,70,8093,6324,108,17,8477,6089
274,31,3,2,0,3,1,0,80,74,8096,6326,80,60,8480,6089
275,31,3,2,0,3,1,0,62,30,8099,6328,62,64,8483,6089
276,31,0,0,2,1,2,1,42,33,8099,6328,46,75,8484,6090
277,31,2,2,2,1,2,1,99,69,8101,6330,109,77,8485,6091
278,31,3,1,0,3,1,0,51,23,8104,6331,63,83,8488,6091
279,32,1,1,2,1,2,1,81,84,8105,6332,79,56,8489,6092
280,32,1,2,1,0,0,3,97,39,8106,6334,108,94,8489,6095
281,32,1,4,1,0,0,3,90,90,8107,6338,94,20,8489,6098
282,32,4,0,0,3,1,0,89,45,8111,6338,103,60,8492,6098
283,32,3,1,0,3,1,0,96,87,8114,6339,100,58,8495,6098
284,32,0,3,1,0,0,3,84,59,8114,6342,87,41,8495,6101
285,32,2,0,0,3,1,0,101,69,8116,6342,112,25,8498,6101
286,32,2,2,2,1,2,1,72,63,8118,6344,77,35,8499,6102
287,32,1,1,2,1,2,1,107,70,8119,6345,122,47,8500,6103
288,33,4,0,0,3,1,0,66,30,8123,6345,65,37,8503,6103
289,33,4,0,0,3,1,0,55,23,8127,6345,66,65,8506,6103
290,33,2,0,0,3,1,0,105,70,8129,6345,111,83,8509,6103
291,33,0,6,1,0,0,3,105,88,8129,6351,105,80,8509,6106
292,33,3,0,0,3,1,0,45,33,8132,6351,49,60,8512,6106
293,33,0,2,1,0,0,3,37,43,8132,6353,45,78,8512,6109
294,33,0,2,1,0,0,3,86,72,8132,6355,108,89,8512,6112
295,33,2,2,2,1,2,1,82,76,8134,6357,81,59,8513,6113
296,33,0,0,2,1,2,1,37,57,8134,6357,32,65,8514,6114
297,34,4,2,0,3,1,0,93,47,8138,6359,106,47,8517,6114
298,34,2,0,0,3,1,0,99,39,8140,6359,111,25,8520,6114
299,34,2,0,0,3,1,0,98,87,8142,6359,103,56,8523,6114
300,34,1,1,2,1,2,1,108,71,8143,6360,123,95,8524,6115
301,34,2,2,2,1,2,1,86,61,8145,6362,88,61,8525,6116
302,34,2,1,0,3,1,0,103,70,8147,6363,115,41,8528,6116
303,34,2,0,0,3,1,0,83,84,8149,6363,82,58,8531,6116
304,34,1,0,0,3,1,0,91,90,8150,6363,97,35,8534,6116
305,34,2,3,1,0,0,3,74,66,8152,6366,77,23,8534,6119
0,1,2,2,2,1,2,1,95,49,8154,6368,107,51,8535,6120
1,1,0,0,2,1,2,1,0,0,8154,6368,1,42,8536,6121
2,1,1,1,2,1,2,1,87,62,8155,6369,89,79,8537,6122
3,1,1,1,2,1,2,1,92,91,8156,6370,98,81,8538,6123
4,1,2,1,0,3,1,0,2,1,8158,6371,3,65,8541,6123
5,1,1,0,0,3,1,0,1,0,8159,6371,3,25,8544,6123
6,1,1,0,0,3,1,0,1,0,8160,6371,3,61,8547,6123
7,1,0,0,2,1,2,1,82,76,8160,6371,82,61,8548,6124
8,1,3,2,0,3,1,0,69,32,8163,6373,68,95,8551,6124
9,2,2,3,1,0,0,3,100,90,8165,6376,103,38,8551,6127
10,2,2,0,0,3,1,0,47,33,8167,6376,52,65,8554,6127
11,2,1,1,2,1,2,1,109,72,8168,6377,124,60,8555,6128
12,2,3,0,0,3,1,0,53,29,8171,6377,65,0,8558,6128
13,2,1,5,1,0,0,3,87,77,8172,6382,108,86,8558,6131
14,2,2,2,2,1,2,1,85,86,8174,6384,83,1,8559,6132
15,2,0,3,1,0,0,3,105,73,8174,6387,111,3,8559,6135
16,2,1,1,2,1,2,1,38,44,8175,6388,46,48,8560,6136
17,2,5,1,0,3,1,0,104,40,8180,6389,114,0,8563,6136
18,3,2,2,2,1,2,1,4,3,8182,6391,4,96,8564,6137
19,3,2,1,0,3,1,0,89,63,8184,6392,92,25,8567,6137
20,3,1,0,0,3,1,0,1,0,8185,6392,4,61,8570,6137
21,3,0,2,1,0,0,3,95,51,8185,6394,107,41,8570,6140
22,3,0,1,1,0,0,3,1,1,8185,6395,3,68,8570,6143
23,3,2,0,0,3,1,0,87,86,8187,6395,86,81,8573,6143
24,3,2,0,0,3,1,0,3,0,8189,6395,6,42,8576,6143
25,3,2,1,0,3,1,0,71,33,8191,6396,71,51,8579,6143
26,3,1,1,2,1,2,1,93,92,8192,6397,99,62,8580,6144
27,4,0,0,2,1,2,1,100,90,8192,6397,104,4,8581,6145
28,4,2,2,2,1,2,1,49,35,8194,6399,53,49,8582,6146
29,4,0,4,1,0,0,3,109,76,8194,6403,124,3,8582,6149
30,4,0,3,1,0,0,3,87,80,8194,6406,108,63,8582,6152
31,4,1,1,2,1,2,1,83,77,8195,6407,83,1,8583,6153
32,4,1,1,2,1,2,1,106,74,8196,6408,112,2,8584,6154
33,4,0,3,1,0,0,3,38,47,8196,6411,46,82,8584,6157
34,4,1,2,1,0,0,3,54,31,8197,6413,65,89,8584,6160
35,4,3,0,0,3,1,0,107,40,8200,6413,117,65,8587,6160
36,5,1,1,2,1,2,1,94,93,8201,6414,100,42,8588,6161
37,5,4,1,0,3,1,0,91,87,8205,6415,89,42,8591,6161
38,5,1,0,0,3,1,0,72,33,8206,6415,74,68,8594,6161
39,5,3,1,0,3,1,0,4,1,8209,6416,7,51,8597,6161
40,5,2,0,0,3,1,0,5,0,8211,6416,9,61,8600,6161
41,5,1,0,0,3,1,0,39,47,8212,6416,49,81,8603,6161
42,5,1,2,1,0,0,3,90,65,8213,6418,92,99,8603,6164
43,5,3,1,0,3,1,0,7,4,8216,6419,7,62,8606,6164
44,5,0,2,1,0,0,3,1,3,8216,6421,3,66,8606,6167
45,6,3,0,0,3,1,0,90,80,8219,6421,111,65,8609,6167
46,6,0,1,1,0,0,3,49,36,8219,6422,53,28,8609,6170
47,6,2,0,0,3,1,0,56,31,8221,6422,68,2,8612,6170
48,6,1,1,2,1,2,1,107,75,8222,6423,113,83,8613,6171
49,6,1,5,1,0,0,3,101,95,8223,6428,104,92,8613,6174
50,6,2,1,0,3,1,0,109,41,8225,6429,120,49,8616,6174
51,6,3,0,0,3,1,0,86,77,8228,6429,86,3,8619,6174
52,6,2,1,0,3,1,0,111,77,8230,6430,127,4,8622,6174
53,6,3,2,0,3,1,0,98,53,8233,6432,110,1,8625,6174
54,7,1,0,0,3,1,0,40,47,8234,6432,52,99,8628,6174
55,7,1,0,0,3,1,0,91,65,8235,6432,95,51,8631,6174
56,7,1,1,2,1,2,1,110,42,8236,6433,121,43,8632,6175
57,7,1,1,2,1,2,1,92,88,8237,6434,90,62,8633,6176
58,7,1,0,0,3,1,0,73,33,8238,6434,77,62,8636,6176
59,7,4,0,0,3,1,0,9,0,8242,6434,12,68,8639,6176
60,7,3,0,0,3,1,0,10,4,8245,6434,10,3,8642,6176
61,7,3,1,0,3,1,0,7,2,8248,6435,10,42,8645,6176
62,7,1,1,2,1,2,1,95,94,8249,6436,101,67,8646,6177
63,8,1,0,0,3,1,0,91,80,8250,6436,114,43,8649,6177
64,8,2,1,0,3,1,0,58,32,8252,6437,71,28,8652,6177
65,8,2,0,0,3,1,0,109,75,8254,6437,116,81,8655,6177
66,8,1,1,2,1,2,1,112,78,8255,6438,128,3,8656,6178
67,8,0,1,1,0,0,3,86,78,8255,6439,86,86,8656,6181
68,8,2,2,2,1,2,1,100,55,8257,6441,111,5,8657,6182
69,8,5,0,0,3,1,0,15,4,8262,6441,13,92,8660,6182
70,8,3,3,2,1,2,1,104,98,8265,6444,105,66,8661,6183
71,8,3,2,0,3,1,0,4,5,8268,6446,6,49,8664,6183
72,9,1,1,2,1,2,1,96,95,8269,6447,102,4,8665,6184
73,9,2,0,0,3,1,0,112,42,8271,6447,124,62,8668,6184
74,9,2,0,0,3,1,0,51,36,8273,6447,56,99,8671,6184
75,9,2,0,0,3,1,0,75,33,8275,6447,80,42,8674,6184
76,9,3,0,0,3,1,0,94,65,8278,6447,98,62,8677,6184
77,9,0,3,1,0,0,3,40,50,8278,6450,52,71,8677,6187
78,9,1,0,0,3,1,0,93,88,8279,6450,93,51,8680,6187
79,9,1,4,1,0,0,3,10,4,8280,6454,12,70,8680,6190
80,9,1,1,2,1,2,1,8,3,8281,6455,11,2,8681,6191
81,10,1,1,2,1,2,1,16,5,8282,6456,14,50,8682,6192
82,10,1,1,2,1,2,1,97,96,8283,6457,103,4,8683,6193
83,10,1,0,0,3,1,0,5,5,8284,6457,9,5,8686,6193
84,10,3,1,0,3,1,0,115,79,8287,6458,131,28,8689,6193
85,10,2,2,2,1,2,1,60,34,8289,6460,72,82,8690,6194
86,10,4,1,0,3,1,0,95,81,8293,6461,117,99,8693,6194
87,10,0,0,2,1,2,1,86,78,8293,6461,87,44,8694,6195
88,10,0,1,1,0,0,3,104,99,8293,6462,105,89,8694,6198
89,10,1,0,0,3,1,0,101,55,8294,6462,114,66,8697,6198
90,11,2,5,1,0,0,3,114,47,8296,6467,124,74,8697,6201
91,11,2,0,0,3,1,0,10,3,8298,6467,14,92,8700,6201
92,11,1,2,1,0,0,3,52,38,8299,6469,56,65,8700,6204
93,11,0,4,1,0,0,3,94,69,8299,6473,98,45,8700,6207
94,11,1,1,2,1,2,1,76,34,8300,6474,81,71,8701,6208
95,11,1,1,2,1,2,1,41,51,8301,6475,53,63,8702,6209
96,11,1,0,0,3,1,0,94,88,8302,6475,96,2,8705,6209
97,11,1,2,1,0,0,3,110,77,8303,6477,116,54,8705,6212
98,11,3,0,0,3,1,0,13,4,8306,6477,15,4,8708,6212
99,12,0,0,2,1,2,1,101,55,8306,6477,115,90,8709,6213
100,12,0,1,1,0,0,3,115,80,8306,6478,131,85,8709,6216
101,12,1,1,2,1,2,1,87,79,8307,6479,88,29,8710,6217
102,12,2,2,2,1,2,1,7,7,8309,6481,10,67,8711,6218
103,12,1,1,2,1,2,1,17,6,8310,6482,15,5,8712,6219
104,12,1,1,2,1,2,1,105,100,8311,6483,106,64,8713,6220
105,12,2,1,0,3,1,0,62,35,8313,6484,75,44,8716,6220
106,12,0,3,1,0,0,3,97,99,8313,6487,103,102,8716,6223
107,12,0,0,2,1,2,1,10,3,8313,6487,15,51,8717,6224
108,13,2,1,0,3,1,0,43,52,8315,6488,56,4,8720,6224
109,13,2,2,2,1,2,1,78,36,8317,6490,82,93,8721,6225
110,13,0,1,1,0,0,3,52,39,8317,6491,56,77,8721,6228
111,13,1,0,0,3,1,0,14,4,8318,6491,18,5,8724,6228
112,13,0,3,1,0,0,3,94,72,8318,6494,98,5,8724,6231
113,13,3,3,2,1,2,1,97,91,8321,6497,97,66,8725,6232
114,13,1,2,1,0,0,3,96,83,8322,6499,117,57,8725,6235
115,13,0,3,1,0,0,3,114,50,8322,6502,124,48,8725,6238
116,13,0,1,1,0,0,3,110,78,8322,6503,116,74,8725,6241
117,14,3,0,0,3,1,0,20,6,8325,6503,18,29,8728,6241
118,14,4,0,0,3,1,0,101,99,8329,6503,106,44,8731,6241
119,14,0,0,2,1,2,1,78,36,8329,6503,83,6,8732,6242
120,14,0,3,1,0,0,3,105,103,8329,6506,106,60,8732,6245
121,14,1,4,1,0,0,3,116,84,8330,6510,131,105,8732,6248
122,14,4,1,0,3,1,0,14,4,8334,6511,18,67,8735,6248
123,14,1,0,0,3,1,0,88,79,8335,6511,91,64,8738,6248
124,14,2,1,0,3,1,0,9,8,8337,6512,13,90,8741,6248
125,14,3,3,2,1,2,1,104,58,8340,6515,116,86,8742,6249
126,15,1,2,1,0,0,3,97,85,8341,6517,117,69,8742,6252
127,15,0,0,2,1,2,1,114,50,8341,6517,125,6,8743,6253
128,15,0,0,2,1,2,1,14,4,8341,6517,19,49,8744,6254
129,15,2,0,0,3,1,0,54,39,8343,6517,59,74,8747,6254
130,15,3,0,0,3,1,0,100,91,8346,6517,100,93,8750,6254
131,15,1,3,1,0,0,3,95,75,8347,6520,98,54,8750,6257
132,15,0,0,2,1,2,1,43,52,8347,6520,57,6,8751,6258
133,15,0,2,1,0,0,3,110,80,8347,6522,116,80,8751,6261
134,15,1,0,0,3,1,0,63,35,8348,6522,78,4,8754,6261
135,16,0,1,1,0,0,3,20,7,8348,6523,18,47,8754,6264
136,16,3,3,2,1,2,1,104,102,8351,6526,107,68,8755,6265
137,16,1,3,1,0,0,3,105,61,8352,6529,116,32,8755,6268
138,16,3,0,0,3,1,0,81,36,8355,6529,86,64,8758,6268
139,16,0,0,2,1,2,1,14,4,8355,6529,20,87,8759,6269
140,16,2,1,0,3,1,0,118,85,8357,6530,134,80,8762,6269
141,16,1,0,0,3,1,0,89,79,8358,6530,94,60,8765,6269
142,16,0,1,1,0,0,3,14,5,8358,6531,18,93,8765,6272
143,16,2,1,0,3,1,0,11,9,8360,6532,16,105,8768,6272
144,17,1,1,2,1,2,1,98,86,8361,6533,118,7,8769,6273
145,17,0,0,2,1,2,1,43,52,8361,6533,58,94,8770,6274
146,17,0,1,1,0,0,3,114,51,8361,6534,125,9,8770,6277
147,17,2,3,1,0,0,3,112,83,8363,6537,116,52,8770,6280
148,17,1,1,2,1,2,1,64,36,8364,6538,79,70,8771,6281
149,17,0,2,1,0,0,3,105,105,8364,6540,106,77,8771,6284
150,17,2,0,0,3,1,0,102,91,8366,6540,103,54,8774,6284
151,17,1,2,1,0,0,3,55,41,8367,6542,59,7,8774,6287
152,17,0,1,1,0,0,3,95,76,8367,6543,98,9,8774,6290
153,18,2,0,0,3,1,0,120,85,8369,6543,137,52,8777,6290
154,18,0,0,2,1,2,1,114,51,8369,6543,126,95,8778,6291
155,18,2,1,0,3,1,0,66,37,8371,6544,82,77,8781,6291
156,18,2,0,0,3,1,0,107,105,8373,6544,109,7,8784,6291
157,18,0,1,1,0,0,3,98,87,8373,6545,118,10,8784,6294
158,18,1,2,1,0,0,3,44,54,8374,6547,58,12,8784,6297
159,18,2,1,0,3,1,0,104,92,8376,6548,106,68,8787,6297
160,18,1,1,2,1,2,1,113,84,8377,6549,117,55,8788,6298
161,18,0,0,2,1,2,1,55,41,8377,6549,60,10,8789,6299
162,19,1,0,0,3,1,0,106,61,8378,6549,119,70,8792,6299
163,19,0,1,1,0,0,3,20,8,8378,6550,18,63,8792,6302
164,19,4,1,0,3,1,0,93,80,8382,6551,97,80,8795,6302
165,19,3,1,0,3,1,0,98,77,8385,6552,101,47,8798,6302
166,19,0,0,2,1,2,1,11,9,8385,6552,17,88,8799,6303
167,19,1,1,2,1,2,1,105,103,8386,6553,108,65,8800,6304
168,19,1,0,0,3,1,0,82,36,8387,6553,89,32,8803,6304
169,19,2,2,2,1,2,1,16,6,8389,6555,21,94,8804,6305
170,19,1,1,2,1,2,1,15,6,8390,6556,19,106,8805,6306
171,20,0,0,2,1,2,1,55,41,8390,6556,61,13,8806,6307
172,20,0,1,1,0,0,3,114,52,8390,6557,126,97,8806,6310
173,20,2,0,0,3,1,0,100,87,8392,6557,121,10,8809,6310
174,20,0,0,2,1,2,1,44,54,8392,6557,59,69,8810,6311
175,20,2,1,0,3,1,0,122,86,8394,6558,140,95,8813,6311
176,20,1,1,2,1,2,1,94,81,8395,6559,98,78,8814,6312
177,20,0,2,1,0,0,3,66,39,8395,6561,82,58,8814,6315
178,20,2,1,0,3,1,0,109,106,8397,6562,112,10,8817,6315
179,20,1,2,1,0,0,3,114,86,8398,6564,117,10,8817,6318
180,21,0,1,1,0,0,3,20,9,8398,6565,18,55,8817,6321
181,21,2,3,1,0,0,3,108,64,8400,6568,119,68,8817,6324
182,21,3,2,0,3,1,0,108,105,8403,6570,111,63,8820,6324
183,21,1,3,1,0,0,3,105,95,8404,6573,106,35,8820,6327
184,21,1,0,0,3,1,0,83,36,8405,6573,92,47,8823,6327
185,21,1,1,2,1,2,1,17,7,8406,6574,22,107,8824,6328
186,21,3,1,0,3,1,0,14,10,8409,6575,20,70,8827,6328
187,21,0,1,1,0,0,3,15,7,8409,6576,19,83,8827,6331
188,21,0,1,1,0,0,3,98,78,8409,6577,101,91,8827,6334
189,22,0,1,1,0,0,3,100,88,8409,6578,121,16,8827,6337
190,22,1,1,2,1,2,1,56,42,8410,6579,62,98,8828,6338
191,22,0,0,2,1,2,1,114,52,8410,6579,127,36,8829,6339
192,22,2,1,0,3,1,0,116,87,8412,6580,120,69,8832,6339
193,22,0,0,2,1,2,1,94,81,8412,6580,99,96,8833,6340
194,22,2,0,0,3,1,0,111,106,8414,6580,115,58,8836,6340
195,22,3,1,0,3,1,0,125,87,8417,6581,143,10,8839,6340
196,22,1,3,1,0,0,3,109,67,8418,6584,119,13,8839,6343
197,22,1,1,2,1,2,1,67,40,8419,6585,83,11,8840,6344
198,23,1,0,0,3,1,0,18,7,8420,6585,25,63,8843,6344
199,23,3,3,2,1,2,1,111,108,8423,6588,112,84,8844,6345
200,23,2,1,0,3,1,0,85,37,8425,6589,95,91,8847,6345
201,23,2,0,0,3,1,0,46,54,8427,6589,62,47,8850,6345
202,23,1,1,2,1,2,1,15,11,8428,6590,21,56,8851,6346
203,23,3,2,0,3,1,0,18,9,8431,6592,22,70,8854,6346
204,23,0,0,2,1,2,1,98,78,8431,6592,102,69,8855,6347
205,23,1,2,1,0,0,3,21,11,8432,6594,18,81,8855,6350
206,23,1,1,2,1,2,1,106,96,8433,6595,107,108,8856,6351
207,24,2,2,2,1,2,1,111,69,8435,6597,120,97,8857,6352
208,24,0,3,1,0,0,3,100,91,8435,6600,121,101,8857,6355
209,24,0,1,1,0,0,3,15,12,8435,6601,21,13,8857,6358
210,24,0,2,1,0,0,3,67,42,8435,6603,83,72,8857,6361
211,24,1,1,2,1,2,1,57,43,8436,6604,63,92,8858,6362
212,24,1,1,2,1,2,1,112,107,8437,6605,116,17,8859,6363
213,24,0,0,2,1,2,1,125,87,8437,6605,144,59,8860,6364
214,24,2,3,1,0,0,3,118,90,8439,6608,120,39,8860,6367
215,24,0,0,2,1,2,1,94,81,8439,6608,100,12,8861,6368
216,25,5,0,0,3,1,0,23,7,8444,6608,28,70,8864,6368
217,25,0,3,1,0,0,3,114,55,8444,6611,127,111,8864,6371
218,25,4,1,0,3,1,0,115,109,8448,6612,115,13,8867,6371
219,25,1,1,2,1,2,1,99,79,8449,6613,103,85,8868,6372
220,25,2,1,0,3,1,0,87,38,8451,6614,98,13,8871,6372
221,25,3,0,0,3,1,0,60,43,8454,6614,66,69,8874,6372
222,25,0,1,1,0,0,3,46,55,8454,6615,62,66,8874,6375
223,25,1,3,1,0,0,3,107,99,8455,6618,107,59,8874,6378
224,25,3,1,0,3,1,0,21,10,8458,6619,25,81,8877,6378
225,26,1,1,2,1,2,1,113,108,8459,6620,117,40,8878,6379
226,26,1,1,2,1,2,1,119,91,8460,6621,121,48,8879,6380
227,26,1,0,0,3,1,0,126,87,8461,6621,147,72,8882,6380
228,26,2,0,0,3,1,0,113,69,8463,6621,123,17,8885,6380
229,26,0,0,2,1,2,1,67,42,8463,6621,84,102,8886,6381
230,26,1,0,0,3,1,0,22,11,8464,6621,21,12,8889,6381
231,26,0,0,2,1,2,1,94,81,8464,6621,101,60,8890,6382
232,26,0,0,2,1,2,1,100,91,8464,6621,122,93,8891,6383
233,26,1,2,1,0,0,3,16,14,8465,6623,21,100,8891,6386
234,27,1,2,1,0,0,3,115,57,8466,6625,127,69,8891,6389
235,27,4,0,0,3,1,0,91,38,8470,6625,101,13,8894,6389
236,27,2,1,0,3,1,0,23,11,8472,6626,28,13,8897,6389
237,27,2,2,2,1,2,1,62,45,8474,6628,67,60,8898,6390
238,27,2,0,0,3,1,0,25,7,8476,6628,31,100,8901,6390
239,27,1,1,2,1,2,1,47,56,8477,6629,63,71,8902,6391
240,27,2,0,0,3,1,0,109,99,8479,6629,110,85,8905,6391
241,27,0,1,1,0,0,3,119,92,8479,6630,121,72,8905,6394
242,27,4,0,0,3,1,0,103,79,8483,6630,106,81,8908,6394
243,28,1,1,2,1,2,1,17,15,8484,6631,22,18,8909,6395
244,28,0,1,1,0,0,3,22,12,8484,6632,21,105,8909,6398
245,28,3,0,0,3,1,0,97,81,8487,6632,104,72,8912,6398
246,28,1,1,2,1,2,1,114,109,8488,6633,118,94,8913,6399
247,28,2,0,0,3,1,0,69,42,8490,6633,87,111,8916,6399
248,28,1,2,1,0,0,3,116,111,8491,6635,115,15,8916,6402
249,28,0,1,1,0,0,3,100,92,8491,6636,122,43,8916,6405
250,28,1,1,2,1,2,1,127,88,8492,6637,148,49,8917,6406
251,28,1,1,2,1,2,1,114,70,8493,6638,124,61,8918,6407
252,29,1,0,0,3,1,0,104,79,8494,6638,109,13,8921,6407
253,29,0,0,2,1,2,1,47,56,8494,6638,64,61,8922,6408
254,29,3,2,0,3,1,0,112,101,8497,6640,113,81,8925,6408
255,29,2,1,0,3,1,0,64,46,8499,6641,70,69,8928,6408
256,29,2,1,0,3,1,0,121,93,8501,6642,124,100,8931,6408
257,29,1,1,2,1,2,1,26,8,8502,6643,32,14,8932,6409
258,29,1,0,0,3,1,0,101,92,8503,6643,125,85,8935,6409
259,29,2,2,2,1,2,1,117,59,8505,6645,128,72,8936,6410
260,29,1,1,2,1,2,1,92,39,8506,6646,102,16,8937,6411
261,30,2,1,0,3,1,0,25,12,8508,6647,31,18,8940,6411
262,30,0,2,1,0,0,3,116,113,8508,6649,115,64,8940,6414
263,30,2,0,0,3,1,0,19,15,8510,6649,25,43,8943,6414
264,30,2,1,0,3,1,0,99,82,8512,6650,107,94,8946,6414
265,30,1,1,2,1,2,1,115,71,8513,6651,125,112,8947,6415
266,30,2,2,2,1,2,1,129,90,8515,6653,149,106,8948,6416
267,30,2,1,0,3,1,0,24,13,8517,6654,24,72,8951,6416
268,30,1,1,2,1,2,1,115,110,8518,6655,119,50,8952,6417
269,30,4,2,0,3,1,0,73,44,8522,6657,90,72,8955,6417
270,31,3,2,0,3,1,0,29,10,8525,6659,35,64,8958,6417
271,31,2,0,0,3,1,0,75,44,8527,6659,93,85,8961,6417
272,31,2,4,1,0,0,3,66,50,8529,6663,70,103,8961,6420
273,31,1,0,0,3,1,0,105,79,8530,6663,112,16,8964,6420
274,31,3,0,0,3,1,0,120,59,8533,6663,131,81,8967,6420
275,31,2,2,2,1,2,1,49,58,8535,6665,65,15,8968,6421
276,31,0,3,1,0,0,3,121,96,8535,6668,124,75,8968,6424
277,31,3,1,0,3,1,0,104,93,8538,6669,128,61,8971,6424
278,31,1,1,2,1,2,1,113,102,8539,6670,114,14,8972,6425
279,32,0,1,1,0,0,3,115,111,8539,6671,119,115,8972,6428
280,32,0,2,1,0,0,3,115,73,8539,6673,125,53,8972,6431
281,32,0,4,1,0,0,3,25,16,8539,6677,31,46,8972,6434
282,32,0,2,1,0,0,3,92,41,8539,6679,102,75,8972,6437
283,32,1,2,1,0,0,3,130,92,8540,6681,149,75,8972,6440
284,32,3,0,0,3,1,0,27,13,8543,6681,27,94,8975,6440
285,32,3,1,0,3,1,0,119,114,8546,6682,118,106,8978,6440
286,32,3,1,0,3,1,0,22,16,8549,6683,28,69,8981,6440
287,32,0,1,1,0,0,3,99,83,8549,6684,107,21,8981,6443
288,33,2,1,0,3,1,0,115,103,8551,6685,117,16,8984,6443
289,33,2,1,0,3,1,0,123,97,8553,6686,127,14,8987,6443
290,33,0,2,1,0,0,3,75,46,8553,6688,93,64,8987,6446
291,33,1,3,1,0,0,3,116,114,8554,6691,119,78,8987,6449
292,33,2,4,1,0,0,3,68,54,8556,6695,70,18,8987,6452
293,33,5,1,0,3,1,0,110,80,8561,6696,115,103,8990,6452
294,33,1,0,0,3,1,0,121,59,8562,6696,134,21,8993,6452
295,33,0,0,2,1,2,1,104,93,8562,6696,129,65,8994,6453
296,33,0,2,1,0,0,3,49,60,8562,6698,65,84,8994,6456
297,34,1,0,0,3,1,0,30,10,8563,6698,38,75,8997,6456
298,34,2,2,2,1,2,1,29,15,8565,6700,28,76,8998,6457
299,34,2,0,0,3,1,0,132,92,8567,6700,152,69,9001,6457
300,34,2,0,0,3,1,0,101,83,8569,6700,110,115,9004,6457
301,34,2,1,0,3,1,0,24,17,8571,6701,31,53,9007,6457
302,34,2,0,0,3,1,0,27,16,8573,6701,34,94,9010,6457
303,34,0,0,2,1,2,1,119,114,8573,6701,119,47,9011,6458
304,34,2,3,1,0,0,3,117,76,8575,6704,125,88,9011,6461
305,34,1,1,2,1,2,1,93,42,8576,6705,103,107,9012,6462
0,1,1,3,1,0,0,3,79,64,8577,6708,83,68,9012,6465
1,1,1,0,0,3,1,0,122,59,8578,6708,137,64,9015,6465
2,1,0,0,2,1,2,1,110,80,8578,6708,116,24,9016,6466
3,1,0,1,1,0,0,3,116,115,8578,6709,119,19,9016,6469
4,1,0,1,1,0,0,3,103,71,8578,6710,115,106,9016,6472
5,1,1,3,1,0,0,3,76,49,8579,6713,93,50,9016,6475
6,1,1,1,2,1,2,1,133,93,8580,6714,153,85,9017,6476
7,1,1,0,0,3,1,0,30,15,8581,6714,31,115,9020,6476
8,1,6,3,0,3,1,0,6,3,8587,6717,3,14,9023,6476
9,2,0,0,2,1,2,1,37,57,8587,6717,33,89,9024,6477
10,2,3,2,0,3,1,0,27,19,8590,6719,34,18,9027,6477
11,2,0,0,2,1,2,1,93,42,8590,6719,104,70,9028,6478
12,2,3,0,0,3,1,0,122,114,8593,6719,122,51,9031,6478
13,2,0,1,1,0,0,3,123,98,8593,6720,127,3,9031,6481
14,2,1,2,1,0,0,3,118,78,8594,6722,125,92,9031,6484
15,2,1,2,1,0,0,3,102,85,8595,6724,110,78,9031,6487
16,2,4,3,0,3,1,0,53,63,8599,6727,68,78,9034,6487
17,2,2,2,2,1,2,1,29,18,8601,6729,35,95,9035,6488
18,3,1,0,0,3,1,0,31,15,8602,6729,34,85,9038,6488
19,3,0,6,1,0,0,3,103,77,8602,6735,115,53,9038,6491
20,3,1,2,1,0,0,3,117,117,8603,6737,119,67,9038,6494
21,3,1,3,1,0,0,3,7,6,8604,6740,3,109,9038,6497
22,3,0,2,1,0,0,3,76,51,8604,6742,93,22,9038,6500
23,3,2,2,2,1,2,1,135,95,8606,6744,154,69,9039,6501
24,3,3,2,0,3,1,0,113,82,8609,6746,119,95,9042,6501
25,3,2,2,2,1,2,1,81,66,8611,6748,84,25,9043,6502
26,3,2,2,2,1,2,1,29,21,8613,6750,35,116,9044,6503
27,4,0,2,1,0,0,3,122,61,8613,6752,137,92,9044,6506
28,4,0,0,2,1,2,1,53,63,8613,6752,69,19,9045,6507
29,4,0,2,1,0,0,3,37,59,8613,6754,33,73,9045,6510
30,4,2,0,0,3,1,0,104,85,8615,6754,113,51,9048,6510
31,4,1,2,1,0,0,3,119,80,8616,6756,125,6,9048,6513
32,4,0,1,1,0,0,3,29,19,8616,6757,35,81,9048,6516
33,4,2,1,0,3,1,0,124,115,8618,6758,125,14,9051,6516
34,4,0,0,2,1,2,1,123,98,8618,6758,128,79,9052,6517
35,4,1,0,0,3,1,0,94,42,8619,6758,107,92,9055,6517
36,5,4,1,0,3,1,0,11,7,8623,6759,6,53,9058,6517
37,5,1,1,2,1,2,1,136,96,8624,6760,155,23,9059,6518
38,5,3,1,0,3,1,0,34,16,8627,6761,37,69,9062,6518
39,5,1,2,1,0,0,3,104,79,8628,6763,115,28,9062,6521
40,5,2,2,2,1,2,1,83,68,8630,6765,85,96,9063,6522
41,5,6,0,0,3,1,0,82,51,8636,6765,96,67,9066,6522
42,5,1,0,0,3,1,0,30,21,8637,6765,38,85,9069,6522
43,5,1,0,0,3,1,0,118,117,8638,6765,122,81,9072,6522
44,5,1,0,0,3,1,0,125,115,8639,6765,128,116,9075,6522
45,6,0,2,1,0,0,3,94,44,8639,6767,107,9,9075,6525
46,6,2,0,0,3,1,0,31,19,8641,6767,38,92,9078,6525
47,6,1,1,2,1,2,1,54,64,8642,6768,70,110,9079,6526
48,6,0,3,1,0,0,3,104,88,8642,6771,113,82,9079,6529
49,6,0,0,2,1,2,1,37,59,8642,6771,34,20,9080,6530
50,6,3,0,0,3,1,0,122,80,8645,6771,128,116,9083,6530
51,6,3,2,0,3,1,0,125,63,8648,6773,140,14,9086,6530
52,6,0,3,1,0,0,3,118,120,8648,6776,122,76,9086,6533
53,6,2,0,0,3,1,0,115,82,8650,6776,122,51,9089,6533
54,7,2,2,2,1,2,1,13,9,8652,6778,7,29,9090,6534
55,7,1,1,2,1,2,1,126,116,8653,6779,129,86,9091,6535
56,7,1,1,2,1,2,1,35,17,8654,6780,38,24,9092,6536
57,7,2,0,0,3,1,0,106,79,8656,6780,118,67,9095,6536
58,7,2,0,0,3,1,0,32,21,8658,6780,41,53,9098,6536
59,7,1,1,2,1,2,1,124,99,8659,6781,129,70,9099,6537
60,7,0,0,2,1,2,1,82,51,8659,6781,97,82,9100,6538
61,7,1,2,1,0,0,3,137,98,8660,6783,155,99,9100,6541
62,7,0,1,1,0,0,3,83,69,8660,6784,85,95,9100,6544
63,8,1,1,2,1,2,1,105,89,8661,6785,114,87,9101,6545
64,8,0,3,1,0,0,3,94,47,8661,6788,107,17,9101,6548
65,8,1,1,2,1,2,1,55,65,8662,6789,71,117,9102,6549
66,8,1,1,2,1,2,1,38,60,8663,6790,35,111,9103,6550
67,8,3,0,0,3,1,0,128,63,8666,6790,143,92,9106,6550
68,8,1,0,0,3,1,0,116,82,8667,6790,125,20,9109,6550
69,8,3,2,0,3,1,0,121,122,8670,6792,125,82,9112,6550
70,8,0,5,1,0,0,3,83,74,8670,6797,85,79,9112,6553
71,8,1,1,2,1,2,1,32,20,8671,6798,39,10,9113,6554
72,9,2,2,2,1,2,1,34,23,8673,6800,42,30,9114,6555
73,9,0,1,1,0,0,3,122,81,8673,6801,128,56,9114,6558
74,9,1,2,1,0,0,3,127,118,8674,6803,129,73,9114,6561
75,9,0,0,2,1,2,1,106,79,8674,6803,119,83,9115,6562
76,9,3,2,0,3,1,0,140,100,8677,6805,158,51,9118,6562
77,9,2,0,0,3,1,0,15,9,8679,6805,10,95,9121,6562
78,9,2,2,2,1,2,1,126,101,8681,6807,130,25,9122,6563
79,9,1,1,2,1,2,1,36,18,8682,6808,39,68,9123,6564
80,9,0,1,1,0,0,3,82,52,8682,6809,97,102,9123,6567
81,10,0,4,1,0,0,3,121,126,8682,6813,125,23,9123,6570
82,10,3,0,0,3,1,0,97,47,8685,6813,110,87,9126,6570
83,10,1,1,2,1,2,1,39,61,8686,6814,36,118,9127,6571
84,10,0,5,1,0,0,3,128,68,8686,6819,143,114,9127,6574
85,10,1,3,1,0,0,3,117,85,8687,6822,125,59,9127,6577
86,10,1,1,2,1,2,1,106,90,8688,6823,115,11,9128,6578
87,10,3,2,0,3,1,0,35,22,8691,6825,42,17,9131,6578
88,10,2,1,0,3,1,0,84,53,8693,6826,100,82,9134,6578
89,10,1,0,0,3,1,0,84,74,8694,6826,88,92,9137,6578
90,11,2,0,0,3,1,0,108,79,8696,6826,122,79,9140,6578
91,11,1,0,0,3,1,0,123,81,8697,6826,131,30,9143,6578
92,11,1,0,0,3,1,0,56,65,8698,6826,74,73,9146,6578
93,11,1,1,2,1,2,1,35,24,8699,6827,43,96,9147,6579
94,11,3,3,2,1,2,1,143,103,8702,6830,159,84,9148,6580
95,11,5,2,0,3,1,0,20,11,8707,6832,13,102,9151,6580
96,11,0,1,1,0,0,3,127,119,8707,6833,129,28,9151,6583
97,11,1,0,0,3,1,0,37,18,8708,6833,42,51,9154,6583
98,11,0,1,1,0,0,3,126,102,8708,6834,130,71,9154,6586
99,12,2,1,0,3,1,0,37,23,8710,6835,45,87,9157,6586
100,12,1,0,0,3,1,0,129,68,8711,6835,146,118,9160,6586
101,12,3,2,0,3,1,0,124,128,8714,6837,128,114,9163,6586
102,12,2,0,0,3,1,0,108,90,8716,6837,118,73,9166,6586
103,12,0,2,1,0,0,3,143,105,8716,6839,159,95,9166,6589
104,12,0,0,2,1,2,1,84,74,8716,6839,89,18,9167,6590
105,12,1,0,0,3,1,0,85,53,8717,6839,103,23,9170,6590
106,12,1,0,0,3,1,0,118,85,8718,6839,128,11,9173,6590
107,12,0,0,2,1,2,1,39,61,8718,6839,37,60,9174,6591
108,13,0,2,1,0,0,3,97,49,8718,6841,110,33,9174,6594
109,13,1,0,0,3,1,0,124,81,8719,6841,134,102,9177,6594
110,13,1,1,2,1,2,1,128,120,8720,6842,130,85,9178,6595
111,13,1,1,2,1,2,1,109,80,8721,6843,123,97,9179,6596
112,13,0,2,1,0,0,3,37,20,8721,6845,42,85,9179,6599
113,13,2,2,2,1,2,1,22,13,8723,6847,14,80,9180,6600
114,13,1,0,0,3,1,0,127,102,8724,6847,133,51,9183,6600
115,13,1,2,1,0,0,3,57,67,8725,6849,74,31,9183,6603
116,13,0,0,2,1,2,1,35,24,8725,6849,44,72,9184,6604
117,14,3,0,0,3,1,0,111,90,8728,6849,121,114,9187,6604
118,14,0,0,2,1,2,1,129,68,8728,6849,147,34,9188,6605
119,14,0,1,1,0,0,3,124,129,8728,6850,128,63,9188,6608
120,14,3,3,2,1,2,1,146,108,8731,6853,160,19,9189,6609
121,14,1,1,2,1,2,1,85,75,8732,6854,90,12,9190,6610
122,14,1,1,2,1,2,1,110,81,8733,6855,124,24,9191,6611
123,14,0,2,1,0,0,3,37,25,8733,6857,45,76,9191,6614
124,14,0,0,2,1,2,1,85,53,8733,6857,104,119,9192,6615
125,14,4,0,0,3,1,0,122,85,8737,6857,131,87,9195,6615
126,15,1,1,2,1,2,1,125,82,8738,6858,135,52,9196,6616
127,15,1,1,2,1,2,1,129,121,8739,6859,131,86,9197,6617
128,15,3,1,0,3,1,0,60,68,8742,6860,77,72,9200,6617
129,15,2,0,0,3,1,0,129,102,8744,6860,136,85,9203,6617
130,15,0,1,1,0,0,3,39,62,8744,6861,37,34,9203,6620
131,15,4,1,0,3,1,0,26,14,8748,6862,17,95,9206,6620
132,15,1,1,2,1,2,1,98,50,8749,6863,111,98,9207,6621
133,15,1,2,1,0,0,3,38,22,8750,6865,42,105,9207,6624
134,15,2,1,0,3,1,0,37,25,8752,6866,47,80,9210,6624
135,16,1,2,1,0,0,3,39,24,8753,6868,42,15,9210,6627
136,16,2,4,1,0,0,3,131,72,8755,6872,147,79,9210,6630
137,16,1,0,0,3,1,0,86,53,8756,6872,107,114,9213,6630
138,16,4,4,2,1,2,1,114,85,8760,6876,125,120,9214,6631
139,16,1,1,2,1,2,1,147,109,8761,6877,161,35,9215,6632
140,16,0,4,1,0,0,3,122,89,8761,6881,131,22,9215,6635
141,16,1,2,1,0,0,3,125,131,8762,6883,128,90,9215,6638
142,16,3,0,0,3,1,0,88,75,8765,6883,93,63,9218,6638
143,16,0,1,1,0,0,3,111,91,8765,6884,121,37,9218,6641
144,17,0,1,1,0,0,3,129,103,8765,6885,136,101,9218,6644
145,17,2,1,0,3,1,0,39,26,8767,6886,50,95,9221,6644
146,17,1,1,2,1,2,1,61,69,8768,6887,78,106,9222,6645
147,17,3,0,0,3,1,0,29,14,8771,6887,20,86,9225,6645
148,17,2,1,0,3,1,0,41,63,8773,6888,40,72,9228,6645
149,17,1,2,1,0,0,3,99,52,8774,6890,111,88,9228,6648
150,17,4,2,0,3,1,0,41,27,8778,6892,48,52,9231,6648
151,17,1,1,2,1,2,1,130,122,8779,6893,132,25,9232,6649
152,17,1,0,0,3,1,0,126,82,8780,6893,138,80,9235,6649
153,18,4,0,0,3,1,0,134,122,8784,6893,135,95,9238,6649
154,18,0,2,1,0,0,3,61,71,8784,6895,78,83,9238,6652
155,18,1,3,1,0,0,3,130,106,8785,6898,136,28,9238,6655
156,18,0,3,1,0,0,3,126,85,8785,6901,138,89,9238,6658
157,18,1,0,0,3,1,0,112,91,8786,6901,124,106,9241,6658
158,18,2,0,0,3,1,0,101,52,8788,6901,114,52,9244,6658
159,18,2,1,0,3,1,0,41,27,8790,6902,53,15,9247,6658
160,18,3,1,0,3,1,0,44,28,8793,6903,51,101,9250,6658
161,18,0,0,2,1,2,1,41,63,8793,6903,41,89,9251,6659
162,19,1,2,1,0,0,3,123,91,8794,6905,131,75,9251,6662
163,19,1,0,0,3,1,0,148,109,8795,6905,164,63,9254,6662
164,19,1,2,1,0,0,3,126,133,8796,6907,128,38,9254,6665
165,19,1,2,1,0,0,3,132,74,8797,6909,147,40,9254,6668
166,19,0,3,1,0,0,3,39,27,8797,6912,42,25,9254,6671
167,19,1,1,2,1,2,1,87,54,8798,6913,108,80,9255,6672
168,19,0,0,2,1,2,1,88,75,8798,6913,94,115,9256,6673
169,19,3,0,0,3,1,0,32,14,8801,6913,23,120,9259,6673
170,19,0,0,2,1,2,1,114,85,8801,6913,126,91,9260,6674
171,20,2,0,0,3,1,0,136,122,8803,6913,138,15,9263,6674
172,20,1,0,0,3,1,0,62,71,8804,6913,81,95,9266,6674
173,20,2,2,2,1,2,1,103,54,8806,6915,115,90,9267,6675
174,20,0,1,1,0,0,3,130,107,8806,6916,136,28,9267,6678
175,20,0,1,1,0,0,3,126,86,8806,6917,138,31,9267,6681
176,20,2,0,0,3,1,0,46,28,8808,6917,54,83,9270,6681
177,20,0,2,1,0,0,3,132,76,8808,6919,147,92,9270,6684
178,20,1,1,2,1,2,1,113,92,8809,6920,125,102,9271,6685
179,20,2,1,0,3,1,0,43,64,8811,6921,44,52,9274,6685
180,21,0,4,1,0,0,3,114,89,8811,6925,126,83,9274,6688
181,21,1,0,0,3,1,0,124,91,8812,6925,134,40,9277,6688
182,21,1,2,1,0,0,3,127,135,8813,6927,128,109,9277,6691
183,21,0,1,1,0,0,3,88,76,8813,6928,94,78,9277,6694
184,21,1,1,2,1,2,1,40,28,8814,6929,43,64,9278,6695
185,21,1,2,1,0,0,3,33,16,8815,6931,23,94,9278,6698
186,21,3,0,0,3,1,0,151,109,8818,6931,167,120,9281,6698
187,21,1,0,0,3,1,0,88,54,8819,6931,111,38,9284,6698
188,21,1,1,2,1,2,1,42,28,8820,6932,54,116,9285,6699
189,22,3,0,0,3,1,0,49,28,8823,6932,57,90,9288,6699
190,22,1,3,1,0,0,3,125,94,8824,6935,134,105,9288,6702
191,22,1,1,2,1,2,1,133,77,8825,6936,148,53,9289,6703
192,22,2,2,2,1,2,1,115,94,8827,6938,126,84,9290,6704
193,22,2,2,2,1,2,1,105,56,8829,6940,116,32,9291,6705
194,22,0,2,1,0,0,3,62,73,8829,6942,81,18,9291,6708
195,22,1,1,2,1,2,1,44,65,8830,6943,45,96,9292,6709
196,22,1,1,2,1,2,1,131,108,8831,6944,137,117,9293,6710
197,22,1,1,2,1,2,1,127,87,8832,6945,139,29,9294,6711
198,23,2,1,0,3,1,0,153,110,8834,6946,170,78,9297,6711
199,23,0,1,1,0,0,3,114,90,8834,6947,126,43,9297,6714
200,23,2,1,0,3,1,0,44,29,8836,6948,57,109,9300,6714
201,23,2,0,0,3,1,0,35,16,8838,6948,26,83,9303,6714
202,23,3,2,0,3,1,0,134,110,8841,6950,140,94,9306,6714
203,23,3,2,0,3,1,0,139,124,8844,6952,141,64,9309,6714
204,23,0,2,1,0,0,3,88,78,8844,6954,94,95,9309,6717
205,23,0,0,2,1,2,1,88,54,8844,6954,112,106,9310,6718
206,23,3,2,0,3,1,0,43,30,8847,6956,46,38,9313,6718
207,24,0,0,2,1,2,1,115,94,8847,6956,127,97,9314,6719
208,24,0,2,1,0,0,3,62,75,8847,6958,81,32,9314,6722
209,24,2,0,0,3,1,0,135,77,8849,6958,151,90,9317,6722
210,24,1,3,1,0,0,3,128,90,8850,6961,139,120,9317,6725
211,24,0,1,1,0,0,3,105,57,8850,6962,116,123,9317,6728
212,24,1,4,1,0,0,3,45,69,8851,6966,45,21,9317,6731
213,24,3,1,0,3,1,0,52,29,8854,6967,60,32,9320,6731
214,24,3,3,2,1,2,1,130,138,8857,6970,129,54,9321,6732
215,24,1,0,0,3,1,0,126,94,8858,6970,137,84,9324,6732
216,25,0,1,1,0,0,3,128,91,8858,6971,139,81,9324,6735
217,25,3,2,0,3,1,0,137,112,8861,6973,143,64,9327,6735
218,25,2,1,0,3,1,0,46,30,8863,6974,60,83,9330,6735
219,25,1,1,2,1,2,1,115,91,8864,6975,127,110,9331,6736
220,25,4,0,0,3,1,0,157,110,8868,6975,173,106,9334,6736
221,25,2,0,0,3,1,0,45,30,8870,6975,49,95,9337,6736
222,25,2,2,2,1,2,1,141,126,8872,6977,142,39,9338,6737
223,25,1,1,2,1,2,1,89,55,8873,6978,113,55,9339,6738
224,25,2,1,0,3,1,0,37,17,8875,6979,29,43,9342,6738
225,26,3,4,1,0,0,3,129,98,8878,6983,137,100,9342,6741
226,26,3,0,0,3,1,0,138,77,8881,6983,154,84,9345,6741
227,26,0,4,1,0,0,3,45,73,8881,6987,45,35,9345,6744
228,26,1,0,0,3,1,0,63,75,8882,6987,84,94,9348,6744
229,26,2,1,0,3,1,0,90,79,8884,6988,97,90,9351,6744
230,26,1,3,1,0,0,3,131,141,8885,6991,129,24,9351,6747
231,26,2,1,0,3,1,0,54,30,8887,6992,63,123,9354,6747
232,26,0,0,2,1,2,1,115,94,8887,6992,128,33,9355,6748
233,26,0,2,1,0,0,3,105,59,8887,6994,116,123,9355,6751
234,27,2,2,2,1,2,1,47,32,8889,6996,50,107,9356,6752
235,27,3,1,0,3,1,0,160,111,8892,6997,176,84,9359,6752
236,27,0,0,2,1,2,1,115,91,8892,6997,128,56,9360,6753
237,27,4,3,0,3,1,0,132,94,8896,7000,142,83,9363,6753
238,27,0,2,1,0,0,3,63,77,8896,7002,84,98,9363,6756
239,27,3,1,0,3,1,0,49,31,8899,7003,63,43,9366,6756
240,27,2,2,2,1,2,1,143,128,8901,7005,143,111,9367,6757
241,27,1,1,2,1,2,1,138,113,8902,7006,144,40,9368,6758
242,27,1,0,0,3,1,0,38,17,8903,7006,32,81,9371,6758
243,28,2,1,0,3,1,0,91,56,8905,7007,116,100,9374,6758
244,28,0,0,2,1,2,1,129,98,8905,7007,138,91,9375,6759
245,28,0,2,1,0,0,3,90,81,8905,7009,97,36,9375,6762
246,28,0,0,2,1,2,1,45,73,8905,7009,46,95,9376,6763
247,28,3,1,0,3,1,0,57,31,8908,7010,66,123,9379,6763
248,28,0,3,1,0,0,3,131,144,8908,7013,129,38,9379,6766
249,28,3,1,0,3,1,0,118,95,8911,7014,131,123,9382,6766
250,28,2,0,0,3,1,0,107,59,8913,7014,119,64,9385,6766
251,28,2,3,1,0,0,3,140,80,8915,7017,154,27,9385,6769
252,29,2,2,2,1,2,1,49,34,8917,7019,51,85,9386,6770
253,29,0,4,1,0,0,3,115,95,8917,7023,128,94,9386,6773
254,29,0,1,1,0,0,3,138,114,8917,7024,144,114,9386,6776
255,29,4,1,0,3,1,0,147,129,8921,7025,146,107,9389,6776
256,29,1,4,1,0,0,3,64,81,8922,7029,84,43,9389,6779
257,29,0,0,2,1,2,1,107,59,8922,7029,120,82,9390,6780
258,29,4,3,0,3,1,0,42,20,8926,7032,35,98,9393,6780
259,29,1,2,1,0,0,3,50,33,8927,7034,63,59,9393,6783
260,29,1,3,1,0,0,3,133,97,8928,7037,142,46,9393,6786
261,30,2,1,0,3,1,0,92,82,8930,7038,100,123,9396,6786
262,30,0,2,1,0,0,3,131,146,8930,7040,129,103,9396,6789
263,30,0,1,1,0,0,3,57,32,8930,7041,66,67,9396,6792
264,30,2,1,0,3,1,0,120,96,8932,7042,134,38,9399,6792
265,30,2,0,0,3,1,0,131,98,8934,7042,141,123,9402,6792
266,30,0,1,1,0,0,3,45,74,8934,7043,46,86,9402,6795
267,30,3,1,0,3,1,0,143,81,8937,7044,157,95,9405,6795
268,30,1,0,0,3,1,0,161,111,8938,7044,179,36,9408,6795
269,30,2,2,2,1,2,1,93,58,8940,7046,117,28,9409,6796
270,31,1,1,2,1,2,1,134,98,8941,7047,143,99,9410,6797
271,31,1,1,2,1,2,1,148,130,8942,7048,147,83,9411,6798
272,31,3,0,0,3,1,0,45,20,8945,7048,38,59,9414,6798
273,31,1,1,2,1,2,1,50,35,8946,7049,52,104,9415,6799
274,31,6,2,0,3,1,0,56,35,8952,7051,66,94,9418,6799
275,31,1,0,0,3,1,0,139,114,8953,7051,147,85,9421,6799
276,31,4,2,0,3,1,0,49,76,8957,7053,49,114,9424,6799
277,31,1,0,0,3,1,0,65,81,8958,7053,87,107,9427,6799
278,31,1,1,2,1,2,1,108,60,8959,7054,121,47,9428,6800
279,32,1,2,1,0,0,3,116,97,8960,7056,128,31,9428,6803
280,32,1,4,1,0,0,3,132,150,8961,7060,129,89,9428,6806
281,32,2,1,0,3,1,0,94,83,8963,7061,103,95,9431,6806
282,32,1,0,0,3,1,0,162,111,8964,7061,182,123,9434,6806
283,32,0,2,1,0,0,3,131,100,8964,7063,141,126,9434,6809
284,32,1,1,2,1,2,1,58,33,8965,7064,67,44,9435,6810
285,32,3,1,0,3,1,0,96,59,8968,7065,120,38,9438,6810
286,32,0,2,1,0,0,3,143,83,8968,7067,157,39,9438,6813
287,32,3,0,0,3,1,0,123,96,8971,7067,137,67,9441,6813
288,33,1,0,0,3,1,0,140,114,8972,7067,150,104,9444,6813
289,33,2,0,0,3,1,0,60,33,8974,7067,70,83,9447,6813
290,33,2,3,1,0,0,3,150,133,8976,7070,147,88,9447,6816
291,33,2,0,0,3,1,0,51,76,8978,7070,52,94,9450,6816
292,33,3,1,0,3,1,0,111,61,8981,7071,124,114,9453,6816
293,33,1,0,0,3,1,0,57,35,8982,7071,69,99,9456,6816
294,33,2,0,0,3,1,0,47,20,8984,7071,41,39,9459,6816
295,33,1,0,0,3,1,0,135,98,8985,7071,146,107,9462,6816
296,33,2,2,2,1,2,1,67,83,8987,7073,88,60,9463,6817
297,34,2,1,0,3,1,0,164,112,8989,7074,185,31,9466,6817
298,34,5,2,0,3,1,0,136,102,8994,7076,144,89,9469,6817
299,34,1,0,0,3,1,0,95,83,8995,7076,106,47,9472,6817
300,34,0,1,1,0,0,3,116,98,8995,7077,128,41,9472,6820
301,34,0,2,1,0,0,3,96,61,8995,7079,120,98,9472,6823
302,34,2,4,1,0,0,3,52,39,8997,7083,52,126,9472,6826
303,34,2,1,0,3,1,0,134,151,8999,7084,132,126,9475,6826
304,34,3,1,0,3,1,0,146,84,9002,7085,160,67,9478,6826
305,34,1,1,2,1,2,1,124,97,9003,7086,138,45,9479,6827
0,1,0,4,1,0,0,3,111,65,9003,7090,124,3,9479,6830
1,1,2,1,0,3,1,0,152,134,9005,7091,150,94,9482,6830
2,1,2,2,2,1,2,1,69,85,9007,7093,89,99,9483,6831
3,1,1,1,2,1,2,1,75,67,9008,7094,78,42,9484,6832
4,1,1,0,0,3,1,0,147,84,9009,7094,163,126,9487,6832
5,1,2,1,0,3,1,0,98,62,9011,7095,123,0,9490,6832
6,1,1,0,0,3,1,0,53,39,9012,7095,55,76,9493,6832
7,1,0,0,2,1,2,1,51,76,9012,7095,53,84,9494,6833
8,1,2,1,0,3,1,0,2,1,9014,7096,3,99,9497,6833
9,2,1,1,2,1,2,1,58,36,9015,7097,70,40,9498,6834
10,2,2,0,0,3,1,0,106,93,9017,7097,132,67,9501,6834
11,2,1,0,0,3,1,0,136,98,9018,7097,149,0,9504,6834
12,2,1,1,2,1,2,1,125,98,9019,7098,139,127,9505,6835
13,2,0,2,1,0,0,3,136,104,9019,7100,144,91,9505,6838
14,2,3,1,0,3,1,0,3,1,9022,7101,3,114,9508,6838
15,2,1,0,0,3,1,0,141,114,9023,7101,153,45,9511,6838
16,2,1,1,2,1,2,1,1,1,9024,7102,1,90,9512,6839
17,2,2,2,2,1,2,1,166,114,9026,7104,186,38,9513,6840
18,3,1,1,2,1,2,1,153,135,9027,7105,151,4,9514,6841
19,3,1,2,1,0,0,3,54,41,9028,7107,55,3,9514,6844
20,3,1,2,1,0,0,3,70,87,9029,7109,89,3,9514,6847
21,3,0,0,2,1,2,1,125,98,9029,7109,140,127,9515,6848
22,3,3,2,0,3,1,0,150,86,9032,7111,166,76,9518,6848
23,3,6,1,0,3,1,0,104,63,9038,7112,126,42,9521,6848
24,3,4,4,2,1,2,1,55,80,9042,7116,54,95,9522,6849
25,3,1,0,0,3,1,0,76,67,9043,7116,81,99,9525,6849
26,3,0,0,2,1,2,1,111,65,9043,7116,125,100,9526,6850
27,4,1,2,1,0,0,3,3,3,9044,7118,3,43,9526,6853
28,4,0,2,1,0,0,3,106,95,9044,7120,132,94,9526,6856
29,4,2,0,0,3,1,0,3,1,9046,7120,4,127,9529,6856
30,4,2,1,0,3,1,0,138,105,9048,7121,147,45,9532,6856
31,4,4,0,0,3,1,0,170,114,9052,7121,189,84,9535,6856
32,4,0,2,1,0,0,3,3,3,9052,7123,3,41,9535,6859
33,4,2,0,0,3,1,0,72,87,9054,7123,92,90,9538,6859
34,4,1,1,2,1,2,1,137,99,9055,7124,150,115,9539,6860
35,4,1,2,1,0,0,3,59,38,9056,7126,70,130,9539,6863
36,5,5,4,0,3,1,0,158,139,9061,7130,154,42,9542,6863
37,5,0,3,1,0,0,3,150,89,9061,7133,166,6,9542,6866
38,5,1,2,1,0,0,3,142,116,9062,7135,153,98,9542,6869
39,5,2,1,0,3,1,0,106,64,9064,7136,129,67,9545,6869
40,5,0,1,1,0,0,3,111,66,9064,7137,125,6,9545,6872
41,5,2,0,0,3,1,0,56,41,9066,7137,58,100,9548,6872
42,5,1,1,2,1,2,1,126,99,9067,7138,141,100,9549,6873
43,5,3,3,2,1,2,1,58,83,9070,7141,55,5,9550,6874
44,5,0,3,1,0,0,3,76,70,9070,7144,81,79,9550,6877
45,6,2,0,0,3,1,0,5,3,9072,7144,6,94,9553,6877
46,6,1,2,1,0,0,3,60,40,9073,7146,70,118,9553,6880
47,6,0,0,2,1,2,1,72,87,9073,7146,93,44,9554,6881
48,6,3,0,0,3,1,0,140,99,9076,7146,153,127,9557,6881
49,6,1,0,0,3,1,0,4,3,9077,7146,6,84,9560,6881
50,6,3,0,0,3,1,0,114,66,9080,7146,128,41,9563,6881
51,6,1,1,2,1,2,1,107,96,9081,7147,133,46,9564,6882
52,6,0,1,1,0,0,3,3,2,9081,7148,4,101,9564,6885
53,6,2,2,2,1,2,1,140,107,9083,7150,148,131,9565,6886
54,7,1,1,2,1,2,1,159,140,9084,7151,155,7,9566,6887
55,7,2,1,0,3,1,0,108,65,9086,7152,132,100,9569,6887
56,7,1,1,2,1,2,1,151,90,9087,7153,167,68,9570,6888
57,7,2,0,0,3,1,0,128,99,9089,7153,144,79,9573,6888
58,7,3,0,0,3,1,0,59,41,9092,7153,61,90,9576,6888
59,7,1,3,1,0,0,3,59,86,9093,7156,55,45,9576,6891
60,7,0,2,1,0,0,3,142,118,9093,7158,153,8,9576,6894
61,7,2,2,2,1,2,1,78,72,9095,7160,82,7,9577,6895
62,7,2,0,0,3,1,0,172,114,9097,7160,192,100,9580,6895
63,8,2,0,0,3,1,0,62,40,9099,7160,73,101,9583,6895
64,8,2,0,0,3,1,0,74,87,9101,7160,96,41,9586,6895
65,8,2,4,1,0,0,3,109,100,9103,7164,133,130,9586,6898
66,8,2,0,0,3,1,0,6,3,9105,7164,9,100,9589,6898
67,8,1,1,2,1,2,1,141,100,9106,7165,154,85,9590,6899
68,8,0,0,2,1,2,1,114,66,9106,7165,129,47,9591,6900
69,8,1,1,2,1,2,1,60,42,9107,7166,62,95,9592,6901
70,8,2,0,0,3,1,0,5,2,9109,7166,7,131,9595,6901
71,8,4,0,0,3,1,0,9,3,9113,7166,9,118,9598,6901
72,9,1,2,1,0,0,3,141,109,9114,7168,148,82,9598,6904
73,9,2,2,2,1,2,1,161,142,9116,7170,156,69,9599,6905
74,9,0,1,1,0,0,3,59,87,9116,7171,55,10,9599,6908
75,9,0,2,1,0,0,3,151,92,9116,7173,167,47,9599,6911
76,9,5,0,0,3,1,0,83,72,9121,7173,85,7,9602,6911
77,9,2,1,0,3,1,0,174,115,9123,7174,195,8,9605,6911
78,9,0,3,1,0,0,3,128,102,9123,7177,144,48,9605,6914
79,9,1,3,1,0,0,3,143,121,9124,7180,153,103,9605,6917
80,9,1,0,0,3,1,0,109,65,9125,7180,135,90,9608,6917
81,10,4,0,0,3,1,0,145,100,9129,7180,157,47,9611,6917
82,10,2,1,0,3,1,0,11,4,9131,7181,12,131,9614,6917
83,10,0,2,1,0,0,3,5,4,9131,7183,7,88,9614,6920
84,10,0,0,2,1,2,1,60,42,9131,7183,63,42,9615,6921
85,10,3,0,0,3,1,0,77,87,9134,7183,99,100,9618,6921
86,10,2,0,0,3,1,0,64,40,9136,7183,76,8,9621,6921
87,10,1,0,0,3,1,0,110,65,9137,7183,138,118,9624,6921
88,10,1,3,1,0,0,3,110,103,9138,7186,133,104,9624,6924
89,10,3,0,0,3,1,0,117,66,9141,7186,132,130,9627,6924
90,11,1,0,0,3,1,0,60,87,9142,7186,58,69,9630,6924
91,11,6,2,0,3,1,0,149,123,9148,7188,156,82,9633,6924
92,11,3,2,0,3,1,0,86,74,9151,7190,88,95,9636,6924
93,11,0,1,1,0,0,3,174,116,9151,7191,195,106,9636,6927
94,11,0,1,1,0,0,3,151,93,9151,7192,167,93,9636,6930
95,11,3,1,0,3,1,0,9,4,9154,7193,12,10,9639,6930
96,11,2,1,0,3,1,0,163,143,9156,7194,159,47,9642,6930
97,11,1,3,1,0,0,3,129,105,9157,7197,144,10,9642,6933
98,11,1,1,2,1,2,1,142,110,9158,7198,149,49,9643,6934
99,12,0,3,1,0,0,3,145,103,9158,7201,157,45,9643,6937
100,12,2,1,0,3,1,0,62,43,9160,7202,66,88,9646,6937
101,12,1,2,1,0,0,3,111,105,9161,7204,133,52,9646,6940
102,12,2,1,0,3,1,0,153,94,9163,7205,170,130,9649,6940
103,12,1,0,0,3,1,0,118,66,9164,7205,135,104,9652,6940
104,12,3,1,0,3,1,0,14,5,9167,7206,15,47,9655,6940
105,12,2,2,2,1,2,1,112,67,9169,7208,139,9,9656,6941
106,12,3,2,0,3,1,0,80,89,9172,7210,102,131,9659,6941
107,12,1,0,0,3,1,0,6,4,9173,7210,10,100,9662,6941
108,13,2,2,2,1,2,1,66,42,9175,7212,77,11,9663,6942
109,13,1,1,2,1,2,1,164,144,9176,7213,160,96,9664,6943
110,13,2,1,0,3,1,0,62,88,9178,7214,61,47,9667,6943
111,13,2,0,0,3,1,0,11,4,9180,7214,15,82,9670,6943
112,13,1,3,1,0,0,3,130,108,9181,7217,144,72,9670,6946
113,13,0,1,1,0,0,3,142,111,9181,7218,149,109,9670,6949
114,13,1,1,2,1,2,1,175,117,9182,7219,196,11,9671,6950
115,13,2,1,0,3,1,0,88,75,9184,7220,91,118,9674,6950
116,13,1,1,2,1,2,1,150,124,9185,7221,157,94,9675,6951
117,14,2,2,2,1,2,1,147,105,9187,7223,158,10,9676,6952
118,14,2,1,0,3,1,0,155,95,9189,7224,173,47,9679,6952
119,14,1,1,2,1,2,1,7,5,9190,7225,11,83,9680,6953
120,14,2,0,0,3,1,0,64,43,9192,7225,69,100,9683,6953
121,14,2,2,2,1,2,1,90,77,9194,7227,92,131,9684,6954
122,14,2,1,0,3,1,0,114,68,9196,7228,142,131,9687,6954
123,14,0,0,2,1,2,1,118,66,9196,7228,136,89,9688,6955
124,14,0,1,1,0,0,3,80,90,9196,7229,102,107,9688,6958
125,14,3,1,0,3,1,0,17,6,9199,7230,18,52,9691,6958
126,15,3,2,0,3,1,0,14,6,9202,7232,18,47,9694,6958
127,15,0,0,2,1,2,1,142,111,9202,7232,150,95,9695,6959
128,15,1,2,1,0,0,3,131,110,9203,7234,144,121,9695,6962
129,15,1,3,1,0,0,3,67,45,9204,7237,77,75,9695,6965
130,15,1,0,0,3,1,0,151,124,9205,7237,160,45,9698,6965
131,15,1,0,0,3,1,0,63,88,9206,7237,64,131,9701,6965
132,15,0,4,1,0,0,3,111,109,9206,7241,133,14,9701,6968
133,15,0,0,2,1,2,1,7,5,9206,7241,12,110,9702,6969
134,15,2,0,0,3,1,0,177,117,9208,7241,199,96,9705,6969
135,16,3,0,0,3,1,0,67,43,9211,7241,72,107,9708,6969
136,16,0,2,1,0,0,3,147,107,9211,7243,158,55,9708,6972
137,16,0,0,2,1,2,1,90,77,9211,7243,93,90,9709,6973
138,16,1,0,0,3,1,0,165,144,9212,7243,163,131,9712,6973
139,16,0,0,2,1,2,1,118,66,9212,7243,137,84,9713,6974
140,16,3,2,0,3,1,0,117,70,9215,7245,145,47,9716,6974
141,16,0,2,1,0,0,3,155,97,9215,7247,173,103,9716,6977
142,16,0,0,2,1,2,1,80,90,9215,7247,103,12,9717,6978
143,16,1,2,1,0,0,3,18,8,9216,7249,18,13,9717,6981
144,17,1,1,2,1,2,1,152,125,9217,7250,161,48,9718,6982
145,17,1,1,2,1,2,1,178,118,9218,7251,200,122,9719,6983
146,17,0,0,2,1,2,1,111,109,9218,7251,134,111,9720,6984
147,17,1,1,2,1,2,1,143,112,9219,7252,151,132,9721,6985
148,17,0,0,2,1,2,1,131,110,9219,7252,145,97,9722,6986
149,17,0,0,2,1,2,1,14,6,9219,7252,19,76,9723,6987
150,17,1,2,1,0,0,3,64,90,9220,7254,64,48,9723,6990
151,17,3,0,0,3,1,0,10,5,9223,7254,15,14,9726,6990
152,17,2,1,0,3,1,0,69,46,9225,7255,80,95,9729,6990
153,18,2,1,0,3,1,0,180,119,9227,7256,203,132,9732,6990
154,18,2,1,0,3,1,0,154,126,9229,7257,164,122,9735,6990
155,18,0,3,1,0,0,3,147,110,9229,7260,158,79,9735,6993
156,18,1,1,2,1,2,1,11,6,9230,7261,16,98,9736,6994
157,18,2,1,0,3,1,0,113,110,9232,7262,137,48,9739,6994
158,18,0,1,1,0,0,3,143,113,9232,7263,151,17,9739,6997
159,18,3,2,0,3,1,0,134,112,9235,7265,148,47,9742,6997
160,18,1,2,1,0,0,3,70,48,9236,7267,80,51,9742,7000
161,18,1,0,0,3,1,0,15,6,9237,7267,22,95,9745,7000
162,19,2,1,0,3,1,0,66,91,9239,7268,67,131,9748,7000
163,19,4,1,0,3,1,0,159,98,9243,7269,176,13,9751,7000
164,19,1,0,0,3,1,0,119,66,9244,7269,140,12,9754,7000
165,19,2,3,1,0,0,3,69,46,9246,7272,72,58,9754,7003
166,19,2,0,0,3,1,0,82,90,9248,7272,106,84,9757,7003
167,19,1,2,1,0,0,3,118,72,9249,7274,145,106,9757,7006
168,19,0,0,2,1,2,1,90,77,9249,7274,94,108,9758,7007
169,19,1,1,2,1,2,1,166,145,9250,7275,164,91,9759,7008
170,19,2,0,0,3,1,0,20,8,9252,7275,21,111,9762,7008
171,20,1,1,2,1,2,1,71,49,9253,7276,81,99,9763,7009
172,20,0,0,2,1,2,1,113,110,9253,7276,138,123,9764,7010
173,20,1,1,2,1,2,1,148,111,9254,7277,159,96,9765,7011
174,20,2,1,0,3,1,0,156,127,9256,7278,167,91,9768,7011
175,20,0,2,1,0,0,3,11,8,9256,7280,16,51,9768,7014
176,20,3,1,0,3,1,0,183,120,9259,7281,206,47,9771,7014
177,20,2,1,0,3,1,0,22,9,9261,7282,24,79,9774,7014
178,20,2,0,0,3,1,0,145,113,9263,7282,154,51,9777,7014
179,20,2,1,0,3,1,0,17,7,9265,7283,25,132,9780,7014
180,21,1,2,1,0,0,3,70,48,9266,7285,72,20,9780,7017
181,21,3,0,0,3,1,0,122,66,9269,7285,143,79,9783,7017
182,21,1,1,2,1,2,1,119,73,9270,7286,146,85,9784,7018
183,21,1,0,0,3,1,0,160,98,9271,7286,179,111,9787,7018
184,21,2,1,0,3,1,0,168,146,9273,7287,167,12,9790,7018
185,21,1,2,1,0,0,3,91,79,9274,7289,94,16,9790,7021
186,21,1,1,2,1,2,1,67,92,9275,7290,68,107,9791,7022
187,21,1,2,1,0,0,3,135,114,9276,7292,148,111,9791,7025
188,21,2,0,0,3,1,0,158,127,9278,7292,170,58,9794,7025
189,22,0,1,1,0,0,3,82,91,9278,7293,106,102,9794,7028
190,22,1,1,2,1,2,1,12,9,9279,7294,17,124,9795,7029
191,22,2,0,0,3,1,0,185,120,9281,7294,209,131,9798,7029
192,22,0,0,2,1,2,1,148,111,9281,7294,160,52,9799,7030
193,22,2,2,2,1,2,1,19,9,9283,7296,26,48,9800,7031
194,22,0,1,1,0,0,3,71,50,9283,7297,81,135,9800,7034
195,22,2,0,0,3,1,0,24,9,9285,7297,27,96,9803,7034
196,22,1,4,1,0,0,3,114,114,9286,7301,138,54,9803,7037
197,22,5,0,0,3,1,0,150,113,9291,7301,157,91,9806,7037
198,23,1,2,1,0,0,3,169,148,9292,7303,167,114,9806,7040
199,23,3,3,2,1,2,1,94,82,9295,7306,95,97,9807,7041
200,23,2,0,0,3,1,0,187,120,9297,7306,212,12,9810,7041
201,23,2,0,0,3,1,0,137,114,9299,7306,151,16,9813,7041
202,23,1,2,1,0,0,3,159,129,9300,7308,170,110,9813,7044
203,23,1,0,0,3,1,0,161,98,9301,7308,182,58,9816,7044
204,23,2,2,2,1,2,1,72,50,9303,7310,73,80,9817,7045
205,23,2,2,2,1,2,1,69,94,9305,7312,69,86,9818,7046
206,23,1,1,2,1,2,1,120,74,9306,7313,147,21,9819,7047
207,24,1,1,2,1,2,1,25,10,9307,7314,28,136,9820,7048
208,24,1,2,1,0,0,3,151,115,9308,7316,157,114,9820,7051
209,24,1,0,0,3,1,0,115,114,9309,7316,141,91,9823,7051
210,24,1,0,0,3,1,0,20,9,9310,7316,29,131,9826,7051
211,24,0,2,1,0,0,3,12,11,9310,7318,17,57,9826,7054
212,24,1,1,2,1,2,1,83,92,9311,7319,107,125,9827,7055
213,24,1,1,2,1,2,1,123,67,9312,7320,144,53,9828,7056
214,24,1,0,0,3,1,0,72,50,9313,7320,84,48,9831,7056
215,24,1,2,1,0,0,3,149,113,9314,7322,160,105,9831,7059
216,25,2,0,0,3,1,0,71,94,9316,7322,72,97,9834,7059
217,25,3,2,0,3,1,0,123,76,9319,7324,150,53,9837,7059
218,25,2,1,0,3,1,0,161,130,9321,7325,173,12,9840,7059
219,25,1,0,0,3,1,0,162,98,9322,7325,185,21,9843,7059
220,25,0,0,2,1,2,1,151,115,9322,7325,158,17,9844,7060
221,25,2,0,0,3,1,0,96,82,9324,7325,98,80,9847,7060
222,25,0,3,1,0,0,3,137,117,9324,7328,151,117,9847,7063
223,25,1,1,2,1,2,1,170,149,9325,7329,168,87,9848,7064
224,25,1,0,0,3,1,0,188,120,9326,7329,215,58,9851,7064
225,26,1,0,0,3,1,0,116,114,9327,7329,144,110,9854,7064
226,26,2,1,0,3,1,0,74,51,9329,7330,87,91,9857,7064
227,26,0,1,1,0,0,3,149,114,9329,7331,160,134,9857,7067
228,26,0,0,2,1,2,1,83,92,9329,7331,108,137,9858,7068
229,26,2,0,0,3,1,0,22,9,9331,7331,32,114,9861,7068
230,26,1,1,2,1,2,1,13,12,9332,7332,18,49,9862,7069
231,26,0,1,1,0,0,3,123,68,9332,7333,144,108,9862,7072
232,26,0,2,1,0,0,3,72,52,9332,7335,73,128,9862,7075
233,26,3,3,2,1,2,1,28,13,9335,7338,29,58,9863,7076
234,27,1,0,0,3,1,0,23,9,9336,7338,35,58,9866,7076
235,27,0,0,2,1,2,1,151,115,9336,7338,159,81,9867,7077
236,27,2,1,0,3,1,0,73,95,9338,7339,75,117,9870,7077
237,27,1,1,2,1,2,1,138,118,9339,7340,152,13,9871,7078
238,27,1,1,2,1,2,1,162,131,9340,7341,174,22,9872,7079
239,27,0,0,2,1,2,1,162,98,9340,7341,186,109,9873,7080
240,27,0,0,2,1,2,1,170,149,9340,7341,169,98,9874,7081
241,27,2,1,0,3,1,0,98,83,9342,7342,101,53,9877,7081
242,27,0,1,1,0,0,3,188,121,9342,7343,215,90,9877,7084
243,28,0,0,2,1,2,1,13,12,9342,7343,19,18,9878,7085
244,28,0,2,1,0,0,3,74,53,9342,7345,87,113,9878,7088
245,28,1,3,1,0,0,3,84,95,9343,7348,108,52,9878,7091
246,28,0,0,2,1,2,1,72,52,9343,7348,74,138,9879,7092
247,28,2,0,0,3,1,0,125,68,9345,7348,147,128,9882,7092
248,28,2,2,2,1,2,1,151,116,9347,7350,161,115,9883,7093
249,28,2,0,0,3,1,0,30,13,9349,7350,32,91,9886,7093
250,28,3,0,0,3,1,0,119,114,9352,7350,147,134,9889,7093
251,28,1,0,0,3,1,0,124,76,9353,7350,153,58,9892,7093
252,29,1,0,0,3,1,0,24,9,9354,7350,38,109,9895,7093
253,29,2,1,0,3,1,0,76,54,9356,7351,90,90,9898,7093
254,29,1,0,0,3,1,0,171,149,9357,7351,172,128,9901,7093
255,29,3,1,0,3,1,0,191,122,9360,7352,218,98,9904,7093
256,29,0,1,1,0,0,3,138,119,9360,7353,152,56,9904,7096
257,29,1,1,2,1,2,1,163,132,9361,7354,175,82,9905,7097
258,29,1,1,2,1,2,1,99,84,9362,7355,102,118,9906,7098
259,29,1,0,0,3,1,0,152,115,9363,7355,162,13,9909,7098
260,29,2,3,1,0,0,3,75,98,9365,7358,75,25,9909,7101
261,30,1,3,1,0,0,3,152,119,9366,7361,161,116,9909,7104
262,30,1,0,0,3,1,0,126,68,9367,7361,150,134,9912,7104
263,30,1,0,0,3,1,0,163,98,9368,7361,189,58,9915,7104
264,30,2,2,2,1,2,1,121,116,9370,7363,148,19,9916,7105
265,30,2,2,2,1,2,1,74,54,9372,7365,75,53,9917,7106
266,30,1,1,2,1,2,1,14,13,9373,7366,20,59,9918,7107
267,30,2,0,0,3,1,0,126,76,9375,7366,156,138,9921,7107
268,30,4,0,0,3,1,0,88,95,9379,7366,111,91,9924,7107
269,30,3,1,0,3,1,0,33,14,9382,7367,35,115,9927,7107
270,31,3,0,0,3,1,0,155,115,9385,7367,165,56,9930,7107
271,31,2,1,0,3,1,0,193,123,9387,7368,221,82,9933,7107
272,31,4,2,0,3,1,0,175,151,9391,7370,175,58,9936,7107
273,31,2,3,1,0,0,3,78,57,9393,7373,90,28,9936,7110
274,31,1,1,2,1,2,1,76,99,9394,7374,76,129,9937,7111
275,31,1,3,1,0,0,3,139,122,9395,7377,152,101,9937,7114
276,31,0,1,1,0,0,3,163,133,9395,7378,175,112,9937,7117
277,31,1,0,0,3,1,0,25,9,9396,7378,41,118,9940,7117
278,31,3,1,0,3,1,0,124,117,9399,7379,151,13,9943,7117
279,32,0,2,1,0,0,3,74,56,9399,7381,75,22,9943,7120
280,32,1,2,1,0,0,3,127,70,9400,7383,150,119,9943,7123
281,32,1,2,1,0,0,3,100,86,9401,7385,102,137,9943,7126
282,32,0,1,1,0,0,3,88,96,9401,7386,111,62,9943,7129
283,32,1,1,2,1,2,1,153,120,9402,7387,162,14,9944,7130
284,32,0,1,1,0,0,3,163,99,9402,7388,189,94,9944,7133
285,32,1,1,2,1,2,1,176,152,9403,7389,176,54,9945,7134
286,32,3,0,0,3,1,0,36,14,9406,7389,38,90,9948,7134
287,32,3,1,0,3,1,0,129,77,9409,7390,159,115,9951,7134
288,33,1,0,0,3,1,0,26,9,9410,7390,44,28,9954,7134
289,33,1,2,1,0,0,3,164,135,9411,7392,175,141,9954,7137
290,33,6,0,0,3,1,0,82,99,9417,7392,79,112,9957,7137
291,33,1,1,2,1,2,1,156,116,9418,7393,166,130,9958,7138
292,33,1,0,0,3,1,0,125,117,9419,7393,154,101,9961,7138
293,33,0,1,1,0,0,3,193,124,9419,7394,221,59,9961,7141
294,33,0,1,1,0,0,3,14,14,9419,7395,20,85,9961,7144
295,33,2,3,1,0,0,3,80,60,9421,7398,90,121,9961,7147
296,33,3,4,1,0,0,3,142,126,9424,7402,152,61,9961,7150
297,34,1,1,2,1,2,1,89,97,9425,7403,112,23,9962,7151
298,34,1,0,0,3,1,0,128,70,9426,7403,153,62,9965,7151
299,34,1,3,1,0,0,3,177,155,9427,7406,176,122,9965,7154
300,34,1,2,1,0,0,3,164,101,9428,7408,189,118,9965,7157
301,34,2,1,0,3,1,0,131,78,9430,7409,162,94,9968,7157
302,34,1,1,2,1,2,1,101,87,9431,7410,103,55,9969,7158
303,34,2,1,0,3,1,0,76,57,9433,7411,78,137,9972,7158
304,34,1,0,0,3,1,0,154,120,9434,7411,165,90,9975,7158
305,34,4,1,0,3,1,0,40,15,9438,7412,41,14,9978,7158
0,1,0,1,1,0,0,3,177,156,9438,7413,176,125,9978,7161
1,1,0,1,1,0,0,3,115,104,9438,7414,117,121,9978,7164
2,1,1,0,0,3,1,0,31,10,9439,7414,41,130,9981,7164
3,1,2,1,0,3,1,0,84,100,9441,7415,82,9,9984,7164
4,1,3,0,0,3,1,0,83,60,9444,7415,93,101,9987,7164
5,1,1,0,0,3,1,0,102,87,9445,7415,106,60,9990,7164
6,1,2,2,2,1,2,1,2,2,9447,7417,1,86,9991,7165
7,1,2,2,2,1,2,1,156,122,9449,7419,166,113,9992,7166
8,1,2,1,0,3,1,0,78,58,9451,7420,81,90,9995,7166
9,2,4,3,0,3,1,0,197,127,9455,7423,224,0,9998,7166
10,2,1,0,0,3,1,0,90,97,9456,7423,115,107,10001,7166
11,2,1,1,2,1,2,1,129,71,9457,7424,154,22,10002,7167
12,2,1,1,2,1,2,1,96,84,9458,7425,107,142,10003,7168
13,2,2,0,0,3,1,0,133,78,9460,7425,165,59,10006,7168
14,2,0,1,1,0,0,3,18,34,9460,7426,10,65,10006,7171
15,2,1,2,1,0,0,3,165,103,9461,7428,189,58,10006,7174
16,2,0,2,1,0,0,3,125,119,9461,7430,154,124,10006,7177
17,2,2,2,2,1,2,1,158,118,9463,7432,167,62,10007,7178
18,3,3,0,0,3,1,0,34,10,9466,7432,44,125,10010,7178
19,3,1,1,2,1,2,1,134,79,9467,7433,166,91,10011,7179
20,3,0,4,1,0,0,3,102,91,9467,7437,106,89,10011,7182
21,3,1,2,1,0,0,3,79,60,9468,7439,81,63,10011,7185
22,3,2,0,0,3,1,0,158,122,9470,7439,169,101,10014,7185
23,3,2,4,1,0,0,3,117,108,9472,7443,117,12,10014,7188
24,3,2,2,2,1,2,1,85,62,9474,7445,94,122,10015,7189
25,3,3,1,0,3,1,0,5,3,9477,7446,4,130,10018,7189
26,3,2,0,0,3,1,0,86,100,9479,7446,85,142,10021,7189
27,4,0,1,1,0,0,3,165,104,9479,7447,189,110,10021,7192
28,4,1,2,1,0,0,3,97,86,9480,7449,107,25,10021,7195
29,4,1,0,0,3,1,0,159,118,9481,7449,170,59,10024,7195
30,4,3,1,0,3,1,0,128,120,9484,7450,157,65,10027,7195
31,4,1,2,1,0,0,3,19,36,9485,7452,10,3,10027,7198
32,4,1,1,2,1,2,1,198,128,9486,7453,225,59,10028,7199
33,4,3,2,0,3,1,0,180,158,9489,7455,179,62,10031,7199
34,4,1,2,1,0,0,3,91,99,9490,7457,115,127,10031,7202
35,4,1,1,2,1,2,1,130,72,9491,7458,155,114,10032,7203
36,5,1,1,2,1,2,1,103,92,9492,7459,107,131,10033,7204
37,5,1,3,1,0,0,3,80,63,9493,7462,81,15,10033,7207
38,5,1,2,1,0,0,3,118,110,9494,7464,117,94,10033,7210
39,5,0,4,1,0,0,3,86,104,9494,7468,85,66,10033,7213
40,5,2,1,0,3,1,0,7,4,9496,7469,7,101,10036,7213
41,5,1,2,1,0,0,3,35,12,9497,7471,44,145,10036,7216
42,5,1,1,2,1,2,1,135,80,9498,7472,167,90,10037,7217
43,5,3,2,0,3,1,0,161,124,9501,7474,172,122,10040,7217
44,5,0,1,1,0,0,3,85,63,9501,7475,94,128,10040,7220
45,6,0,3,1,0,0,3,128,123,9501,7478,157,6,10040,7223
46,6,1,1,2,1,2,1,199,129,9502,7479,226,115,10041,7224
47,6,0,4,1,0,0,3,159,122,9502,7483,170,113,10041,7227
48,6,1,0,0,3,1,0,92,99,9503,7483,118,101,10044,7227
49,6,1,6,1,0,0,3,98,92,9504,7489,107,68,10044,7230
50,6,4,3,0,3,1,0,39,15,9508,7492,47,59,10047,7230
51,6,3,1,0,3,1,0,168,105,9511,7493,192,127,10050,7230
52,6,1,2,1,0,0,3,181,160,9512,7495,179,62,10050,7233
53,6,0,2,1,0,0,3,19,38,9512,7497,10,65,10050,7236
54,7,2,2,2,1,2,1,120,112,9514,7499,118,67,10051,7237
55,7,1,0,0,3,1,0,93,99,9515,7499,121,122,10054,7237
56,7,0,2,1,0,0,3,130,74,9515,7501,155,97,10054,7240
57,7,0,1,1,0,0,3,7,5,9515,7502,7,131,10054,7243
58,7,3,0,0,3,1,0,138,80,9518,7502,170,131,10057,7243
59,7,0,2,1,0,0,3,103,94,9518,7504,107,62,10057,7246
60,7,2,2,2,1,2,1,82,65,9520,7506,82,26,10058,7247
61,7,1,0,0,3,1,0,162,124,9521,7506,175,15,10061,7247
62,7,3,1,0,3,1,0,88,64,9524,7507,97,145,10064,7247
63,8,1,0,0,3,1,0,129,123,9525,7507,160,90,10067,7247
64,8,1,3,1,0,0,3,99,95,9526,7510,107,9,10067,7250
65,8,1,2,1,0,0,3,160,124,9527,7512,170,130,10067,7253
66,8,1,1,2,1,2,1,87,105,9528,7513,86,63,10068,7254
67,8,2,1,0,3,1,0,21,39,9530,7514,13,115,10071,7254
68,8,3,3,2,1,2,1,42,18,9533,7517,48,66,10072,7255
69,8,1,3,1,0,0,3,169,108,9534,7520,192,71,10072,7258
70,8,2,0,0,3,1,0,183,160,9536,7520,182,113,10075,7258
71,8,5,0,0,3,1,0,204,129,9541,7520,229,101,10078,7258
72,9,3,0,0,3,1,0,133,74,9544,7520,158,131,10081,7258
73,9,3,0,0,3,1,0,123,112,9547,7520,121,26,10084,7258
74,9,1,2,1,0,0,3,89,66,9548,7522,97,65,10084,7261
75,9,1,2,1,0,0,3,130,125,9549,7524,160,125,10084,7264
76,9,3,0,0,3,1,0,10,5,9552,7524,10,145,10087,7264
77,9,0,2,1,0,0,3,138,82,9552,7526,170,134,10087,7267
78,9,0,2,1,0,0,3,82,67,9552,7528,82,69,10087,7270
79,9,2,0,0,3,1,0,95,99,9554,7528,124,15,10090,7270
80,9,3,1,0,3,1,0,165,125,9557,7529,178,67,10093,7270
81,10,1,1,2,1,2,1,161,125,9558,7530,171,102,10094,7271
82,10,0,0,2,1,2,1,99,95,9558,7530,108,116,10095,7272
83,10,2,2,2,1,2,1,105,96,9560,7532,108,114,10096,7273
84,10,2,0,0,3,1,0,185,160,9562,7532,185,90,10099,7273
85,10,0,2,1,0,0,3,87,107,9562,7534,86,133,10099,7276
86,10,3,5,1,0,0,3,85,72,9565,7539,82,12,10099,7279
87,10,2,1,0,3,1,0,171,109,9567,7540,195,97,10102,7279
88,10,0,2,1,0,0,3,21,41,9567,7542,13,128,10102,7282
89,10,3,4,1,0,0,3,45,22,9570,7546,48,74,10102,7285
90,11,3,0,0,3,1,0,126,112,9573,7546,124,63,10105,7285
91,11,1,0,0,3,1,0,166,125,9574,7546,181,26,10108,7285
92,11,1,0,0,3,1,0,139,82,9575,7546,173,145,10111,7285
93,11,3,1,0,3,1,0,207,130,9578,7547,232,131,10114,7285
94,11,2,1,0,3,1,0,12,6,9580,7548,13,65,10117,7285
95,11,2,1,0,3,1,0,91,67,9582,7549,100,69,10120,7285
96,11,0,1,1,0,0,3,133,75,9582,7550,158,70,10120,7288
97,11,1,0,0,3,1,0,131,125,9583,7550,163,15,10123,7288
98,11,1,1,2,1,2,1,96,100,9584,7551,125,135,10124,7289
99,12,1,3,1,0,0,3,88,110,9585,7554,86,117,10124,7292
100,12,1,1,2,1,2,1,162,126,9586,7555,172,98,10125,7293
101,12,1,1,2,1,2,1,46,23,9587,7556,49,13,10126,7294
102,12,2,1,0,3,1,0,173,110,9589,7557,198,90,10129,7294
103,12,3,1,0,3,1,0,24,42,9592,7558,16,102,10132,7294
104,12,1,0,0,3,1,0,86,72,9593,7558,85,74,10135,7294
105,12,1,1,2,1,2,1,100,96,9594,7559,109,129,10136,7295
106,12,1,1,2,1,2,1,106,97,9595,7560,109,117,10137,7296
107,12,0,0,2,1,2,1,185,160,9595,7560,186,134,10138,7297
108,13,0,1,1,0,0,3,96,101,9595,7561,125,73,10138,7300
109,13,0,0,2,1,2,1,133,75,9595,7561,159,146,10139,7301
110,13,2,2,2,1,2,1,141,84,9597,7563,174,27,10140,7302
111,13,1,0,0,3,1,0,208,130,9598,7563,235,135,10143,7302
112,13,3,2,0,3,1,0,27,44,9601,7565,19,131,10146,7302
113,13,2,2,2,1,2,1,168,127,9603,7567,182,64,10147,7303
114,13,1,1,2,1,2,1,132,126,9604,7568,164,66,10148,7304
115,13,3,0,0,3,1,0,15,6,9607,7568,16,69,10151,7304
116,13,1,2,1,0,0,3,92,69,9608,7570,100,120,10151,7307
117,14,1,2,1,0,0,3,47,25,9609,7572,49,93,10151,7310
118,14,2,2,2,1,2,1,90,112,9611,7574,87,118,10152,7311
119,14,4,3,0,3,1,0,90,75,9615,7577,88,129,10155,7311
120,14,1,1,2,1,2,1,186,161,9616,7578,187,132,10156,7312
121,14,2,2,2,1,2,1,94,71,9618,7580,101,14,10157,7313
122,14,1,0,0,3,1,0,127,112,9619,7580,127,134,10160,7313
123,14,2,2,2,1,2,1,164,128,9621,7582,173,16,10161,7314
124,14,3,0,0,3,1,0,103,96,9624,7582,112,98,10164,7314
125,14,1,2,1,0,0,3,107,99,9625,7584,109,105,10164,7317
126,15,3,3,2,1,2,1,211,133,9628,7587,236,28,10165,7318
127,15,1,2,1,0,0,3,97,103,9629,7589,125,67,10165,7321
128,15,2,3,1,0,0,3,143,87,9631,7592,174,77,10165,7324
129,15,0,0,2,1,2,1,15,6,9631,7592,17,121,10166,7325
130,15,4,0,0,3,1,0,31,44,9635,7592,22,73,10169,7325
131,15,4,0,0,3,1,0,177,110,9639,7592,201,135,10172,7325
132,15,0,2,1,0,0,3,133,77,9639,7594,159,69,10172,7328
133,15,1,1,2,1,2,1,133,127,9640,7595,165,147,10173,7329
134,15,1,3,1,0,0,3,169,130,9641,7598,182,72,10173,7332
135,16,5,0,0,3,1,0,95,112,9646,7598,90,135,10176,7332
136,16,3,2,0,3,1,0,93,77,9649,7600,91,105,10179,7332
137,16,1,0,0,3,1,0,95,71,9650,7600,104,93,10182,7332
138,16,2,0,0,3,1,0,105,96,9652,7600,115,132,10185,7332
139,16,2,2,2,1,2,1,17,8,9654,7602,18,135,10186,7333
140,16,0,1,1,0,0,3,47,26,9654,7603,49,19,10186,7336
141,16,4,0,0,3,1,0,111,99,9658,7603,112,98,10189,7336
142,16,2,1,0,3,1,0,188,162,9660,7604,190,129,10192,7336
143,16,0,2,1,0,0,3,127,114,9660,7606,127,121,10192,7339
144,17,0,0,2,1,2,1,143,87,9660,7606,175,15,10193,7340
145,17,1,0,0,3,1,0,134,127,9661,7606,168,28,10196,7340
146,17,0,1,1,0,0,3,211,134,9661,7607,236,75,10196,7343
147,17,1,0,0,3,1,0,178,110,9662,7607,204,67,10199,7343
148,17,0,1,1,0,0,3,31,45,9662,7608,22,150,10199,7346
149,17,2,2,2,1,2,1,166,130,9664,7610,174,74,10200,7347
150,17,3,1,0,3,1,0,100,104,9667,7611,128,69,10203,7347
151,17,1,1,2,1,2,1,134,78,9668,7612,160,122,10204,7348
152,17,0,2,1,0,0,3,169,132,9668,7614,182,80,10204,7351
153,18,1,2,1,0,0,3,212,136,9669,7616,236,125,10204,7354
154,18,0,1,1,0,0,3,143,88,9669,7617,175,138,10204,7357
155,18,1,1,2,1,2,1,135,128,9670,7618,169,68,10205,7358
156,18,1,1,2,1,2,1,135,79,9671,7619,161,81,10206,7359
157,18,3,2,0,3,1,0,34,47,9674,7621,25,69,10209,7359
158,18,1,1,2,1,2,1,179,111,9675,7622,205,29,10210,7360
159,18,2,0,0,3,1,0,107,96,9677,7622,118,75,10213,7360
160,18,3,1,0,3,1,0,103,105,9680,7623,131,15,10216,7360
161,18,2,1,0,3,1,0,168,131,9682,7624,177,150,10219,7360
162,19,0,2,1,0,0,3,188,164,9682,7626,190,77,10219,7363
163,19,2,2,2,1,2,1,19,10,9684,7628,19,130,10220,7364
164,19,0,0,2,1,2,1,127,114,9684,7628,128,94,10221,7365
165,19,2,2,2,1,2,1,97,73,9686,7630,105,20,10222,7366
166,19,2,0,0,3,1,0,95,77,9688,7630,94,121,10225,7366
167,19,0,0,2,1,2,1,95,112,9688,7630,91,133,10226,7367
168,19,2,1,0,3,1,0,171,133,9690,7631,185,98,10229,7367
169,19,1,3,1,0,0,3,112,102,9691,7634,112,138,10229,7370
170,19,1,2,1,0,0,3,48,28,9692,7636,49,108,10229,7373
171,20,0,1,1,0,0,3,212,137,9692,7637,236,84,10229,7376
172,20,3,2,0,3,1,0,37,49,9695,7639,28,125,10232,7376
173,20,3,3,2,1,2,1,110,99,9698,7642,119,69,10233,7377
174,20,1,3,1,0,0,3,136,82,9699,7645,161,141,10233,7380
175,20,0,0,2,1,2,1,179,111,9699,7645,206,16,10234,7381
176,20,0,1,1,0,0,3,168,132,9699,7646,177,32,10234,7384
177,20,1,3,1,0,0,3,136,131,9700,7649,169,124,10234,7387
178,20,1,0,0,3,1,0,104,105,9701,7649,134,75,10237,7387
179,20,0,1,1,0,0,3,188,165,9701,7650,190,72,10237,7390
180,21,4,1,0,3,1,0,101,74,9705,7651,108,98,10240,7390
181,21,1,0,0,3,1,0,172,133,9706,7651,188,94,10243,7390
182,21,3,1,0,3,1,0,98,78,9709,7652,97,138,10246,7390
183,21,3,0,0,3,1,0,130,114,9712,7652,131,133,10249,7390
184,21,1,1,2,1,2,1,20,11,9713,7653,20,21,10250,7391
185,21,2,0,0,3,1,0,114,102,9715,7653,115,150,10253,7391
186,21,1,2,1,0,0,3,144,90,9716,7655,175,111,10253,7394
187,21,1,2,1,0,0,3,49,30,9717,7657,49,80,10253,7397
188,21,1,1,2,1,2,1,96,113,9718,7658,92,131,10254,7398
189,22,3,1,0,3,1,0,139,83,9721,7659,164,16,10257,7398
190,22,2,1,0,3,1,0,190,166,9723,7660,193,32,10260,7398
191,22,2,0,0,3,1,0,39,49,9725,7660,31,69,10263,7398
192,22,3,1,0,3,1,0,215,138,9728,7661,239,141,10266,7398
193,22,2,2,2,1,2,1,112,101,9730,7663,120,73,10267,7399
194,22,0,0,2,1,2,1,136,131,9730,7663,170,126,10268,7400
195,22,0,0,2,1,2,1,104,105,9730,7663,135,125,10269,7401
196,22,1,0,0,3,1,0,180,111,9731,7663,209,75,10272,7401
197,22,0,0,2,1,2,1,168,132,9731,7663,178,85,10273,7402
198,23,1,0,0,3,1,0,99,78,9732,7663,100,150,10276,7402
199,23,0,1,1,0,0,3,139,84,9732,7664,164,97,10276,7405
200,23,2,0,0,3,1,0,98,113,9734,7664,95,32,10279,7405
201,23,0,1,1,0,0,3,130,115,9734,7665,131,141,10279,7408
202,23,1,1,2,1,2,1,173,134,9735,7666,189,134,10280,7409
203,23,2,2,2,1,2,1,22,13,9737,7668,21,99,10281,7410
204,23,1,0,0,3,1,0,145,90,9738,7668,178,131,10284,7410
205,23,3,1,0,3,1,0,104,75,9741,7669,111,80,10287,7410
206,23,1,0,0,3,1,0,115,102,9742,7669,118,21,10290,7410
207,24,2,3,1,0,0,3,100,116,9744,7672,95,78,10290,7413
208,24,4,3,0,3,1,0,43,52,9748,7675,34,141,10293,7413
209,24,2,1,0,3,1,0,114,102,9750,7676,123,126,10296,7413
210,24,2,1,0,3,1,0,182,112,9752,7677,212,125,10299,7413
211,24,2,1,0,3,1,0,217,139,9754,7678,242,97,10302,7413
212,24,2,1,0,3,1,0,138,132,9756,7679,173,111,10305,7413
213,24,1,1,2,1,2,1,50,31,9757,7680,50,70,10306,7414
214,24,0,0,2,1,2,1,190,166,9757,7680,194,86,10307,7415
215,24,3,2,0,3,1,0,171,134,9760,7682,181,16,10310,7415
216,25,0,2,1,0,0,3,115,104,9760,7684,118,35,10310,7418
217,25,4,3,0,3,1,0,143,87,9764,7687,167,131,10313,7418
218,25,0,2,1,0,0,3,104,77,9764,7689,111,137,10313,7421
219,25,1,1,2,1,2,1,105,106,9765,7690,136,100,10314,7422
220,25,5,0,0,3,1,0,27,13,9770,7690,24,80,10317,7422
221,25,2,1,0,3,1,0,175,135,9772,7691,192,141,10320,7422
222,25,2,2,2,1,2,1,101,80,9774,7693,101,74,10321,7423
223,25,2,1,0,3,1,0,147,91,9776,7694,181,21,10324,7423
224,25,0,1,1,0,0,3,130,116,9776,7695,131,153,10324,7426
225,26,3,2,0,3,1,0,118,106,9779,7697,121,70,10327,7426
226,26,1,0,0,3,1,0,101,116,9780,7697,98,86,10330,7426
227,26,1,1,2,1,2,1,51,32,9781,7698,51,127,10331,7427
228,26,0,0,2,1,2,1,171,134,9781,7698,182,126,10332,7428
229,26,2,1,0,3,1,0,184,113,9783,7699,215,111,10335,7428
230,26,1,1,2,1,2,1,191,167,9784,7700,195,17,10336,7429
231,26,2,1,0,3,1,0,45,53,9786,7701,37,97,10339,7429
232,26,1,2,1,0,0,3,115,104,9787,7703,123,144,10339,7432
233,26,0,0,2,1,2,1,217,139,9787,7703,243,101,10340,7433
234,27,4,2,0,3,1,0,179,137,9791,7705,195,74,10343,7433
235,27,2,1,0,3,1,0,29,14,9793,7706,27,70,10346,7433
236,27,1,1,2,1,2,1,144,88,9794,7707,168,142,10347,7434
237,27,2,3,1,0,0,3,107,109,9796,7710,136,156,10347,7437
238,27,2,2,2,1,2,1,219,141,9798,7712,244,22,10348,7438
239,27,1,1,2,1,2,1,105,78,9799,7713,112,36,10349,7439
240,27,4,2,0,3,1,0,134,118,9803,7715,134,78,10352,7439
241,27,3,2,0,3,1,0,150,93,9806,7717,184,80,10355,7439
242,27,2,1,0,3,1,0,140,133,9808,7718,176,137,10358,7439
243,28,1,2,1,0,0,3,102,82,9809,7720,101,130,10358,7442
244,28,1,1,2,1,2,1,119,107,9810,7721,122,87,10359,7443
245,28,1,4,1,0,0,3,116,108,9811,7725,123,114,10359,7446
246,28,2,0,0,3,1,0,193,167,9813,7725,198,126,10362,7446
247,28,2,1,0,3,1,0,186,114,9815,7726,218,131,10365,7446
248,28,1,1,2,1,2,1,172,135,9816,7727,183,98,10366,7447
249,28,1,3,1,0,0,3,46,56,9817,7730,37,104,10366,7450
250,28,1,1,2,1,2,1,102,117,9818,7731,99,18,10367,7451
251,28,1,0,0,3,1,0,52,32,9819,7731,54,144,10370,7451
252,29,0,0,2,1,2,1,107,109,9819,7731,137,138,10371,7452
253,29,1,2,1,0,0,3,180,139,9820,7733,195,159,10371,7455
254,29,0,0,2,1,2,1,29,14,9820,7733,28,37,10372,7456
255,29,3,2,0,3,1,0,108,80,9823,7735,115,70,10375,7456
256,29,2,1,0,3,1,0,142,134,9825,7736,179,142,10378,7456
257,29,0,0,2,1,2,1,219,141,9825,7736,245,81,10379,7457
258,29,1,1,2,1,2,1,151,94,9826,7737,185,79,10380,7458
259,29,2,2,2,1,2,1,136,120,9828,7739,135,75,10381,7459
260,29,1,1,2,1,2,1,145,89,9829,7740,169,23,10382,7460
261,30,1,2,1,0,0,3,187,116,9830,7742,218,26,10382,7463
262,30,3,2,0,3,1,0,196,169,9833,7744,201,114,10385,7463
263,30,0,1,1,0,0,3,172,136,9833,7745,183,134,10385,7466
264,30,0,2,1,0,0,3,116,110,9833,7747,123,101,10385,7469
265,30,2,0,0,3,1,0,104,117,9835,7747,102,104,10388,7469
266,30,0,4,1,0,0,3,119,111,9835,7751,122,21,10388,7472
267,30,1,1,2,1,2,1,53,33,9836,7752,55,127,10389,7473
268,30,3,1,0,3,1,0,105,83,9839,7753,104,144,10392,7473
269,30,1,1,2,1,2,1,137,121,9840,7754,136,88,10393,7474
270,31,1,1,2,1,2,1,188,117,9841,7755,219,160,10394,7475
271,31,0,0,2,1,2,1,151,94,9841,7755,186,76,10395,7476
272,31,1,1,2,1,2,1,108,110,9842,7756,138,38,10396,7477
273,31,1,1,2,1,2,1,220,142,9843,7757,246,71,10397,7478
274,31,3,1,0,3,1,0,49,57,9846,7758,40,142,10400,7478
275,31,3,0,0,3,1,0,183,139,9849,7758,198,130,10403,7478
276,31,0,1,1,0,0,3,145,90,9849,7759,169,82,10403,7481
277,31,1,3,1,0,0,3,143,137,9850,7762,179,84,10403,7484
278,31,1,3,1,0,0,3,30,17,9851,7765,28,91,10403,7487
279,32,2,1,0,3,1,0,198,170,9853,7766,204,104,10406,7487
280,32,3,2,0,3,1,0,107,119,9856,7768,105,114,10409,7487
281,32,3,1,0,3,1,0,56,34,9859,7769,58,134,10412,7487
282,32,3,0,0,3,1,0,175,136,9862,7769,186,138,10415,7487
283,32,1,2,1,0,0,3,120,113,9863,7771,122,147,10415,7490
284,32,2,0,0,3,1,0,107,83,9865,7771,107,101,10418,7490
285,32,1,5,1,0,0,3,138,126,9866,7776,136,24,10418,7493
286,32,4,1,0,3,1,0,120,111,9870,7777,126,26,10421,7493
287,32,2,0,0,3,1,0,110,80,9872,7777,118,127,10424,7493
288,33,0,2,1,0,0,3,151,96,9872,7779,186,133,10424,7496
289,33,0,3,1,0,0,3,49,60,9872,7782,40,41,10424,7499
290,33,0,0,2,1,2,1,143,137,9872,7782,180,83,10425,7500
291,33,1,0,0,3,1,0,146,90,9873,7782,172,71,10428,7500
292,33,3,1,0,3,1,0,223,143,9876,7783,249,160,10431,7500
293,33,0,2,1,0,0,3,108,112,9876,7785,138,94,10431,7503
294,33,1,0,0,3,1,0,176,136,9877,7785,189,76,10434,7503
295,33,2,2,2,1,2,1,190,119,9879,7787,220,85,10435,7504
296,33,1,1,2,1,2,1,184,140,9880,7788,199,25,10436,7505
297,34,6,2,0,3,1,0,36,19,9886,7790,31,127,10439,7505
298,34,0,1,1,0,0,3,120,114,9886,7791,122,137,10439,7508
299,34,2,0,0,3,1,0,122,111,9888,7791,129,142,10442,7508
300,34,1,1,2,1,2,1,108,84,9889,7792,108,139,10443,7509
301,34,0,0,2,1,2,1,107,119,9889,7792,106,102,10444,7510
302,34,2,3,1,0,0,3,112,83,9891,7795,118,150,10444,7513
303,34,1,3,1,0,0,3,139,129,9892,7798,136,117,10444,7516
304,34,1,0,0,3,1,0,57,34,9893,7798,61,104,10447,7516
305,34,1,1,2,1,2,1,199,171,9894,7799,205,27,10448,7517
0,1,0,3,1,0,0,3,0,3,9894,7802,0,28,10448,7520
1,1,0,2,1,0,0,3,199,173,9894,7804,205,59,10448,7523
2,1,3,1,0,3,1,0,193,120,9897,7805,223,102,10451,7523
3,1,2,1,0,3,1,0,51,61,9899,7806,43,133,10454,7523
4,1,1,2,1,0,0,3,1,2,9900,7808,0,145,10454,7526
5,1,1,0,0,3,1,0,58,34,9901,7808,64,104,10457,7526
6,1,1,1,2,1,2,1,109,85,9902,7809,109,77,10458,7527
7,1,1,0,0,3,1,0,224,143,9903,7809,252,104,10461,7527
8,1,1,0,0,3,1,0,121,114,9904,7809,125,85,10464,7527
9,2,2,0,0,3,1,0,118,98,9906,7809,131,27,10467,7527
10,2,1,1,2,1,2,1,140,130,9907,7810,137,140,10468,7528
11,2,2,0,0,3,1,0,178,136,9909,7810,192,41,10471,7528
12,2,0,2,1,0,0,3,122,113,9909,7812,129,163,10471,7531
13,2,2,1,0,3,1,0,109,120,9911,7813,109,83,10474,7531
14,2,0,3,1,0,0,3,108,115,9911,7816,138,3,10474,7534
15,2,0,0,2,1,2,1,143,137,9911,7816,181,1,10475,7535
16,2,1,1,2,1,2,1,37,20,9912,7817,32,72,10476,7536
17,2,1,1,2,1,2,1,56,24,9913,7818,67,138,10477,7537
18,3,1,0,0,3,1,0,200,173,9914,7818,208,102,10480,7537
19,3,3,0,0,3,1,0,61,34,9917,7818,67,85,10483,7537
20,3,3,1,0,3,1,0,59,25,9920,7819,70,104,10486,7537
21,3,2,2,2,1,2,1,195,122,9922,7821,224,105,10487,7538
22,3,1,1,2,1,2,1,2,3,9923,7822,1,134,10488,7539
23,3,0,0,2,1,2,1,51,61,9923,7822,44,29,10489,7540
24,3,1,3,1,0,0,3,122,117,9924,7825,125,75,10489,7543
25,3,4,1,0,3,1,0,228,144,9928,7826,255,145,10492,7543
26,3,3,0,0,3,1,0,3,3,9931,7826,3,77,10495,7543
27,4,3,2,0,3,1,0,143,132,9934,7828,140,104,10498,7543
28,4,2,2,2,1,2,1,120,100,9936,7830,132,164,10499,7544
29,4,5,3,0,3,1,0,114,123,9941,7833,112,27,10502,7544
30,4,0,1,1,0,0,3,122,114,9941,7834,129,143,10502,7547
31,4,0,1,1,0,0,3,109,86,9941,7835,109,44,10502,7550
32,4,0,0,2,1,2,1,108,115,9941,7835,139,139,10503,7551
33,4,3,5,1,0,0,3,181,141,9944,7840,192,62,10503,7554
34,4,2,1,0,3,1,0,39,21,9946,7841,35,1,10506,7554
35,4,0,1,1,0,0,3,122,118,9946,7842,125,6,10506,7557
36,5,2,2,2,1,2,1,230,146,9948,7844,256,86,10507,7558
37,5,0,2,1,0,0,3,51,63,9948,7846,44,86,10507,7561
38,5,1,1,2,1,2,1,62,35,9949,7847,68,103,10508,7562
39,5,4,1,0,3,1,0,199,123,9953,7848,227,29,10511,7562
40,5,3,2,0,3,1,0,6,5,9956,7850,6,75,10514,7562
41,5,3,1,0,3,1,0,146,138,9959,7851,184,145,10517,7562
42,5,6,0,0,3,1,0,206,173,9965,7851,211,134,10520,7562
43,5,3,5,1,0,0,3,62,30,9968,7856,70,108,10520,7565
44,5,0,0,2,1,2,1,2,3,9968,7856,2,78,10521,7566
45,6,0,1,1,0,0,3,143,133,9968,7857,140,148,10521,7569
46,6,0,2,1,0,0,3,108,117,9968,7859,139,65,10521,7572
47,6,1,1,2,1,2,1,115,124,9969,7860,113,140,10522,7573
48,6,2,2,2,1,2,1,41,23,9971,7862,36,165,10523,7574
49,6,4,1,0,3,1,0,126,119,9975,7863,128,44,10526,7574
50,6,1,2,1,0,0,3,123,116,9976,7865,129,107,10526,7577
51,6,0,5,1,0,0,3,6,10,9976,7870,6,30,10526,7580
52,6,2,0,0,3,1,0,111,86,9978,7870,112,143,10529,7580
53,6,4,4,2,1,2,1,124,104,9982,7874,133,2,10530,7581
54,7,0,1,1,0,0,3,206,174,9982,7875,211,89,10530,7584
55,7,1,2,1,0,0,3,63,37,9983,7877,68,81,10530,7587
56,7,2,1,0,3,1,0,64,31,9985,7878,73,134,10533,7587
57,7,2,0,0,3,1,0,232,146,9987,7878,259,29,10536,7587
58,7,0,2,1,0,0,3,146,140,9987,7880,184,106,10536,7590
59,7,3,3,2,1,2,1,5,6,9990,7883,3,87,10537,7591
60,7,2,1,0,3,1,0,53,64,9992,7884,47,75,10540,7591
61,7,2,1,0,3,1,0,183,142,9994,7885,195,108,10543,7591
62,7,0,0,2,1,2,1,199,123,9994,7885,228,7,10544,7592
63,8,1,3,1,0,0,3,116,127,9995,7888,113,68,10544,7595
64,8,4,2,0,3,1,0,45,25,9999,7890,39,44,10547,7595
65,8,1,3,1,0,0,3,124,119,10000,7893,129,33,10547,7598
66,8,3,2,0,3,1,0,114,88,10003,7895,115,165,10550,7598
67,8,1,0,0,3,1,0,125,104,10004,7895,136,107,10553,7598
68,8,0,0,2,1,2,1,6,10,10004,7895,7,149,10554,7599
69,8,0,1,1,0,0,3,108,118,10004,7896,139,5,10554,7602
70,8,0,1,1,0,0,3,126,120,10004,7897,128,146,10554,7605
71,8,1,2,1,0,0,3,144,135,10005,7899,140,143,10554,7608
72,9,1,0,0,3,1,0,207,174,10006,7899,214,81,10557,7608
73,9,1,2,1,0,0,3,64,39,10007,7901,68,10,10557,7611
74,9,2,1,0,3,1,0,148,141,10009,7902,187,29,10560,7611
75,9,1,1,2,1,2,1,200,124,10010,7903,229,34,10561,7612
76,9,2,2,2,1,2,1,7,8,10012,7905,4,90,10562,7613
77,9,1,2,1,0,0,3,145,137,10013,7907,140,111,10562,7616
78,9,3,1,0,3,1,0,186,143,10016,7908,198,106,10565,7616
79,9,1,1,2,1,2,1,233,147,10017,7909,260,76,10566,7617
80,9,1,2,1,0,0,3,65,33,10018,7911,73,90,10566,7620
81,10,1,1,2,1,2,1,127,121,10019,7912,129,108,10567,7621
82,10,4,0,0,3,1,0,112,118,10023,7912,142,134,10570,7621
83,10,2,3,1,0,0,3,118,130,10025,7915,113,149,10570,7624
84,10,3,0,0,3,1,0,117,88,10028,7915,118,5,10573,7624
85,10,1,1,2,1,2,1,46,26,10029,7916,40,69,10574,7625
86,10,0,0,2,1,2,1,6,10,10029,7916,8,166,10575,7626
87,10,0,0,2,1,2,1,125,104,10029,7916,137,144,10576,7627
88,10,1,1,2,1,2,1,54,65,10030,7917,48,45,10577,7628
89,10,0,1,1,0,0,3,124,120,10030,7918,129,152,10577,7631
90,11,2,0,0,3,1,0,66,39,10032,7918,71,149,10580,7631
91,11,0,1,1,0,0,3,7,9,10032,7919,4,13,10580,7634
92,11,1,0,0,3,1,0,149,141,10033,7919,190,81,10583,7634
93,11,1,1,2,1,2,1,66,34,10034,7920,74,77,10584,7635
94,11,3,3,2,1,2,1,128,107,10037,7923,138,107,10585,7636
95,11,1,1,2,1,2,1,146,138,10038,7924,141,91,10586,7637
96,11,0,1,1,0,0,3,186,144,10038,7925,198,32,10586,7640
97,11,0,0,2,1,2,1,233,147,10038,7925,261,91,10587,7641
98,11,3,3,2,1,2,1,210,177,10041,7928,215,35,10588,7642
99,12,3,1,0,3,1,0,130,122,10044,7929,132,107,10591,7642
100,12,2,2,2,1,2,1,202,126,10046,7931,230,167,10592,7643
101,12,3,1,0,3,1,0,69,40,10049,7932,74,5,10595,7643
102,12,2,0,0,3,1,0,126,120,10051,7932,132,111,10598,7643
103,12,2,2,2,1,2,1,48,28,10053,7934,41,135,10599,7644
104,12,1,2,1,0,0,3,119,132,10054,7936,113,155,10599,7647
105,12,1,0,0,3,1,0,118,88,10055,7936,121,108,10602,7647
106,12,1,1,2,1,2,1,55,66,10056,7937,49,145,10603,7648
107,12,1,0,0,3,1,0,7,10,10057,7937,11,69,10606,7648
108,13,0,0,2,1,2,1,112,118,10057,7937,143,92,10607,7649
109,13,4,4,2,1,2,1,132,111,10061,7941,139,33,10608,7650
110,13,1,3,1,0,0,3,150,144,10062,7944,190,16,10608,7653
111,13,8,1,0,3,1,0,74,35,10070,7945,77,91,10611,7653
112,13,1,1,2,1,2,1,187,145,10071,7946,199,78,10612,7654
113,13,1,1,2,1,2,1,147,139,10072,7947,142,82,10613,7655
114,13,2,3,1,0,0,3,9,12,10074,7950,4,38,10613,7658
115,13,4,0,0,3,1,0,237,147,10078,7950,264,149,10616,7658
116,13,1,0,0,3,1,0,211,177,10079,7950,218,45,10619,7658
117,14,0,1,1,0,0,3,119,133,10079,7951,113,95,10619,7661
118,14,3,2,0,3,1,0,205,128,10082,7953,233,5,10622,7661
119,14,2,1,0,3,1,0,213,178,10084,7954,221,108,10625,7661
120,14,0,3,1,0,0,3,69,43,10084,7957,74,72,10625,7664
121,14,2,1,0,3,1,0,50,29,10086,7958,44,107,10628,7664
122,14,1,5,1,0,0,3,119,93,10087,7963,121,114,10628,7667
123,14,1,1,2,1,2,1,56,67,10088,7964,50,156,10629,7668
124,14,2,0,0,3,1,0,132,122,10090,7964,135,135,10632,7668
125,14,2,2,2,1,2,1,9,12,10092,7966,12,146,10633,7669
126,15,1,1,2,1,2,1,151,145,10093,7967,191,39,10634,7670
127,15,2,2,2,1,2,1,134,113,10095,7969,140,83,10635,7671
128,15,4,0,0,3,1,0,78,35,10099,7969,80,149,10638,7671
129,15,1,2,1,0,0,3,148,141,10100,7971,142,19,10638,7674
130,15,1,1,2,1,2,1,188,146,10101,7972,200,92,10639,7675
131,15,3,1,0,3,1,0,240,148,10104,7973,267,45,10642,7675
132,15,0,4,1,0,0,3,126,124,10104,7977,132,36,10642,7678
133,15,0,0,2,1,2,1,9,12,10104,7977,5,168,10643,7679
134,15,1,2,1,0,0,3,113,120,10105,7979,143,81,10643,7682
135,16,1,0,0,3,1,0,10,12,10106,7979,15,114,10646,7682
136,16,1,3,1,0,0,3,57,70,10107,7982,50,75,10646,7685
137,16,1,1,2,1,2,1,70,44,10108,7983,75,136,10647,7686
138,16,0,5,1,0,0,3,205,133,10108,7988,233,111,10647,7689
139,16,4,1,0,3,1,0,123,94,10112,7989,124,95,10650,7689
140,16,1,1,2,1,2,1,120,134,10113,7990,114,108,10651,7690
141,16,1,1,2,1,2,1,10,13,10114,7991,6,147,10652,7691
142,16,0,2,1,0,0,3,132,124,10114,7993,135,39,10652,7694
143,16,1,3,1,0,0,3,214,181,10115,7996,221,159,10652,7697
144,17,1,2,1,0,0,3,127,126,10116,7998,132,22,10652,7700
145,17,1,2,1,0,0,3,51,31,10117,8000,44,86,10652,7703
146,17,3,0,0,3,1,0,137,113,10120,8000,143,92,10655,7703
147,17,2,0,0,3,1,0,190,146,10122,8000,203,149,10658,7703
148,17,2,0,0,3,1,0,242,148,10124,8000,270,168,10661,7703
149,17,2,2,2,1,2,1,153,147,10126,8002,192,46,10662,7704
150,17,1,1,2,1,2,1,149,142,10127,8003,143,82,10663,7705
151,17,2,2,2,1,2,1,115,122,10129,8005,144,40,10664,7706
152,17,3,0,0,3,1,0,81,35,10132,8005,83,5,10667,7706
153,18,2,3,1,0,0,3,83,38,10134,8008,83,171,10667,7709
154,18,0,0,2,1,2,1,115,122,10134,8008,145,150,10668,7710
155,18,1,2,1,0,0,3,121,136,10135,8010,114,85,10668,7713
156,18,1,2,1,0,0,3,150,144,10136,8012,143,43,10668,7716
157,18,4,1,0,3,1,0,194,147,10140,8013,206,5,10671,7716
158,18,3,0,0,3,1,0,156,147,10143,8013,195,147,10674,7716
159,18,1,3,1,0,0,3,128,129,10144,8016,132,95,10674,7719
160,18,3,1,0,3,1,0,54,32,10147,8017,47,22,10677,7719
161,18,6,2,0,3,1,0,143,115,10153,8019,146,46,10680,7719
162,19,2,1,0,3,1,0,216,182,10155,8020,224,95,10683,7719
163,19,2,1,0,3,1,0,72,45,10157,8021,78,159,10686,7719
164,19,0,1,1,0,0,3,205,134,10157,8022,233,139,10686,7722
165,19,1,0,0,3,1,0,11,13,10158,8022,9,111,10689,7722
166,19,2,0,0,3,1,0,59,70,10160,8022,53,114,10692,7722
167,19,2,1,0,3,1,0,12,13,10162,8023,18,108,10695,7722
168,19,2,2,2,1,2,1,125,96,10164,8025,125,40,10696,7723
169,19,3,4,1,0,0,3,135,128,10167,8029,135,89,10696,7726
170,19,2,0,0,3,1,0,244,148,10169,8029,273,75,10699,7726
171,20,3,2,0,3,1,0,131,131,10172,8031,135,46,10702,7726
172,20,0,1,1,0,0,3,150,145,10172,8032,143,8,10702,7729
173,20,2,0,0,3,1,0,123,136,10174,8032,117,22,10705,7729
174,20,1,0,0,3,1,0,126,96,10175,8032,128,95,10708,7729
175,20,6,0,0,3,1,0,149,115,10181,8032,149,150,10711,7729
176,20,2,0,0,3,1,0,56,32,10183,8032,50,43,10714,7729
177,20,3,0,0,3,1,0,118,122,10186,8032,148,171,10717,7729
178,20,3,2,0,3,1,0,197,149,10189,8034,209,147,10720,7729
179,20,0,1,1,0,0,3,156,148,10189,8035,195,78,10720,7732
180,21,4,1,0,3,1,0,87,39,10193,8036,86,159,10723,7732
181,21,0,3,1,0,0,3,59,73,10193,8039,53,92,10723,7735
182,21,1,2,1,0,0,3,217,184,10194,8041,224,117,10723,7738
183,21,1,0,0,3,1,0,206,134,10195,8041,236,95,10726,7738
184,21,2,0,0,3,1,0,246,148,10197,8041,276,108,10729,7738
185,21,0,3,1,0,0,3,156,151,10197,8044,195,142,10729,7741
186,21,1,2,1,0,0,3,73,47,10198,8046,78,88,10729,7744
187,21,1,1,2,1,2,1,12,14,10199,8047,10,41,10730,7745
188,21,1,0,0,3,1,0,13,13,10200,8047,21,95,10733,7745
189,22,1,1,2,1,2,1,119,123,10201,8048,149,47,10734,7746
190,22,3,2,0,3,1,0,152,117,10204,8050,152,78,10737,7746
191,22,2,3,1,0,0,3,133,134,10206,8053,135,150,10737,7749
192,22,2,2,2,1,2,1,128,98,10208,8055,129,23,10738,7750
193,22,2,1,0,3,1,0,152,146,10210,8056,146,171,10741,7750
194,22,1,2,1,0,0,3,198,151,10211,8058,209,114,10741,7753
195,22,1,3,1,0,0,3,124,139,10212,8061,117,11,10741,7756
196,22,2,2,2,1,2,1,58,34,10214,8063,51,151,10742,7757
197,22,0,0,2,1,2,1,135,128,10214,8063,136,44,10743,7758
198,23,1,1,2,1,2,1,247,149,10215,8064,277,93,10744,7759
199,23,0,0,2,1,2,1,206,134,10215,8064,237,89,10745,7760
200,23,1,3,1,0,0,3,218,187,10216,8067,224,44,10745,7763
201,23,2,0,0,3,1,0,75,47,10218,8067,81,95,10748,7763
202,23,3,1,0,3,1,0,90,40,10221,8068,89,108,10751,7763
203,23,1,0,0,3,1,0,199,151,10222,8068,212,142,10754,7763
204,23,0,0,2,1,2,1,156,151,10222,8068,196,96,10755,7764
205,23,1,1,2,1,2,1,13,15,10223,8069,11,118,10756,7765
206,23,2,1,0,3,1,0,61,74,10225,8070,56,23,10759,7765
207,24,1,0,0,3,1,0,134,134,10226,8070,138,11,10762,7765
208,24,0,2,1,0,0,3,58,36,10226,8072,51,153,10762,7768
209,24,1,2,1,0,0,3,129,100,10227,8074,129,47,10762,7771
210,24,0,1,1,0,0,3,152,118,10227,8075,152,162,10762,7774
211,24,0,3,1,0,0,3,119,126,10227,8078,149,117,10762,7777
212,24,1,0,0,3,1,0,125,139,10228,8078,120,47,10765,7777
213,24,1,2,1,0,0,3,153,148,10229,8080,146,81,10765,7780
214,24,2,2,2,1,2,1,137,130,10231,8082,137,172,10766,7781
215,24,1,0,0,3,1,0,14,13,10232,8082,24,151,10769,7781
216,25,1,0,0,3,1,0,219,187,10233,8082,227,89,10772,7781
217,25,2,0,0,3,1,0,249,149,10235,8082,280,142,10775,7781
218,25,5,1,0,3,1,0,95,41,10240,8083,92,93,10778,7781
219,25,1,1,2,1,2,1,62,75,10241,8084,57,97,10779,7782
220,25,3,2,0,3,1,0,78,49,10244,8086,84,44,10782,7782
221,25,2,1,0,3,1,0,158,152,10246,8087,199,118,10785,7782
222,25,0,4,1,0,0,3,199,155,10246,8091,212,26,10785,7785
223,25,0,1,1,0,0,3,13,16,10246,8092,11,111,10785,7788
224,25,0,0,2,1,2,1,206,134,10246,8092,238,96,10786,7789
225,26,2,1,0,3,1,0,131,101,10248,8093,132,153,10789,7789
226,26,5,1,0,3,1,0,63,37,10253,8094,54,117,10792,7789
227,26,2,3,1,0,0,3,16,16,10255,8097,24,50,10792,7792
228,26,4,0,0,3,1,0,123,126,10259,8097,152,162,10795,7792
229,26,1,1,2,1,2,1,138,131,10260,8098,138,12,10796,7793
230,26,3,1,0,3,1,0,128,140,10263,8099,123,172,10799,7793
231,26,3,1,0,3,1,0,155,119,10266,8100,155,142,10802,7793
232,26,0,2,1,0,0,3,62,77,10266,8102,57,154,10802,7796
233,26,4,4,2,1,2,1,138,138,10270,8106,139,82,10803,7797
234,27,0,0,2,1,2,1,13,16,10270,8106,12,90,10804,7798
235,27,0,0,2,1,2,1,199,155,10270,8106,213,98,10805,7799
236,27,0,0,2,1,2,1,219,187,10270,8106,228,27,10806,7800
237,27,1,3,1,0,0,3,250,152,10271,8109,280,121,10806,7803
238,27,1,1,2,1,2,1,79,50,10272,8110,85,48,10807,7804
239,27,4,0,0,3,1,0,99,41,10276,8110,95,44,10810,7804
240,27,1,2,1,0,0,3,154,150,10277,8112,146,114,10810,7807
241,27,2,2,2,1,2,1,208,136,10279,8114,239,94,10811,7808
242,27,1,3,1,0,0,3,159,155,10280,8117,199,99,10811,7811
243,28,2,1,0,3,1,0,130,141,10282,8118,126,117,10814,7811
244,28,2,1,0,3,1,0,64,78,10284,8119,60,172,10817,7811
245,28,2,1,0,3,1,0,65,38,10286,8120,57,162,10820,7811
246,28,2,4,1,0,0,3,140,142,10288,8124,139,145,10820,7814
247,28,1,1,2,1,2,1,124,127,10289,8125,153,122,10821,7815
248,28,0,2,1,0,0,3,131,103,10289,8127,132,85,10821,7818
249,28,0,0,2,1,2,1,138,131,10289,8127,139,154,10822,7819
250,28,2,1,0,3,1,0,210,137,10291,8128,242,50,10825,7819
251,28,1,2,1,0,0,3,17,18,10292,8130,24,15,10825,7822
252,29,0,1,1,0,0,3,159,156,10292,8131,199,93,10825,7825
253,29,2,2,2,1,2,1,252,154,10294,8133,281,49,10826,7826
254,29,3,1,0,3,1,0,127,128,10297,8134,156,99,10829,7826
255,29,0,1,1,0,0,3,13,17,10297,8135,12,53,10829,7829
256,29,4,0,0,3,1,0,159,119,10301,8135,158,98,10832,7829
257,29,3,2,0,3,1,0,222,189,10304,8137,231,154,10835,7829
258,29,1,1,2,1,2,1,155,151,10305,8138,147,45,10836,7830
259,29,1,1,2,1,2,1,200,156,10306,8139,214,95,10837,7831
260,29,1,1,2,1,2,1,100,42,10307,8140,96,28,10838,7832
261,30,1,1,2,1,2,1,18,19,10308,8141,25,118,10839,7833
262,30,1,2,1,0,0,3,66,40,10309,8143,57,125,10839,7836
263,30,2,2,2,1,2,1,142,144,10311,8145,140,115,10840,7837
264,30,1,1,2,1,2,1,211,138,10312,8146,243,155,10841,7838
265,30,1,3,1,0,0,3,131,144,10313,8149,126,148,10841,7841
266,30,1,0,0,3,1,0,65,78,10314,8149,63,15,10844,7841
267,30,0,0,2,1,2,1,79,50,10314,8149,86,173,10845,7842
268,30,3,0,0,3,1,0,134,103,10317,8149,135,162,10848,7842
269,30,3,0,0,3,1,0,141,131,10320,8149,142,85,10851,7842
270,31,1,2,1,0,0,3,101,44,10321,8151,96,56,10851,7845
271,31,1,0,0,3,1,0,156,151,10322,8151,150,99,10854,7845
272,31,3,2,0,3,1,0,130,130,10325,8153,159,45,10857,7845
273,31,4,3,0,3,1,0,204,159,10329,8156,217,49,10860,7845
274,31,2,1,0,3,1,0,15,18,10331,8157,15,154,10863,7845
275,31,2,0,0,3,1,0,254,154,10333,8157,284,28,10866,7845
276,31,3,2,0,3,1,0,162,158,10336,8159,202,173,10869,7845
277,31,3,1,0,3,1,0,162,120,10339,8160,161,93,10872,7845
278,31,2,2,2,1,2,1,144,146,10341,8162,141,96,10873,7846
279,32,2,0,0,3,1,0,133,144,10343,8162,129,125,10876,7846
280,32,2,1,0,3,1,0,143,132,10345,8163,145,162,10879,7846
281,32,0,3,1,0,0,3,18,22,10345,8166,25,151,10879,7849
282,32,4,2,0,3,1,0,226,191,10349,8168,234,15,10882,7849
283,32,2,3,1,0,0,3,136,106,10351,8171,135,118,10882,7852
284,32,0,2,1,0,0,3,66,42,10351,8173,57,101,10882,7855
285,32,1,3,1,0,0,3,66,81,10352,8176,63,121,10882,7858
286,32,2,1,0,3,1,0,81,51,10354,8177,89,155,10885,7858
287,32,0,4,1,0,0,3,211,142,10354,8181,243,88,10885,7861
288,33,3,5,1,0,0,3,104,49,10357,8186,96,52,10885,7864
289,33,3,0,0,3,1,0,69,42,10360,8186,60,99,10888,7864
290,33,3,4,1,0,0,3,147,150,10363,8190,141,96,10888,7867
291,33,3,0,0,3,1,0,257,154,10366,8190,287,15,10891,7867
292,33,3,0,0,3,1,0,159,151,10369,8190,153,56,10894,7867
293,33,0,3,1,0,0,3,130,133,10369,8193,159,99,10894,7870
294,33,0,0,2,1,2,1,204,159,10369,8193,218,174,10895,7871
295,33,1,1,2,1,2,1,163,159,10370,8194,203,155,10896,7872
296,33,4,1,0,3,1,0,166,121,10374,8195,164,28,10899,7872
297,34,3,0,0,3,1,0,21,22,10377,8195,28,101,10902,7872
298,34,1,0,0,3,1,0,134,144,10378,8195,132,45,10905,7872
299,34,2,2,2,1,2,1,68,83,10380,8197,64,119,10906,7873
300,34,2,2,2,1,2,1,228,193,10382,8199,235,156,10907,7874
301,34,1,0,0,3,1,0,82,51,10383,8199,92,121,10910,7874
302,34,4,2,0,3,1,0,140,108,10387,8201,138,151,10913,7874
303,34,3,1,0,3,1,0,146,133,10390,8202,148,125,10916,7874
304,34,2,1,0,3,1,0,213,143,10392,8203,246,162,10919,7874
305,34,1,1,2,1,2,1,16,19,10393,8204,16,89,10920,7875
0,1,2,1,0,3,1,0,42,16,10395,8205,44,23,10923,7875
1,1,0,1,1,0,0,3,146,134,10395,8206,148,97,10923,7878
2,1,1,1,2,1,2,1,70,43,10396,8207,61,120,10924,7879
3,1,1,3,1,0,0,3,25,28,10397,8210,22,99,10924,7882
4,1,1,1,2,1,2,1,22,23,10398,8211,29,57,10925,7883
5,1,3,1,0,3,1,0,71,84,10401,8212,67,174,10928,7883
6,1,0,2,1,0,0,3,213,145,10401,8214,246,124,10928,7886
7,1,1,2,1,0,0,3,1,2,10402,8216,0,97,10928,7889
8,1,1,1,2,1,2,1,135,145,10403,8217,133,163,10929,7890
9,2,3,3,2,1,2,1,231,196,10406,8220,236,100,10930,7891
10,2,0,1,1,0,0,3,130,134,10406,8221,159,12,10930,7894
11,2,1,3,1,0,0,3,205,162,10407,8224,218,158,10930,7897
12,2,4,2,0,3,1,0,146,128,10411,8226,155,99,10933,7897
13,2,1,1,2,1,2,1,27,10,10412,8227,45,53,10934,7898
14,2,2,2,2,1,2,1,142,110,10414,8229,139,29,10935,7899
15,2,3,2,0,3,1,0,166,161,10417,8231,206,0,10938,7899
16,2,2,0,0,3,1,0,84,51,10419,8231,95,45,10941,7899
17,2,0,4,1,0,0,3,112,87,10419,8235,118,31,10941,7902
18,3,1,0,0,3,1,0,23,23,10420,8235,32,174,10944,7902
19,3,3,2,0,3,1,0,133,136,10423,8237,162,97,10947,7902
20,3,3,1,0,3,1,0,138,146,10426,8238,136,124,10950,7902
21,3,2,1,0,3,1,0,44,17,10428,8239,47,163,10953,7902
22,3,0,3,1,0,0,3,1,5,10428,8242,0,26,10953,7905
23,3,1,0,0,3,1,0,214,145,10429,8242,249,53,10956,7905
24,3,2,1,0,3,1,0,72,44,10431,8243,64,97,10959,7905
25,3,2,1,0,3,1,0,148,135,10433,8244,151,99,10962,7905
26,3,4,0,0,3,1,0,29,28,10437,8244,25,57,10965,7905
27,4,0,0,2,1,2,1,166,161,10437,8244,207,30,10966,7906
28,4,0,0,2,1,2,1,84,51,10437,8244,96,100,10967,7907
29,4,3,3,2,1,2,1,234,199,10440,8247,237,1,10968,7908
30,4,1,1,2,1,2,1,28,11,10441,8248,46,159,10969,7909
31,4,1,3,1,0,0,3,72,87,10442,8251,67,103,10969,7912
32,4,0,2,1,0,0,3,142,112,10442,8253,139,123,10969,7915
33,4,2,4,1,0,0,3,148,132,10444,8257,155,34,10969,7918
34,4,1,0,0,3,1,0,113,87,10445,8257,121,12,10972,7918
35,4,2,1,0,3,1,0,207,163,10447,8258,221,45,10975,7918
36,5,2,2,2,1,2,1,115,89,10449,8260,122,100,10976,7919
37,5,1,0,0,3,1,0,134,136,10450,8260,165,57,10979,7919
38,5,2,2,2,1,2,1,140,148,10452,8262,137,160,10980,7920
39,5,3,3,2,1,2,1,151,138,10455,8265,152,164,10981,7921
40,5,0,5,1,0,0,3,1,10,10455,8270,0,56,10981,7924
41,5,3,0,0,3,1,0,26,23,10458,8270,35,26,10984,7924
42,5,1,1,2,1,2,1,73,45,10459,8271,65,125,10985,7925
43,5,3,0,0,3,1,0,32,28,10462,8271,28,97,10988,7925
44,5,2,1,0,3,1,0,46,18,10464,8272,50,174,10991,7925
45,6,1,0,0,3,1,0,149,132,10465,8272,158,123,10994,7925
46,6,2,1,0,3,1,0,216,146,10467,8273,252,1,10997,7925
47,6,0,2,1,0,0,3,28,13,10467,8275,46,106,10997,7928
48,6,3,0,0,3,1,0,145,112,10470,8275,142,45,11000,7928
49,6,2,3,1,0,0,3,74,90,10472,8278,67,33,11000,7931
50,6,1,0,0,3,1,0,167,161,10473,8278,210,12,11003,7931
51,6,2,2,2,1,2,1,236,201,10475,8280,238,101,11004,7932
52,6,3,3,2,1,2,1,87,54,10478,8283,97,98,11005,7933
53,6,2,0,0,3,1,0,209,163,10480,8283,224,34,11008,7933
54,7,1,0,0,3,1,0,146,112,10481,8283,145,57,11011,7933
55,7,1,2,1,0,0,3,74,47,10482,8285,65,29,11011,7936
56,7,1,1,2,1,2,1,116,90,10483,8286,123,98,11012,7937
57,7,1,1,2,1,2,1,135,137,10484,8287,166,175,11013,7938
58,7,2,0,0,3,1,0,48,18,10486,8287,53,160,11016,7938
59,7,2,5,1,0,0,3,3,15,10488,8292,0,109,11016,7941
60,7,4,0,0,3,1,0,30,23,10492,8292,38,125,11019,7941
61,7,2,1,0,3,1,0,153,139,10494,8293,155,56,11022,7941
62,7,1,1,2,1,2,1,33,29,10495,8294,29,165,11023,7942
63,8,2,0,0,3,1,0,5,15,10497,8294,3,12,11026,7942
64,8,0,1,1,0,0,3,140,149,10497,8295,137,36,11026,7945
65,8,2,2,2,1,2,1,238,203,10499,8297,239,58,11027,7946
66,8,1,1,2,1,2,1,150,133,10500,8298,159,101,11028,7947
67,8,2,2,2,1,2,1,76,92,10502,8300,68,35,11029,7948
68,8,4,1,0,3,1,0,171,162,10506,8301,213,101,11032,7948
69,8,0,3,1,0,0,3,216,149,10506,8304,252,48,11032,7951
70,8,2,0,0,3,1,0,211,163,10508,8304,227,123,11035,7951
71,8,0,4,1,0,0,3,28,17,10508,8308,46,101,11035,7954
72,9,1,1,2,1,2,1,88,55,10509,8309,98,99,11036,7955
73,9,1,2,1,0,0,3,49,20,10510,8311,53,4,11036,7958
74,9,2,0,0,3,1,0,32,23,10512,8311,41,160,11039,7958
75,9,2,2,2,1,2,1,137,139,10514,8313,167,126,11040,7959
76,9,0,2,1,0,0,3,153,141,10514,8315,155,32,11040,7962
77,9,2,3,1,0,0,3,148,115,10516,8318,145,178,11040,7965
78,9,1,2,1,0,0,3,75,49,10517,8320,65,59,11040,7968
79,9,1,1,2,1,2,1,117,91,10518,8321,124,166,11041,7969
80,9,0,1,1,0,0,3,33,30,10518,8322,29,112,11041,7972
81,10,4,3,0,3,1,0,175,165,10522,8325,216,101,11044,7972
82,10,2,0,0,3,1,0,218,149,10524,8325,255,101,11047,7972
83,10,1,0,0,3,1,0,77,92,10525,8325,71,123,11050,7972
84,10,0,1,1,0,0,3,211,164,10525,8326,227,61,11050,7975
85,10,0,0,2,1,2,1,5,15,10525,8326,4,102,11051,7976
86,10,3,3,2,1,2,1,241,206,10528,8329,240,100,11052,7977
87,10,0,0,2,1,2,1,28,17,10528,8329,47,13,11053,7978
88,10,0,1,1,0,0,3,49,21,10528,8330,53,51,11053,7981
89,10,1,1,2,1,2,1,141,150,10529,8331,138,36,11054,7982
90,11,1,0,0,3,1,0,89,55,10530,8331,101,126,11057,7982
91,11,2,1,0,3,1,0,77,50,10532,8332,68,178,11060,7982
92,11,6,2,0,3,1,0,38,25,10538,8334,44,36,11063,7982
93,11,3,3,2,1,2,1,153,136,10541,8337,160,33,11064,7983
94,11,0,1,1,0,0,3,153,142,10541,8338,155,115,11064,7986
95,11,1,0,0,3,1,0,149,115,10542,8338,148,166,11067,7986
96,11,1,1,2,1,2,1,118,92,10543,8339,125,60,11068,7987
97,11,0,0,2,1,2,1,33,30,10543,8339,30,161,11069,7988
98,11,0,0,2,1,2,1,137,139,10543,8339,168,5,11070,7989
99,12,1,1,2,1,2,1,29,18,10544,8340,48,124,11071,7990
100,12,3,3,2,1,2,1,80,95,10547,8343,72,14,11072,7991
101,12,1,1,2,1,2,1,176,166,10548,8344,217,103,11073,7992
102,12,3,1,0,3,1,0,221,150,10551,8345,258,61,11076,7992
103,12,2,2,2,1,2,1,213,166,10553,8347,228,101,11077,7993
104,12,2,1,0,3,1,0,143,151,10555,8348,141,51,11080,7993
105,12,3,1,0,3,1,0,52,22,10558,8349,56,101,11083,7993
106,12,1,1,2,1,2,1,6,16,10559,8350,5,37,11084,7994
107,12,3,1,0,3,1,0,244,207,10562,8351,243,101,11087,7994
108,13,1,0,0,3,1,0,154,142,10563,8351,158,5,11090,7994
109,13,1,1,2,1,2,1,214,167,10564,8352,229,179,11091,7995
110,13,1,1,2,1,2,1,78,51,10565,8353,69,38,11092,7996
111,13,3,2,0,3,1,0,140,141,10568,8355,171,161,11095,7996
112,13,1,0,0,3,1,0,34,30,10569,8355,33,36,11098,7996
113,13,2,2,2,1,2,1,91,57,10571,8357,102,61,11099,7997
114,13,4,0,0,3,1,0,153,115,10575,8357,151,33,11102,7997
115,13,1,5,1,0,0,3,119,97,10576,8362,125,118,11102,8000
116,13,1,1,2,1,2,1,154,137,10577,8363,161,127,11103,8001
117,14,3,1,0,3,1,0,179,167,10580,8364,220,166,11106,8001
118,14,1,1,2,1,2,1,245,208,10581,8365,244,15,11107,8002
119,14,1,1,2,1,2,1,144,152,10582,8366,142,125,11108,8003
120,14,2,1,0,3,1,0,40,26,10584,8367,47,101,11111,8003
121,14,3,6,1,0,0,3,9,22,10587,8373,5,54,11111,8006
122,14,0,0,2,1,2,1,221,150,10587,8373,259,102,11112,8007
123,14,3,1,0,3,1,0,83,96,10590,8374,75,103,11115,8007
124,14,3,0,0,3,1,0,55,22,10593,8374,59,101,11118,8007
125,14,1,2,1,0,0,3,30,20,10594,8376,48,64,11118,8010
126,15,2,1,0,3,1,0,36,31,10596,8377,36,38,11121,8010
127,15,4,1,0,3,1,0,158,138,10600,8378,164,61,11124,8010
128,15,2,0,0,3,1,0,247,208,10602,8378,247,127,11127,8010
129,15,0,2,1,0,0,3,119,99,10602,8380,125,8,11127,8013
130,15,1,2,1,0,0,3,155,144,10603,8382,158,57,11127,8016
131,15,0,1,1,0,0,3,214,168,10603,8383,229,36,11127,8019
132,15,1,3,1,0,0,3,92,60,10604,8386,102,121,11127,8022
133,15,1,0,0,3,1,0,154,115,10605,8386,154,161,11130,8022
134,15,2,1,0,3,1,0,142,142,10607,8387,174,36,11133,8022
135,16,2,2,2,1,2,1,146,154,10609,8389,143,102,11134,8023
136,16,0,1,1,0,0,3,40,27,10609,8390,47,106,11134,8026
137,16,3,1,0,3,1,0,224,151,10612,8391,262,179,11137,8026
138,16,3,2,0,3,1,0,33,22,10615,8393,51,127,11140,8026
139,16,2,4,1,0,0,3,80,55,10617,8397,69,18,11140,8029
140,16,1,0,0,3,1,0,84,96,10618,8397,78,166,11143,8029
141,16,1,1,2,1,2,1,156,145,10619,8398,159,126,11144,8030
142,16,0,0,2,1,2,1,9,22,10619,8398,6,65,11145,8031
143,16,3,1,0,3,1,0,58,23,10622,8399,62,102,11148,8031
144,17,1,0,0,3,1,0,180,167,10623,8399,223,61,11151,8031
145,17,2,1,0,3,1,0,249,209,10625,8400,250,36,11154,8031
146,17,0,0,2,1,2,1,154,115,10625,8400,155,122,11155,8032
147,17,1,5,1,0,0,3,159,143,10626,8405,164,164,11155,8035
148,17,3,1,0,3,1,0,217,169,10629,8406,232,8,11158,8035
149,17,2,2,2,1,2,1,121,101,10631,8408,126,58,11159,8036
150,17,1,1,2,1,2,1,143,143,10632,8409,175,39,11160,8037
151,17,3,0,0,3,1,0,39,31,10635,8409,39,101,11163,8037
152,17,1,1,2,1,2,1,93,61,10636,8410,103,37,11164,8038
153,18,2,0,0,3,1,0,123,101,10638,8410,129,101,11167,8038
154,18,0,1,1,0,0,3,159,144,10638,8411,164,11,11167,8041
155,18,3,1,0,3,1,0,183,168,10641,8412,226,164,11170,8041
156,18,2,2,2,1,2,1,95,63,10643,8414,104,40,11171,8042
157,18,2,2,2,1,2,1,35,24,10645,8416,52,38,11172,8043
158,18,3,0,0,3,1,0,220,169,10648,8416,235,122,11175,8043
159,18,2,3,1,0,0,3,251,212,10650,8419,250,64,11175,8046
160,18,3,1,0,3,1,0,157,116,10653,8420,158,18,11178,8046
161,18,2,2,2,1,2,1,145,145,10655,8422,176,59,11179,8047
162,19,2,0,0,3,1,0,148,154,10657,8422,146,179,11182,8047
163,19,3,0,0,3,1,0,227,151,10660,8422,265,166,11185,8047
164,19,1,0,0,3,1,0,85,96,10661,8422,81,36,11188,8047
165,19,1,0,0,3,1,0,10,22,10662,8422,9,127,11191,8047
166,19,3,0,0,3,1,0,61,23,10665,8422,65,106,11194,8047
167,19,1,1,2,1,2,1,81,56,10666,8423,70,66,11195,8048
168,19,1,0,0,3,1,0,157,145,10667,8423,162,102,11198,8048
169,19,1,3,1,0,0,3,40,34,10668,8426,39,129,11198,8051
170,19,4,1,0,3,1,0,44,28,10672,8427,50,102,11201,8051
171,20,0,0,2,1,2,1,183,168,10672,8427,227,123,11202,8052
172,20,0,2,1,0,0,3,85,98,10672,8429,81,167,11202,8055
173,20,2,2,2,1,2,1,37,26,10674,8431,53,12,11203,8056
174,20,0,2,1,0,0,3,159,146,10674,8433,164,62,11203,8059
175,20,1,1,2,1,2,1,221,170,10675,8434,236,39,11204,8060
176,20,2,2,2,1,2,1,97,65,10677,8436,105,19,11205,8061
177,20,0,0,2,1,2,1,157,116,10677,8436,159,102,11206,8062
178,20,2,0,0,3,1,0,125,101,10679,8436,132,129,11209,8062
179,20,1,3,1,0,0,3,252,215,10680,8439,250,43,11209,8065
180,21,0,1,1,0,0,3,145,146,10680,8440,176,109,11209,8068
181,21,2,3,1,0,0,3,159,148,10682,8443,162,69,11209,8071
182,21,2,0,0,3,1,0,46,28,10684,8443,53,102,11212,8071
183,21,3,0,0,3,1,0,64,23,10687,8443,68,127,11215,8071
184,21,0,1,1,0,0,3,40,35,10687,8444,39,105,11215,8074
185,21,6,0,0,3,1,0,154,154,10693,8444,149,64,11218,8074
186,21,1,3,1,0,0,3,228,154,10694,8447,265,39,11218,8077
187,21,0,1,1,0,0,3,10,23,10694,8448,9,182,11218,8080
188,21,2,1,0,3,1,0,83,57,10696,8449,73,166,11221,8080
189,22,0,0,2,1,2,1,221,170,10696,8449,237,103,11222,8081
190,22,2,2,2,1,2,1,159,118,10698,8451,160,106,11223,8082
191,22,2,4,1,0,0,3,230,158,10700,8455,265,126,11223,8085
192,22,1,1,2,1,2,1,38,27,10701,8456,54,44,11224,8086
193,22,1,0,0,3,1,0,86,98,10702,8456,84,12,11227,8086
194,22,1,2,1,0,0,3,184,170,10703,8458,227,65,11227,8089
195,22,1,0,0,3,1,0,98,65,10704,8458,108,129,11230,8089
196,22,1,1,2,1,2,1,160,147,10705,8459,165,20,11231,8090
197,22,0,1,1,0,0,3,252,216,10705,8460,250,42,11231,8093
198,23,1,1,2,1,2,1,11,24,10706,8461,10,168,11232,8094
199,23,0,0,2,1,2,1,40,35,10706,8461,40,128,11233,8095
200,23,0,2,1,0,0,3,46,30,10706,8463,53,169,11233,8098
201,23,0,1,1,0,0,3,83,58,10706,8464,73,112,11233,8101
202,23,1,2,1,0,0,3,160,150,10707,8466,162,185,11233,8104
203,23,2,0,0,3,1,0,66,23,10709,8466,71,64,11236,8104
204,23,1,2,1,0,0,3,126,103,10710,8468,132,72,11236,8107
205,23,0,2,1,0,0,3,145,148,10710,8470,176,105,11236,8110
206,23,1,0,0,3,1,0,155,154,10711,8470,152,39,11239,8110
207,24,0,1,1,0,0,3,160,148,10711,8471,165,109,11239,8113
208,24,1,2,1,0,0,3,87,100,10712,8473,84,106,11239,8116
209,24,3,0,0,3,1,0,187,170,10715,8473,230,44,11242,8116
210,24,2,0,0,3,1,0,100,65,10717,8473,111,112,11245,8116
211,24,2,0,0,3,1,0,232,158,10719,8473,268,42,11248,8116
212,24,1,0,0,3,1,0,156,154,10720,8473,155,12,11251,8116
213,24,4,4,2,1,2,1,256,220,10724,8477,251,130,11252,8117
214,24,3,1,0,3,1,0,224,171,10727,8478,240,20,11255,8117
215,24,3,1,0,3,1,0,41,28,10730,8479,57,65,11258,8117
216,25,2,6,1,0,0,3,42,41,10732,8485,40,15,11258,8120
217,25,0,3,1,0,0,3,126,106,10732,8488,132,42,11258,8123
218,25,0,0,2,1,2,1,100,65,10732,8488,112,186,11259,8124
219,25,2,1,0,3,1,0,48,31,10734,8489,56,64,11262,8124
220,25,3,1,0,3,1,0,162,119,10737,8490,163,105,11265,8124
221,25,1,1,2,1,2,1,84,59,10738,8491,74,169,11266,8125
222,25,2,2,2,1,2,1,147,150,10740,8493,177,170,11267,8126
223,25,2,1,0,3,1,0,162,151,10742,8494,165,128,11270,8126
224,25,1,1,2,1,2,1,67,24,10743,8495,72,127,11271,8127
225,26,3,1,0,3,1,0,190,171,10746,8496,233,130,11274,8127
226,26,3,0,0,3,1,0,259,220,10749,8496,254,112,11277,8127
227,26,2,0,0,3,1,0,162,148,10751,8496,168,72,11280,8127
228,26,2,2,2,1,2,1,89,102,10753,8498,85,66,11281,8128
229,26,1,1,2,1,2,1,157,155,10754,8499,156,21,11282,8129
230,26,2,2,2,1,2,1,234,160,10756,8501,269,45,11283,8130
231,26,1,0,0,3,1,0,225,171,10757,8501,243,109,11286,8130
232,26,2,1,0,3,1,0,13,25,10759,8502,13,42,11289,8130
233,26,3,0,0,3,1,0,44,28,10762,8502,60,106,11292,8130
234,27,1,0,0,3,1,0,163,119,10763,8502,166,15,11295,8130
235,27,1,1,2,1,2,1,127,107,10764,8503,133,129,11296,8131
236,27,4,0,0,3,1,0,104,65,10768,8503,115,170,11299,8131
237,27,0,0,2,1,2,1,147,150,10768,8503,178,65,11300,8132
238,27,2,4,1,0,0,3,44,45,10770,8507,40,45,11300,8135
239,27,0,0,2,1,2,1,48,31,10770,8507,57,128,11301,8136
240,27,3,2,0,3,1,0,87,61,10773,8509,77,42,11304,8136
241,27,0,0,2,1,2,1,162,148,10773,8509,169,187,11305,8137
242,27,1,1,2,1,2,1,163,152,10774,8510,166,170,11306,8138
243,28,1,3,1,0,0,3,191,174,10775,8513,233,75,11306,8141
244,28,0,2,1,0,0,3,234,162,10775,8515,269,24,11306,8144
245,28,2,2,2,1,2,1,91,104,10777,8517,86,110,11307,8145
246,28,0,1,1,0,0,3,13,26,10777,8518,13,133,11307,8148
247,28,2,1,0,3,1,0,261,221,10779,8519,257,66,11310,8148
248,28,1,1,2,1,2,1,45,29,10780,8520,61,106,11311,8149
249,28,0,0,2,1,2,1,225,171,10780,8520,244,113,11312,8150
250,28,3,2,0,3,1,0,70,26,10783,8522,75,45,11315,8150
251,28,4,0,0,3,1,0,161,155,10787,8522,159,106,11318,8150
252,29,2,2,2,1,2,1,46,47,10789,8524,41,66,11319,8151
253,29,1,1,2,1,2,1,105,66,10790,8525,116,171,11320,8152
254,29,1,2,1,0,0,3,88,63,10791,8527,77,131,11320,8155
255,29,1,1,2,1,2,1,163,149,10792,8528,170,171,11321,8156
256,29,0,0,2,1,2,1,127,107,10792,8528,134,188,11322,8157
257,29,3,1,0,3,1,0,150,151,10795,8529,181,45,11325,8157
258,29,3,2,0,3,1,0,51,33,10798,8531,60,15,11328,8157
259,29,3,0,0,3,1,0,166,119,10801,8531,169,129,11331,8157
260,29,0,2,1,0,0,3,163,154,10801,8533,166,45,11331,8160
261,30,2,0,0,3,1,0,263,221,10803,8533,260,171,11334,8160
262,30,1,2,1,0,0,3,235,164,10804,8535,269,136,11334,8163
263,30,1,1,2,1,2,1,162,156,10805,8536,160,111,11335,8164
264,30,3,0,0,3,1,0,94,104,10808,8536,89,75,11338,8164
265,30,2,3,1,0,0,3,15,29,10810,8539,13,109,11338,8167
266,30,1,0,0,3,1,0,192,174,10811,8539,236,106,11341,8167
267,30,2,1,0,3,1,0,47,30,10813,8540,64,113,11344,8167
268,30,0,0,2,1,2,1,70,26,10813,8540,76,25,11345,8168
269,30,3,3,2,1,2,1,54,36,10816,8543,61,67,11346,8169
270,31,0,1,1,0,0,3,163,155,10816,8544,166,48,11346,8172
271,31,0,0,2,1,2,1,150,151,10816,8544,182,132,11347,8173
272,31,4,1,0,3,1,0,170,120,10820,8545,172,66,11350,8173
273,31,1,2,1,0,0,3,89,65,10821,8547,77,18,11350,8176
274,31,0,1,1,0,0,3,127,108,10821,8548,134,174,11350,8179
275,31,0,2,1,0,0,3,46,49,10821,8550,41,191,11350,8182
276,31,3,2,0,3,1,0,108,68,10824,8552,119,45,11353,8182
277,31,2,1,0,3,1,0,165,150,10826,8553,173,45,11356,8182
278,31,2,1,0,3,1,0,227,172,10828,8554,247,129,11359,8182
279,32,0,0,2,1,2,1,235,164,10828,8554,270,114,11360,8183
280,32,1,1,2,1,2,1,55,37,10829,8555,62,26,11361,8184
281,32,0,6,1,0,0,3,15,35,10829,8561,13,114,11361,8187
282,32,1,2,1,0,0,3,193,176,10830,8563,236,194,11361,8190
283,32,4,0,0,3,1,0,51,30,10834,8563,67,171,11364,8190
284,32,2,1,0,3,1,0,96,105,10836,8564,92,106,11367,8190
285,32,5,1,0,3,1,0,75,27,10841,8565,79,136,11370,8190
286,32,2,0,0,3,1,0,91,65,10843,8565,80,109,11373,8190
287,32,1,0,0,3,1,0,163,156,10844,8565,163,75,11376,8190
288,33,2,1,0,3,1,0,195,177,10846,8566,239,45,11379,8190
289,33,2,2,2,1,2,1,265,223,10848,8568,261,175,11380,8191
290,33,3,1,0,3,1,0,111,69,10851,8569,122,18,11383,8191
291,33,2,1,0,3,1,0,172,121,10853,8570,175,48,11386,8191
292,33,0,6,1,0,0,3,127,114,10853,8576,134,48,11386,8194
293,33,0,1,1,0,0,3,150,152,10853,8577,182,112,11386,8197
294,33,1,1,2,1,2,1,228,173,10854,8578,248,67,11387,8198
295,33,4,1,0,3,1,0,50,50,10858,8579,44,67,11390,8198
296,33,3,3,2,1,2,1,168,153,10861,8582,174,133,11391,8199
297,34,3,0,0,3,1,0,166,156,10864,8582,166,114,11394,8199
298,34,1,2,1,0,0,3,236,166,10865,8584,270,109,11394,8202
299,34,1,5,1,0,0,3,56,42,10866,8589,62,139,11394,8205
300,34,2,0,0,3,1,0,53,30,10868,8589,70,194,11397,8205
301,34,1,1,2,1,2,1,92,66,10869,8590,81,115,11398,8206
302,34,1,2,1,0,0,3,97,107,10870,8592,92,132,11398,8209
303,34,2,2,2,1,2,1,165,157,10872,8594,167,27,11399,8210
304,34,1,3,1,0,0,3,76,30,10873,8597,79,78,11399,8213
305,34,5,3,0,3,1,0,20,38,10878,8600,16,171,11402,8213
0,1,2,1,0,3,1,0,58,43,10880,8601,65,150,11405,8213
1,1,1,1,2,1,2,1,98,108,10881,8602,93,116,11406,8214
2,1,2,0,0,3,1,0,55,30,10883,8602,73,109,11409,8214
3,1,3,2,0,3,1,0,153,154,10886,8604,185,78,11412,8214
4,1,0,3,1,0,0,3,14,17,10886,8607,20,135,11412,8217
5,1,2,0,0,3,1,0,174,121,10888,8607,178,127,11415,8217
6,1,1,1,2,1,2,1,237,167,10889,8608,271,28,11416,8218
7,1,1,0,0,3,1,0,93,66,10890,8608,84,125,11419,8218
8,1,2,2,2,1,2,1,267,225,10892,8610,262,172,11420,8219
9,2,2,1,0,3,1,0,52,51,10894,8611,47,45,11423,8219
10,2,1,1,2,1,2,1,196,178,10895,8612,240,176,11424,8220
11,2,0,0,2,1,2,1,151,96,10895,8612,187,68,11425,8221
12,2,0,0,2,1,2,1,111,69,10895,8612,123,68,11426,8222
13,2,1,0,0,3,1,0,185,140,10896,8612,202,14,11429,8222
14,2,0,1,1,0,0,3,168,154,10896,8613,174,197,11429,8225
15,2,1,0,0,3,1,0,128,114,10897,8613,137,139,11432,8225
16,2,4,2,0,3,1,0,232,175,10901,8615,251,114,11435,8225
17,2,3,4,1,0,0,3,169,125,10904,8619,164,51,11435,8228
18,3,0,0,2,1,2,1,267,225,10904,8619,263,29,11436,8229
19,3,1,0,0,3,1,0,154,154,10905,8619,188,172,11439,8229
20,3,4,1,0,3,1,0,59,31,10909,8620,76,127,11442,8229
21,3,0,0,2,1,2,1,174,121,10909,8620,179,126,11443,8230
22,3,1,0,0,3,1,0,99,108,10910,8620,96,109,11446,8230
23,3,2,1,0,3,1,0,95,67,10912,8621,87,150,11449,8230
24,3,2,2,2,1,2,1,16,19,10914,8623,21,177,11450,8231
25,3,2,3,1,0,0,3,130,117,10916,8626,137,81,11450,8234
26,3,3,0,0,3,1,0,61,43,10919,8626,68,135,11453,8234
27,4,2,1,0,3,1,0,153,97,10921,8627,190,197,11456,8234
28,4,0,1,1,0,0,3,237,168,10921,8628,271,54,11456,8237
29,4,3,0,0,3,1,0,171,154,10924,8628,177,139,11459,8237
30,4,2,1,0,3,1,0,198,179,10926,8629,243,114,11462,8237
31,4,2,2,2,1,2,1,187,142,10928,8631,203,69,11463,8238
32,4,1,0,0,3,1,0,170,125,10929,8631,167,45,11466,8238
33,4,0,2,1,0,0,3,16,21,10929,8633,21,71,11466,8241
34,4,2,2,2,1,2,1,234,177,10931,8635,252,117,11467,8242
35,4,1,1,2,1,2,1,53,52,10932,8636,48,82,11468,8243
36,5,1,1,2,1,2,1,131,118,10933,8637,138,110,11469,8244
37,5,3,0,0,3,1,0,102,108,10936,8637,99,127,11472,8244
38,5,2,2,2,1,2,1,113,71,10938,8639,124,173,11473,8245
39,5,3,1,0,3,1,0,64,44,10941,8640,71,14,11476,8245
40,5,3,0,0,3,1,0,62,31,10944,8640,79,150,11479,8245
41,5,1,3,1,0,0,3,96,70,10945,8643,87,180,11479,8248
42,5,2,0,0,3,1,0,269,225,10947,8643,266,135,11482,8248
43,5,1,1,2,1,2,1,175,122,10948,8644,180,30,11483,8249
44,5,1,1,2,1,2,1,155,155,10949,8645,189,127,11484,8250
45,6,1,0,0,3,1,0,188,142,10950,8645,206,114,11487,8250
46,6,2,2,2,1,2,1,66,46,10952,8647,72,174,11488,8251
47,6,1,1,2,1,2,1,199,180,10953,8648,244,72,11489,8252
48,6,3,2,0,3,1,0,156,99,10956,8650,193,117,11492,8252
49,6,3,1,0,3,1,0,173,126,10959,8651,170,69,11495,8252
50,6,2,1,0,3,1,0,55,53,10961,8652,51,139,11498,8252
51,6,4,1,0,3,1,0,241,169,10965,8653,274,45,11501,8252
52,6,3,4,1,0,0,3,174,158,10968,8657,177,85,11501,8255
53,6,2,3,1,0,0,3,18,24,10970,8660,21,200,11501,8258
54,7,4,1,0,3,1,0,179,123,10974,8661,183,14,11504,8258
55,7,2,2,2,1,2,1,157,157,10976,8663,190,128,11505,8259
56,7,0,2,1,0,0,3,269,227,10976,8665,266,183,11505,8262
57,7,0,0,2,1,2,1,62,31,10976,8665,80,136,11506,8263
58,7,1,1,2,1,2,1,132,119,10977,8666,139,151,11507,8264
59,7,0,4,1,0,0,3,113,75,10977,8670,124,130,11507,8267
60,7,2,4,1,0,0,3,104,112,10979,8674,99,33,11507,8270
61,7,0,3,1,0,0,3,234,180,10979,8677,252,113,11507,8273
62,7,1,1,2,1,2,1,97,71,10980,8678,88,55,11508,8274
63,8,1,3,1,0,0,3,157,102,10981,8681,193,116,11508,8277
64,8,1,0,0,3,1,0,189,142,10982,8681,209,139,11511,8277
65,8,2,2,2,1,2,1,99,73,10984,8683,89,115,11512,8278
66,8,2,0,0,3,1,0,175,126,10986,8683,173,174,11515,8278
67,8,3,0,0,3,1,0,202,180,10989,8683,247,85,11518,8278
68,8,3,1,0,3,1,0,244,170,10992,8684,277,69,11521,8278
69,8,1,3,1,0,0,3,67,49,10993,8687,72,203,11521,8281
70,8,2,1,0,3,1,0,20,25,10995,8688,24,45,11524,8281
71,8,1,4,1,0,0,3,56,57,10996,8692,51,120,11524,8284
72,9,0,1,1,0,0,3,234,181,10996,8693,252,36,11524,8287
73,9,4,0,0,3,1,0,117,75,11000,8693,127,128,11527,8287
74,9,1,0,0,3,1,0,175,158,11001,8693,180,130,11530,8287
75,9,2,1,0,3,1,0,106,113,11003,8694,102,14,11533,8287
76,9,1,4,1,0,0,3,158,161,11004,8698,190,139,11533,8290
77,9,0,3,1,0,0,3,62,34,11004,8701,80,75,11533,8293
78,9,3,2,0,3,1,0,182,125,11007,8703,186,55,11536,8293
79,9,2,3,1,0,0,3,134,122,11009,8706,139,186,11536,8296
80,9,5,0,0,3,1,0,274,227,11014,8706,269,151,11539,8296
81,10,3,2,0,3,1,0,192,144,11017,8708,212,85,11542,8296
82,10,3,1,0,3,1,0,102,74,11020,8709,92,203,11545,8296
83,10,2,1,0,3,1,0,159,103,11022,8710,196,174,11548,8296
84,10,0,1,1,0,0,3,244,171,11022,8711,277,118,11548,8299
85,10,0,1,1,0,0,3,67,50,11022,8712,72,48,11548,8302
86,10,1,2,1,0,0,3,57,59,11023,8714,51,119,11548,8305
87,10,0,2,1,0,0,3,202,182,11023,8716,247,72,11548,8308
88,10,0,2,1,0,0,3,175,128,11023,8718,173,123,11548,8311
89,10,2,3,1,0,0,3,22,28,11025,8721,24,142,11548,8314
90,11,3,0,0,3,1,0,277,227,11028,8721,272,130,11551,8314
91,11,0,3,1,0,0,3,158,164,11028,8724,190,189,11551,8317
92,11,1,2,1,0,0,3,118,77,11029,8726,127,58,11551,8320
93,11,1,0,0,3,1,0,183,125,11030,8726,189,48,11554,8320
94,11,2,3,1,0,0,3,108,116,11032,8729,102,78,11554,8323
95,11,0,2,1,0,0,3,159,105,11032,8731,196,39,11554,8326
96,11,1,2,1,0,0,3,176,160,11033,8733,180,154,11554,8329
97,11,2,1,0,3,1,0,136,123,11035,8734,142,14,11557,8329
98,11,2,2,2,1,2,1,236,183,11037,8736,253,140,11558,8330
99,12,0,4,1,0,0,3,244,175,11037,8740,277,88,11558,8333
100,12,4,0,0,3,1,0,71,50,11041,8740,75,142,11561,8333
101,12,2,0,0,3,1,0,64,34,11043,8740,83,203,11564,8333
102,12,0,0,2,1,2,1,183,125,11043,8740,190,73,11565,8334
103,12,3,0,0,3,1,0,195,144,11046,8740,215,39,11568,8334
104,12,1,0,0,3,1,0,103,74,11047,8740,95,123,11571,8334
105,12,2,2,2,1,2,1,177,130,11049,8742,174,129,11572,8335
106,12,4,1,0,3,1,0,206,183,11053,8743,250,119,11575,8335
107,12,1,1,2,1,2,1,23,29,11054,8744,25,175,11576,8336
108,13,3,0,0,3,1,0,280,227,11057,8744,275,118,11579,8336
109,13,0,0,2,1,2,1,108,116,11057,8744,103,49,11580,8337
110,13,0,3,1,0,0,3,159,108,11057,8747,196,192,11580,8340
111,13,2,0,0,3,1,0,120,77,11059,8747,130,14,11583,8340
112,13,0,1,1,0,0,3,57,60,11059,8748,51,133,11583,8343
113,13,1,0,0,3,1,0,137,123,11060,8748,145,140,11586,8343
114,13,0,2,1,0,0,3,158,166,11060,8750,190,81,11586,8346
115,13,0,3,1,0,0,3,236,186,11060,8753,253,157,11586,8349
116,13,1,2,1,0,0,3,177,162,11061,8755,180,61,11586,8352
117,14,2,0,0,3,1,0,185,125,11063,8755,193,123,11589,8352
118,14,2,1,0,3,1,0,282,228,11065,8756,278,88,11592,8352
119,14,2,4,1,0,0,3,25,33,11067,8760,25,122,11592,8355
120,14,3,1,0,3,1,0,209,184,11070,8761,253,129,11595,8355
121,14,2,1,0,3,1,0,246,176,11072,8762,280,175,11598,8355
122,14,3,1,0,3,1,0,74,51,11075,8763,78,73,11601,8355
123,14,4,0,0,3,1,0,68,34,11079,8763,86,142,11604,8355
124,14,1,2,1,0,0,3,104,76,11080,8765,95,42,11604,8358
125,14,2,1,0,3,1,0,197,145,11082,8766,218,133,11607,8358
126,15,4,0,0,3,1,0,162,166,11086,8766,193,118,11610,8358
127,15,3,2,0,3,1,0,180,164,11089,8768,183,192,11613,8358
128,15,1,1,2,1,2,1,138,124,11090,8769,146,62,11614,8359
129,15,1,1,2,1,2,1,237,187,11091,8770,254,82,11615,8360
130,15,2,3,1,0,0,3,59,63,11093,8773,51,17,11615,8363
131,15,1,2,1,0,0,3,121,79,11094,8775,130,52,11615,8366
132,15,2,1,0,3,1,0,179,131,11096,8776,177,140,11618,8366
133,15,0,2,1,0,0,3,108,118,11096,8778,103,206,11618,8369
134,15,0,0,2,1,2,1,159,108,11096,8778,197,158,11619,8370
135,16,0,0,2,1,2,1,25,33,11096,8778,26,130,11620,8371
136,16,1,1,2,1,2,1,247,177,11097,8779,281,134,11621,8372
137,16,0,3,1,0,0,3,209,187,11097,8782,253,161,11621,8375
138,16,3,1,0,3,1,0,285,229,11100,8783,281,123,11624,8375
139,16,2,3,1,0,0,3,70,37,11102,8786,86,178,11624,8378
140,16,3,0,0,3,1,0,188,125,11105,8786,196,88,11627,8378
141,16,2,3,1,0,0,3,106,79,11107,8789,95,125,11627,8381
142,16,3,1,0,3,1,0,111,119,11110,8790,106,142,11630,8381
143,16,5,0,0,3,1,0,79,51,11115,8790,81,42,11633,8381
144,17,0,1,1,0,0,3,59,64,11115,8791,51,143,11633,8384
145,17,3,3,2,1,2,1,200,148,11118,8794,219,193,11634,8385
146,17,2,4,1,0,0,3,161,112,11120,8798,197,65,11634,8388
147,17,1,1,2,1,2,1,181,165,11121,8799,184,119,11635,8389
148,17,1,0,0,3,1,0,180,131,11122,8799,180,17,11638,8389
149,17,0,2,1,0,0,3,121,81,11122,8801,130,85,11638,8392
150,17,2,5,1,0,0,3,140,129,11124,8806,146,55,11638,8395
151,17,1,1,2,1,2,1,163,167,11125,8807,194,207,11639,8396
152,17,2,0,0,3,1,0,239,187,11127,8807,257,73,11642,8396
153,18,2,1,0,3,1,0,211,188,11129,8808,256,17,11645,8396
154,18,1,0,0,3,1,0,162,112,11130,8808,200,119,11648,8396
155,18,0,0,2,1,2,1,200,148,11130,8808,220,66,11649,8397
156,18,0,1,1,0,0,3,59,65,11130,8809,51,196,11649,8400
157,18,2,1,0,3,1,0,123,82,11132,8810,133,142,11652,8400
158,18,1,0,0,3,1,0,182,165,11133,8810,187,55,11655,8400
159,18,0,1,1,0,0,3,140,130,11133,8811,146,76,11655,8403
160,18,1,1,2,1,2,1,181,132,11134,8812,181,86,11656,8404
161,18,2,3,1,0,0,3,241,190,11136,8815,257,210,11656,8407
162,19,2,1,0,3,1,0,27,34,11138,8816,29,161,11659,8407
163,19,3,0,0,3,1,0,250,177,11141,8816,284,143,11662,8407
164,19,3,1,0,3,1,0,82,52,11144,8817,84,134,11665,8407
165,19,3,1,0,3,1,0,109,80,11147,8818,98,130,11668,8407
166,19,1,1,2,1,2,1,112,120,11148,8819,107,89,11669,8408
167,19,1,2,1,0,0,3,286,231,11149,8821,281,128,11669,8411
168,19,3,4,1,0,0,3,191,129,11152,8825,196,181,11669,8414
169,19,2,0,0,3,1,0,165,167,11154,8825,197,123,11672,8414
170,19,1,0,0,3,1,0,71,37,11155,8825,89,42,11675,8414
171,20,3,3,2,1,2,1,214,191,11158,8828,257,67,11676,8415
172,20,2,1,0,3,1,0,243,191,11160,8829,260,142,11679,8415
173,20,1,2,1,0,0,3,163,114,11161,8831,200,58,11679,8418
174,20,1,2,1,0,0,3,124,84,11162,8833,133,126,11679,8421
175,20,1,2,1,0,0,3,60,67,11163,8835,51,213,11679,8424
176,20,4,1,0,3,1,0,254,178,11167,8836,287,17,11682,8424
177,20,0,0,2,1,2,1,182,165,11167,8836,188,77,11683,8425
178,20,0,2,1,0,0,3,200,150,11167,8838,220,89,11683,8428
179,20,2,2,2,1,2,1,183,134,11169,8840,182,120,11684,8429
180,21,0,0,2,1,2,1,71,37,11169,8840,90,135,11685,8430
181,21,1,0,0,3,1,0,110,80,11170,8840,101,17,11688,8430
182,21,0,0,2,1,2,1,82,52,11170,8840,85,197,11689,8431
183,21,2,0,0,3,1,0,193,129,11172,8840,199,143,11692,8431
184,21,1,1,2,1,2,1,113,121,11173,8841,108,162,11693,8432
185,21,2,3,1,0,0,3,167,170,11175,8844,197,131,11693,8435
186,21,2,0,0,3,1,0,288,231,11177,8844,284,130,11696,8435
187,21,1,0,0,3,1,0,125,84,11178,8844,136,42,11699,8435
188,21,1,2,1,0,0,3,141,132,11179,8846,146,184,11699,8438
189,22,1,0,0,3,1,0,215,191,11180,8846,260,213,11702,8438
190,22,2,0,0,3,1,0,165,114,11182,8846,203,77,11705,8438
191,22,2,1,0,3,1,0,185,135,11184,8847,185,142,11708,8438
192,22,3,2,0,3,1,0,246,193,11187,8849,263,89,11711,8438
193,22,1,2,1,0,0,3,61,69,11188,8851,51,123,11711,8441
194,22,3,2,0,3,1,0,203,152,11191,8853,223,58,11714,8441
195,22,0,1,1,0,0,3,182,166,11191,8854,188,129,11714,8444
196,22,3,2,0,3,1,0,30,36,11194,8856,32,67,11717,8444
197,22,2,1,0,3,1,0,256,179,11196,8857,290,89,11720,8444
198,23,1,0,0,3,1,0,114,121,11197,8857,111,135,11723,8444
199,23,0,1,1,0,0,3,125,85,11197,8858,136,134,11723,8447
200,23,3,0,0,3,1,0,291,231,11200,8858,287,17,11726,8447
201,23,2,2,2,1,2,1,73,39,11202,8860,91,198,11727,8448
202,23,1,0,0,3,1,0,111,80,11203,8860,104,143,11730,8448
203,23,3,2,0,3,1,0,196,131,11206,8862,202,162,11733,8448
204,23,0,0,2,1,2,1,141,132,11206,8862,147,131,11734,8449
205,23,3,0,0,3,1,0,170,170,11209,8862,200,42,11737,8449
206,23,1,0,0,3,1,0,247,193,11210,8862,266,67,11740,8449
207,24,1,2,1,0,0,3,31,38,11211,8864,32,126,11740,8452
208,24,2,3,1,0,0,3,187,138,11213,8867,185,92,11740,8455
209,24,1,1,2,1,2,1,216,192,11214,8868,261,59,11741,8456
210,24,1,2,1,0,0,3,257,181,11215,8870,290,216,11741,8459
211,24,0,0,2,1,2,1,182,166,11215,8870,189,185,11742,8460
212,24,1,0,0,3,1,0,166,114,11216,8870,206,142,11745,8460
213,24,3,1,0,3,1,0,206,153,11219,8871,226,129,11748,8460
214,24,1,1,2,1,2,1,83,53,11220,8872,86,90,11749,8461
215,25,0,2,1,0,0,3,291,233,11220,8874,287,70,11749,8464
216,25,4,1,0,3,1,0,129,86,11224,8875,139,143,11752,8464
217,25,0,0,2,1,2,1,170,170,11224,8875,201,163,11753,8465
218,25,0,0,2,1,2,1,182,166,11224,8875,190,132,11754,8466
219,25,1,1,2,1,2,1,142,133,11225,8876,148,43,11755,8467
220,25,0,2,1,0,0,3,247,195,11225,8878,266,138,11755,8470
221,25,1,2,1,0,0,3,115,123,11226,8880,111,201,11755,8473
222,25,1,0,0,3,1,0,197,131,11227,8880,205,90,11758,8473
223,25,1,2,1,0,0,3,74,41,11228,8882,91,20,11758,8476
224,26,2,2,2,1,2,1,189,140,11230,8884,186,135,11759,8477
225,26,2,0,0,3,1,0,218,192,11232,8884,264,142,11762,8477
226,26,1,1,2,1,2,1,167,115,11233,8885,207,93,11763,8478
227,26,2,0,0,3,1,0,85,53,11235,8885,89,126,11766,8478
228,26,2,2,2,1,2,1,259,183,11237,8887,291,130,11767,8479
229,26,1,2,1,0,0,3,62,71,11238,8889,51,188,11767,8482
230,26,1,1,2,1,2,1,32,39,11239,8890,33,78,11768,8483
231,26,0,3,1,0,0,3,206,156,11239,8893,226,219,11768,8486
232,27,2,1,0,3,1,0,293,234,11241,8894,290,90,11771,8486
233,27,0,1,1,0,0,3,197,132,11241,8895,205,204,11771,8489
234,27,0,1,1,0,0,3,182,167,11241,8896,190,46,11771,8492
235,27,1,2,1,0,0,3,130,88,11242,8898,139,166,11771,8495
236,27,3,3,2,1,2,1,77,44,11245,8901,92,71,11772,8496
237,27,2,1,0,3,1,0,144,134,11247,8902,151,138,11775,8496
238,27,1,1,2,1,2,1,116,124,11248,8903,112,144,11776,8497
239,27,1,0,0,3,1,0,171,170,11249,8903,204,20,11779,8497
240,27,2,0,0,3,1,0,249,195,11251,8903,269,132,11782,8497
241,28,1,2,1,0,0,3,86,55,11252,8905,89,96,11782,8500
242,28,1,3,1,0,0,3,219,195,11253,8908,264,191,11782,8503
243,28,3,0,0,3,1,0,192,140,11256,8908,189,219,11785,8503
244,28,1,3,1,0,0,3,78,47,11257,8911,92,129,11785,8506
245,28,0,4,1,0,0,3,62,75,11257,8915,51,135,11785,8509
246,28,1,1,2,1,2,1,33,40,11258,8916,34,131,11786,8510
0,1,2,1,0,3,1,0,2,1,11260,8917,3,0,11789,8510
1,1,4,1,0,3,1,0,4,1,11264,8918,3,0,11792,8510
2,1,1,1,2,1,2,1,1,1,11265,8919,1,132,11793,8511
3,1,1,3,1,0,0,3,105,52,11266,8922,96,120,11793,8514
4,1,1,3,1,0,0,3,48,23,11267,8925,41,194,11793,8517
5,1,2,1,0,3,1,0,80,48,11269,8926,95,30,11796,8517
6,1,2,1,0,3,1,0,88,56,11271,8927,92,0,11799,8517
7,1,2,0,0,3,1,0,2,0,11273,8927,3,48,11802,8517
8,1,0,2,1,0,0,3,0,2,11273,8929,0,3,11802,8520
9,2,2,0,0,3,1,0,148,90,11275,8929,175,0,11805,8520
10,2,1,2,1,0,0,3,1,2,11276,8931,0,62,11805,8523
11,2,4,2,0,3,1,0,4,2,11280,8933,3,89,11808,8523
12,2,3,4,1,0,0,3,3,4,11283,8937,0,3,11808,8526
13,2,1,3,1,0,0,3,39,15,11284,8940,38,74,11808,8529
14,2,1,2,1,0,0,3,145,136,11285,8942,151,34,11808,8532
15,2,0,1,1,0,0,3,249,196,11285,8943,269,3,11808,8535
16,2,3,6,1,0,0,3,3,6,11288,8949,0,3,11808,8538
17,2,1,3,1,0,0,3,77,33,11289,8952,79,3,11808,8541
18,3,2,0,0,3,1,0,6,1,11291,8952,6,0,11811,8541
19,3,2,0,0,3,1,0,2,2,11293,8952,3,0,11814,8541
20,3,1,1,2,1,2,1,89,57,11294,8953,93,133,11815,8542
21,3,0,4,1,0,0,3,1,5,11294,8957,1,33,11815,8545
22,3,2,1,0,3,1,0,50,24,11296,8958,44,48,11818,8545
23,3,2,2,2,1,2,1,82,50,11298,8960,96,4,11819,8546
24,3,0,0,2,1,2,1,2,1,11298,8960,4,1,11820,8547
25,3,2,1,0,3,1,0,4,1,11300,8961,6,120,11823,8547
26,3,1,0,0,3,1,0,106,52,11301,8961,99,194,11826,8547
27,4,0,1,1,0,0,3,39,16,11301,8962,38,37,11826,8550
28,4,0,0,2,1,2,1,2,1,11301,8962,5,90,11827,8551
29,4,0,2,1,0,0,3,4,4,11301,8964,3,6,11827,8554
30,4,7,0,0,3,1,0,84,33,11308,8964,82,3,11830,8554
31,4,2,0,0,3,1,0,5,4,11310,8964,3,62,11833,8554
32,4,2,2,2,1,2,1,150,92,11312,8966,176,4,11834,8555
33,4,1,1,2,1,2,1,250,197,11313,8967,270,75,11835,8556
34,4,1,3,1,0,0,3,2,5,11314,8970,0,6,11835,8559
35,4,0,0,2,1,2,1,3,6,11314,8970,1,134,11836,8560
36,5,2,0,0,3,1,0,6,1,11316,8970,9,90,11839,8560
37,5,1,2,1,0,0,3,7,3,11317,8972,6,3,11839,8563
38,5,4,1,0,3,1,0,86,51,11321,8973,99,1,11842,8563
39,5,2,1,0,3,1,0,5,7,11323,8974,4,33,11845,8563
40,5,5,0,0,3,1,0,7,2,11328,8974,6,120,11848,8563
41,5,1,3,1,0,0,3,90,60,11329,8977,93,3,11848,8566
42,5,1,2,1,0,0,3,2,7,11330,8979,1,197,11848,8569
43,5,1,2,1,0,0,3,51,26,11331,8981,44,3,11848,8572
44,5,2,1,0,3,1,0,147,137,11333,8982,154,48,11851,8572
45,6,1,1,2,1,2,1,107,53,11334,8983,100,5,11852,8573
46,6,1,2,1,0,0,3,3,3,11335,8985,5,9,11852,8576
47,6,2,2,2,1,2,1,4,7,11337,8987,1,4,11853,8577
48,6,1,4,1,0,0,3,85,37,11338,8991,82,7,11853,8580
49,6,2,0,0,3,1,0,41,16,11340,8991,41,134,11856,8580
50,6,1,3,1,0,0,3,251,200,11341,8994,270,9,11856,8583
51,6,3,2,0,3,1,0,7,6,11344,8996,6,75,11859,8583
52,6,2,1,0,3,1,0,7,5,11346,8997,6,37,11862,8583
53,6,0,1,1,0,0,3,150,93,11346,8998,176,65,11862,8586
54,7,0,1,1,0,0,3,86,52,11346,8999,99,200,11862,8589
55,7,2,1,0,3,1,0,92,61,11348,9000,96,120,11865,8589
56,7,4,2,0,3,1,0,10,3,11352,9002,12,5,11868,8589
57,7,1,1,2,1,2,1,3,8,11353,9003,2,4,11869,8590
58,7,3,2,0,3,1,0,54,28,11356,9005,47,90,11872,8590
59,7,2,1,0,3,1,0,149,138,11358,9006,157,3,11875,8590
60,7,1,2,1,0,0,3,86,39,11359,9008,82,36,11875,8593
61,7,2,0,0,3,1,0,9,2,11361,9008,9,3,11878,8593
62,7,2,2,2,1,2,1,7,9,11363,9010,5,2,11879,8594
63,8,1,2,1,0,0,3,108,55,11364,9012,100,12,11879,8597
64,8,3,0,0,3,1,0,6,3,11367,9012,8,65,11882,8597
65,8,2,2,2,1,2,1,6,9,11369,9014,2,49,11883,8598
66,8,2,1,0,3,1,0,9,7,11371,9015,9,37,11886,8598
67,8,0,1,1,0,0,3,10,4,11371,9016,12,78,11886,8601
68,8,3,2,0,3,1,0,254,202,11374,9018,273,134,11889,8601
69,8,2,3,1,0,0,3,9,8,11376,9021,6,10,11889,8604
70,8,0,3,1,0,0,3,150,96,11376,9024,176,39,11889,8607
71,8,3,2,0,3,1,0,10,5,11379,9026,9,4,11892,8607
72,9,0,0,2,1,2,1,92,61,11379,9026,97,4,11893,8608
73,9,0,0,2,1,2,1,41,16,11379,9026,42,4,11894,8609
74,9,1,4,1,0,0,3,4,12,11380,9030,2,5,11894,8612
75,9,2,1,0,3,1,0,56,29,11382,9031,50,120,11897,8612
76,9,2,1,0,3,1,0,88,53,11384,9032,102,90,11900,8612
77,9,2,1,0,3,1,0,151,139,11386,9033,160,4,11903,8612
78,9,1,1,2,1,2,1,10,3,11387,9034,10,6,11904,8613
79,9,0,1,1,0,0,3,7,10,11387,9035,5,12,11904,8616
80,9,2,0,0,3,1,0,88,39,11389,9035,85,200,11907,8616
81,10,4,2,0,3,1,0,10,5,11393,9037,11,37,11910,8616
82,10,2,3,1,0,0,3,11,10,11395,9040,9,137,11910,8619
83,10,2,0,0,3,1,0,11,8,11397,9040,9,49,11913,8619
84,10,3,2,0,3,1,0,111,57,11400,9042,103,78,11916,8619
85,10,3,0,0,3,1,0,153,96,11403,9042,179,4,11919,8619
86,10,1,3,1,0,0,3,255,205,11404,9045,273,42,11919,8622
87,10,0,1,1,0,0,3,6,10,11404,9046,2,13,11919,8625
88,10,0,2,1,0,0,3,10,6,11404,9048,12,15,11919,8628
89,10,4,0,0,3,1,0,14,5,11408,9048,12,65,11922,8628
90,11,3,0,0,3,1,0,9,10,11411,9048,5,200,11925,8628
91,11,2,1,0,3,1,0,94,62,11413,9049,100,6,11928,8628
92,11,3,1,0,3,1,0,44,17,11416,9050,45,4,11931,8628
93,11,3,3,2,1,2,1,7,15,11419,9053,3,5,11932,8629
94,11,1,0,0,3,1,0,57,29,11420,9053,53,12,11935,8629
95,11,3,1,0,3,1,0,154,140,11423,9054,163,90,11938,8629
96,11,0,4,1,0,0,3,88,57,11423,9058,102,18,11938,8632
97,11,3,1,0,3,1,0,10,11,11426,9059,8,120,11941,8632
98,11,6,0,0,3,1,0,94,39,11432,9059,88,5,11944,8632
99,12,2,0,0,3,1,0,12,3,11434,9059,13,78,11947,8632
100,12,0,0,2,1,2,1,11,10,11434,9059,10,43,11948,8633
101,12,2,2,2,1,2,1,13,10,11436,9061,10,5,11949,8634
102,12,0,4,1,0,0,3,111,61,11436,9065,103,7,11949,8637
103,12,3,3,2,1,2,1,156,99,11439,9068,180,50,11950,8638
104,12,0,1,1,0,0,3,255,206,11439,9069,273,16,11950,8641
105,12,0,1,1,0,0,3,10,7,11439,9070,12,68,11950,8644
106,12,0,1,1,0,0,3,14,6,11439,9071,12,40,11950,8647
107,12,3,0,0,3,1,0,13,5,11442,9071,14,137,11953,8647
108,13,4,0,0,3,1,0,13,10,11446,9071,8,5,11956,8647
109,13,0,4,1,0,0,3,44,21,11446,9075,45,9,11956,8650
110,13,2,3,1,0,0,3,9,18,11448,9078,3,15,11956,8653
111,13,1,2,1,0,0,3,58,31,11449,9080,53,21,11956,8656
112,13,3,2,0,3,1,0,91,59,11452,9082,105,78,11959,8656
113,13,1,3,1,0,0,3,155,143,11453,9085,163,123,11959,8659
114,13,1,1,2,1,2,1,11,12,11454,9086,9,6,11960,8660
115,13,0,1,1,0,0,3,94,40,11454,9087,88,93,11960,8663
116,13,1,1,2,1,2,1,256,207,11455,9088,274,5,11961,8664
117,14,3,0,0,3,1,0,13,7,11458,9088,15,137,11964,8664
118,14,4,1,0,3,1,0,17,6,11462,9089,17,43,11967,8664
119,14,4,2,0,3,1,0,98,64,11466,9091,103,50,11970,8664
120,14,2,2,2,1,2,1,16,8,11468,9093,13,17,11971,8665
121,14,3,0,0,3,1,0,94,59,11471,9093,108,40,11974,8665
122,14,5,0,0,3,1,0,161,99,11476,9093,183,5,11977,8665
123,14,4,1,0,3,1,0,16,4,11480,9094,16,7,11980,8665
124,14,3,0,0,3,1,0,14,10,11483,9094,13,200,11983,8665
125,14,1,1,2,1,2,1,112,62,11484,9095,104,6,11984,8666
126,15,1,0,0,3,1,0,257,207,11485,9095,277,123,11987,8666
127,15,1,1,2,1,2,1,95,41,11486,9096,89,10,11988,8667
128,15,0,0,2,1,2,1,13,10,11486,9096,11,6,11989,8668
129,15,2,1,0,3,1,0,46,22,11488,9097,48,15,11992,8668
130,15,1,2,1,0,0,3,10,20,11489,9099,3,71,11992,8671
131,15,1,0,0,3,1,0,59,31,11490,9099,56,78,11995,8671
132,15,2,0,0,3,1,0,15,10,11492,9099,11,6,11998,8671
133,15,3,2,0,3,1,0,14,14,11495,9101,12,93,12001,8671
134,15,0,2,1,0,0,3,155,145,11495,9103,163,24,12001,8674
135,16,2,1,0,3,1,0,96,60,11497,9104,111,50,12004,8674
136,16,3,0,0,3,1,0,20,6,11500,9104,20,200,12007,8674
137,16,2,4,1,0,0,3,100,68,11502,9108,103,20,12007,8677
138,16,1,1,2,1,2,1,17,9,11503,9109,14,138,12008,8678
139,16,1,0,0,3,1,0,113,62,11504,9109,107,43,12011,8678
140,16,0,0,2,1,2,1,161,99,11504,9109,184,7,12012,8679
141,16,2,0,0,3,1,0,18,4,11506,9109,19,6,12015,8679
142,16,3,0,0,3,1,0,62,31,11509,9109,59,7,12018,8679
143,16,0,1,1,0,0,3,13,8,11509,9110,15,8,12018,8682
144,17,1,2,1,0,0,3,11,22,11510,9112,3,81,12018,8685
145,17,3,0,0,3,1,0,18,10,11513,9112,14,93,12021,8685
146,17,1,2,1,0,0,3,15,12,11514,9114,13,126,12021,8688
147,17,2,2,2,1,2,1,15,12,11516,9116,12,11,12022,8689
148,17,1,0,0,3,1,0,47,22,11517,9116,51,24,12025,8689
149,17,3,1,0,3,1,0,158,146,11520,9117,166,71,12028,8689
150,17,2,4,1,0,0,3,259,211,11522,9121,277,18,12028,8692
151,17,2,2,2,1,2,1,16,16,11524,9123,13,41,12029,8693
152,17,3,5,1,0,0,3,98,46,11527,9128,89,9,12029,8696
153,18,1,3,1,0,0,3,17,19,11528,9131,13,27,12029,8699
154,18,1,1,2,1,2,1,16,13,11529,9132,13,10,12030,8700
155,18,2,1,0,3,1,0,17,13,11531,9133,16,11,12033,8700
156,18,0,1,1,0,0,3,158,147,11531,9134,166,10,12033,8703
157,18,2,2,2,1,2,1,261,213,11533,9136,278,42,12034,8704
158,18,1,0,0,3,1,0,99,46,11534,9136,92,18,12037,8704
159,18,0,1,1,0,0,3,18,11,11534,9137,14,84,12037,8707
160,18,0,3,1,0,0,3,47,25,11534,9140,51,74,12037,8710
161,18,1,1,2,1,2,1,162,100,11535,9141,185,94,12038,8711
162,19,1,0,0,3,1,0,101,68,11536,9141,106,43,12041,8711
163,19,0,1,1,0,0,3,96,61,11536,9142,111,11,12041,8714
164,19,1,1,2,1,2,1,19,5,11537,9143,20,51,12042,8715
165,19,0,1,1,0,0,3,13,9,11537,9144,15,10,12042,8718
166,19,1,1,2,1,2,1,63,32,11538,9145,60,139,12043,8719
167,19,5,1,0,3,1,0,25,7,11543,9146,23,126,12046,8719
168,19,3,0,0,3,1,0,116,62,11546,9146,110,6,12049,8719
169,19,1,3,1,0,0,3,12,25,11547,9149,3,23,12049,8722
170,19,2,2,2,1,2,1,19,11,11549,9151,15,201,12050,8723
171,20,2,0,0,3,1,0,19,19,11551,9151,16,74,12053,8723
172,20,1,3,1,0,0,3,18,16,11552,9154,16,13,12053,8726
173,20,0,3,1,0,0,3,16,16,11552,9157,13,30,12053,8729
174,20,2,0,0,3,1,0,160,147,11554,9157,169,84,12056,8729
175,20,0,1,1,0,0,3,18,12,11554,9158,14,14,12056,8732
176,20,3,0,0,3,1,0,264,213,11557,9158,281,94,12059,8732
177,20,0,1,1,0,0,3,162,101,11557,9159,185,21,12059,8735
178,20,0,1,1,0,0,3,99,47,11557,9160,92,45,12059,8738
179,20,0,1,1,0,0,3,47,26,11557,9161,51,13,12059,8741
180,21,0,0,2,1,2,1,19,5,11557,9161,21,12,12060,8742
181,21,3,2,0,3,1,0,119,64,11560,9163,113,13,12063,8742
182,21,1,1,2,1,2,1,14,10,11561,9164,16,7,12064,8743
183,21,1,0,0,3,1,0,161,147,11562,9164,172,23,12067,8743
184,21,1,0,0,3,1,0,97,61,11563,9164,114,10,12070,8743
185,21,3,2,0,3,1,0,22,13,11566,9166,18,126,12073,8743
186,21,2,3,1,0,0,3,14,28,11568,9169,3,54,12073,8746
187,21,0,0,2,1,2,1,63,32,11568,9169,61,44,12074,8747
188,21,0,1,1,0,0,3,101,69,11568,9170,106,204,12074,8750
189,22,0,3,1,0,0,3,47,29,11568,9173,51,26,12074,8753
190,22,0,1,1,0,0,3,16,17,11568,9174,13,87,12074,8756
191,22,4,0,0,3,1,0,29,7,11572,9174,26,14,12077,8756
192,22,3,1,0,3,1,0,267,214,11575,9175,284,13,12080,8756
193,22,1,0,0,3,1,0,19,12,11576,9175,17,45,12083,8756
194,22,1,4,1,0,0,3,100,51,11577,9179,92,142,12083,8759
195,22,1,1,2,1,2,1,163,102,11578,9180,186,31,12084,8760
196,22,4,2,0,3,1,0,123,66,11582,9182,116,21,12087,8760
197,22,1,1,2,1,2,1,19,17,11583,9183,17,75,12088,8761
198,23,3,0,0,3,1,0,164,147,11586,9183,175,44,12091,8761
199,23,4,0,0,3,1,0,105,69,11590,9183,109,7,12094,8761
200,23,2,1,0,3,1,0,65,33,11592,9184,64,10,12097,8761
201,23,1,1,2,1,2,1,23,14,11593,9185,19,95,12098,8762
202,23,3,0,0,3,1,0,100,61,11596,9185,117,126,12101,8762
203,23,2,0,0,3,1,0,21,5,11598,9185,24,204,12104,8762
204,23,1,3,1,0,0,3,15,13,11599,9188,16,16,12104,8765
205,23,4,2,0,3,1,0,23,21,11603,9190,19,54,12107,8765
206,23,2,1,0,3,1,0,16,29,11605,9191,6,12,12110,8765
207,24,2,1,0,3,1,0,18,18,11607,9192,16,13,12113,8765
208,24,1,1,2,1,2,1,164,103,11608,9193,187,88,12114,8766
209,24,1,2,1,0,0,3,24,16,11609,9195,19,24,12114,8769
210,24,1,0,0,3,1,0,124,66,11610,9195,119,45,12117,8769
211,24,0,1,1,0,0,3,267,215,11610,9196,284,78,12117,8772
212,24,1,1,2,1,2,1,20,13,11611,9197,18,143,12118,8773
213,24,1,3,1,0,0,3,30,10,11612,9200,26,34,12118,8776
214,24,0,2,1,0,0,3,47,31,11612,9202,51,57,12118,8779
215,24,2,2,2,1,2,1,21,19,11614,9204,18,27,12119,8780
216,25,1,0,0,3,1,0,22,5,11615,9204,27,95,12122,8780
217,25,3,1,0,3,1,0,103,62,11618,9205,120,16,12125,8780
218,25,1,0,0,3,1,0,101,51,11619,9205,95,12,12128,8780
219,25,2,0,0,3,1,0,18,29,11621,9205,9,14,12131,8780
220,25,5,0,0,3,1,0,169,147,11626,9205,178,204,12134,8780
221,25,0,0,2,1,2,1,47,31,11626,9205,52,127,12135,8781
222,25,3,0,0,3,1,0,26,21,11629,9205,22,10,12138,8781
223,25,1,3,1,0,0,3,66,36,11630,9208,64,10,12138,8784
224,25,2,4,1,0,0,3,107,73,11632,9212,109,27,12138,8787
225,26,4,0,0,3,1,0,128,66,11636,9212,122,78,12141,8787
226,26,1,0,0,3,1,0,25,16,11637,9212,22,34,12144,8787
227,26,6,0,0,3,1,0,36,10,11643,9212,29,88,12147,8787
228,26,2,1,0,3,1,0,22,14,11645,9213,21,44,12150,8787
229,26,2,1,0,3,1,0,166,104,11647,9214,190,45,12153,8787
230,26,1,2,1,0,0,3,19,20,11648,9216,16,146,12153,8790
231,26,1,1,2,1,2,1,22,20,11649,9217,19,14,12154,8791
232,26,0,1,1,0,0,3,15,14,11649,9218,16,30,12154,8794
233,26,1,2,1,0,0,3,268,217,11650,9220,284,60,12154,8797
234,27,0,1,1,0,0,3,18,30,11650,9221,9,130,12154,8800
235,27,1,2,1,0,0,3,67,38,11651,9223,64,19,12154,8803
236,27,1,3,1,0,0,3,170,150,11652,9226,178,13,12154,8806
237,27,2,0,0,3,1,0,105,62,11654,9226,123,14,12157,8806
238,27,6,2,0,3,1,0,113,75,11660,9228,112,95,12160,8806
239,27,2,1,0,3,1,0,49,32,11662,9229,55,204,12163,8806
240,27,1,1,2,1,2,1,23,6,11663,9230,28,28,12164,8807
241,27,2,0,0,3,1,0,28,21,11665,9230,25,12,12167,8807
242,27,1,1,2,1,2,1,102,52,11666,9231,96,11,12168,8808
243,28,0,2,1,0,0,3,268,219,11666,9233,284,15,12168,8811
244,28,0,1,1,0,0,3,166,105,11666,9234,190,33,12168,8814
245,28,1,1,2,1,2,1,23,21,11667,9235,20,61,12169,8815
246,28,1,0,0,3,1,0,37,10,11668,9235,32,14,12172,8815
247,28,1,1,2,1,2,1,16,15,11669,9236,17,46,12173,8816
248,28,4,1,0,3,1,0,27,7,11673,9237,31,78,12176,8816
249,28,0,0,2,1,2,1,25,16,11673,9237,23,89,12177,8817
250,28,1,0,0,3,1,0,129,66,11674,9237,125,146,12180,8817
251,28,1,1,2,1,2,1,20,21,11675,9238,17,45,12181,8818
252,29,1,1,2,1,2,1,50,33,11676,9239,56,14,12182,8819
253,29,1,1,2,1,2,1,171,151,11677,9240,179,20,12183,8820
254,29,1,1,2,1,2,1,114,76,11678,9241,113,35,12184,8821
255,29,1,0,0,3,1,0,23,14,11679,9241,24,11,12187,8821
256,29,2,0,0,3,1,0,107,62,11681,9241,126,28,12190,8821
257,29,3,2,0,3,1,0,70,40,11684,9243,67,14,12193,8821
258,29,2,4,1,0,0,3,104,56,11686,9247,96,133,12193,8824
259,29,5,1,0,3,1,0,23,31,11691,9248,12,95,12196,8824
260,29,2,1,0,3,1,0,30,22,11693,9249,28,204,12199,8824
261,30,1,0,0,3,1,0,17,15,11694,9249,20,14,12202,8824
262,30,1,3,1,0,0,3,130,69,11695,9252,125,64,12202,8827
263,30,1,0,0,3,1,0,26,16,11696,9252,26,45,12205,8827
264,30,0,0,2,1,2,1,114,76,11696,9252,114,79,12206,8828
265,30,0,2,1,0,0,3,166,107,11696,9254,190,149,12206,8831
266,30,2,2,2,1,2,1,22,23,11698,9256,18,205,12207,8832
267,30,1,1,2,1,2,1,24,22,11699,9257,21,16,12208,8833
268,30,5,1,0,3,1,0,42,11,11704,9258,35,33,12211,8833
269,30,3,0,0,3,1,0,30,7,11707,9258,34,46,12214,8833
270,31,1,3,1,0,0,3,71,43,11708,9261,67,82,12214,8836
271,31,1,1,2,1,2,1,51,34,11709,9262,57,21,12215,8837
272,31,1,3,1,0,0,3,269,222,11710,9265,284,17,12215,8840
273,31,3,0,0,3,1,0,107,56,11713,9265,99,89,12218,8840
274,31,2,1,0,3,1,0,32,23,11715,9266,31,14,12221,8840
275,31,0,1,1,0,0,3,23,15,11715,9267,24,136,12221,8843
276,31,1,0,0,3,1,0,24,31,11716,9267,15,35,12224,8843
277,31,4,1,0,3,1,0,26,24,11720,9268,21,95,12227,8843
278,31,0,0,2,1,2,1,171,151,11720,9268,180,29,12228,8844
279,32,2,0,0,3,1,0,168,107,11722,9268,193,205,12231,8844
280,32,0,1,1,0,0,3,24,23,11722,9269,21,14,12231,8847
281,32,2,0,0,3,1,0,132,69,11724,9269,128,33,12234,8847
282,32,1,2,1,0,0,3,27,18,11725,9271,26,67,12234,8850
283,32,3,0,0,3,1,0,20,15,11728,9271,23,45,12237,8850
284,32,0,1,1,0,0,3,107,63,11728,9272,126,17,12237,8853
285,32,0,2,1,0,0,3,114,78,11728,9274,114,49,12237,8856
286,32,2,0,0,3,1,0,32,7,11730,9274,37,149,12240,8856
287,32,4,1,0,3,1,0,46,12,11734,9275,38,16,12243,8856
288,33,1,8,1,0,0,3,270,230,11735,9283,284,24,12243,8859
289,33,2,0,0,3,1,0,26,23,11737,9283,24,35,12246,8859
290,33,1,1,2,1,2,1,33,24,11738,9284,32,90,12247,8860
291,33,1,3,1,0,0,3,24,18,11739,9287,24,32,12247,8863
292,33,1,2,1,0,0,3,172,153,11740,9289,180,17,12247,8866
293,33,0,2,1,0,0,3,51,36,11740,9291,57,98,12247,8869
294,33,2,0,0,3,1,0,26,31,11742,9291,18,49,12250,8869
295,33,2,1,0,3,1,0,109,57,11744,9292,102,82,12253,8869
296,33,1,2,1,0,0,3,27,26,11745,9294,21,139,12253,8872
297,34,2,1,0,3,1,0,134,70,11747,9295,131,16,12256,8872
298,34,3,2,0,3,1,0,171,109,11750,9297,196,17,12259,8872
299,34,0,1,1,0,0,3,71,44,11750,9298,67,36,12259,8875
300,34,2,1,0,3,1,0,48,13,11752,9299,41,67,12262,8875
301,34,1,3,1,0,0,3,28,21,11753,9302,26,17,12262,8878
302,34,3,1,0,3,1,0,35,8,11756,9303,40,45,12265,8878
303,34,1,1,2,1,2,1,115,79,11757,9304,115,18,12266,8879
304,34,3,1,0,3,1,0,110,64,11760,9305,129,149,12269,8879
305,34,2,1,0,3,1,0,22,16,11762,9306,26,205,12272,8879
0,1,3,1,0,3,1,0,38,9,11765,9307,43,90,12275,8879
1,1,2,0,0,3,1,0,28,23,11767,9307,27,139,12278,8879
2,1,2,1,0,3,1,0,112,65,11769,9308,132,17,12281,8879
3,1,3,0,0,3,1,0,112,57,11772,9308,105,16,12284,8879
4,1,0,3,1,0,0,3,134,73,11772,9311,131,20,12284,8882
5,1,2,2,2,1,2,1,33,16,11774,9313,35,50,12285,8883
6,1,0,1,1,0,0,3,69,29,11774,9314,79,152,12285,8886
7,1,2,0,0,3,1,0,24,16,11776,9314,29,36,12288,8886
8,1,0,1,1,0,0,3,48,14,11776,9315,41,21,12288,8889
9,2,2,2,2,1,2,1,117,81,11778,9317,116,72,12289,8890
10,2,1,2,1,0,0,3,173,155,11779,9319,180,85,12289,8893
11,2,1,2,1,0,0,3,72,46,11780,9321,67,35,12289,8896
12,2,1,0,0,3,1,0,29,21,11781,9321,29,35,12292,8896
13,2,0,1,1,0,0,3,27,27,11781,9322,21,27,12292,8899
14,2,5,1,0,3,1,0,29,19,11786,9323,27,98,12295,8899
15,2,1,1,2,1,2,1,27,32,11787,9324,19,68,12296,8900
16,2,1,1,2,1,2,1,172,110,11788,9325,197,32,12297,8901
17,2,1,0,0,3,1,0,34,24,11789,9325,35,17,12300,8901
18,3,4,1,0,3,1,0,31,33,11793,9326,22,20,12303,8901
19,3,2,0,0,3,1,0,40,9,11795,9326,46,152,12306,8901
20,3,5,0,0,3,1,0,53,14,11800,9326,44,90,12309,8901
21,3,5,3,0,3,1,0,33,26,11805,9329,30,50,12312,8901
22,3,0,1,1,0,0,3,112,58,11805,9330,105,39,12312,8904
23,3,0,2,1,0,0,3,33,18,11805,9332,35,20,12312,8907
24,3,1,1,2,1,2,1,135,74,11806,9333,132,140,12313,8908
25,3,2,4,1,0,0,3,26,20,11808,9337,29,19,12313,8911
26,3,1,1,2,1,2,1,113,66,11809,9338,133,73,12314,8912
27,4,1,0,0,3,1,0,70,29,11810,9338,82,68,12317,8912
28,4,3,4,1,0,0,3,120,85,11813,9342,116,101,12317,8915
29,4,1,0,0,3,1,0,174,155,11814,9342,183,32,12320,8915
30,4,3,0,0,3,1,0,75,46,11817,9342,70,20,12323,8915
31,4,0,3,1,0,0,3,172,113,11817,9345,197,30,12323,8918
32,4,1,2,1,0,0,3,30,23,11818,9347,29,20,12323,8921
33,4,0,0,2,1,2,1,34,24,11818,9347,36,36,12324,8922
34,4,1,1,2,1,2,1,114,67,11819,9348,134,36,12325,8923
35,4,1,0,0,3,1,0,30,19,11820,9348,30,21,12328,8923
36,5,1,4,1,0,0,3,34,22,11821,9352,35,42,12328,8926
37,5,1,2,1,0,0,3,41,11,11822,9354,46,76,12328,8929
38,5,7,0,0,3,1,0,60,14,11829,9354,47,50,12331,8929
39,5,0,4,1,0,0,3,26,24,11829,9358,29,23,12331,8932
40,5,3,0,0,3,1,0,115,58,11832,9358,108,85,12334,8932
41,5,1,0,0,3,1,0,32,33,11833,9358,25,140,12337,8932
42,5,2,0,0,3,1,0,35,26,11835,9358,33,90,12340,8932
43,5,1,2,1,0,0,3,136,76,11836,9360,132,155,12340,8935
44,5,2,1,0,3,1,0,29,28,11838,9361,24,19,12343,8935
45,6,1,2,1,0,0,3,76,48,11839,9363,70,71,12343,8938
46,6,1,4,1,0,0,3,35,28,11840,9367,36,104,12343,8941
47,6,0,1,1,0,0,3,120,86,11840,9368,116,24,12343,8944
48,6,1,1,2,1,2,1,175,156,11841,9369,184,21,12344,8945
49,6,3,1,0,3,1,0,33,24,11844,9370,32,20,12347,8945
50,6,2,2,2,1,2,1,72,31,11846,9372,83,33,12348,8946
51,6,3,1,0,3,1,0,175,114,11849,9373,200,36,12351,8946
52,6,2,1,0,3,1,0,116,68,11851,9374,137,36,12354,8946
53,6,0,2,1,0,0,3,30,21,11851,9376,30,33,12354,8949
54,7,1,2,1,0,0,3,116,60,11852,9378,108,93,12354,8952
55,7,4,2,0,3,1,0,34,23,11856,9380,33,50,12357,8952
56,7,1,2,1,0,0,3,27,26,11857,9382,29,39,12357,8955
57,7,1,0,0,3,1,0,30,28,11858,9382,27,140,12360,8955
58,7,1,0,0,3,1,0,33,33,11859,9382,28,155,12363,8955
59,7,0,0,2,1,2,1,34,22,11859,9382,36,86,12364,8956
60,7,3,0,0,3,1,0,63,14,11862,9382,50,42,12367,8956
61,7,2,0,0,3,1,0,138,76,11864,9382,135,23,12370,8956
62,7,2,1,0,3,1,0,37,27,11866,9383,36,76,12373,8956
63,8,0,2,1,0,0,3,175,116,11866,9385,200,74,12373,8959
64,8,4,0,0,3,1,0,45,11,11870,9385,49,33,12376,8959
65,8,3,1,0,3,1,0,38,29,11873,9386,39,20,12379,8959
66,8,3,3,2,1,2,1,178,159,11876,9389,185,37,12380,8960
67,8,1,0,0,3,1,0,77,48,11877,9389,73,24,12383,8960
68,8,0,0,2,1,2,1,33,24,11877,9389,33,34,12384,8961
69,8,3,0,0,3,1,0,75,31,11880,9389,86,104,12387,8961
70,8,3,2,0,3,1,0,119,70,11883,9391,140,21,12390,8961
71,8,1,2,1,0,0,3,121,88,11884,9393,116,22,12390,8964
72,9,0,2,1,0,0,3,37,29,11884,9395,36,42,12390,8967
73,9,4,0,0,3,1,0,67,14,11888,9395,53,76,12393,8967
74,9,0,1,1,0,0,3,27,27,11888,9396,29,36,12393,8970
75,9,2,0,0,3,1,0,118,60,11890,9396,111,23,12396,8970
76,9,2,1,0,3,1,0,32,29,11892,9397,30,155,12399,8970
77,9,2,2,2,1,2,1,35,35,11894,9399,29,43,12400,8971
78,9,1,2,1,0,0,3,35,25,11895,9401,33,143,12400,8974
79,9,1,2,1,0,0,3,78,50,11896,9403,73,96,12400,8977
80,9,2,0,0,3,1,0,140,76,11898,9403,138,86,12403,8977
81,10,1,1,2,1,2,1,35,23,11899,9404,37,22,12404,8978
82,10,5,0,0,3,1,0,50,11,11904,9404,52,104,12407,8978
83,10,2,2,2,1,2,1,180,161,11906,9406,186,75,12408,8979
84,10,1,0,0,3,1,0,176,116,11907,9406,203,50,12411,8979
85,10,1,0,0,3,1,0,34,24,11908,9406,36,24,12414,8979
86,10,0,0,2,1,2,1,75,31,11908,9406,87,38,12415,8980
87,10,1,1,2,1,2,1,122,89,11909,9407,117,21,12416,8981
88,10,0,1,1,0,0,3,38,30,11909,9408,39,25,12416,8984
89,10,2,1,0,3,1,0,121,71,11911,9409,143,34,12419,8984
90,11,0,1,1,0,0,3,78,51,11911,9410,73,46,12419,8987
91,11,4,0,0,3,1,0,71,14,11915,9410,56,155,12422,8987
92,11,3,1,0,3,1,0,38,26,11918,9411,36,23,12425,8987
93,11,2,3,1,0,0,3,34,32,11920,9414,30,79,12425,8990
94,11,2,1,0,3,1,0,37,36,11922,9415,32,86,12428,8990
95,11,1,1,2,1,2,1,119,61,11923,9416,112,43,12429,8991
96,11,1,3,1,0,0,3,28,30,11924,9419,29,25,12429,8994
97,11,3,0,0,3,1,0,143,76,11927,9419,141,36,12432,8994
98,11,1,1,2,1,2,1,123,90,11928,9420,118,144,12433,8995
99,12,3,1,0,3,1,0,31,31,11931,9421,32,75,12436,8995
100,12,5,1,0,3,1,0,55,12,11936,9422,55,21,12439,8995
101,12,3,2,0,3,1,0,40,31,11939,9424,39,104,12442,8995
102,12,1,2,1,0,0,3,181,163,11940,9426,186,53,12442,8998
103,12,1,1,2,1,2,1,35,25,11941,9427,37,145,12443,8999
104,12,1,2,1,0,0,3,76,33,11942,9429,87,27,12443,9002
105,12,2,2,2,1,2,1,40,32,11944,9431,40,97,12444,9003
106,12,2,2,2,1,2,1,123,73,11946,9433,144,26,12445,9004
107,12,1,2,1,0,0,3,36,25,11947,9435,37,37,12445,9007
108,13,0,2,1,0,0,3,176,118,11947,9437,203,49,12445,9010
109,13,4,0,0,3,1,0,42,26,11951,9437,39,155,12448,9010
110,13,2,2,2,1,2,1,80,53,11953,9439,74,80,12449,9011
111,13,4,1,0,3,1,0,38,33,11957,9440,33,86,12452,9011
112,13,5,0,0,3,1,0,42,36,11962,9440,35,25,12455,9011
113,13,0,1,1,0,0,3,71,15,11962,9441,56,46,12455,9014
114,13,2,1,0,3,1,0,121,62,11964,9442,115,36,12458,9014
115,13,2,0,0,3,1,0,125,90,11966,9442,121,23,12461,9014
116,13,1,1,2,1,2,1,144,77,11967,9443,142,39,12462,9015
117,14,0,3,1,0,0,3,144,80,11967,9446,142,30,12462,9018
118,14,2,0,0,3,1,0,57,12,11969,9446,58,26,12465,9018
119,14,1,0,0,3,1,0,182,163,11970,9446,189,145,12468,9018
120,14,1,1,2,1,2,1,36,26,11971,9447,38,54,12469,9019
121,14,2,0,0,3,1,0,38,25,11973,9447,40,21,12472,9019
122,14,3,3,2,1,2,1,79,36,11976,9450,88,50,12473,9020
123,14,1,1,2,1,2,1,124,74,11977,9451,145,98,12474,9021
124,14,2,0,0,3,1,0,42,31,11979,9451,42,75,12477,9021
125,14,3,2,0,3,1,0,34,33,11982,9453,35,37,12480,9021
126,15,2,0,0,3,1,0,42,32,11984,9453,43,23,12483,9021
127,15,4,1,0,3,1,0,75,16,11988,9454,59,25,12486,9021
128,15,1,1,2,1,2,1,81,54,11989,9455,75,87,12487,9022
129,15,1,1,2,1,2,1,177,119,11990,9456,204,81,12488,9023
130,15,2,2,2,1,2,1,40,35,11992,9458,34,40,12489,9024
131,15,1,1,2,1,2,1,43,37,11993,9459,36,47,12490,9025
132,15,2,2,2,1,2,1,123,64,11995,9461,116,105,12491,9026
133,15,2,0,0,3,1,0,127,90,11997,9461,124,155,12494,9026
134,15,3,1,0,3,1,0,45,27,12000,9462,42,36,12497,9026
135,16,1,2,1,0,0,3,80,38,12001,9464,88,29,12497,9029
136,16,4,1,0,3,1,0,46,32,12005,9465,45,21,12500,9029
137,16,0,0,2,1,2,1,34,33,12005,9465,36,99,12501,9030
138,16,0,2,1,0,0,3,182,165,12005,9467,189,26,12501,9033
139,16,4,0,0,3,1,0,148,80,12009,9467,145,54,12504,9033
140,16,1,0,0,3,1,0,39,25,12010,9467,43,30,12507,9033
141,16,0,0,2,1,2,1,124,74,12010,9467,146,51,12508,9034
142,16,1,1,2,1,2,1,58,13,12011,9468,59,146,12509,9035
143,16,1,2,1,0,0,3,124,66,12012,9470,116,40,12509,9038
144,17,3,0,0,3,1,0,78,16,12015,9470,62,105,12512,9038
145,17,0,3,1,0,0,3,42,35,12015,9473,43,158,12512,9041
146,17,1,1,2,1,2,1,128,91,12016,9474,125,37,12513,9042
147,17,1,4,1,0,0,3,82,58,12017,9478,75,50,12513,9045
148,17,1,1,2,1,2,1,37,27,12018,9479,39,82,12514,9046
149,17,1,0,0,3,1,0,41,35,12019,9479,37,75,12517,9046
150,17,5,0,0,3,1,0,50,27,12024,9479,45,25,12520,9046
151,17,1,1,2,1,2,1,178,120,12025,9480,205,88,12521,9047
152,17,1,0,0,3,1,0,44,37,12026,9480,39,40,12524,9047
153,18,3,1,0,3,1,0,47,38,12029,9481,42,40,12527,9047
154,18,0,0,2,1,2,1,37,27,12029,9481,40,89,12528,9048
155,18,3,1,0,3,1,0,53,28,12032,9482,48,75,12531,9048
156,18,1,0,0,3,1,0,42,35,12033,9482,40,105,12534,9048
157,18,1,0,0,3,1,0,83,58,12034,9482,78,37,12537,9048
158,18,2,0,0,3,1,0,184,165,12036,9482,192,82,12540,9048
159,18,0,0,2,1,2,1,178,120,12036,9482,206,26,12541,9049
160,18,1,5,1,0,0,3,129,96,12037,9487,125,53,12541,9052
161,18,3,2,0,3,1,0,45,37,12040,9489,46,40,12544,9052
162,19,1,0,0,3,1,0,125,74,12041,9489,149,158,12547,9052
163,19,3,1,0,3,1,0,61,14,12044,9490,62,26,12550,9052
164,19,2,0,0,3,1,0,80,16,12046,9490,65,21,12553,9052
165,19,1,1,2,1,2,1,47,33,12047,9491,46,52,12554,9053
166,19,2,2,2,1,2,1,41,27,12049,9493,44,147,12555,9054
167,19,1,2,1,0,0,3,81,40,12050,9495,88,102,12555,9057
168,19,1,4,1,0,0,3,149,84,12051,9499,145,32,12555,9060
169,19,3,1,0,3,1,0,37,34,12054,9500,39,54,12558,9060
170,19,0,3,1,0,0,3,124,69,12054,9503,116,33,12558,9063
171,20,0,2,1,0,0,3,184,167,12054,9505,192,56,12558,9066
172,20,2,2,2,1,2,1,47,39,12056,9507,47,76,12559,9067
173,20,1,1,2,1,2,1,54,29,12057,9508,49,41,12560,9068
174,20,2,2,2,1,2,1,39,29,12059,9510,41,38,12561,9069
175,20,0,0,2,1,2,1,42,35,12059,9510,41,34,12562,9070
176,20,0,1,1,0,0,3,81,41,12059,9511,88,92,12562,9073
177,20,1,1,2,1,2,1,130,97,12060,9512,126,41,12563,9074
178,20,2,2,2,1,2,1,85,60,12062,9514,79,27,12564,9075
179,20,0,1,1,0,0,3,178,121,12062,9515,206,108,12564,9078
180,21,3,2,0,3,1,0,45,37,12065,9517,44,54,12567,9078
181,21,1,0,0,3,1,0,62,14,12066,9517,65,52,12570,9078
182,21,2,0,0,3,1,0,82,16,12068,9517,68,147,12573,9078
183,21,1,1,2,1,2,1,48,34,12069,9518,47,27,12574,9079
184,21,1,1,2,1,2,1,38,35,12070,9519,40,93,12575,9080
185,21,5,0,0,3,1,0,129,69,12075,9519,119,82,12578,9080
186,21,3,0,0,3,1,0,50,38,12078,9519,45,32,12581,9080
187,21,0,0,2,1,2,1,41,27,12078,9519,45,159,12582,9081
188,21,0,1,1,0,0,3,149,85,12078,9520,145,105,12582,9084
189,22,1,1,2,1,2,1,40,30,12079,9521,42,42,12583,9085
190,22,4,1,0,3,1,0,51,40,12083,9522,50,38,12586,9085
191,22,1,3,1,0,0,3,131,100,12084,9525,126,30,12586,9088
192,22,2,1,0,3,1,0,186,168,12086,9526,195,108,12589,9088
193,22,1,2,1,0,0,3,179,123,12087,9528,206,37,12589,9091
194,22,0,1,1,0,0,3,81,42,12087,9529,88,59,12589,9094
195,22,0,0,2,1,2,1,85,60,12087,9529,80,42,12590,9095
196,22,4,0,0,3,1,0,58,29,12091,9529,52,21,12593,9095
197,22,4,2,0,3,1,0,129,76,12095,9531,152,76,12596,9095
198,23,1,1,2,1,2,1,51,39,12096,9532,46,106,12597,9096
199,23,4,0,0,3,1,0,42,35,12100,9532,43,147,12600,9096
200,23,4,1,0,3,1,0,133,70,12104,9533,122,54,12603,9096
201,23,0,2,1,0,0,3,149,87,12104,9535,145,55,12603,9099
202,23,1,2,1,0,0,3,46,39,12105,9537,44,30,12603,9102
203,23,3,0,0,3,1,0,44,27,12108,9537,48,82,12606,9102
204,23,0,1,1,0,0,3,48,35,12108,9538,47,162,12606,9105
205,23,2,0,0,3,1,0,84,16,12110,9538,71,32,12609,9105
206,23,3,1,0,3,1,0,65,15,12113,9539,68,93,12612,9105
207,24,2,0,0,3,1,0,53,40,12115,9539,53,42,12615,9105
208,24,0,4,1,0,0,3,131,104,12115,9543,126,79,12615,9108
209,24,2,2,2,1,2,1,131,78,12117,9545,153,39,12616,9109
210,24,2,1,0,3,1,0,87,61,12119,9546,83,32,12619,9109
211,24,0,0,2,1,2,1,179,123,12119,9546,207,22,12620,9110
212,24,1,0,0,3,1,0,82,42,12120,9546,91,30,12623,9110
213,24,2,1,0,3,1,0,67,16,12122,9547,71,42,12626,9110
214,24,1,0,0,3,1,0,187,168,12123,9547,198,37,12629,9110
215,24,1,1,2,1,2,1,41,31,12124,9548,43,109,12630,9111
216,25,0,0,2,1,2,1,133,70,12124,9548,123,148,12631,9112
217,25,7,1,0,3,1,0,91,17,12131,9549,74,30,12634,9112
218,25,2,1,0,3,1,0,44,36,12133,9550,46,162,12637,9112
219,25,1,0,0,3,1,0,150,87,12134,9550,148,82,12640,9112
220,25,3,2,0,3,1,0,49,41,12137,9552,47,55,12643,9112
221,25,0,0,2,1,2,1,51,39,12137,9552,47,55,12644,9113
222,25,0,0,2,1,2,1,44,27,12137,9552,49,60,12645,9114
223,25,3,0,0,3,1,0,51,35,12140,9552,50,93,12648,9114
224,25,3,1,0,3,1,0,61,30,12143,9553,55,106,12651,9114
225,26,1,2,1,0,0,3,42,33,12144,9555,43,82,12651,9117
226,26,1,0,0,3,1,0,68,16,12145,9555,74,30,12654,9117
227,26,1,2,1,0,0,3,54,42,12146,9557,53,40,12654,9120
228,26,1,3,1,0,0,3,132,107,12147,9560,126,58,12654,9123
229,26,1,3,1,0,0,3,188,171,12148,9563,198,25,12654,9126
230,26,2,1,0,3,1,0,46,28,12150,9564,52,42,12657,9126
231,26,0,6,1,0,0,3,82,48,12150,9570,91,45,12657,9129
232,26,1,4,1,0,0,3,180,127,12151,9574,207,35,12657,9132
233,26,4,1,0,3,1,0,135,79,12155,9575,156,109,12660,9132
234,27,2,1,0,3,1,0,51,42,12157,9576,50,106,12663,9132
235,27,2,1,0,3,1,0,93,18,12159,9577,77,93,12666,9132
236,27,1,1,2,1,2,1,52,36,12160,9578,51,40,12667,9133
237,27,1,3,1,0,0,3,45,39,12161,9581,46,85,12667,9136
238,27,2,0,0,3,1,0,89,61,12163,9581,86,148,12670,9136
239,27,1,2,1,0,0,3,52,41,12164,9583,47,33,12670,9139
240,27,2,0,0,3,1,0,63,30,12166,9583,58,55,12673,9139
241,27,1,0,0,3,1,0,134,70,12167,9583,126,162,12676,9139
242,27,1,6,1,0,0,3,151,93,12168,9589,148,63,12676,9142
243,28,4,4,2,1,2,1,72,20,12172,9593,75,83,12677,9143
244,28,0,2,1,0,0,3,54,44,12172,9595,53,61,12677,9146
245,28,0,3,1,0,0,3,52,39,12172,9598,51,45,12677,9149
246,28,0,1,1,0,0,3,188,172,12172,9599,198,48,12677,9152
247,28,0,1,1,0,0,3,180,128,12172,9600,207,109,12677,9155
248,28,2,1,0,3,1,0,48,29,12174,9601,55,109,12680,9155
249,28,1,4,1,0,0,3,83,52,12175,9605,91,28,12680,9158
250,28,2,1,0,3,1,0,137,80,12177,9606,159,40,12683,9158
251,28,1,1,2,1,2,1,43,34,12178,9607,44,36,12684,9159
252,29,2,1,0,3,1,0,95,19,12180,9608,80,40,12687,9159
253,29,2,2,2,1,2,1,91,63,12182,9610,87,163,12688,9160
254,29,1,2,1,0,0,3,181,130,12183,9612,207,36,12688,9163
255,29,4,1,0,3,1,0,138,71,12187,9613,129,45,12691,9163
256,29,1,1,2,1,2,1,152,94,12188,9614,149,31,12692,9164
257,29,1,3,1,0,0,3,52,45,12189,9617,50,66,12692,9167
258,29,0,0,2,1,2,1,52,41,12189,9617,48,86,12693,9168
259,29,3,0,0,3,1,0,66,30,12192,9617,61,93,12696,9168
260,29,1,1,2,1,2,1,133,108,12193,9618,127,56,12697,9169
261,30,2,2,2,1,2,1,54,41,12195,9620,52,41,12698,9170
262,30,4,0,0,3,1,0,49,39,12199,9620,49,109,12701,9170
263,30,1,3,1,0,0,3,49,32,12200,9623,55,86,12701,9173
264,30,1,2,1,0,0,3,84,54,12201,9625,91,64,12701,9176
265,30,1,0,0,3,1,0,73,20,12202,9625,78,48,12704,9176
266,30,3,1,0,3,1,0,57,45,12205,9626,56,148,12707,9176
267,30,2,0,0,3,1,0,139,80,12207,9626,162,28,12710,9176
268,30,4,1,0,3,1,0,192,173,12211,9627,201,36,12713,9176
269,30,4,0,0,3,1,0,47,34,12215,9627,47,109,12716,9176
270,31,4,1,0,3,1,0,142,72,12219,9628,132,31,12719,9176
271,31,3,3,2,1,2,1,60,48,12222,9631,57,87,12720,9177
272,31,1,2,1,0,0,3,67,32,12223,9633,61,69,12720,9180
273,31,1,0,0,3,1,0,134,108,12224,9633,130,93,12723,9180
274,31,0,2,1,0,0,3,181,132,12224,9635,207,166,12723,9183
275,31,1,2,1,0,0,3,53,47,12225,9637,50,43,12723,9186
276,31,0,0,2,1,2,1,95,19,12225,9637,81,46,12724,9187
277,31,3,0,0,3,1,0,55,41,12228,9637,51,109,12727,9187
278,31,0,0,2,1,2,1,91,63,12228,9637,88,37,12728,9188
279,32,0,0,2,1,2,1,49,39,12228,9637,50,29,12729,9189
280,32,1,2,1,0,0,3,55,43,12229,9639,52,51,12729,9192
281,32,1,1,2,1,2,1,193,174,12230,9640,202,110,12730,9193
282,32,0,1,1,0,0,3,47,35,12230,9641,47,59,12730,9196
283,32,1,1,2,1,2,1,153,95,12231,9642,150,87,12731,9197
284,32,1,2,1,0,0,3,85,56,12232,9644,91,151,12731,9200
285,32,2,0,0,3,1,0,75,20,12234,9644,81,41,12734,9200
286,32,1,1,2,1,2,1,50,33,12235,9645,56,37,12735,9201
287,32,0,0,2,1,2,1,139,80,12235,9645,163,65,12736,9202
288,33,1,0,0,3,1,0,61,48,12236,9645,60,93,12739,9202
289,33,2,0,0,3,1,0,97,19,12238,9645,84,87,12742,9202
290,33,4,0,0,3,1,0,71,32,12242,9645,64,87,12745,9202
291,33,0,0,2,1,2,1,134,108,12242,9645,131,47,12746,9203
292,33,4,1,0,3,1,0,95,64,12246,9646,91,109,12749,9203
293,33,2,5,1,0,0,3,183,137,12248,9651,207,72,12749,9206
294,33,2,3,1,0,0,3,49,38,12250,9654,47,169,12749,9209
295,33,3,1,0,3,1,0,56,48,12253,9655,53,31,12752,9209
296,33,0,0,2,1,2,1,55,41,12253,9655,52,44,12753,9210
297,34,4,0,0,3,1,0,79,20,12257,9655,84,65,12756,9210
298,34,2,3,1,0,0,3,57,46,12259,9658,52,40,12756,9213
299,34,2,1,0,3,1,0,141,81,12261,9659,166,151,12759,9213
300,34,0,3,1,0,0,3,49,42,12261,9662,50,44,12759,9216
301,34,1,4,1,0,0,3,194,178,12262,9666,202,62,12759,9219
302,34,3,2,0,3,1,0,145,74,12265,9668,135,29,12762,9219
303,34,1,4,1,0,0,3,154,99,12266,9672,150,54,12762,9222
304,34,1,0,0,3,1,0,51,33,12267,9672,59,110,12765,9222
305,34,3,1,0,3,1,0,88,57,12270,9673,94,37,12768,9222
0,1,2,1,0,3,1,0,81,21,12272,9674,87,31,12771,9222
1,1,2,1,0,3,1,0,57,42,12274,9675,55,37,12774,9222
2,1,1,1,2,1,2,1,96,65,12275,9676,92,48,12775,9223
3,1,0,2,1,0,0,3,51,35,12275,9678,59,169,12775,9226
4,1,0,1,1,0,0,3,134,109,12275,9679,131,172,12775,9229
5,1,0,3,1,0,0,3,259,186,12275,9682,291,57,12775,9232
6,1,2,1,0,3,1,0,53,37,12277,9683,60,62,12778,9232
7,1,0,1,1,0,0,3,145,75,12277,9684,135,32,12778,9235
8,1,2,2,2,1,2,1,143,83,12279,9686,167,41,12779,9236
9,2,0,1,1,0,0,3,49,43,12279,9687,50,207,12779,9239
10,2,3,1,0,3,1,0,74,33,12282,9688,67,44,12782,9239
11,2,2,0,0,3,1,0,63,48,12284,9688,63,65,12785,9239
12,2,2,0,0,3,1,0,59,46,12286,9688,55,110,12788,9239
13,2,1,1,2,1,2,1,195,179,12287,9689,203,73,12789,9240
14,2,0,4,1,0,0,3,49,42,12287,9693,47,48,12789,9243
15,2,0,0,2,1,2,1,206,156,12287,9693,227,45,12790,9244
16,2,0,4,1,0,0,3,56,52,12287,9697,53,96,12790,9247
17,2,6,1,0,3,1,0,103,20,12293,9698,87,87,12793,9247
18,3,0,0,2,1,2,1,51,35,12293,9698,60,33,12794,9248
19,3,3,0,0,3,1,0,84,21,12296,9698,90,62,12797,9248
20,3,3,1,0,3,1,0,106,21,12299,9699,90,48,12800,9248
21,3,2,3,1,0,0,3,59,45,12301,9702,55,175,12800,9251
22,3,0,0,2,1,2,1,145,75,12301,9702,136,170,12801,9252
23,3,3,2,0,3,1,0,146,85,12304,9704,170,31,12804,9252
24,3,0,2,1,0,0,3,259,188,12304,9706,291,44,12804,9255
25,3,5,3,0,3,1,0,101,68,12309,9709,95,37,12807,9255
26,3,3,2,0,3,1,0,56,39,12312,9711,63,110,12810,9255
27,4,1,2,1,0,0,3,196,181,12313,9713,203,51,12810,9258
28,4,0,2,1,0,0,3,74,35,12313,9715,67,60,12810,9261
29,4,1,1,2,1,2,1,57,53,12314,9716,54,208,12811,9262
30,4,2,0,0,3,1,0,51,43,12316,9716,53,44,12814,9262
31,4,3,2,0,3,1,0,137,111,12319,9718,134,73,12817,9262
32,4,0,0,2,1,2,1,206,156,12319,9718,228,66,12818,9263
33,4,1,1,2,1,2,1,64,49,12320,9719,64,46,12819,9264
34,4,2,2,2,1,2,1,61,48,12322,9721,56,88,12820,9265
35,4,3,1,0,3,1,0,52,43,12325,9722,50,96,12823,9265
36,5,3,0,0,3,1,0,109,21,12328,9722,93,33,12826,9265
37,5,3,0,0,3,1,0,77,35,12331,9722,70,48,12829,9265
38,5,0,2,1,0,0,3,259,190,12331,9724,291,173,12829,9268
39,5,3,3,2,1,2,1,59,42,12334,9727,64,74,12830,9269
40,5,2,2,2,1,2,1,61,47,12336,9729,56,111,12831,9270
41,5,0,3,1,0,0,3,145,78,12336,9732,136,40,12831,9273
42,5,4,1,0,3,1,0,150,86,12340,9733,173,175,12834,9273
43,5,1,2,1,0,0,3,102,70,12341,9735,95,34,12834,9276
44,5,1,3,1,0,0,3,52,38,12342,9738,60,65,12834,9279
45,6,2,2,2,1,2,1,208,158,12344,9740,229,45,12835,9280
46,6,2,0,0,3,1,0,66,49,12346,9740,67,208,12838,9280
47,6,0,2,1,0,0,3,61,50,12346,9742,56,63,12838,9283
48,6,0,2,1,0,0,3,196,183,12346,9744,203,91,12838,9286
49,6,0,0,2,1,2,1,52,43,12346,9744,51,45,12839,9287
50,6,1,0,0,3,1,0,138,111,12347,9744,137,96,12842,9287
51,6,5,0,0,3,1,0,89,21,12352,9744,93,46,12845,9287
52,6,2,1,0,3,1,0,61,43,12354,9745,67,66,12848,9287
53,6,0,2,1,0,0,3,57,55,12354,9747,54,51,12848,9290
54,7,3,1,0,3,1,0,55,39,12357,9748,63,34,12851,9290
55,7,2,0,0,3,1,0,111,21,12359,9748,96,40,12854,9290
56,7,3,0,0,3,1,0,80,35,12362,9748,73,33,12857,9290
57,7,3,0,0,3,1,0,105,70,12365,9748,98,175,12860,9290
58,7,1,0,0,3,1,0,52,43,12366,9748,56,173,12863,9290
59,7,0,1,1,0,0,3,259,191,12366,9749,291,114,12863,9293
60,7,2,0,0,3,1,0,63,47,12368,9749,59,51,12866,9293
61,7,2,2,2,1,2,1,147,80,12370,9751,137,66,12867,9294
62,7,1,1,2,1,2,1,151,87,12371,9752,174,75,12868,9295
63,8,3,3,2,1,2,1,55,46,12374,9755,52,209,12869,9296
64,8,1,2,1,0,0,3,90,23,12375,9757,93,48,12869,9299
65,8,2,2,2,1,2,1,68,51,12377,9759,68,52,12870,9300
66,8,0,2,1,0,0,3,57,57,12377,9761,54,69,12870,9303
67,8,3,1,0,3,1,0,64,44,12380,9762,70,96,12873,9303
68,8,0,5,1,0,0,3,208,163,12380,9767,229,66,12873,9306
69,8,4,0,0,3,1,0,65,50,12384,9767,59,46,12876,9306
70,8,0,0,2,1,2,1,196,183,12384,9767,204,46,12877,9307
71,8,0,1,1,0,0,3,138,112,12384,9768,137,94,12877,9310
72,9,0,2,1,0,0,3,55,41,12384,9770,63,117,12877,9313
73,9,1,0,0,3,1,0,81,35,12385,9770,76,175,12880,9313
74,9,0,2,1,0,0,3,105,72,12385,9772,98,78,12880,9316
75,9,3,0,0,3,1,0,55,43,12388,9772,59,40,12883,9316
76,9,1,1,2,1,2,1,260,192,12389,9773,292,35,12884,9317
77,9,1,4,1,0,0,3,209,167,12390,9777,229,36,12884,9320
78,9,2,1,0,3,1,0,149,81,12392,9778,140,51,12887,9320
79,9,1,2,1,0,0,3,112,23,12393,9780,96,69,12887,9323
80,9,2,3,1,0,0,3,153,90,12395,9783,174,49,12887,9326
81,10,1,1,2,1,2,1,65,45,12396,9784,71,210,12888,9327
82,10,0,0,2,1,2,1,90,23,12396,9784,94,95,12889,9328
83,10,1,1,2,1,2,1,64,48,12397,9785,60,70,12890,9329
84,10,2,0,0,3,1,0,155,90,12399,9785,177,46,12893,9329
85,10,1,0,0,3,1,0,197,183,12400,9785,207,36,12896,9329
86,10,3,2,0,3,1,0,58,48,12403,9787,55,48,12899,9329
87,10,0,3,1,0,0,3,138,115,12403,9790,137,69,12899,9332
88,10,3,2,0,3,1,0,71,53,12406,9792,71,173,12902,9332
89,10,2,1,0,3,1,0,67,51,12408,9793,62,52,12905,9332
90,11,2,1,0,3,1,0,57,44,12410,9794,62,175,12908,9332
91,11,2,0,0,3,1,0,114,23,12412,9794,99,51,12911,9332
92,11,2,1,0,3,1,0,83,36,12414,9795,79,35,12914,9332
93,11,0,0,2,1,2,1,105,72,12414,9795,99,118,12915,9333
94,11,1,3,1,0,0,3,56,44,12415,9798,63,81,12915,9336
95,11,1,1,2,1,2,1,210,168,12416,9799,230,41,12916,9337
96,11,3,1,0,3,1,0,60,58,12419,9800,57,69,12919,9337
97,11,2,4,1,0,0,3,151,85,12421,9804,140,99,12919,9340
98,11,2,4,1,0,0,3,262,196,12423,9808,292,52,12919,9343
99,12,3,1,0,3,1,0,93,24,12426,9809,97,210,12922,9343
100,12,1,2,1,0,0,3,65,50,12427,9811,60,98,12922,9346
101,12,1,2,1,0,0,3,156,92,12428,9813,177,73,12922,9349
102,12,1,1,2,1,2,1,198,184,12429,9814,208,70,12923,9350
103,12,1,0,0,3,1,0,139,115,12430,9814,140,52,12926,9350
104,12,4,2,0,3,1,0,69,47,12434,9816,74,46,12929,9350
105,12,2,0,0,3,1,0,73,53,12436,9816,74,48,12932,9350
106,12,2,1,0,3,1,0,69,52,12438,9817,65,173,12935,9350
107,12,1,3,1,0,0,3,59,51,12439,9820,55,39,12935,9353
108,13,2,0,0,3,1,0,212,168,12441,9820,233,118,12938,9353
109,13,5,0,0,3,1,0,119,23,12446,9820,102,99,12941,9353
110,13,1,1,2,1,2,1,84,37,12447,9821,80,52,12942,9354
111,13,1,1,2,1,2,1,61,59,12448,9822,58,36,12943,9355
112,13,1,2,1,0,0,3,58,46,12449,9824,62,84,12943,9358
113,13,0,0,2,1,2,1,262,196,12449,9824,293,176,12944,9359
114,13,3,0,0,3,1,0,108,72,12452,9824,102,98,12947,9359
115,13,1,2,1,0,0,3,60,53,12453,9826,55,72,12947,9362
116,13,1,1,2,1,2,1,57,45,12454,9827,64,53,12948,9363
117,14,1,1,2,1,2,1,94,25,12455,9828,98,174,12949,9364
118,14,2,0,0,3,1,0,158,92,12457,9828,180,210,12952,9364
119,14,3,1,0,3,1,0,142,116,12460,9829,143,48,12955,9364
120,14,1,3,1,0,0,3,70,50,12461,9832,74,55,12955,9367
121,14,2,0,0,3,1,0,67,50,12463,9832,63,39,12958,9367
122,14,2,1,0,3,1,0,153,86,12465,9833,143,46,12961,9367
123,14,1,4,1,0,0,3,70,56,12466,9837,65,75,12961,9370
124,14,0,2,1,0,0,3,108,74,12466,9839,102,73,12961,9373
125,14,4,2,0,3,1,0,202,186,12470,9841,211,41,12964,9373
126,15,4,0,0,3,1,0,216,168,12474,9841,236,52,12967,9373
127,15,1,1,2,1,2,1,85,38,12475,9842,81,54,12968,9374
128,15,1,0,0,3,1,0,74,53,12476,9842,77,176,12971,9374
129,15,2,1,0,3,1,0,60,47,12478,9843,65,99,12974,9374
130,15,1,1,2,1,2,1,58,46,12479,9844,65,74,12975,9375
131,15,0,1,1,0,0,3,262,197,12479,9845,293,101,12975,9378
132,15,1,1,2,1,2,1,120,24,12480,9846,103,85,12976,9379
133,15,1,4,1,0,0,3,61,57,12481,9850,55,39,12976,9382
134,15,1,1,2,1,2,1,62,60,12482,9851,59,119,12977,9383
135,16,2,0,0,3,1,0,144,116,12484,9851,146,41,12980,9383
136,16,2,3,1,0,0,3,96,28,12486,9854,98,42,12980,9386
137,16,3,1,0,3,1,0,156,87,12489,9855,146,48,12983,9386
138,16,2,0,0,3,1,0,204,186,12491,9855,214,174,12986,9386
139,16,1,0,0,3,1,0,109,74,12492,9855,105,210,12989,9386
140,16,0,2,1,0,0,3,58,48,12492,9857,65,76,12989,9389
141,16,4,1,0,3,1,0,74,51,12496,9858,77,39,12992,9389
142,16,2,0,0,3,1,0,69,50,12498,9858,66,55,12995,9389
143,16,3,2,0,3,1,0,161,94,12501,9860,183,75,12998,9389
144,17,1,1,2,1,2,1,121,25,12502,9861,104,55,12999,9390
145,17,3,0,0,3,1,0,77,53,12505,9861,80,119,13002,9390
146,17,0,2,1,0,0,3,62,62,12505,9863,59,55,13002,9393
147,17,3,1,0,3,1,0,63,48,12508,9864,68,101,13005,9393
148,17,1,1,2,1,2,1,263,198,12509,9865,294,47,13006,9394
149,17,2,1,0,3,1,0,218,169,12511,9866,239,99,13009,9394
150,17,1,3,1,0,0,3,86,41,12512,9869,81,77,13009,9397
151,17,1,3,1,0,0,3,62,60,12513,9872,55,88,13009,9400
152,17,1,1,2,1,2,1,71,57,12514,9873,66,177,13010,9401
153,18,5,4,0,3,1,0,91,45,12519,9877,84,99,13013,9401
154,18,2,0,0,3,1,0,123,25,12521,9877,107,210,13016,9401
155,18,3,1,0,3,1,0,80,54,12524,9878,83,55,13019,9401
156,18,2,0,0,3,1,0,64,62,12526,9878,62,101,13022,9401
157,18,0,0,2,1,2,1,62,60,12526,9878,56,56,13023,9402
158,18,0,0,2,1,2,1,63,48,12526,9878,69,78,13024,9403
159,18,0,5,1,0,0,3,71,62,12526,9883,66,91,13024,9406
160,18,1,1,2,1,2,1,205,187,12527,9884,215,120,13025,9407
161,18,2,3,1,0,0,3,220,172,12529,9887,239,50,13025,9410
162,19,3,0,0,3,1,0,99,28,12532,9887,101,177,13028,9410
163,19,2,1,0,3,1,0,71,51,12534,9888,69,174,13031,9410
164,19,2,1,0,3,1,0,163,95,12536,9889,186,42,13034,9410
165,19,0,0,2,1,2,1,58,48,12536,9889,66,49,13035,9411
166,19,0,3,1,0,0,3,263,201,12536,9892,294,58,13035,9414
167,19,2,1,0,3,1,0,76,52,12538,9893,80,41,13038,9414
168,19,0,0,2,1,2,1,109,74,12538,9893,106,76,13039,9415
169,19,3,2,0,3,1,0,147,118,12541,9895,149,39,13042,9415
170,19,0,2,1,0,0,3,156,89,12541,9897,146,79,13042,9418
171,20,2,0,0,3,1,0,73,62,12543,9897,69,99,13045,9418
172,20,1,2,1,0,0,3,92,47,12544,9899,84,213,13045,9421
173,20,1,1,2,1,2,1,65,63,12545,9900,63,51,13046,9422
174,20,2,1,0,3,1,0,64,61,12547,9901,59,78,13049,9422
175,20,0,3,1,0,0,3,63,51,12547,9904,69,82,13049,9425
176,20,3,1,0,3,1,0,223,173,12550,9905,242,101,13052,9425
177,20,0,2,1,0,0,3,147,120,12550,9907,149,58,13052,9428
178,20,2,1,0,3,1,0,207,188,12552,9908,218,56,13055,9428
179,20,2,3,1,0,0,3,82,57,12554,9911,83,94,13055,9431
180,21,1,4,1,0,0,3,100,32,12555,9915,101,123,13055,9434
181,21,3,3,2,1,2,1,74,54,12558,9918,70,77,13056,9435
182,21,1,4,1,0,0,3,157,93,12559,9922,146,42,13056,9438
183,21,1,0,0,3,1,0,164,95,12560,9922,189,41,13059,9438
184,21,0,1,1,0,0,3,263,202,12560,9923,294,45,13059,9441
185,21,0,0,2,1,2,1,76,52,12560,9923,81,178,13060,9442
186,21,4,0,0,3,1,0,127,25,12564,9923,110,49,13063,9442
187,21,1,1,2,1,2,1,59,49,12565,9924,67,59,13064,9443
188,21,1,0,0,3,1,0,110,74,12566,9924,109,174,13067,9443
189,22,0,2,1,0,0,3,65,65,12566,9926,63,85,13067,9446
190,22,2,1,0,3,1,0,84,58,12568,9927,86,51,13070,9446
191,22,2,3,1,0,0,3,75,65,12570,9930,69,81,13070,9449
192,22,2,2,2,1,2,1,65,53,12572,9932,70,50,13071,9450
193,22,1,0,0,3,1,0,148,120,12573,9932,152,56,13074,9450
194,22,1,0,0,3,1,0,224,173,12574,9932,245,213,13077,9450
195,22,3,0,0,3,1,0,103,32,12577,9932,104,58,13080,9450
196,22,2,2,2,1,2,1,209,190,12579,9934,219,100,13081,9451
197,22,0,1,1,0,0,3,64,62,12579,9935,59,104,13081,9454
198,23,0,0,2,1,2,1,110,74,12579,9935,110,59,13082,9455
199,23,6,1,0,3,1,0,133,26,12585,9936,113,42,13085,9455
200,23,1,1,2,1,2,1,158,94,12586,9937,147,179,13086,9456
201,23,5,1,0,3,1,0,169,96,12591,9938,192,123,13089,9456
202,23,1,1,2,1,2,1,66,54,12592,9939,71,46,13090,9457
203,23,2,1,0,3,1,0,61,50,12594,9940,70,41,13093,9457
204,23,2,1,0,3,1,0,94,48,12596,9941,87,174,13096,9457
205,23,1,1,2,1,2,1,75,55,12597,9942,71,95,13097,9458
206,23,0,0,2,1,2,1,263,202,12597,9942,295,78,13098,9459
207,24,0,1,1,0,0,3,76,53,12597,9943,81,59,13098,9462
208,24,3,1,0,3,1,0,106,33,12600,9944,107,100,13101,9462
209,24,1,4,1,0,0,3,66,69,12601,9948,63,53,13101,9465
210,24,0,1,1,0,0,3,75,66,12601,9949,69,54,13101,9468
211,24,1,1,2,1,2,1,210,191,12602,9950,220,82,13102,9469
212,24,1,1,2,1,2,1,149,121,12603,9951,153,214,13103,9470
213,24,2,1,0,3,1,0,86,59,12605,9952,89,104,13106,9470
214,24,0,1,1,0,0,3,64,63,12605,9953,59,88,13106,9473
215,24,1,1,2,1,2,1,225,174,12606,9954,246,60,13107,9474
216,25,1,2,1,0,0,3,62,52,12607,9956,70,182,13107,9477
217,25,3,2,0,3,1,0,136,28,12610,9958,116,174,13110,9477
218,25,2,1,0,3,1,0,96,49,12612,9959,90,95,13113,9477
219,25,2,5,1,0,0,3,112,79,12614,9964,110,49,13113,9480
220,25,1,0,0,3,1,0,67,54,12615,9964,74,78,13116,9480
221,25,0,3,1,0,0,3,263,205,12615,9967,295,44,13116,9483
222,25,1,1,2,1,2,1,76,56,12616,9968,72,43,13117,9484
223,25,0,0,2,1,2,1,169,96,12616,9968,193,60,13118,9485
224,25,0,1,1,0,0,3,158,95,12616,9969,147,126,13118,9488
225,26,1,1,2,1,2,1,67,70,12617,9970,64,175,13119,9489
226,26,5,1,0,3,1,0,111,34,12622,9971,110,82,13122,9489
227,26,2,2,2,1,2,1,77,68,12624,9973,70,215,13123,9490
228,26,3,0,0,3,1,0,213,191,12627,9973,223,53,13126,9490
229,26,0,0,2,1,2,1,64,63,12627,9973,60,61,13127,9491
230,26,0,1,1,0,0,3,149,122,12627,9974,153,57,13127,9494
231,26,1,2,1,0,0,3,87,61,12628,9976,89,91,13127,9497
232,26,1,2,1,0,0,3,77,55,12629,9978,81,107,13127,9500
233,26,1,0,0,3,1,0,77,56,12630,9978,75,100,13130,9500
234,27,3,0,0,3,1,0,99,49,12633,9978,93,44,13133,9500
235,27,1,2,1,0,0,3,159,97,12634,9980,147,98,13133,9503
236,27,2,0,0,3,1,0,114,79,12636,9980,113,59,13136,9503
237,27,1,1,2,1,2,1,68,55,12637,9981,75,44,13137,9504
238,27,0,2,1,0,0,3,62,54,12637,9983,70,103,13137,9507
239,27,1,4,1,0,0,3,226,178,12638,9987,246,81,13137,9510
240,27,9,2,0,3,1,0,145,30,12647,9989,119,126,13140,9510
241,27,2,2,2,1,2,1,69,72,12649,9991,65,183,13141,9511
242,27,2,3,1,0,0,3,265,208,12651,9994,295,63,13141,9514
243,28,3,0,0,3,1,0,67,63,12654,9994,63,175,13144,9514
244,28,4,2,0,3,1,0,115,36,12658,9996,113,57,13147,9514
245,28,1,0,0,3,1,0,78,56,12659,9996,78,215,13150,9514
246,28,1,1,2,1,2,1,88,62,12660,9997,90,50,13151,9515
247,28,0,2,1,0,0,3,77,70,12660,9999,70,56,13151,9518
248,28,0,1,1,0,0,3,77,56,12660,10000,81,94,13151,9521
249,28,0,1,1,0,0,3,149,123,12660,10001,153,85,13151,9524
250,28,2,1,0,3,1,0,215,192,12662,10002,226,61,13154,9524
251,28,0,0,2,1,2,1,169,96,12662,10002,194,108,13155,9525
252,29,3,1,0,3,1,0,117,80,12665,10003,116,103,13158,9525
253,29,4,0,0,3,1,0,149,30,12669,10003,122,183,13161,9525
254,29,2,2,2,1,2,1,71,74,12671,10005,66,45,13162,9526
255,29,1,2,1,0,0,3,69,57,12672,10007,75,129,13162,9529
256,29,1,6,1,0,0,3,266,214,12673,10013,295,101,13162,9532
257,29,2,2,2,1,2,1,228,180,12675,10015,247,45,13163,9533
258,29,2,2,2,1,2,1,101,51,12677,10017,94,82,13164,9534
259,29,2,0,0,3,1,0,161,97,12679,10017,150,59,13167,9534
260,29,2,0,0,3,1,0,64,54,12681,10017,73,63,13170,9534
261,30,1,0,0,3,1,0,79,56,12682,10017,81,57,13173,9534
262,30,2,0,0,3,1,0,117,36,12684,10017,116,61,13176,9534
263,30,5,0,0,3,1,0,93,62,12689,10017,93,45,13179,9534
264,30,1,6,1,0,0,3,170,102,12690,10023,194,97,13179,9537
265,30,2,1,0,3,1,0,151,124,12692,10024,156,175,13182,9537
266,30,1,0,0,3,1,0,78,56,12693,10024,84,56,13185,9537
267,30,0,3,1,0,0,3,77,73,12693,10027,70,53,13185,9540
268,30,2,1,0,3,1,0,163,98,12695,10028,153,85,13188,9540
269,30,0,1,1,0,0,3,215,193,12695,10029,226,218,13188,9543
270,31,2,3,1,0,0,3,268,217,12697,10032,295,106,13188,9546
271,31,1,0,0,3,1,0,150,30,12698,10032,125,85,13191,9546
272,31,1,0,0,3,1,0,94,62,12699,10032,96,45,13194,9546
273,31,3,1,0,3,1,0,74,75,12702,10033,69,59,13197,9546
274,31,2,1,0,3,1,0,69,64,12704,10034,66,183,13200,9546
275,31,3,0,0,3,1,0,67,54,12707,10034,76,108,13203,9546
276,31,1,2,1,0,0,3,229,182,12708,10036,247,104,13203,9549
277,31,0,0,2,1,2,1,69,57,12708,10036,76,64,13204,9550
278,31,4,1,0,3,1,0,105,52,12712,10037,97,129,13207,9550
279,32,0,1,1,0,0,3,79,57,12712,10038,81,59,13207,9553
280,32,0,2,1,0,0,3,163,100,12712,10040,153,221,13207,9556
281,32,2,2,2,1,2,1,172,104,12714,10042,195,62,13208,9557
282,32,2,2,2,1,2,1,79,75,12716,10044,71,46,13209,9558
283,32,0,2,1,0,0,3,215,195,12716,10046,226,85,13209,9561
284,32,3,1,0,3,1,0,81,57,12719,10047,87,175,13212,9561
285,32,1,1,2,1,2,1,118,37,12720,10048,117,98,13213,9562
286,32,2,0,0,3,1,0,119,80,12722,10048,119,57,13216,9562
287,32,1,1,2,1,2,1,152,125,12723,10049,157,54,13217,9563
288,33,3,0,0,3,1,0,153,30,12726,10049,128,57,13220,9563
289,33,1,2,1,0,0,3,106,54,12727,10051,97,111,13220,9566
290,33,3,1,0,3,1,0,97,63,12730,10052,99,106,13223,9566
291,33,3,3,2,1,2,1,77,78,12733,10055,70,105,13224,9567
292,33,1,1,2,1,2,1,80,76,12734,10056,72,65,13225,9568
293,33,1,4,1,0,0,3,70,68,12735,10060,66,132,13225,9571
294,33,2,4,1,0,0,3,71,61,12737,10064,76,62,13225,9574
295,33,1,2,1,0,0,3,269,219,12738,10066,295,88,13225,9577
296,33,1,2,1,0,0,3,230,184,12739,10068,247,186,13225,9580
297,34,1,2,1,0,0,3,119,39,12740,10070,117,49,13225,9583
298,34,3,4,1,0,0,3,82,61,12743,10074,81,101,13225,9586
299,34,2,2,2,1,2,1,165,102,12745,10076,154,63,13226,9587
300,34,3,0,0,3,1,0,175,104,12748,10076,198,175,13229,9587
301,34,3,2,0,3,1,0,218,197,12751,10078,229,45,13232,9587
302,34,1,2,1,0,0,3,120,82,12752,10080,119,62,13232,9590
303,34,3,1,0,3,1,0,70,55,12755,10081,79,221,13235,9590
304,34,0,1,1,0,0,3,152,126,12755,10082,157,88,13235,9593
305,34,2,2,2,1,2,1,83,59,12757,10084,88,55,13236,9594
0,1,3,1,0,3,1,0,156,31,12760,10085,131,62,13239,9594
1,1,3,1,0,3,1,0,100,64,12763,10086,102,88,13242,9594
2,1,2,0,0,3,1,0,177,104,12765,10086,201,55,13245,9594
3,1,0,4,1,0,0,3,70,59,12765,10090,79,108,13245,9597
4,1,6,1,0,3,1,0,94,58,12771,10091,97,65,13248,9597
5,1,2,2,2,1,2,1,72,70,12773,10093,67,187,13249,9598
6,1,0,1,1,0,0,3,167,116,12773,10094,207,48,13249,9601
7,1,3,2,0,3,1,0,74,63,12776,10096,79,111,13252,9601
8,1,3,3,2,1,2,1,109,57,12779,10099,98,133,13253,9602
9,2,0,1,1,0,0,3,165,103,12779,10100,154,91,13253,9605
10,2,4,0,0,3,1,0,81,78,12783,10100,73,62,13256,9605
11,2,1,0,0,3,1,0,81,76,12784,10100,75,57,13259,9605
12,2,1,2,1,0,0,3,121,84,12785,10102,119,66,13259,9608
13,2,1,5,1,0,0,3,153,131,12786,10107,157,52,13259,9611
14,2,0,1,1,0,0,3,83,60,12786,10108,88,104,13259,9614
15,2,3,0,0,3,1,0,85,61,12789,10108,84,106,13262,9614
16,2,2,2,2,1,2,1,220,199,12791,10110,230,88,13263,9615
17,2,2,1,0,3,1,0,121,40,12793,10111,120,135,13266,9615
18,3,1,0,0,3,1,0,122,40,12794,10111,123,48,13269,9615
19,3,2,0,0,3,1,0,158,31,12796,10111,134,187,13272,9615
20,3,4,2,0,3,1,0,104,66,12800,10113,105,62,13275,9615
21,3,2,1,0,3,1,0,179,105,12802,10114,204,62,13278,9615
22,3,3,3,2,1,2,1,75,73,12805,10117,68,89,13279,9616
23,3,2,0,0,3,1,0,76,63,12807,10117,82,55,13282,9616
24,3,1,0,0,3,1,0,95,58,12808,10117,100,133,13285,9616
25,3,0,2,1,0,0,3,167,118,12808,10119,207,68,13285,9619
26,3,2,1,0,3,1,0,72,60,12810,10120,82,111,13288,9619
27,4,1,1,2,1,2,1,122,85,12811,10121,120,105,13289,9620
28,4,4,1,0,3,1,0,89,62,12815,10122,87,48,13292,9620
29,4,4,1,0,3,1,0,183,106,12819,10123,207,66,13295,9620
30,4,2,0,0,3,1,0,83,78,12821,10123,76,88,13298,9620
31,4,0,1,1,0,0,3,220,200,12821,10124,230,60,13298,9623
32,4,4,0,0,3,1,0,157,131,12825,10124,160,135,13301,9623
33,4,2,0,0,3,1,0,111,57,12827,10124,101,91,13304,9623
34,4,6,2,0,3,1,0,171,105,12833,10126,157,52,13307,9623
35,4,1,2,1,0,0,3,84,62,12834,10128,88,111,13307,9626
36,5,0,1,1,0,0,3,95,59,12834,10129,100,114,13307,9629
37,5,2,0,0,3,1,0,160,31,12836,10129,137,106,13310,9629
38,5,3,1,0,3,1,0,107,67,12839,10130,108,55,13313,9629
39,5,0,3,1,0,0,3,81,79,12839,10133,75,71,13313,9632
40,5,0,1,1,0,0,3,76,64,12839,10134,82,65,13313,9635
41,5,2,1,0,3,1,0,74,61,12841,10135,85,89,13316,9635
42,5,6,2,0,3,1,0,128,42,12847,10137,126,133,13319,9635
43,5,2,1,0,3,1,0,77,74,12849,10138,71,62,13322,9635
44,5,1,1,2,1,2,1,168,119,12850,10139,208,188,13323,9636
45,6,4,1,0,3,1,0,93,63,12854,10140,90,135,13326,9636
46,6,2,1,0,3,1,0,185,107,12856,10141,210,60,13329,9636
47,6,2,1,0,3,1,0,85,79,12858,10142,79,52,13332,9636
48,6,1,1,2,1,2,1,221,201,12859,10143,231,112,13333,9637
49,6,1,4,1,0,0,3,77,68,12860,10147,82,94,13333,9640
50,6,0,2,1,0,0,3,157,133,12860,10149,160,51,13333,9643
51,6,0,4,1,0,0,3,111,61,12860,10153,101,108,13333,9646
52,6,1,1,2,1,2,1,123,86,12861,10154,121,89,13334,9647
53,6,1,1,2,1,2,1,172,106,12862,10155,158,72,13335,9648
54,7,2,2,2,1,2,1,76,63,12864,10157,86,63,13336,9649
55,7,5,0,0,3,1,0,133,42,12869,10157,129,89,13339,9649
56,7,1,0,0,3,1,0,161,31,12870,10157,140,55,13342,9649
57,7,2,0,0,3,1,0,109,67,12872,10157,111,106,13345,9649
58,7,3,3,2,1,2,1,80,77,12875,10160,72,66,13346,9650
59,7,3,1,0,3,1,0,98,60,12878,10161,103,66,13349,9650
60,7,2,2,2,1,2,1,86,64,12880,10163,89,134,13350,9651
61,7,3,3,2,1,2,1,84,82,12883,10166,76,189,13351,9652
62,7,0,4,1,0,0,3,168,123,12883,10170,208,117,13351,9655
63,8,1,1,2,1,2,1,186,108,12884,10171,211,90,13352,9656
64,8,4,1,0,3,1,0,115,62,12888,10172,104,60,13355,9656
65,8,2,0,0,3,1,0,95,63,12890,10172,93,112,13358,9656
66,8,1,1,2,1,2,1,173,107,12891,10173,159,52,13359,9657
67,8,0,2,1,0,0,3,85,81,12891,10175,79,138,13359,9660
68,8,2,2,2,1,2,1,79,70,12893,10177,83,53,13360,9661
69,8,1,1,2,1,2,1,110,68,12894,10178,112,109,13361,9662
70,8,0,5,1,0,0,3,221,206,12894,10183,231,137,13361,9665
71,8,1,1,2,1,2,1,124,87,12895,10184,122,73,13362,9666
72,9,1,2,1,0,0,3,81,79,12896,10186,72,97,13362,9669
73,9,1,0,0,3,1,0,134,42,12897,10186,132,106,13365,9669
74,9,4,1,0,3,1,0,165,32,12901,10187,143,66,13368,9669
75,9,0,0,2,1,2,1,84,82,12901,10187,77,90,13369,9670
76,9,2,3,1,0,0,3,170,126,12903,10190,208,69,13369,9673
77,9,1,1,2,1,2,1,87,65,12904,10191,90,190,13370,9674
78,9,1,0,0,3,1,0,99,60,12905,10191,106,63,13373,9674
79,9,3,3,2,1,2,1,160,136,12908,10194,161,118,13374,9675
80,9,1,2,1,0,0,3,77,65,12909,10196,86,58,13374,9678
81,10,1,1,2,1,2,1,174,108,12910,10197,160,191,13375,9679
82,10,3,2,0,3,1,0,168,34,12913,10199,146,90,13378,9679
83,10,1,3,1,0,0,3,116,65,12914,10202,104,115,13378,9682
84,10,2,1,0,3,1,0,112,69,12916,10203,115,60,13381,9682
85,10,1,4,1,0,0,3,187,112,12917,10207,211,56,13381,9685
86,10,2,0,0,3,1,0,81,70,12919,10207,86,138,13384,9685
87,10,3,0,0,3,1,0,88,81,12922,10207,82,52,13387,9685
88,10,0,3,1,0,0,3,124,90,12922,10210,122,140,13387,9688
89,10,4,1,0,3,1,0,99,64,12926,10211,96,73,13390,9688
90,11,6,1,0,3,1,0,140,43,12932,10212,135,118,13393,9688
91,11,0,3,1,0,0,3,221,209,12932,10215,231,93,13393,9691
92,11,1,2,1,0,0,3,82,81,12933,10217,72,112,13393,9694
93,11,0,2,1,0,0,3,160,138,12933,10219,161,66,13393,9697
94,11,1,0,0,3,1,0,171,126,12934,10219,211,97,13396,9697
95,11,0,2,1,0,0,3,99,62,12934,10221,106,72,13396,9700
96,11,1,2,1,0,0,3,88,67,12935,10223,90,61,13396,9703
97,11,2,1,0,3,1,0,79,66,12937,10224,89,66,13399,9703
98,11,3,2,0,3,1,0,87,84,12940,10226,80,106,13402,9703
99,12,0,0,2,1,2,1,187,112,12940,10226,212,139,13403,9704
100,12,3,0,0,3,1,0,171,34,12943,10226,149,60,13406,9704
101,12,3,1,0,3,1,0,119,66,12946,10227,107,52,13409,9704
102,12,5,3,0,3,1,0,117,72,12951,10230,118,140,13412,9704
103,12,2,1,0,3,1,0,90,82,12953,10231,85,115,13415,9704
104,12,2,3,1,0,0,3,84,84,12955,10234,72,93,13415,9707
105,12,3,1,0,3,1,0,102,65,12958,10235,99,191,13418,9707
106,12,1,0,0,3,1,0,82,70,12959,10235,89,73,13421,9707
107,12,1,3,1,0,0,3,125,93,12960,10238,122,121,13421,9710
108,13,0,2,1,0,0,3,174,110,12960,10240,160,69,13421,9713
109,13,1,1,2,1,2,1,222,210,12961,10241,232,62,13422,9714
110,13,2,0,0,3,1,0,81,66,12963,10241,92,56,13425,9714
111,13,0,1,1,0,0,3,171,127,12963,10242,211,96,13425,9717
112,13,3,3,2,1,2,1,91,70,12966,10245,91,73,13426,9718
113,13,0,1,1,0,0,3,99,63,12966,10246,106,100,13426,9721
114,13,0,3,1,0,0,3,140,46,12966,10249,135,115,13426,9724
115,13,3,1,0,3,1,0,163,139,12969,10250,164,106,13429,9724
116,13,2,3,1,0,0,3,89,87,12971,10253,80,69,13429,9727
117,14,1,1,2,1,2,1,91,83,12972,10254,86,141,13430,9728
118,14,2,0,0,3,1,0,173,34,12974,10254,152,139,13433,9728
119,14,3,0,0,3,1,0,120,72,12977,10254,121,191,13436,9728
120,14,4,4,2,1,2,1,88,88,12981,10258,73,53,13437,9729
121,14,1,3,1,0,0,3,83,73,12982,10261,89,118,13437,9732
122,14,0,0,2,1,2,1,99,63,12982,10261,107,61,13438,9733
123,14,3,0,0,3,1,0,122,66,12985,10261,110,121,13441,9733
124,14,2,0,0,3,1,0,189,112,12987,10261,215,73,13444,9733
125,14,1,0,0,3,1,0,103,65,12988,10261,102,96,13447,9733
126,15,1,1,2,1,2,1,223,211,12989,10262,233,70,13448,9734
127,15,2,1,0,3,1,0,105,66,12991,10263,105,73,13451,9734
128,15,4,2,0,3,1,0,178,112,12995,10265,163,106,13454,9734
129,15,0,7,1,0,0,3,89,94,12995,10272,80,118,13454,9737
130,15,0,1,1,0,0,3,163,140,12995,10273,164,64,13454,9740
131,15,1,2,1,0,0,3,92,72,12996,10275,91,59,13454,9743
132,15,0,1,1,0,0,3,140,47,12996,10276,135,103,13454,9746
133,15,0,3,1,0,0,3,125,96,12996,10279,122,65,13454,9749
134,15,0,2,1,0,0,3,171,129,12996,10281,211,96,13454,9752
135,16,3,2,0,3,1,0,102,65,12999,10283,110,53,13457,9752
136,16,3,1,0,3,1,0,176,35,13002,10284,155,141,13460,9752
137,16,3,3,2,1,2,1,192,115,13005,10287,216,192,13461,9753
138,16,2,2,2,1,2,1,90,90,13007,10289,74,119,13462,9754
139,16,0,0,2,1,2,1,83,73,13007,10289,90,70,13463,9755
140,16,4,1,0,3,1,0,85,67,13011,10290,95,139,13466,9755
141,16,3,1,0,3,1,0,94,84,13014,10291,89,121,13469,9755
142,16,2,0,0,3,1,0,124,66,13016,10291,113,96,13472,9755
143,16,0,1,1,0,0,3,120,73,13016,10292,121,76,13472,9758
144,17,1,1,2,1,2,1,93,73,13017,10293,92,65,13473,9759
145,17,1,2,1,0,0,3,141,49,13018,10295,135,99,13473,9762
146,17,1,0,0,3,1,0,90,94,13019,10295,83,103,13476,9762
147,17,2,1,0,3,1,0,127,97,13021,10296,125,106,13479,9762
148,17,2,3,1,0,0,3,165,143,13023,10299,164,73,13479,9765
149,17,1,0,0,3,1,0,172,129,13024,10299,214,59,13482,9765
150,17,0,0,2,1,2,1,223,211,13024,10299,234,74,13483,9766
151,17,2,2,2,1,2,1,107,68,13026,10301,106,66,13484,9767
152,17,1,2,1,0,0,3,179,114,13027,10303,163,121,13484,9770
153,18,0,2,1,0,0,3,107,70,13027,10305,106,124,13484,9773
154,18,1,2,1,0,0,3,180,116,13028,10307,163,76,13484,9776
155,18,1,3,1,0,0,3,95,87,13029,10310,89,109,13484,9779
156,18,4,0,0,3,1,0,227,211,13033,10310,237,59,13487,9779
157,18,3,2,0,3,1,0,130,99,13036,10312,128,103,13490,9779
158,18,2,2,2,1,2,1,143,51,13038,10314,136,66,13491,9780
159,18,1,0,0,3,1,0,94,73,13039,10314,95,99,13494,9780
160,18,0,0,2,1,2,1,90,94,13039,10314,84,140,13495,9781
161,18,0,3,1,0,0,3,165,146,13039,10317,164,77,13495,9784
162,19,1,2,1,0,0,3,173,131,13040,10319,214,122,13495,9787
163,19,2,1,0,3,1,0,126,67,13042,10320,116,66,13498,9787
164,19,2,1,0,3,1,0,122,74,13044,10321,124,121,13501,9787
165,19,3,0,0,3,1,0,93,90,13047,10321,77,141,13504,9787
166,19,2,0,0,3,1,0,85,73,13049,10321,93,96,13507,9787
167,19,3,1,0,3,1,0,88,68,13052,10322,98,53,13510,9787
168,19,3,1,0,3,1,0,195,116,13055,10323,219,70,13513,9787
169,19,1,3,1,0,0,3,103,68,13056,10326,110,195,13513,9790
170,19,5,0,0,3,1,0,181,35,13061,10326,158,76,13516,9790
171,20,0,1,1,0,0,3,107,71,13061,10327,106,106,13516,9793
172,20,3,0,0,3,1,0,98,87,13064,10327,92,76,13519,9793
173,20,1,5,1,0,0,3,91,99,13065,10332,84,125,13519,9796
174,20,0,2,1,0,0,3,227,213,13065,10334,237,127,13519,9799
175,20,1,1,2,1,2,1,131,100,13066,10335,129,60,13520,9800
176,20,3,0,0,3,1,0,97,73,13069,10335,98,140,13523,9800
177,20,0,3,1,0,0,3,165,149,13069,10338,164,102,13523,9803
178,20,1,4,1,0,0,3,181,120,13070,10342,163,69,13523,9806
179,20,2,0,0,3,1,0,128,67,13072,10342,119,109,13526,9806
180,21,2,0,0,3,1,0,87,73,13074,10342,96,109,13529,9806
181,21,4,0,0,3,1,0,147,51,13078,10342,139,76,13532,9806
182,21,4,0,0,3,1,0,185,35,13082,10342,161,96,13535,9806
183,21,1,1,2,1,2,1,92,100,13083,10343,85,71,13536,9807
184,21,4,1,0,3,1,0,97,91,13087,10344,80,121,13539,9807
185,21,4,2,0,3,1,0,177,133,13091,10346,217,141,13542,9807
186,21,1,2,1,0,0,3,123,76,13092,10348,124,80,13542,9810
187,21,0,1,1,0,0,3,88,69,13092,10349,98,198,13542,9813
188,21,1,2,1,0,0,3,104,70,13093,10351,110,69,13542,9816
189,22,0,0,2,1,2,1,128,67,13093,10351,120,77,13543,9817
190,22,2,2,2,1,2,1,109,73,13095,10353,107,61,13544,9818
191,22,1,2,1,0,0,3,182,122,13096,10355,163,105,13544,9821
192,22,2,1,0,3,1,0,229,214,13098,10356,240,140,13547,9821
193,22,2,4,1,0,0,3,133,104,13100,10360,129,72,13547,9824
194,22,3,0,0,3,1,0,168,149,13103,10360,167,125,13550,9824
195,22,3,1,0,3,1,0,101,88,13106,10361,95,106,13553,9824
196,22,0,0,2,1,2,1,97,73,13106,10361,99,54,13554,9825
197,22,0,4,1,0,0,3,195,120,13106,10365,219,130,13554,9828
198,23,0,0,2,1,2,1,104,70,13106,10365,111,97,13555,9829
199,23,3,0,0,3,1,0,150,51,13109,10365,142,198,13558,9829
200,23,0,1,1,0,0,3,123,77,13109,10366,124,80,13558,9832
201,23,1,0,0,3,1,0,93,100,13110,10366,88,141,13561,9832
202,23,1,1,2,1,2,1,89,70,13111,10367,99,110,13562,9833
203,23,1,1,2,1,2,1,178,134,13112,10368,218,72,13563,9834
204,23,5,1,0,3,1,0,190,36,13117,10369,164,80,13566,9834
205,23,6,2,0,3,1,0,103,93,13123,10371,83,69,13569,9834
206,23,2,1,0,3,1,0,99,74,13125,10372,102,121,13572,9834
207,24,4,0,0,3,1,0,132,67,13129,10372,123,61,13575,9834
208,24,1,2,1,0,0,3,110,75,13130,10374,107,75,13575,9837
209,24,2,2,2,1,2,1,184,124,13132,10376,164,141,13576,9838
210,24,1,1,2,1,2,1,196,121,13133,10377,220,107,13577,9839
211,24,1,6,1,0,0,3,102,94,13134,10383,95,133,13577,9842
212,24,1,1,2,1,2,1,169,150,13135,10384,168,77,13578,9843
213,24,0,2,1,0,0,3,229,216,13135,10386,240,57,13578,9846
214,24,0,1,1,0,0,3,133,105,13135,10387,129,128,13578,9849
215,24,1,1,2,1,2,1,88,74,13136,10388,97,106,13579,9850
216,25,1,2,1,0,0,3,90,72,13137,10390,99,83,13579,9853
217,25,1,2,1,0,0,3,151,53,13138,10392,142,75,13579,9856
218,25,1,1,2,1,2,1,94,101,13139,10393,89,122,13580,9857
219,25,2,4,1,0,0,3,105,97,13141,10397,83,83,13580,9860
220,25,1,1,2,1,2,1,179,135,13142,10398,219,70,13581,9861
221,25,0,3,1,0,0,3,104,73,13142,10401,111,113,13581,9864
222,25,2,1,0,3,1,0,192,37,13144,10402,167,107,13584,9864
223,25,2,1,0,3,1,0,171,151,13146,10403,171,198,13587,9864
224,25,1,4,1,0,0,3,100,78,13147,10407,102,100,13587,9867
225,26,3,1,0,3,1,0,136,106,13150,10408,132,57,13590,9867
226,26,3,1,0,3,1,0,135,68,13153,10409,126,141,13593,9867
227,26,1,0,0,3,1,0,185,124,13154,10409,167,141,13596,9867
228,26,0,3,1,0,0,3,196,124,13154,10412,220,131,13596,9870
229,26,1,1,2,1,2,1,103,95,13155,10413,96,76,13597,9871
230,26,0,2,1,0,0,3,88,76,13155,10415,97,136,13597,9874
231,26,3,0,0,3,1,0,113,75,13158,10415,110,106,13600,9874
232,26,2,5,1,0,0,3,231,221,13160,10420,240,80,13600,9877
233,26,2,3,1,0,0,3,125,80,13162,10423,124,64,13600,9880
234,27,0,0,2,1,2,1,151,53,13162,10423,143,84,13601,9881
235,27,1,3,1,0,0,3,95,104,13163,10426,89,73,13601,9884
236,27,3,1,0,3,1,0,182,136,13166,10427,222,83,13604,9884
237,27,1,3,1,0,0,3,105,76,13167,10430,111,139,13604,9887
238,27,2,0,0,3,1,0,233,221,13169,10430,243,122,13607,9887
239,27,3,1,0,3,1,0,108,98,13172,10431,86,113,13610,9887
240,27,1,3,1,0,0,3,91,75,13173,10434,99,110,13610,9890
241,27,1,1,2,1,2,1,172,152,13174,10435,172,101,13611,9891
242,27,1,0,0,3,1,0,101,78,13175,10435,105,75,13614,9891
243,28,2,0,0,3,1,0,137,68,13177,10435,129,106,13617,9891
244,28,3,3,2,1,2,1,195,40,13180,10438,168,65,13618,9892
245,28,1,1,2,1,2,1,126,81,13181,10439,125,142,13619,9893
246,28,2,3,1,0,0,3,187,127,13183,10442,167,134,13619,9896
247,28,2,1,0,3,1,0,105,96,13185,10443,99,80,13622,9896
248,28,3,0,0,3,1,0,91,76,13188,10443,100,76,13625,9896
249,28,3,2,0,3,1,0,139,108,13191,10445,135,198,13628,9896
250,28,3,1,0,3,1,0,116,76,13194,10446,113,141,13631,9896
251,28,1,2,1,0,0,3,197,126,13195,10448,220,60,13631,9899
252,29,2,1,0,3,1,0,174,153,13197,10449,175,110,13634,9899
253,29,2,0,0,3,1,0,189,127,13199,10449,170,101,13637,9899
254,29,1,1,2,1,2,1,96,105,13200,10450,90,85,13638,9900
255,29,0,2,1,0,0,3,233,223,13200,10452,243,78,13638,9903
256,29,1,0,0,3,1,0,92,75,13201,10452,102,139,13641,9903
257,29,2,0,0,3,1,0,103,78,13203,10452,108,83,13644,9903
258,29,2,1,0,3,1,0,153,54,13205,10453,146,73,13647,9903
259,29,3,0,0,3,1,0,185,136,13208,10453,225,113,13650,9903
260,29,1,1,2,1,2,1,106,77,13209,10454,112,66,13651,9904
261,30,2,0,0,3,1,0,139,68,13211,10454,132,80,13654,9904
262,30,1,1,2,1,2,1,117,77,13212,10455,114,123,13655,9905
263,30,2,1,0,3,1,0,199,127,13214,10456,223,141,13658,9905
264,30,4,1,0,3,1,0,109,97,13218,10457,102,198,13661,9905
265,30,2,0,0,3,1,0,141,108,13220,10457,138,142,13664,9905
266,30,3,0,0,3,1,0,94,76,13223,10457,103,60,13667,9905
267,30,0,3,1,0,0,3,195,43,13223,10460,168,137,13667,9908
268,30,2,1,0,3,1,0,128,82,13225,10461,128,106,13670,9908
269,30,2,0,0,3,1,0,110,98,13227,10461,89,76,13673,9908
270,31,2,3,1,0,0,3,105,81,13229,10464,108,116,13673,9911
271,31,4,2,0,3,1,0,157,56,13233,10466,149,83,13676,9911
272,31,3,1,0,3,1,0,99,106,13236,10467,93,66,13679,9911
273,31,4,2,0,3,1,0,145,110,13240,10469,141,78,13682,9911
274,31,0,0,2,1,2,1,92,75,13240,10469,103,107,13683,9912
275,31,0,2,1,0,0,3,185,138,13240,10471,225,142,13683,9915
276,31,1,3,1,0,0,3,175,156,13241,10474,175,76,13683,9918
277,31,1,4,1,0,0,3,234,227,13242,10478,243,113,13683,9921
278,31,3,1,0,3,1,0,192,128,13245,10479,173,85,13686,9921
279,32,0,0,2,1,2,1,199,127,13245,10479,224,124,13687,9922
280,32,5,2,0,3,1,0,200,45,13250,10481,171,60,13690,9922
281,32,2,2,2,1,2,1,111,99,13252,10483,103,102,13691,9923
282,32,0,0,2,1,2,1,110,98,13252,10483,90,81,13692,9924
283,32,2,0,0,3,1,0,96,76,13254,10483,106,198,13695,9924
284,32,2,0,0,3,1,0,108,77,13256,10483,115,142,13698,9924
285,32,2,2,2,1,2,1,130,84,13258,10485,129,138,13699,9925
286,32,3,1,0,3,1,0,95,76,13261,10486,106,141,13702,9925
287,32,0,1,1,0,0,3,139,69,13261,10487,132,81,13702,9928
288,33,3,2,0,3,1,0,160,58,13264,10489,152,66,13705,9928
289,33,3,1,0,3,1,0,120,78,13267,10490,117,83,13708,9928
290,33,1,2,1,0,0,3,193,130,13268,10492,173,79,13708,9931
291,33,2,0,0,3,1,0,101,106,13270,10492,96,107,13711,9931
292,33,0,2,1,0,0,3,234,229,13270,10494,243,119,13711,9934
293,33,0,2,1,0,0,3,145,112,13270,10496,141,88,13711,9937
294,33,1,4,1,0,0,3,176,160,13271,10500,175,145,13711,9940
295,33,0,1,1,0,0,3,185,139,13271,10501,225,79,13711,9943
296,33,0,2,1,0,0,3,105,83,13271,10503,108,116,13711,9946
297,34,1,0,0,3,1,0,201,45,13272,10503,174,124,13714,9946
298,34,4,1,0,3,1,0,143,70,13276,10504,135,198,13717,9946
299,34,2,1,0,3,1,0,132,85,13278,10505,132,60,13720,9946
300,34,3,2,0,3,1,0,202,129,13281,10507,227,102,13723,9946
301,34,3,1,0,3,1,0,114,100,13284,10508,106,81,13726,9946
302,34,3,1,0,3,1,0,113,99,13287,10509,93,142,13729,9946
303,34,3,2,0,3,1,0,99,78,13290,10511,109,141,13732,9946
304,34,2,1,0,3,1,0,97,77,13292,10512,109,81,13735,9946
305,34,0,4,1,0,0,3,108,81,13292,10516,115,141,13735,9949
0,1,2,1,0,3,1,0,203,46,13294,10517,177,79,13738,9949
1,1,2,0,0,3,1,0,115,99,13296,10517,96,79,13741,9949
2,1,2,1,0,3,1,0,204,130,13298,10518,230,88,13744,9949
3,1,2,2,2,1,2,1,110,83,13300,10520,116,61,13745,9950
4,1,1,0,0,3,1,0,106,83,13301,10520,111,102,13748,9950
5,1,0,0,2,1,2,1,154,99,13301,10520,151,142,13749,9951
6,1,0,2,1,0,0,3,160,60,13301,10522,152,119,13749,9954
7,1,2,2,2,1,2,1,194,142,13303,10524,190,84,13750,9955
8,1,1,1,2,1,2,1,121,79,13304,10525,118,125,13751,9956
9,2,2,3,1,0,0,3,99,80,13306,10528,109,144,13751,9959
10,2,4,2,0,3,1,0,136,87,13310,10530,135,107,13754,9959
11,2,2,2,2,1,2,1,116,102,13312,10532,107,82,13755,9960
12,2,1,1,2,1,2,1,102,107,13313,10533,97,67,13756,9961
13,2,0,2,1,0,0,3,193,132,13313,10535,173,112,13756,9964
14,2,0,3,1,0,0,3,176,163,13313,10538,175,141,13756,9967
15,2,1,1,2,1,2,1,144,71,13314,10539,136,146,13757,9968
16,2,0,0,2,1,2,1,99,78,13314,10539,110,120,13758,9969
17,2,0,0,2,1,2,1,145,112,13314,10539,142,82,13759,9970
18,3,3,3,2,1,2,1,139,90,13317,10542,136,62,13760,9971
19,3,0,0,2,1,2,1,194,142,13317,10542,191,113,13761,9972
20,3,1,3,1,0,0,3,111,86,13318,10545,116,87,13761,9975
21,3,1,1,2,1,2,1,116,100,13319,10546,97,80,13762,9976
22,3,2,0,0,3,1,0,205,46,13321,10546,180,125,13765,9976
23,3,3,1,0,3,1,0,163,61,13324,10547,155,102,13768,9976
24,3,4,1,0,3,1,0,125,80,13328,10548,121,88,13771,9976
25,3,0,1,1,0,0,3,106,84,13328,10549,111,82,13771,9979
26,3,2,0,0,3,1,0,206,130,13330,10549,233,142,13774,9979
27,4,2,2,2,1,2,1,147,114,13332,10551,143,108,13775,9980
28,4,0,2,1,0,0,3,193,134,13332,10553,173,70,13775,9983
29,4,4,2,0,3,1,0,103,82,13336,10555,112,62,13778,9983
30,4,2,0,0,3,1,0,196,142,13338,10555,194,120,13781,9983
31,4,0,0,2,1,2,1,176,163,13338,10555,176,147,13782,9984
32,4,2,2,2,1,2,1,146,73,13340,10557,137,83,13783,9985
33,4,2,0,0,3,1,0,101,78,13342,10557,113,144,13786,9985
34,4,4,1,0,3,1,0,120,103,13346,10558,110,119,13789,9985
35,4,0,0,2,1,2,1,154,99,13346,10558,152,83,13790,9986
36,5,0,3,1,0,0,3,102,110,13346,10561,97,91,13790,9989
37,5,2,2,2,1,2,1,108,86,13348,10563,112,88,13791,9990
38,5,3,3,2,1,2,1,119,103,13351,10566,98,103,13792,9991
39,5,4,0,0,3,1,0,209,46,13355,10566,183,141,13795,9991
40,5,1,0,0,3,1,0,207,130,13356,10566,236,113,13798,9991
41,5,1,0,0,3,1,0,126,80,13357,10566,124,142,13801,9991
42,5,2,2,2,1,2,1,165,63,13359,10568,156,126,13802,9992
43,5,1,0,0,3,1,0,112,86,13360,10568,119,80,13805,9992
44,5,1,0,0,3,1,0,140,90,13361,10568,139,82,13808,9992
45,6,0,0,2,1,2,1,101,78,13361,10568,114,71,13809,9993
46,6,0,0,2,1,2,1,147,114,13361,10568,144,120,13810,9994
47,6,2,1,0,3,1,0,148,74,13363,10569,140,144,13813,9994
48,6,0,2,1,0,0,3,154,101,13363,10571,152,150,13813,9997
49,6,1,0,0,3,1,0,194,134,13364,10571,176,120,13816,9997
50,6,1,2,1,0,0,3,197,144,13365,10573,194,86,13816,10000
51,6,2,1,0,3,1,0,122,104,13367,10574,113,62,13819,10000
52,6,1,0,0,3,1,0,104,82,13368,10574,115,108,13822,10000
53,6,1,2,1,0,0,3,177,165,13369,10576,176,86,13822,10003
54,7,3,2,0,3,1,0,115,88,13372,10578,122,126,13825,10003
55,7,2,2,2,1,2,1,142,92,13374,10580,140,142,13826,10004
56,7,4,0,0,3,1,0,213,46,13378,10580,186,120,13829,10004
57,7,1,1,2,1,2,1,103,111,13379,10581,98,104,13830,10005
58,7,2,1,0,3,1,0,121,104,13381,10582,101,91,13833,10005
59,7,0,1,1,0,0,3,165,64,13381,10583,156,145,13833,10008
60,7,3,2,0,3,1,0,111,88,13384,10585,115,113,13836,10008
61,7,1,0,0,3,1,0,123,104,13385,10585,116,82,13839,10008
62,7,1,1,2,1,2,1,127,81,13386,10586,125,89,13840,10009
63,8,0,3,1,0,0,3,207,133,13386,10589,236,89,13840,10012
64,8,6,0,0,3,1,0,219,46,13392,10589,189,62,13843,10012
65,8,1,2,1,0,0,3,148,116,13393,10591,144,83,13843,10015
66,8,2,1,0,3,1,0,103,79,13395,10592,117,82,13846,10015
67,8,2,1,0,3,1,0,156,102,13397,10593,155,144,13849,10015
68,8,3,3,2,1,2,1,197,137,13400,10596,177,121,13850,10016
69,8,2,0,0,3,1,0,150,74,13402,10596,143,108,13853,10016
70,8,1,1,2,1,2,1,178,166,13403,10597,177,72,13854,10017
71,8,3,1,0,3,1,0,200,145,13406,10598,197,86,13857,10017
72,9,0,1,1,0,0,3,103,112,13406,10599,98,116,13857,10020
73,9,1,0,0,3,1,0,122,104,13407,10599,104,142,13860,10020
74,9,4,5,1,0,0,3,115,93,13411,10604,115,129,13860,10023
75,9,3,0,0,3,1,0,118,88,13414,10604,125,145,13863,10023
76,9,2,0,0,3,1,0,106,82,13416,10604,118,104,13866,10023
77,9,0,1,1,0,0,3,165,65,13416,10605,156,123,13866,10026
78,9,1,0,0,3,1,0,143,92,13417,10605,143,91,13869,10026
79,9,3,0,0,3,1,0,126,104,13420,10605,119,89,13872,10026
80,9,0,0,2,1,2,1,127,81,13420,10605,126,151,13873,10027
81,10,1,0,0,3,1,0,151,74,13421,10605,146,82,13876,10027
82,10,0,4,1,0,0,3,197,141,13421,10609,177,86,13876,10030
83,10,1,2,1,0,0,3,104,81,13422,10611,117,65,13876,10033
84,10,1,0,0,3,1,0,179,166,13423,10611,180,121,13879,10033
85,10,1,0,0,3,1,0,208,133,13424,10611,239,86,13882,10033
86,10,2,1,0,3,1,0,221,47,13426,10612,192,144,13885,10033
87,10,3,1,0,3,1,0,130,82,13429,10613,129,72,13888,10033
88,10,0,1,1,0,0,3,156,103,13429,10614,155,107,13888,10036
89,10,3,1,0,3,1,0,203,146,13432,10615,200,108,13891,10036
90,11,0,2,1,0,0,3,118,90,13432,10617,125,126,13891,10039
91,11,2,0,0,3,1,0,150,116,13434,10617,147,91,13894,10039
92,11,3,4,1,0,0,3,125,108,13437,10621,104,119,13894,10042
93,11,0,4,1,0,0,3,115,97,13437,10625,115,154,13894,10045
94,11,3,0,0,3,1,0,109,82,13440,10625,121,142,13897,10045
95,11,0,0,2,1,2,1,143,92,13440,10625,144,90,13898,10046
96,11,2,0,0,3,1,0,105,112,13442,10625,101,129,13901,10046
97,11,2,0,0,3,1,0,128,104,13444,10625,122,145,13904,10046
98,11,1,0,0,3,1,0,166,65,13445,10625,159,89,13907,10046
99,12,2,2,2,1,2,1,205,148,13447,10627,201,145,13908,10047
100,12,1,3,1,0,0,3,209,136,13448,10630,239,124,13908,10050
101,12,1,3,1,0,0,3,131,85,13449,10633,129,89,13908,10053
102,12,4,0,0,3,1,0,225,47,13453,10633,195,72,13911,10053
103,12,2,2,2,1,2,1,106,83,13455,10635,118,108,13912,10054
104,12,3,2,0,3,1,0,154,76,13458,10637,149,86,13915,10054
105,12,1,2,1,0,0,3,157,105,13459,10639,155,111,13915,10057
106,12,2,0,0,3,1,0,181,166,13461,10639,183,65,13918,10057
107,12,0,1,1,0,0,3,197,142,13461,10640,177,85,13918,10060
108,13,1,4,1,0,0,3,151,120,13462,10644,147,132,13918,10063
109,13,4,1,0,3,1,0,158,77,13466,10645,152,90,13921,10063
110,13,0,1,1,0,0,3,118,91,13466,10646,125,157,13921,10066
111,13,3,1,0,3,1,0,112,83,13469,10647,124,145,13924,10066
112,13,5,1,0,3,1,0,148,93,13474,10648,147,119,13927,10066
113,13,4,0,0,3,1,0,109,112,13478,10648,104,142,13930,10066
114,13,4,3,0,3,1,0,129,111,13482,10651,107,126,13933,10066
115,13,1,0,0,3,1,0,129,104,13483,10651,125,89,13936,10066
116,13,2,0,0,3,1,0,117,97,13485,10651,118,145,13939,10066
117,14,1,0,0,3,1,0,167,65,13486,10651,162,72,13942,10066
118,14,1,1,2,1,2,1,206,149,13487,10652,202,109,13943,10067
119,14,3,2,0,3,1,0,134,87,13490,10654,132,111,13946,10067
120,14,1,2,1,0,0,3,158,107,13491,10656,155,88,13946,10070
121,14,0,4,1,0,0,3,197,146,13491,10660,177,94,13946,10073
122,14,1,3,1,0,0,3,210,139,13492,10663,239,89,13946,10076
123,14,1,0,0,3,1,0,226,47,13493,10663,198,124,13949,10076
124,14,2,1,0,3,1,0,183,167,13495,10664,186,90,13952,10076
125,14,5,2,0,3,1,0,122,99,13500,10666,121,65,13955,10076
126,15,3,2,0,3,1,0,132,113,13503,10668,110,89,13958,10076
127,15,3,3,2,1,2,1,112,115,13506,10671,105,127,13959,10077
128,15,0,0,2,1,2,1,151,120,13506,10671,148,146,13960,10078
129,15,1,0,0,3,1,0,119,91,13507,10671,128,145,13963,10078
130,15,0,4,1,0,0,3,112,87,13507,10675,124,160,13963,10081
131,15,1,2,1,0,0,3,159,79,13508,10677,152,122,13963,10084
132,15,1,1,2,1,2,1,107,84,13509,10678,119,133,13964,10085
133,15,1,1,2,1,2,1,149,94,13510,10679,148,90,13965,10086
134,15,1,1,2,1,2,1,130,105,13511,10680,126,143,13966,10087
135,16,0,0,2,1,2,1,158,107,13511,10680,156,91,13967,10088
136,16,2,0,0,3,1,0,228,47,13513,10680,201,109,13970,10088
137,16,0,1,1,0,0,3,183,168,13513,10681,186,136,13970,10091
138,16,2,0,0,3,1,0,212,139,13515,10681,242,88,13973,10091
139,16,2,2,2,1,2,1,169,67,13517,10683,163,90,13974,10092
140,16,4,4,2,1,2,1,126,103,13521,10687,122,112,13975,10093
141,16,0,1,1,0,0,3,132,114,13521,10688,110,127,13975,10096
142,16,1,2,1,0,0,3,207,151,13522,10690,202,97,13975,10099
143,16,4,1,0,3,1,0,138,88,13526,10691,135,65,13978,10099
144,17,1,2,1,0,0,3,108,86,13527,10693,119,163,13978,10102
145,17,2,1,0,3,1,0,114,116,13529,10694,108,145,13981,10102
146,17,2,1,0,3,1,0,114,88,13531,10695,127,90,13984,10102
147,17,0,0,2,1,2,1,159,79,13531,10695,153,147,13985,10103
148,17,1,1,2,1,2,1,150,95,13532,10696,149,90,13986,10104
149,17,0,0,2,1,2,1,197,146,13532,10696,178,144,13987,10105
150,17,2,1,0,3,1,0,132,106,13534,10697,129,122,13990,10105
151,17,0,5,1,0,0,3,119,96,13534,10702,128,75,13990,10108
152,17,2,2,2,1,2,1,153,122,13536,10704,149,128,13991,10109
153,18,4,1,0,3,1,0,136,107,13540,10705,132,163,13994,10109
154,18,0,2,1,0,0,3,183,170,13540,10707,186,125,13994,10112
155,18,5,0,0,3,1,0,113,86,13545,10707,122,144,13997,10112
156,18,4,1,0,3,1,0,157,123,13549,10708,152,90,14000,10112
157,18,0,1,1,0,0,3,197,147,13549,10709,178,93,14000,10115
158,18,1,0,0,3,1,0,160,79,13550,10709,156,128,14003,10115
159,18,0,0,2,1,2,1,150,95,13550,10709,150,146,14004,10116
160,18,2,0,0,3,1,0,116,116,13552,10709,111,112,14007,10116
161,18,3,1,0,3,1,0,117,89,13555,10710,130,75,14010,10116
162,19,1,1,2,1,2,1,127,104,13556,10711,123,91,14011,10117
163,19,1,1,2,1,2,1,213,140,13557,10712,243,92,14012,10118
164,19,1,0,0,3,1,0,139,88,13558,10712,138,109,14015,10118
165,19,1,1,2,1,2,1,229,48,13559,10713,202,98,14016,10119
166,19,0,1,1,0,0,3,119,97,13559,10714,128,130,14016,10122
167,19,1,2,1,0,0,3,133,116,13560,10716,110,68,14016,10125
168,19,0,1,1,0,0,3,169,68,13560,10717,163,91,14016,10128
169,19,0,3,1,0,0,3,207,154,13560,10720,202,150,14016,10131
170,19,0,0,2,1,2,1,158,107,13560,10720,157,137,14017,10132
171,20,1,0,0,3,1,0,161,79,13561,10720,159,93,14020,10132
172,20,0,3,1,0,0,3,157,126,13561,10723,152,149,14020,10135
173,20,3,0,0,3,1,0,139,107,13564,10723,135,75,14023,10135
174,20,0,0,2,1,2,1,158,107,13564,10723,158,145,14024,10136
175,20,0,2,1,0,0,3,197,149,13564,10725,178,166,14024,10139
176,20,0,2,1,0,0,3,113,88,13564,10727,122,115,14024,10142
177,20,2,1,0,3,1,0,185,171,13566,10728,189,128,14027,10142
178,20,2,1,0,3,1,0,118,117,13568,10729,114,130,14030,10142
179,20,2,2,2,1,2,1,119,91,13570,10731,131,91,14031,10143
180,21,4,2,0,3,1,0,173,70,13574,10733,166,92,14034,10143
181,21,4,5,1,0,0,3,154,100,13578,10738,150,94,14034,10146
182,21,8,0,0,3,1,0,237,48,13586,10738,205,150,14037,10146
183,21,3,2,0,3,1,0,121,119,13589,10740,117,91,14040,10146
184,21,1,0,0,3,1,0,140,88,13590,10740,141,125,14043,10146
185,21,2,1,0,3,1,0,135,117,13592,10741,113,137,14046,10146
186,21,1,0,0,3,1,0,128,104,13593,10741,126,98,14049,10146
187,21,0,2,1,0,0,3,119,99,13593,10743,128,112,14049,10149
188,21,1,2,1,0,0,3,214,142,13594,10745,243,148,14049,10152
189,22,2,3,1,0,0,3,199,152,13596,10748,178,152,14049,10155
190,22,0,6,1,0,0,3,207,160,13596,10754,202,169,14049,10158
191,22,1,1,2,1,2,1,158,127,13597,10755,153,76,14050,10159
192,22,3,1,0,3,1,0,116,89,13600,10756,125,91,14053,10159
193,22,1,1,2,1,2,1,162,80,13601,10757,160,69,14054,10160
194,22,2,2,2,1,2,1,121,93,13603,10759,132,131,14055,10161
195,22,1,1,2,1,2,1,159,108,13604,10760,159,129,14056,10162
196,22,1,1,2,1,2,1,186,172,13605,10761,190,94,14057,10163
197,22,2,1,0,3,1,0,141,108,13607,10762,138,115,14060,10163
198,23,4,1,0,3,1,0,241,49,13611,10763,208,125,14063,10163
199,23,3,0,0,3,1,0,176,70,13614,10763,169,98,14066,10163
200,23,1,0,0,3,1,0,120,99,13615,10763,131,91,14069,10163
201,23,2,0,0,3,1,0,137,117,13617,10763,116,92,14072,10163
202,23,1,0,0,3,1,0,155,100,13618,10763,153,112,14075,10163
203,23,1,1,2,1,2,1,215,143,13619,10764,244,138,14076,10164
204,23,2,1,0,3,1,0,130,105,13621,10765,129,150,14079,10164
205,23,2,0,0,3,1,0,142,88,13623,10765,144,148,14082,10164
206,23,3,5,1,0,0,3,124,124,13626,10770,117,97,14082,10167
207,24,0,0,2,1,2,1,199,152,13626,10770,179,116,14083,10168
208,24,1,3,1,0,0,3,216,146,13627,10773,244,172,14083,10171
209,24,0,0,2,1,2,1,186,172,13627,10773,191,153,14084,10172
210,24,0,1,1,0,0,3,158,128,13627,10774,153,72,14084,10175
211,24,1,0,0,3,1,0,122,93,13628,10774,135,97,14087,10175
212,24,3,1,0,3,1,0,165,81,13631,10775,163,76,14090,10175
213,24,2,2,2,1,2,1,118,91,13633,10777,126,95,14091,10176
214,24,4,2,0,3,1,0,163,110,13637,10779,162,91,14094,10176
215,24,0,3,1,0,0,3,207,163,13637,10782,202,134,14094,10179
216,25,4,0,0,3,1,0,159,100,13641,10782,156,138,14097,10179
217,25,3,0,0,3,1,0,140,117,13644,10782,119,150,14100,10179
218,25,0,4,1,0,0,3,124,128,13644,10786,117,175,14100,10182
219,25,0,2,1,0,0,3,122,95,13644,10788,135,95,14100,10185
220,25,4,0,0,3,1,0,134,105,13648,10788,132,148,14103,10185
221,25,2,2,2,1,2,1,122,101,13650,10790,132,99,14104,10186
222,25,0,0,2,1,2,1,176,70,13650,10790,170,126,14105,10187
223,25,3,0,0,3,1,0,144,108,13653,10790,141,112,14108,10187
224,25,2,0,0,3,1,0,144,88,13655,10790,147,129,14111,10187
225,26,0,1,1,0,0,3,186,173,13655,10791,191,119,14111,10190
226,26,0,0,2,1,2,1,207,163,13655,10791,203,77,14112,10191
227,26,3,1,0,3,1,0,202,153,13658,10792,182,91,14115,10191
228,26,2,0,0,3,1,0,160,128,13660,10792,156,91,14118,10191
229,26,2,3,1,0,0,3,218,149,13662,10795,244,156,14118,10194
230,26,1,1,2,1,2,1,164,111,13663,10796,163,73,14119,10195
231,26,0,1,1,0,0,3,165,82,13663,10797,163,137,14119,10198
232,26,1,1,2,1,2,1,119,92,13664,10798,127,98,14120,10199
233,26,0,2,1,0,0,3,241,51,13664,10800,208,98,14120,10202
234,27,2,2,2,1,2,1,136,107,13666,10802,133,130,14121,10203
235,27,1,4,1,0,0,3,141,121,13667,10806,119,101,14121,10206
236,27,4,0,0,3,1,0,163,100,13671,10806,159,150,14124,10206
237,27,1,0,0,3,1,0,161,128,13672,10806,159,126,14127,10206
238,27,0,0,2,1,2,1,124,128,13672,10806,118,96,14128,10207
239,27,3,1,0,3,1,0,147,109,13675,10807,144,138,14131,10207
240,27,0,1,1,0,0,3,176,71,13675,10808,170,178,14131,10210
241,27,0,0,2,1,2,1,122,95,13675,10808,136,100,14132,10211
242,27,2,0,0,3,1,0,124,101,13677,10808,135,148,14135,10211
243,28,1,1,2,1,2,1,219,150,13678,10809,245,120,14136,10212
244,28,2,3,1,0,0,3,121,95,13680,10812,127,140,14136,10215
245,28,0,0,2,1,2,1,165,82,13680,10812,164,113,14137,10216
246,28,2,1,0,3,1,0,209,164,13682,10813,206,91,14140,10216
247,28,3,1,0,3,1,0,147,89,13685,10814,150,156,14143,10216
248,28,3,0,0,3,1,0,244,51,13688,10814,211,91,14146,10216
249,28,0,2,1,0,0,3,186,175,13688,10816,191,101,14146,10219
250,28,3,2,0,3,1,0,167,113,13691,10818,166,77,14149,10219
251,28,3,2,0,3,1,0,205,155,13694,10820,185,73,14152,10219
252,29,0,0,2,1,2,1,136,107,13694,10820,134,102,14153,10220
253,29,0,0,2,1,2,1,124,101,13694,10820,136,127,14154,10221
254,29,3,0,0,3,1,0,179,71,13697,10820,173,148,14157,10221
255,29,2,3,1,0,0,3,163,131,13699,10823,159,99,14157,10224
256,29,0,2,1,0,0,3,141,123,13699,10825,119,181,14157,10227
257,29,4,0,0,3,1,0,167,100,13703,10825,162,130,14160,10227
258,29,2,1,0,3,1,0,124,96,13705,10826,139,138,14163,10227
259,29,1,0,0,3,1,0,125,128,13706,10826,121,150,14166,10227
260,29,1,1,2,1,2,1,148,110,13707,10827,145,101,14167,10228
261,30,2,0,0,3,1,0,123,95,13709,10827,130,101,14170,10228
262,30,1,1,2,1,2,1,168,114,13710,10828,167,141,14171,10229
263,30,2,0,0,3,1,0,181,71,13712,10828,176,91,14174,10229
264,30,1,2,1,0,0,3,220,152,13713,10830,245,80,14174,10232
265,30,3,2,0,3,1,0,189,177,13716,10832,194,91,14177,10232
266,30,2,2,2,1,2,1,207,157,13718,10834,186,114,14178,10233
267,30,1,0,0,3,1,0,245,51,13719,10834,214,120,14181,10233
268,30,2,2,2,1,2,1,211,166,13721,10836,207,74,14182,10234
269,30,1,0,0,3,1,0,148,89,13722,10836,153,101,14185,10234
270,31,1,2,1,0,0,3,164,133,13723,10838,159,151,14185,10237
271,31,0,0,2,1,2,1,124,96,13723,10838,140,128,14186,10238
272,31,2,2,2,1,2,1,150,112,13725,10840,146,131,14187,10239
273,31,3,2,0,3,1,0,168,84,13728,10842,167,138,14190,10239
274,31,1,0,0,3,1,0,126,128,13729,10842,124,91,14193,10239
275,31,1,1,2,1,2,1,142,124,13730,10843,120,157,14194,10240
276,31,2,0,0,3,1,0,169,100,13732,10843,165,181,14197,10240
277,31,1,2,1,0,0,3,124,97,13733,10845,130,153,14197,10243
278,31,1,2,1,0,0,3,125,103,13734,10847,136,105,14197,10246
279,32,1,1,2,1,2,1,190,178,13735,10848,195,115,14198,10247
280,32,1,1,2,1,2,1,221,153,13736,10849,246,75,14199,10248
281,32,2,0,0,3,1,0,183,71,13738,10849,179,120,14202,10248
282,32,3,1,0,3,1,0,139,108,13741,10850,137,80,14205,10248
283,32,3,0,0,3,1,0,151,89,13744,10850,156,141,14208,10248
284,32,0,1,1,0,0,3,245,52,13744,10851,214,94,14208,10251
285,32,2,0,0,3,1,0,209,157,13746,10851,189,99,14211,10251
286,32,1,3,1,0,0,3,212,169,13747,10854,207,104,14211,10254
287,32,2,0,0,3,1,0,170,114,13749,10854,170,101,14214,10254
288,33,1,0,0,3,1,0,169,84,13750,10854,170,151,14217,10254
289,33,2,1,0,3,1,0,166,134,13752,10855,162,181,14220,10254
290,33,0,0,2,1,2,1,125,103,13752,10855,137,92,14221,10255
291,33,2,0,0,3,1,0,126,97,13754,10855,133,128,14224,10255
292,33,2,0,0,3,1,0,171,100,13756,10855,168,80,14227,10255
293,33,2,1,0,3,1,0,211,158,13758,10856,192,153,14230,10255
294,33,0,2,1,0,0,3,126,130,13758,10858,124,108,14230,10258
295,33,1,2,1,0,0,3,125,98,13759,10860,140,134,14230,10261
296,33,2,1,0,3,1,0,152,113,13761,10861,149,157,14233,10261
297,34,2,0,0,3,1,0,192,178,13763,10861,198,101,14236,10261
298,34,2,1,0,3,1,0,223,154,13765,10862,249,115,14239,10261
299,34,1,3,1,0,0,3,152,92,13766,10865,156,97,14239,10264
300,34,2,0,0,3,1,0,247,52,13768,10865,217,99,14242,10264
301,34,2,2,2,1,2,1,172,116,13770,10867,171,105,14243,10265
302,34,2,1,0,3,1,0,141,109,13772,10868,140,141,14246,10265
303,34,2,1,0,3,1,0,144,125,13774,10869,123,120,14249,10265
304,34,3,2,0,3,1,0,186,73,13777,10871,182,75,14252,10265
305,34,1,2,1,0,0,3,213,171,13778,10873,207,141,14252,10268
0,1,5,0,0,3,1,0,252,52,13783,10873,220,153,14255,10268
1,1,0,1,1,0,0,3,126,98,13783,10874,133,154,14255,10271
2,1,2,2,2,1,2,1,132,90,13785,10876,140,135,14256,10272
3,1,0,3,1,0,0,3,126,133,13785,10879,124,104,14256,10275
4,1,0,1,1,0,0,3,125,99,13785,10880,140,123,14256,10278
5,1,2,1,0,3,1,0,173,101,13787,10881,171,80,14259,10278
6,1,4,0,0,3,1,0,190,73,13791,10881,185,108,14262,10278
7,1,2,1,0,3,1,0,154,114,13793,10882,152,92,14265,10278
8,1,1,3,1,0,0,3,212,161,13794,10885,192,131,14265,10281
9,2,1,1,2,1,2,1,126,104,13795,10886,138,76,14266,10282
10,2,1,1,2,1,2,1,170,85,13796,10887,171,97,14267,10283
11,2,1,1,2,1,2,1,142,110,13797,10888,141,98,14268,10284
12,2,1,1,2,1,2,1,173,117,13798,10889,172,106,14269,10285
13,2,0,1,1,0,0,3,223,155,13798,10890,249,144,14269,10288
14,2,1,2,1,0,0,3,145,127,13799,10892,123,184,14269,10291
15,2,3,2,0,3,1,0,195,180,13802,10894,201,141,14272,10291
16,2,0,4,1,0,0,3,159,155,13802,10898,153,160,14272,10294
17,2,1,2,1,0,0,3,153,94,13803,10900,156,102,14272,10297
18,3,3,0,0,3,1,0,157,114,13806,10900,155,104,14275,10297
19,3,1,4,1,0,0,3,213,165,13807,10904,192,95,14275,10300
20,3,0,1,1,0,0,3,125,100,13807,10905,140,157,14275,10303
21,3,2,1,0,3,1,0,175,118,13809,10906,175,153,14278,10303
22,3,3,0,0,3,1,0,129,98,13812,10906,136,135,14281,10303
23,3,0,0,2,1,2,1,132,90,13812,10906,141,81,14282,10304
24,3,3,0,0,3,1,0,255,52,13815,10906,223,144,14285,10304
25,3,3,1,0,3,1,0,193,74,13818,10907,188,123,14288,10304
26,3,2,1,0,3,1,0,128,134,13820,10908,127,108,14291,10304
27,4,0,3,1,0,0,3,153,97,13820,10911,156,156,14291,10307
28,4,2,1,0,3,1,0,257,53,13822,10912,226,98,14294,10307
29,4,0,1,1,0,0,3,173,102,13822,10913,171,100,14294,10310
30,4,2,4,1,0,0,3,225,159,13824,10917,249,163,14294,10313
31,4,2,1,0,3,1,0,128,105,13826,10918,141,141,14297,10313
32,4,0,0,2,1,2,1,159,155,13826,10918,154,107,14298,10314
33,4,6,2,0,3,1,0,148,112,13832,10920,144,131,14301,10314
34,4,1,3,1,0,0,3,146,130,13833,10923,123,79,14301,10317
35,4,2,1,0,3,1,0,172,86,13835,10924,174,102,14304,10317
36,5,3,1,0,3,1,0,132,99,13838,10925,139,81,14307,10317
37,5,2,0,0,3,1,0,159,114,13840,10925,158,123,14310,10317
38,5,0,0,2,1,2,1,195,180,13840,10925,202,96,14311,10318
39,5,0,1,1,0,0,3,128,135,13840,10926,127,160,14311,10321
40,5,1,0,0,3,1,0,176,118,13841,10926,178,108,14314,10321
41,5,0,3,1,0,0,3,132,93,13841,10929,141,187,14314,10324
42,5,0,1,1,0,0,3,213,166,13841,10930,192,107,14314,10327
43,5,3,0,0,3,1,0,196,74,13844,10930,191,144,14317,10327
44,5,2,0,0,3,1,0,127,100,13846,10930,143,135,14320,10327
45,6,5,1,0,3,1,0,262,54,13851,10931,229,107,14323,10327
46,6,2,0,0,3,1,0,130,105,13853,10931,144,131,14326,10327
47,6,0,1,1,0,0,3,159,156,13853,10932,154,159,14326,10330
48,6,2,1,0,3,1,0,134,94,13855,10933,144,79,14329,10330
49,6,2,0,0,3,1,0,174,86,13857,10933,177,96,14332,10330
50,6,1,0,0,3,1,0,174,102,13858,10933,174,102,14335,10330
51,6,4,2,0,3,1,0,157,99,13862,10935,159,98,14338,10330
52,6,1,3,1,0,0,3,226,162,13863,10938,249,144,14338,10333
53,6,1,1,2,1,2,1,147,131,13864,10939,124,164,14339,10334
54,7,1,1,2,1,2,1,177,119,13865,10940,179,161,14340,10335
55,7,1,1,2,1,2,1,160,115,13866,10941,159,136,14341,10336
56,7,1,3,1,0,0,3,214,169,13867,10944,192,111,14341,10339
57,7,1,3,1,0,0,3,128,103,13868,10947,143,84,14341,10342
58,7,0,3,1,0,0,3,128,138,13868,10950,127,147,14341,10345
59,7,0,3,1,0,0,3,132,102,13868,10953,139,190,14341,10348
60,7,0,1,1,0,0,3,195,181,13868,10954,202,110,14341,10351
61,7,1,1,2,1,2,1,149,113,13869,10955,145,124,14342,10352
62,7,2,2,2,1,2,1,198,76,13871,10957,192,101,14343,10353
63,8,2,3,1,0,0,3,136,97,13873,10960,144,105,14343,10356
64,8,2,0,0,3,1,0,159,99,13875,10960,162,107,14346,10356
65,8,1,0,0,3,1,0,227,162,13876,10960,252,79,14349,10356
66,8,3,0,0,3,1,0,133,105,13879,10960,147,159,14352,10356
67,8,2,2,2,1,2,1,149,133,13881,10962,125,145,14353,10357
68,8,2,0,0,3,1,0,161,156,13883,10962,157,96,14356,10357
69,8,0,3,1,0,0,3,174,89,13883,10965,177,134,14356,10360
70,8,5,1,0,3,1,0,267,55,13888,10966,232,164,14359,10360
71,8,1,1,2,1,2,1,175,103,13889,10967,175,99,14360,10361
72,9,0,2,1,0,0,3,132,104,13889,10969,139,167,14360,10364
73,9,2,1,0,3,1,0,176,90,13891,10970,180,124,14363,10364
74,9,4,2,0,3,1,0,164,117,13895,10972,162,84,14366,10364
75,9,0,0,2,1,2,1,195,181,13895,10972,203,148,14367,10365
76,9,0,2,1,0,0,3,128,105,13895,10974,143,104,14367,10368
77,9,0,1,1,0,0,3,128,139,13895,10975,127,193,14367,10371
78,9,1,5,1,0,0,3,150,118,13896,10980,145,114,14367,10374
79,9,0,1,1,0,0,3,177,120,13896,10981,179,139,14367,10377
80,9,1,0,0,3,1,0,215,169,13897,10981,195,161,14370,10377
81,10,0,1,1,0,0,3,149,134,13897,10982,125,162,14370,10380
82,10,4,0,0,3,1,0,271,55,13901,10982,235,134,14373,10380
83,10,4,3,0,3,1,0,179,106,13905,10985,178,145,14376,10380
84,10,1,2,1,0,0,3,228,164,13906,10987,252,99,14376,10383
85,10,1,3,1,0,0,3,133,107,13907,10990,139,82,14376,10386
86,10,0,1,1,0,0,3,136,98,13907,10991,144,110,14376,10389
87,10,0,1,1,0,0,3,161,157,13907,10992,157,127,14376,10392
88,10,5,1,0,3,1,0,203,77,13912,10993,195,99,14379,10392
89,10,3,1,0,3,1,0,162,100,13915,10994,165,110,14382,10392
90,11,0,0,2,1,2,1,150,118,13915,10994,146,194,14383,10393
91,11,1,1,2,1,2,1,177,91,13916,10995,181,162,14384,10394
92,11,3,3,2,1,2,1,131,108,13919,10998,144,106,14385,10395
93,11,1,3,1,0,0,3,129,142,13920,11001,127,170,14385,10398
94,11,0,0,2,1,2,1,177,120,13920,11001,180,85,14386,10399
95,11,1,4,1,0,0,3,134,109,13921,11005,147,117,14386,10402
96,11,2,1,0,3,1,0,166,118,13923,11006,165,148,14389,10402
97,11,2,0,0,3,1,0,217,169,13925,11006,198,104,14392,10402
98,11,1,2,1,0,0,3,196,183,13926,11008,203,142,14392,10405
99,12,1,3,1,0,0,3,229,167,13927,11011,252,130,14392,10408
100,12,4,0,0,3,1,0,275,55,13931,11011,238,145,14395,10408
101,12,1,2,1,0,0,3,180,108,13932,11013,178,137,14395,10411
102,12,0,0,2,1,2,1,162,100,13932,11013,166,163,14396,10412
103,12,0,0,2,1,2,1,149,134,13932,11013,126,100,14397,10413
104,12,2,0,0,3,1,0,135,107,13934,11013,142,110,14400,10413
105,12,1,1,2,1,2,1,137,99,13935,11014,145,163,14401,10414
106,12,3,2,0,3,1,0,206,79,13938,11016,198,110,14404,10414
107,12,1,2,1,0,0,3,132,110,13939,11018,144,85,14404,10417
108,13,3,1,0,3,1,0,199,184,13942,11019,206,170,14407,10417
109,13,2,1,0,3,1,0,164,101,13944,11020,169,142,14410,10417
110,13,6,0,0,3,1,0,172,118,13950,11020,168,85,14413,10417
111,13,1,3,1,0,0,3,151,121,13951,11023,146,151,14413,10420
112,13,0,0,2,1,2,1,177,120,13951,11023,181,107,14414,10421
113,13,0,4,1,0,0,3,217,173,13951,11027,198,102,14414,10424
114,13,1,3,1,0,0,3,178,94,13952,11030,181,197,14414,10427
115,13,1,0,0,3,1,0,135,109,13953,11030,150,85,14417,10427
116,13,3,1,0,3,1,0,164,158,13956,11031,160,104,14420,10427
117,14,0,0,2,1,2,1,137,99,13956,11031,146,138,14421,10428
118,14,2,0,0,3,1,0,277,55,13958,11031,241,130,14424,10428
119,14,1,3,1,0,0,3,130,145,13959,11034,127,166,14424,10431
120,14,4,0,0,3,1,0,233,167,13963,11034,255,163,14427,10431
121,14,3,3,2,1,2,1,152,137,13966,11037,127,118,14428,10432
122,14,2,1,0,3,1,0,137,108,13968,11038,145,100,14431,10432
123,14,4,1,0,3,1,0,210,80,13972,11039,201,145,14434,10432
124,14,1,1,2,1,2,1,181,109,13973,11040,179,111,14435,10433
125,14,0,0,2,1,2,1,132,110,13973,11040,145,111,14436,10434
126,15,3,1,0,3,1,0,181,95,13976,11041,184,142,14439,10434
127,15,3,1,0,3,1,0,167,102,13979,11042,172,197,14442,10434
128,15,1,3,1,0,0,3,200,187,13980,11045,206,110,14442,10437
129,15,0,1,1,0,0,3,177,121,13980,11046,181,105,14442,10440
130,15,2,1,0,3,1,0,137,110,13982,11047,153,151,14445,10440
131,15,1,1,2,1,2,1,165,159,13983,11048,161,86,14446,10441
132,15,1,2,1,0,0,3,173,120,13984,11050,168,173,14446,10444
133,15,1,1,2,1,2,1,218,174,13985,11051,199,86,14447,10445
134,15,0,1,1,0,0,3,151,122,13985,11052,146,107,14447,10448
135,16,0,0,2,1,2,1,137,108,13985,11052,146,146,14448,10449
136,16,2,0,0,3,1,0,279,55,13987,11052,244,163,14451,10449
137,16,1,1,2,1,2,1,174,121,13988,11053,169,167,14452,10450
138,16,1,1,2,1,2,1,131,146,13989,11054,128,139,14453,10451
139,16,1,0,0,3,1,0,153,137,13990,11054,130,142,14456,10451
140,16,0,4,1,0,0,3,137,103,13990,11058,146,133,14456,10454
141,16,5,0,0,3,1,0,186,109,13995,11058,182,118,14459,10454
142,16,2,1,0,3,1,0,134,111,13997,11059,148,111,14462,10454
143,16,4,1,0,3,1,0,214,81,14001,11060,204,100,14465,10454
144,17,1,0,0,3,1,0,182,95,14002,11060,187,86,14468,10454
145,17,0,1,1,0,0,3,200,188,14002,11061,206,108,14468,10457
146,17,2,1,0,3,1,0,153,123,14004,11062,149,86,14471,10457
147,17,2,1,0,3,1,0,179,122,14006,11063,184,173,14474,10457
148,17,0,1,1,0,0,3,233,168,14006,11064,255,200,14474,10460
149,17,0,1,1,0,0,3,165,160,14006,11065,161,154,14474,10463
150,17,3,1,0,3,1,0,221,175,14009,11066,202,111,14477,10463
151,17,2,0,0,3,1,0,139,110,14011,11066,156,110,14480,10463
152,17,3,2,0,3,1,0,170,104,14014,11068,175,107,14483,10463
153,18,1,2,1,0,0,3,201,190,14015,11070,206,203,14483,10466
154,18,1,0,0,3,1,0,166,160,14016,11070,164,110,14486,10466
155,18,1,2,1,0,0,3,234,170,14017,11072,255,110,14486,10469
156,18,0,0,2,1,2,1,139,110,14017,11072,157,109,14487,10470
157,18,1,3,1,0,0,3,180,125,14018,11075,184,149,14487,10473
158,18,1,1,2,1,2,1,154,138,14019,11076,131,155,14488,10474
159,18,1,3,1,0,0,3,171,107,14020,11079,175,176,14488,10477
160,18,3,2,0,3,1,0,156,125,14023,11081,152,111,14491,10477
161,18,1,3,1,0,0,3,183,98,14024,11084,187,89,14491,10480
162,19,1,0,0,3,1,0,138,108,14025,11084,149,118,14494,10480
163,19,0,2,1,0,0,3,137,105,14025,11086,146,114,14494,10483
164,19,0,0,2,1,2,1,134,111,14025,11086,149,101,14495,10484
165,19,3,0,0,3,1,0,189,109,14028,11086,185,142,14498,10484
166,19,3,3,2,1,2,1,134,149,14031,11089,129,134,14499,10485
167,19,2,0,0,3,1,0,216,81,14033,11089,207,163,14502,10485
168,19,2,1,0,3,1,0,223,176,14035,11090,205,167,14505,10485
169,19,1,1,2,1,2,1,175,122,14036,11091,170,140,14506,10486
170,19,2,0,0,3,1,0,281,55,14038,11091,247,86,14509,10486
171,20,5,1,0,3,1,0,176,108,14043,11092,178,89,14512,10486
172,20,0,0,2,1,2,1,139,110,14043,11092,158,177,14513,10487
173,20,3,0,0,3,1,0,186,98,14046,11092,190,111,14516,10487
174,20,2,4,1,0,0,3,158,129,14048,11096,152,152,14516,10490
175,20,2,1,0,3,1,0,168,161,14050,11097,167,109,14519,10490
176,20,0,1,1,0,0,3,234,171,14050,11098,255,113,14519,10493
177,20,0,0,2,1,2,1,189,109,14050,11098,186,204,14520,10494
178,20,1,1,2,1,2,1,202,191,14051,11099,207,141,14521,10495
179,20,0,2,1,0,0,3,154,140,14051,11101,131,113,14521,10498
180,21,2,1,0,3,1,0,140,109,14053,11102,152,114,14524,10498
181,21,1,2,1,0,0,3,138,107,14054,11104,146,158,14524,10501
182,21,1,0,0,3,1,0,217,81,14055,11104,210,142,14527,10501
183,21,2,0,0,3,1,0,225,176,14057,11104,208,134,14530,10501
184,21,1,1,2,1,2,1,135,150,14058,11105,130,87,14531,10502
185,21,2,0,0,3,1,0,177,122,14060,11105,173,163,14534,10502
186,21,3,1,0,3,1,0,183,126,14063,11106,187,101,14537,10502
187,21,3,2,0,3,1,0,205,193,14066,11108,210,118,14540,10502
188,21,1,3,1,0,0,3,135,114,14067,11111,149,207,14540,10505
189,22,0,0,2,1,2,1,158,129,14067,11111,153,168,14541,10506
190,22,1,1,2,1,2,1,140,111,14068,11112,159,112,14542,10507
191,22,2,0,0,3,1,0,170,161,14070,11112,170,89,14545,10507
192,22,1,0,0,3,1,0,177,108,14071,11112,181,141,14548,10507
193,22,3,2,0,3,1,0,157,142,14074,11114,134,113,14551,10507
194,22,3,1,0,3,1,0,284,56,14077,11115,250,113,14554,10507
195,22,0,1,1,0,0,3,189,110,14077,11116,186,180,14554,10510
196,22,1,1,2,1,2,1,187,99,14078,11117,191,153,14555,10511
197,22,0,1,1,0,0,3,234,172,14078,11118,255,112,14555,10514
198,23,0,1,1,0,0,3,183,127,14078,11119,187,137,14555,10517
199,23,0,2,1,0,0,3,177,124,14078,11121,173,210,14555,10520
200,23,1,2,1,0,0,3,226,178,14079,11123,208,145,14555,10523
201,23,1,1,2,1,2,1,206,194,14080,11124,211,164,14556,10524
202,23,2,2,2,1,2,1,137,152,14082,11126,131,114,14557,10525
203,23,2,2,2,1,2,1,137,116,14084,11128,150,119,14558,10526
204,23,3,1,0,3,1,0,143,110,14087,11129,155,158,14561,10526
205,23,3,1,0,3,1,0,220,82,14090,11130,213,87,14564,10526
206,23,0,0,2,1,2,1,158,129,14090,11130,154,115,14565,10527
207,24,0,4,1,0,0,3,234,176,14090,11134,255,115,14565,10530
208,24,1,1,2,1,2,1,171,162,14091,11135,171,142,14566,10531
209,24,0,2,1,0,0,3,138,109,14091,11137,146,183,14566,10534
210,24,3,2,0,3,1,0,190,101,14094,11139,194,168,14569,10534
211,24,4,0,0,3,1,0,181,108,14098,11139,184,153,14572,10534
212,24,2,1,0,3,1,0,159,143,14100,11140,137,112,14575,10534
213,24,1,4,1,0,0,3,190,114,14101,11144,186,92,14575,10537
214,24,2,0,0,3,1,0,142,111,14103,11144,162,101,14578,10537
215,24,1,2,1,0,0,3,285,58,14104,11146,250,116,14578,10540
216,25,1,3,1,0,0,3,184,130,14105,11149,187,118,14578,10543
217,25,3,3,2,1,2,1,140,119,14108,11152,151,159,14579,10544
218,25,2,1,0,3,1,0,179,125,14110,11153,176,119,14582,10544
219,25,4,1,0,3,1,0,141,153,14114,11154,134,145,14585,10544
220,25,5,1,0,3,1,0,231,179,14119,11155,211,87,14588,10544
221,25,1,1,2,1,2,1,159,130,14120,11156,155,165,14589,10545
222,25,0,0,2,1,2,1,220,82,14120,11156,214,211,14590,10546
223,25,0,0,2,1,2,1,143,110,14120,11156,156,115,14591,10547
224,25,2,0,0,3,1,0,208,194,14122,11156,214,137,14594,10547
225,26,2,0,0,3,1,0,144,111,14124,11156,165,118,14597,10547
226,26,1,0,0,3,1,0,160,143,14125,11156,140,115,14600,10547
227,26,3,3,2,1,2,1,174,165,14128,11159,172,154,14601,10548
228,26,2,2,2,1,2,1,140,111,14130,11161,147,113,14602,10549
229,26,3,0,0,3,1,0,184,108,14133,11161,187,101,14605,10549
230,26,0,2,1,0,0,3,234,178,14133,11163,255,145,14605,10552
231,26,5,0,0,3,1,0,290,58,14138,11163,253,92,14608,10552
232,26,1,0,0,3,1,0,191,114,14139,11163,189,168,14611,10552
233,26,2,0,0,3,1,0,222,82,14141,11163,217,116,14614,10552
234,27,2,1,0,3,1,0,192,102,14143,11164,197,119,14617,10552
235,27,1,1,2,1,2,1,180,126,14144,11165,177,116,14618,10553
236,27,1,3,1,0,0,3,209,197,14145,11168,214,90,14618,10556
237,27,1,1,2,1,2,1,142,154,14146,11169,135,117,14619,10557
238,27,0,1,1,0,0,3,184,131,14146,11170,187,214,14619,10560
239,27,2,1,0,3,1,0,146,112,14148,11171,168,165,14622,10560
240,27,1,0,0,3,1,0,160,130,14149,11171,158,145,14625,10560
241,27,0,2,1,0,0,3,231,181,14149,11173,211,162,14625,10563
242,27,1,3,1,0,0,3,141,122,14150,11176,151,186,14625,10566
243,28,3,0,0,3,1,0,194,114,14153,11176,192,115,14628,10566
244,28,1,0,0,3,1,0,291,58,14154,11176,256,101,14631,10566
245,28,0,3,1,0,0,3,234,181,14154,11179,255,171,14631,10569
246,28,4,2,0,3,1,0,147,112,14158,11181,159,113,14634,10569
247,28,3,0,0,3,1,0,177,165,14161,11181,175,118,14637,10569
248,28,2,2,2,1,2,1,142,113,14163,11183,148,155,14638,10570
249,28,3,2,0,3,1,0,225,84,14166,11185,220,92,14641,10570
250,28,5,0,0,3,1,0,189,108,14171,11185,190,137,14644,10570
251,28,1,1,2,1,2,1,161,144,14172,11186,141,146,14645,10571
252,29,2,2,2,1,2,1,148,114,14174,11188,169,146,14646,10572
253,29,1,2,1,0,0,3,210,199,14175,11190,214,119,14646,10575
254,29,1,3,1,0,0,3,232,184,14176,11193,211,217,14646,10578
255,29,1,2,1,0,0,3,143,156,14177,11195,135,116,14646,10581
256,29,0,2,1,0,0,3,160,132,14177,11197,158,93,14646,10584
257,29,1,0,0,3,1,0,178,165,14178,11197,178,119,14649,10584
258,29,1,1,2,1,2,1,181,127,14179,11198,178,118,14650,10585
259,29,2,2,2,1,2,1,194,104,14181,11200,198,187,14651,10586
260,29,0,2,1,0,0,3,184,133,14181,11202,187,165,14651,10589
261,30,2,0,0,3,1,0,236,181,14183,11202,258,119,14654,10589
262,30,3,2,0,3,1,0,146,158,14186,11204,138,115,14657,10589
263,30,1,0,0,3,1,0,142,122,14187,11204,154,155,14660,10589
264,30,3,0,0,3,1,0,197,114,14190,11204,195,101,14663,10589
265,30,2,1,0,3,1,0,163,145,14192,11205,144,137,14666,10589
266,30,2,0,0,3,1,0,144,113,14194,11205,151,165,14669,10589
267,30,3,0,0,3,1,0,294,58,14197,11205,259,118,14672,10589
268,30,3,0,0,3,1,0,228,84,14200,11205,223,171,14675,10589
269,30,2,3,1,0,0,3,149,115,14202,11208,159,149,14675,10592
270,31,2,1,0,3,1,0,212,200,14204,11209,217,92,14678,10592
271,31,0,2,1,0,0,3,148,116,14204,11211,169,220,14678,10595
272,31,0,3,1,0,0,3,232,187,14204,11214,211,190,14678,10598
273,31,0,2,1,0,0,3,181,129,14204,11216,178,119,14678,10601
274,31,2,2,2,1,2,1,180,167,14206,11218,179,147,14679,10602
275,31,4,1,0,3,1,0,188,134,14210,11219,190,119,14682,10602
276,31,2,3,1,0,0,3,196,107,14212,11222,198,168,14682,10605
277,31,3,1,0,3,1,0,192,109,14215,11223,193,93,14685,10605
278,31,2,1,0,3,1,0,162,133,14217,11224,161,118,14688,10605
279,32,0,0,2,1,2,1,142,122,14217,11224,155,150,14689,10606
280,32,1,3,1,0,0,3,237,184,14218,11227,258,121,14689,10609
281,32,1,1,2,1,2,1,295,59,14219,11228,260,120,14690,10610
282,32,5,1,0,3,1,0,233,85,14224,11229,226,115,14693,10610
283,32,0,0,2,1,2,1,149,115,14224,11229,160,172,14694,10611
284,32,1,2,1,0,0,3,145,115,14225,11231,151,104,14694,10614
285,32,2,1,0,3,1,0,165,146,14227,11232,147,165,14697,10614
286,32,2,1,0,3,1,0,199,115,14229,11233,198,137,14700,10614
287,32,6,2,0,3,1,0,152,160,14235,11235,141,155,14703,10614
288,33,1,2,1,0,0,3,181,169,14236,11237,179,223,14703,10617
289,33,1,0,0,3,1,0,163,133,14237,11237,164,190,14706,10617
290,33,2,1,0,3,1,0,194,110,14239,11238,196,168,14709,10617
291,33,0,1,1,0,0,3,212,201,14239,11239,217,118,14709,10620
292,33,1,1,2,1,2,1,197,108,14240,11240,199,120,14710,10621
293,33,0,0,2,1,2,1,188,134,14240,11240,191,93,14711,10622
294,33,1,0,0,3,1,0,238,184,14241,11240,261,93,14714,10622
295,33,1,3,1,0,0,3,233,190,14242,11243,211,121,14714,10625
296,33,1,2,1,0,0,3,149,118,14243,11245,169,122,14714,10628
297,34,1,4,1,0,0,3,166,150,14244,11249,147,124,14714,10631
298,34,0,2,1,0,0,3,145,117,14244,11251,151,123,14714,10634
299,34,0,0,2,1,2,1,149,115,14244,11251,161,138,14715,10635
300,34,1,0,0,3,1,0,153,160,14245,11251,144,104,14718,10635
301,34,1,3,1,0,0,3,143,125,14246,11254,155,175,14718,10638
302,34,3,1,0,3,1,0,184,130,14249,11255,181,155,14721,10638
303,34,3,2,0,3,1,0,202,117,14252,11257,201,165,14724,10638
304,34,2,2,2,1,2,1,235,87,14254,11259,227,151,14725,10639
305,34,3,1,0,3,1,0,298,60,14257,11260,263,147,14728,10639
0,1,6,0,0,3,1,0,304,60,14263,11260,266,93,14731,10639
1,1,1,0,0,3,1,0,164,133,14264,11260,167,124,14734,10639
2,1,0,2,1,0,0,3,143,127,14264,11262,155,121,14734,10642
3,1,1,1,2,1,2,1,213,202,14265,11263,218,166,14735,10643
4,1,2,0,0,3,1,0,190,134,14267,11263,194,122,14738,10643
5,1,2,1,0,3,1,0,237,88,14269,11264,230,121,14741,10643
6,1,2,1,0,3,1,0,196,111,14271,11265,199,168,14744,10643
7,1,2,1,0,3,1,0,151,119,14273,11266,172,115,14747,10643
8,1,2,2,2,1,2,1,168,152,14275,11268,148,48,14748,10644
9,2,0,2,1,0,0,3,197,110,14275,11270,199,226,14748,10647
10,2,3,1,0,3,1,0,205,118,14278,11271,204,175,14751,10647
11,2,0,0,2,1,2,1,184,130,14278,11271,182,152,14752,10648
12,2,0,2,1,0,0,3,181,171,14278,11273,179,141,14752,10651
13,2,1,0,0,3,1,0,146,117,14279,11273,154,104,14755,10651
14,2,3,1,0,3,1,0,169,135,14282,11274,165,123,14758,10651
15,2,1,0,0,3,1,0,61,33,14283,11274,73,190,14761,10651
16,2,1,2,1,0,0,3,154,162,14284,11276,144,123,14761,10654
17,2,4,4,2,1,2,1,153,119,14288,11280,162,94,14762,10655
18,3,3,0,0,3,1,0,193,134,14291,11280,197,115,14765,10655
19,3,3,1,0,3,1,0,307,61,14294,11281,269,166,14768,10655
20,3,6,0,0,3,1,0,243,88,14300,11281,233,122,14771,10655
21,3,0,4,1,0,0,3,213,206,14300,11285,218,51,14771,10658
22,3,0,0,2,1,2,1,168,152,14300,11285,149,122,14772,10659
23,3,2,1,0,3,1,0,166,134,14302,11286,170,168,14775,10659
24,3,4,1,0,3,1,0,200,112,14306,11287,202,93,14778,10659
25,3,1,3,1,0,0,3,144,130,14307,11290,155,124,14778,10662
26,3,2,0,0,3,1,0,153,119,14309,11290,175,124,14781,10662
27,4,1,5,1,0,0,3,185,135,14310,11295,182,193,14781,10665
28,4,0,2,1,0,0,3,181,173,14310,11297,179,107,14781,10668
29,4,1,1,2,1,2,1,147,118,14311,11298,155,95,14782,10669
30,4,1,0,0,3,1,0,170,135,14312,11298,168,175,14785,10669
31,4,3,0,0,3,1,0,310,61,14315,11298,272,141,14788,10669
32,4,0,0,2,1,2,1,205,118,14315,11298,205,124,14789,10670
33,4,1,3,1,0,0,3,198,113,14316,11301,199,155,14789,10673
34,4,1,2,1,0,0,3,155,164,14317,11303,144,127,14789,10676
35,4,1,1,2,1,2,1,62,34,14318,11304,74,124,14790,10677
36,5,3,1,0,3,1,0,246,89,14321,11305,236,115,14793,10677
37,5,2,0,0,3,1,0,202,112,14323,11305,205,166,14796,10677
38,5,2,3,1,0,0,3,155,122,14325,11308,162,171,14796,10680
39,5,0,1,1,0,0,3,213,207,14325,11309,218,229,14796,10683
40,5,1,0,0,3,1,0,145,130,14326,11309,158,122,14799,10683
41,5,3,3,2,1,2,1,169,137,14329,11312,171,142,14800,10684
42,5,2,1,0,3,1,0,157,165,14331,11313,147,122,14803,10684
43,5,2,1,0,3,1,0,170,153,14333,11314,152,124,14806,10684
44,5,1,1,2,1,2,1,194,135,14334,11315,198,52,14807,10685
45,6,2,1,0,3,1,0,64,35,14336,11316,77,124,14810,10685
46,6,1,1,2,1,2,1,311,62,14337,11317,273,156,14811,10686
47,6,2,0,0,3,1,0,155,119,14339,11317,178,175,14814,10686
48,6,1,2,1,0,0,3,182,175,14340,11319,179,98,14814,10689
49,6,2,2,2,1,2,1,149,120,14342,11321,156,94,14815,10690
50,6,1,0,0,3,1,0,171,135,14343,11321,171,107,14818,10690
51,6,2,0,0,3,1,0,207,118,14345,11321,208,193,14821,10690
52,6,0,0,2,1,2,1,185,135,14345,11321,183,128,14822,10691
53,6,4,0,0,3,1,0,202,113,14349,11321,202,124,14825,10691
54,7,1,1,2,1,2,1,247,90,14350,11322,237,143,14826,10692
55,7,0,0,2,1,2,1,202,112,14350,11322,206,176,14827,10693
56,7,2,1,0,3,1,0,196,136,14352,11323,201,166,14830,10693
57,7,1,1,2,1,2,1,146,131,14353,11324,159,125,14831,10694
58,7,2,1,0,3,1,0,172,154,14355,11325,155,115,14834,10694
59,7,2,2,2,1,2,1,171,139,14357,11327,172,230,14835,10695
60,7,2,1,0,3,1,0,159,166,14359,11328,150,171,14838,10695
61,7,2,1,0,3,1,0,157,123,14361,11329,165,122,14841,10695
62,7,0,1,1,0,0,3,185,136,14361,11330,183,55,14841,10698
63,8,0,3,1,0,0,3,213,210,14361,11333,218,110,14841,10701
64,8,0,3,1,0,0,3,207,121,14361,11336,208,101,14841,10704
65,8,2,1,0,3,1,0,157,120,14363,11337,181,156,14844,10704
66,8,3,3,2,1,2,1,185,178,14366,11340,180,194,14845,10705
67,8,3,1,0,3,1,0,152,121,14369,11341,159,122,14848,10705
68,8,2,1,0,3,1,0,173,136,14371,11342,174,124,14851,10705
69,8,2,0,0,3,1,0,313,62,14373,11342,276,124,14854,10705
70,8,3,1,0,3,1,0,67,36,14376,11343,80,94,14857,10705
71,8,3,0,0,3,1,0,205,113,14379,11343,205,128,14860,10705
72,9,0,0,2,1,2,1,202,112,14379,11343,207,111,14861,10706
73,9,2,0,0,3,1,0,159,123,14381,11343,168,166,14864,10706
74,9,1,2,1,0,0,3,186,138,14382,11345,183,174,14864,10709
75,9,1,3,1,0,0,3,147,134,14383,11348,159,233,14864,10712
76,9,1,3,1,0,0,3,160,169,14384,11351,150,118,14864,10715
77,9,0,2,1,0,0,3,152,123,14384,11353,159,58,14864,10718
78,9,0,0,2,1,2,1,247,90,14384,11353,238,126,14865,10719
79,9,1,0,0,3,1,0,173,154,14385,11353,158,143,14868,10719
80,9,3,0,0,3,1,0,199,136,14388,11353,204,176,14871,10719
81,10,3,0,0,3,1,0,160,120,14391,11353,184,124,14874,10719
82,10,1,1,2,1,2,1,314,63,14392,11354,277,102,14875,10720
83,10,3,2,0,3,1,0,210,123,14395,11356,211,122,14878,10720
84,10,2,5,1,0,0,3,215,215,14397,11361,218,197,14878,10723
85,10,0,2,1,0,0,3,185,180,14397,11363,180,127,14878,10726
86,10,0,3,1,0,0,3,173,139,14397,11366,174,125,14878,10729
87,10,1,0,0,3,1,0,172,139,14398,11366,175,156,14881,10729
88,10,3,1,0,3,1,0,70,37,14401,11367,83,128,14884,10729
89,10,3,1,0,3,1,0,208,114,14404,11368,208,94,14887,10729
90,11,2,3,1,0,0,3,212,126,14406,11371,211,61,14887,10732
91,11,1,2,1,0,0,3,203,114,14407,11373,207,159,14887,10735
92,11,4,2,0,3,1,0,163,125,14411,11375,171,118,14890,10735
93,11,0,1,1,0,0,3,186,139,14411,11376,183,129,14890,10738
94,11,0,0,2,1,2,1,147,134,14411,11376,160,144,14891,10739
95,11,0,1,1,0,0,3,152,124,14411,11377,159,169,14891,10742
96,11,1,0,0,3,1,0,248,90,14412,11377,241,233,14894,10742
97,11,2,2,2,1,2,1,175,156,14414,11379,159,177,14895,10743
98,11,1,2,1,0,0,3,161,171,14415,11381,150,114,14895,10746
99,12,1,4,1,0,0,3,174,143,14416,11385,174,64,14895,10749
100,12,1,1,2,1,2,1,204,115,14417,11386,208,103,14896,10750
101,12,0,0,2,1,2,1,199,136,14417,11386,205,128,14897,10751
102,12,2,2,2,1,2,1,217,217,14419,11388,219,95,14898,10752
103,12,1,1,2,1,2,1,186,181,14420,11389,181,126,14899,10753
104,12,2,1,0,3,1,0,174,140,14422,11390,178,197,14902,10753
105,12,2,1,0,3,1,0,316,64,14424,11391,280,174,14905,10753
106,12,3,1,0,3,1,0,211,115,14427,11392,211,122,14908,10753
107,12,2,1,0,3,1,0,162,121,14429,11393,187,128,14911,10753
108,13,1,3,1,0,0,3,164,128,14430,11396,171,236,14911,10756
109,13,4,1,0,3,1,0,252,91,14434,11397,244,124,14914,10756
110,13,1,1,2,1,2,1,213,127,14435,11398,212,119,14915,10757
111,13,2,3,1,0,0,3,188,142,14437,11401,183,147,14915,10760
112,13,2,1,0,3,1,0,163,172,14439,11402,153,169,14918,10760
113,13,4,0,0,3,1,0,179,156,14443,11402,162,159,14921,10760
114,13,2,1,0,3,1,0,72,38,14445,11403,86,129,14924,10760
115,13,0,2,1,0,0,3,152,126,14445,11405,159,180,14924,10763
116,13,1,1,2,1,2,1,148,135,14446,11406,161,115,14925,10764
117,14,0,0,2,1,2,1,174,140,14446,11406,179,104,14926,10765
118,14,5,0,0,3,1,0,321,64,14451,11406,283,126,14929,10765
119,14,1,1,2,1,2,1,200,137,14452,11407,206,198,14930,10766
120,14,1,0,0,3,1,0,218,217,14453,11407,222,128,14933,10766
121,14,1,0,0,3,1,0,187,181,14454,11407,184,64,14936,10766
122,14,1,0,0,3,1,0,175,143,14455,11407,177,122,14939,10766
123,14,0,1,1,0,0,3,162,122,14455,11408,187,98,14939,10769
124,14,1,0,0,3,1,0,205,115,14456,11408,211,128,14942,10769
125,14,0,1,1,0,0,3,211,116,14456,11409,211,177,14942,10772
126,15,2,2,2,1,2,1,181,158,14458,11411,163,199,14943,10773
127,15,1,1,2,1,2,1,212,117,14459,11412,212,120,14944,10774
128,15,3,1,0,3,1,0,167,129,14462,11413,174,180,14947,10774
129,15,1,0,0,3,1,0,149,135,14463,11413,164,124,14950,10774
130,15,1,1,2,1,2,1,164,173,14464,11414,154,160,14951,10775
131,15,2,0,0,3,1,0,74,38,14466,11414,89,147,14954,10775
132,15,1,0,0,3,1,0,189,142,14467,11414,186,115,14957,10775
133,15,0,1,1,0,0,3,152,127,14467,11415,159,239,14957,10778
134,15,1,2,1,0,0,3,214,129,14468,11417,212,172,14957,10781
135,16,1,1,2,1,2,1,253,92,14469,11418,245,129,14958,10782
136,16,1,2,1,0,0,3,206,117,14470,11420,211,129,14958,10785
137,16,2,1,0,3,1,0,220,218,14472,11421,225,129,14961,10785
138,16,3,0,0,3,1,0,177,140,14475,11421,182,128,14964,10785
139,16,3,0,0,3,1,0,324,64,14478,11421,286,64,14967,10785
140,16,2,0,0,3,1,0,164,122,14480,11421,190,122,14970,10785
141,16,1,1,2,1,2,1,201,138,14481,11422,207,178,14971,10786
142,16,1,2,1,0,0,3,188,183,14482,11424,184,123,14971,10789
143,16,1,1,2,1,2,1,182,159,14483,11425,164,99,14972,10790
144,17,1,2,1,0,0,3,176,145,14484,11427,177,242,14972,10793
145,17,1,0,0,3,1,0,213,117,14485,11427,215,172,14975,10793
146,17,1,0,0,3,1,0,190,142,14486,11427,189,180,14978,10793
147,17,0,2,1,0,0,3,149,137,14486,11429,164,107,14978,10796
148,17,1,2,1,0,0,3,165,175,14487,11431,154,202,14978,10799
149,17,0,0,2,1,2,1,152,127,14487,11431,160,125,14979,10800
150,17,3,0,0,3,1,0,77,38,14490,11431,92,115,14982,10800
151,17,3,1,0,3,1,0,217,130,14493,11432,215,147,14985,10800
152,17,0,0,2,1,2,1,167,129,14493,11432,175,161,14986,10801
153,18,0,1,1,0,0,3,213,118,14493,11433,215,118,14986,10804
154,18,1,2,1,0,0,3,166,177,14494,11435,154,245,14986,10807
155,18,2,1,0,3,1,0,79,39,14496,11436,95,107,14989,10807
156,18,1,2,1,0,0,3,191,144,14497,11438,189,132,14989,10810
157,18,3,1,0,3,1,0,191,184,14500,11439,187,180,14992,10810
158,18,1,6,1,0,0,3,153,133,14501,11445,160,164,14992,10813
159,18,2,3,1,0,0,3,219,133,14503,11448,215,128,14992,10816
160,18,2,1,0,3,1,0,178,146,14505,11449,180,147,14995,10816
161,18,1,1,2,1,2,1,168,130,14506,11450,176,203,14996,10817
162,19,1,0,0,3,1,0,221,218,14507,11450,228,178,14999,10817
163,19,1,1,2,1,2,1,325,65,14508,11451,287,130,15000,10818
164,19,4,0,0,3,1,0,186,159,14512,11451,167,128,15003,10818
165,19,1,0,0,3,1,0,202,138,14513,11451,210,129,15006,10818
166,19,1,0,0,3,1,0,165,122,14514,11451,193,172,15009,10818
167,19,3,0,0,3,1,0,209,117,14517,11451,214,123,15012,10818
168,19,1,0,0,3,1,0,254,92,14518,11451,248,64,15015,10818
169,19,3,2,0,3,1,0,152,139,14521,11453,167,99,15018,10818
170,19,2,0,0,3,1,0,179,140,14523,11453,185,122,15021,10818
171,20,2,0,0,3,1,0,170,130,14525,11453,179,132,15024,10818
172,20,0,2,1,0,0,3,191,186,14525,11455,187,248,15024,10821
173,20,2,1,0,3,1,0,155,134,14527,11456,163,203,15027,10821
174,20,0,1,1,0,0,3,166,178,14527,11457,154,131,15027,10824
175,20,0,3,1,0,0,3,79,42,14527,11460,95,183,15027,10827
176,20,3,0,0,3,1,0,222,133,14530,11460,218,118,15030,10827
177,20,2,0,0,3,1,0,215,118,14532,11460,218,147,15033,10827
178,20,2,1,0,3,1,0,193,145,14534,11461,192,107,15036,10827
179,20,2,1,0,3,1,0,180,147,14536,11462,183,164,15039,10827
180,21,1,3,1,0,0,3,153,142,14537,11465,167,181,15039,10830
181,21,1,1,2,1,2,1,166,123,14538,11466,194,249,15040,10831
182,21,3,0,0,3,1,0,257,92,14541,11466,251,129,15043,10831
183,21,0,2,1,0,0,3,179,142,14541,11468,185,175,15043,10834
184,21,0,2,1,0,0,3,170,132,14541,11470,179,102,15043,10837
185,21,2,0,0,3,1,0,188,159,14543,11470,170,122,15046,10837
186,21,2,2,2,1,2,1,223,220,14545,11472,229,124,15047,10838
187,21,1,2,1,0,0,3,210,119,14546,11474,214,67,15047,10841
188,21,1,1,2,1,2,1,203,139,14547,11475,211,131,15048,10842
189,22,1,2,1,0,0,3,194,147,14548,11477,192,105,15048,10845
190,22,0,3,1,0,0,3,180,150,14548,11480,183,206,15048,10848
191,22,0,2,1,0,0,3,222,135,14548,11482,218,131,15048,10851
192,22,3,1,0,3,1,0,82,43,14551,11483,98,164,15051,10851
193,22,8,0,0,3,1,0,333,65,14559,11483,290,183,15054,10851
194,22,1,2,1,0,0,3,156,136,14560,11485,163,135,15054,10854
195,22,2,0,0,3,1,0,168,123,14562,11485,197,118,15057,10854
196,22,0,2,1,0,0,3,191,188,14562,11487,187,134,15057,10857
197,22,1,1,2,1,2,1,216,119,14563,11488,219,108,15058,10858
198,23,2,2,2,1,2,1,155,144,14565,11490,168,68,15059,10859
199,23,0,3,1,0,0,3,203,142,14565,11493,211,252,15059,10862
200,23,6,2,0,3,1,0,263,94,14571,11495,254,181,15062,10862
201,23,1,1,2,1,2,1,171,133,14572,11496,180,130,15063,10863
202,23,5,2,0,3,1,0,193,161,14577,11498,173,175,15066,10863
203,23,2,0,0,3,1,0,168,178,14579,11498,157,122,15069,10863
204,23,4,2,0,3,1,0,214,121,14583,11500,217,131,15072,10863
205,23,1,2,1,0,0,3,180,144,14584,11502,185,127,15072,10866
206,23,1,0,0,3,1,0,224,220,14585,11502,232,147,15075,10866
207,24,1,1,2,1,2,1,223,136,14586,11503,219,106,15076,10867
208,24,2,1,0,3,1,0,170,124,14588,11504,200,206,15079,10867
209,24,2,1,0,3,1,0,158,137,14590,11505,166,131,15082,10867
210,24,0,1,1,0,0,3,82,44,14590,11506,98,133,15082,10870
211,24,1,1,2,1,2,1,181,151,14591,11507,184,109,15083,10871
212,24,3,0,0,3,1,0,336,65,14594,11507,293,118,15086,10871
213,24,2,2,2,1,2,1,193,190,14596,11509,188,165,15087,10872
214,24,3,0,0,3,1,0,219,119,14599,11509,222,135,15090,10872
215,24,2,1,0,3,1,0,226,221,14601,11510,235,134,15093,10872
216,25,1,0,0,3,1,0,264,94,14602,11510,257,175,15096,10872
217,25,1,0,0,3,1,0,194,161,14603,11510,176,181,15099,10872
218,25,4,2,0,3,1,0,207,144,14607,11512,214,147,15102,10872
219,25,1,0,0,3,1,0,195,147,14608,11512,195,122,15105,10872
220,25,3,0,0,3,1,0,171,178,14611,11512,160,68,15108,10872
221,25,1,1,2,1,2,1,156,145,14612,11513,169,128,15109,10873
222,25,0,0,2,1,2,1,180,144,14612,11513,186,184,15110,10874
223,25,0,1,1,0,0,3,171,134,14612,11514,180,134,15110,10877
224,25,0,1,1,0,0,3,214,122,14612,11515,217,255,15110,10880
225,26,1,3,1,0,0,3,171,127,14613,11518,200,112,15110,10883
226,26,1,1,2,1,2,1,220,120,14614,11519,223,207,15111,10884
227,26,2,1,0,3,1,0,228,222,14616,11520,238,165,15114,10884
228,26,6,0,0,3,1,0,342,65,14622,11520,296,135,15117,10884
229,26,2,5,1,0,0,3,183,156,14624,11525,184,109,15117,10887
230,26,4,0,0,3,1,0,86,44,14628,11525,101,122,15120,10887
231,26,0,0,2,1,2,1,180,144,14628,11525,187,135,15121,10888
232,26,2,1,0,3,1,0,195,191,14630,11526,191,131,15124,10888
233,26,3,3,2,1,2,1,226,139,14633,11529,220,134,15125,10889
234,27,1,0,0,3,1,0,195,161,14634,11529,179,255,15128,10889
235,27,3,0,0,3,1,0,174,178,14637,11529,163,134,15131,10889
236,27,3,0,0,3,1,0,267,94,14640,11529,260,184,15134,10889
237,27,1,0,0,3,1,0,208,144,14641,11529,217,118,15137,10889
238,27,0,2,1,0,0,3,158,139,14641,11531,166,184,15137,10892
239,27,1,0,0,3,1,0,215,122,14642,11531,220,147,15140,10892
240,27,2,3,1,0,0,3,158,148,14644,11534,169,178,15140,10895
241,27,0,1,1,0,0,3,195,148,14644,11535,195,131,15140,10898
242,27,2,3,1,0,0,3,173,137,14646,11538,180,71,15140,10901
243,28,2,2,2,1,2,1,182,146,14648,11540,188,110,15141,10902
244,28,1,0,0,3,1,0,87,44,14649,11540,104,184,15144,10902
245,28,2,3,1,0,0,3,210,147,14651,11543,217,138,15144,10905
246,28,1,0,0,3,1,0,184,156,14652,11543,187,131,15147,10905
247,28,4,1,0,3,1,0,224,121,14656,11544,226,134,15150,10905
248,28,2,1,0,3,1,0,230,223,14658,11545,241,112,15153,10905
249,28,4,1,0,3,1,0,346,66,14662,11546,299,207,15156,10905
250,28,2,0,0,3,1,0,173,127,14664,11546,203,135,15159,10905
251,28,3,2,0,3,1,0,198,193,14667,11548,194,122,15162,10905
252,29,5,3,0,3,1,0,200,164,14672,11551,182,138,15165,10905
253,29,1,0,0,3,1,0,174,137,14673,11551,183,147,15168,10905
254,29,2,1,0,3,1,0,160,149,14675,11552,172,165,15171,10905
255,29,3,0,0,3,1,0,198,148,14678,11552,198,178,15174,10905
256,29,3,1,0,3,1,0,270,95,14681,11553,263,118,15177,10905
257,29,4,0,0,3,1,0,91,44,14685,11553,107,131,15180,10905
258,29,0,0,2,1,2,1,226,139,14685,11553,221,256,15181,10906
259,29,2,1,0,3,1,0,176,179,14687,11554,166,184,15184,10906
260,29,2,1,0,3,1,0,160,140,14689,11555,169,134,15187,10906
261,30,1,1,2,1,2,1,211,148,14690,11556,218,113,15188,10907
262,30,2,2,2,1,2,1,348,68,14692,11558,300,132,15189,10908
263,30,1,0,0,3,1,0,174,127,14693,11558,206,134,15192,10908
264,30,3,1,0,3,1,0,185,147,14696,11559,191,135,15195,10908
265,30,2,4,1,0,0,3,200,197,14698,11563,194,113,15195,10911
266,30,1,2,1,0,0,3,231,225,14699,11565,241,125,15195,10914
267,30,2,3,1,0,0,3,217,125,14701,11568,220,210,15195,10917
268,30,2,1,0,3,1,0,186,157,14703,11569,190,184,15198,10917
269,30,1,1,2,1,2,1,225,122,14704,11570,227,72,15199,10918
270,31,1,4,1,0,0,3,227,143,14705,11574,221,137,15199,10921
271,31,1,2,1,0,0,3,175,139,14706,11576,183,141,15199,10924
272,31,2,0,0,3,1,0,178,179,14708,11576,169,147,15202,10924
273,31,0,0,2,1,2,1,270,95,14708,11576,264,166,15203,10925
274,31,0,0,2,1,2,1,91,44,14708,11576,108,179,15204,10926
275,31,3,0,0,3,1,0,163,140,14711,11576,172,131,15207,10926
276,31,0,6,1,0,0,3,198,154,14711,11582,198,259,15207,10929
277,31,4,0,0,3,1,0,164,149,14715,11582,175,184,15210,10929
278,31,1,0,0,3,1,0,201,164,14716,11582,185,118,15213,10929
279,32,4,3,0,3,1,0,215,151,14720,11585,221,113,15216,10929
280,32,1,1,2,1,2,1,201,198,14721,11586,195,185,15217,10930
281,32,0,2,1,0,0,3,185,149,14721,11588,191,137,15217,10933
282,32,1,1,2,1,2,1,218,126,14722,11589,221,136,15218,10934
283,32,1,0,0,3,1,0,349,68,14723,11589,303,125,15221,10934
284,32,2,1,0,3,1,0,272,96,14725,11590,267,113,15224,10934
285,32,1,4,1,0,0,3,175,131,14726,11594,206,75,15224,10937
286,32,0,0,2,1,2,1,231,225,14726,11594,242,133,15225,10938
287,32,2,0,0,3,1,0,188,157,14728,11594,193,137,15228,10938
288,33,4,5,1,0,0,3,95,49,14732,11599,108,262,15228,10941
289,33,1,1,2,1,2,1,165,150,14733,11600,176,211,15229,10942
290,33,1,1,2,1,2,1,199,155,14734,11601,199,142,15230,10943
291,33,0,2,1,0,0,3,163,142,14734,11603,172,150,15230,10946
292,33,2,2,2,1,2,1,229,145,14736,11605,222,167,15231,10947
293,33,1,1,2,1,2,1,226,123,14737,11606,228,185,15232,10948
294,33,1,1,2,1,2,1,189,158,14738,11607,194,180,15233,10949
295,33,3,5,1,0,0,3,181,184,14741,11612,169,116,15233,10952
296,33,4,2,0,3,1,0,179,141,14745,11614,186,118,15236,10952
297,34,4,1,0,3,1,0,353,69,14749,11615,306,131,15239,10952
298,34,4,3,0,3,1,0,276,99,14753,11618,270,113,15242,10952
299,34,2,2,2,1,2,1,220,128,14755,11620,222,126,15243,10953
300,34,2,6,1,0,0,3,177,137,14757,11626,206,188,15243,10956
301,34,2,0,0,3,1,0,217,151,14759,11626,224,133,15246,10956
302,34,2,1,0,3,1,0,233,226,14761,11627,245,137,15249,10956
303,34,1,1,2,1,2,1,202,199,14762,11628,196,138,15250,10957
304,34,0,0,2,1,2,1,201,164,14762,11628,186,137,15251,10958
305,34,2,2,2,1,2,1,187,151,14764,11630,192,76,15252,10959
0,1,3,1,0,3,1,0,356,70,14767,11631,309,188,15255,10959
1,1,1,0,0,3,1,0,202,164,14768,11631,189,113,15258,10959
2,1,2,0,0,3,1,0,179,137,14770,11631,209,155,15261,10959
3,1,1,0,0,3,1,0,234,226,14771,11631,248,137,15264,10959
4,1,0,1,1,0,0,3,179,142,14771,11632,186,150,15264,10962
5,1,0,3,1,0,0,3,199,158,14771,11635,199,214,15264,10965
6,1,2,0,0,3,1,0,228,123,14773,11635,231,76,15267,10965
7,1,0,0,2,1,2,1,189,158,14773,11635,195,119,15268,10966
8,1,1,0,0,3,1,0,221,128,14774,11635,225,167,15271,10966
9,2,1,3,1,0,0,3,218,154,14775,11638,224,188,15271,10969
10,2,0,2,1,0,0,3,181,186,14775,11640,169,265,15271,10972
11,2,0,1,1,0,0,3,187,152,14775,11641,192,140,15271,10975
12,2,2,2,2,1,2,1,231,147,14777,11643,223,117,15272,10976
13,2,2,2,2,1,2,1,167,152,14779,11645,177,143,15273,10977
14,2,1,0,0,3,1,0,234,190,14780,11645,214,133,15276,10977
15,2,2,0,0,3,1,0,278,99,14782,11645,273,150,15279,10977
16,2,4,1,0,3,1,0,99,50,14786,11646,111,131,15282,10977
17,2,1,0,0,3,1,0,239,184,14787,11646,264,138,15285,10977
18,3,0,2,1,0,0,3,234,228,14787,11648,248,79,15285,10980
19,3,0,0,2,1,2,1,189,158,14787,11648,196,215,15286,10981
20,3,0,1,1,0,0,3,221,129,14787,11649,225,122,15286,10984
21,3,3,0,0,3,1,0,170,152,14790,11649,180,167,15289,10984
22,3,3,1,0,3,1,0,182,143,14793,11650,189,188,15292,10984
23,3,1,1,2,1,2,1,200,159,14794,11651,200,151,15293,10985
24,3,2,0,0,3,1,0,204,164,14796,11651,192,265,15296,10985
25,3,1,1,2,1,2,1,180,138,14797,11652,210,114,15297,10986
26,3,3,1,0,3,1,0,231,124,14800,11653,234,155,15300,10986
27,4,2,0,0,3,1,0,241,184,14802,11653,267,188,15303,10986
28,4,4,0,0,3,1,0,360,70,14806,11653,312,133,15306,10986
29,4,1,2,1,0,0,3,182,188,14807,11655,169,141,15306,10989
30,4,1,2,1,0,0,3,188,154,14808,11657,192,140,15306,10992
31,4,1,0,0,3,1,0,235,190,14809,11657,217,140,15309,10992
32,4,2,2,2,1,2,1,101,52,14811,11659,112,144,15310,10993
33,4,1,1,2,1,2,1,205,165,14812,11660,193,151,15311,10994
34,4,4,0,0,3,1,0,235,147,14816,11660,226,131,15314,10994
35,4,5,0,0,3,1,0,283,99,14821,11660,276,167,15317,10994
36,5,2,0,0,3,1,0,223,129,14823,11660,228,155,15320,10994
37,5,0,3,1,0,0,3,231,127,14823,11663,234,268,15320,10997
38,5,1,0,0,3,1,0,171,152,14824,11663,183,79,15323,10997
39,5,1,1,2,1,2,1,201,160,14825,11664,201,115,15324,10998
40,5,0,1,1,0,0,3,218,155,14825,11665,224,125,15324,11001
41,5,2,1,0,3,1,0,182,139,14827,11666,213,188,15327,11001
42,5,1,1,2,1,2,1,190,159,14828,11667,197,152,15328,11002
43,5,0,3,1,0,0,3,234,231,14828,11670,248,218,15328,11005
44,5,2,3,1,0,0,3,184,146,14830,11673,189,120,15328,11008
45,6,2,2,2,1,2,1,362,72,14832,11675,313,141,15329,11009
46,6,2,1,0,3,1,0,103,53,14834,11676,115,125,15332,11009
47,6,2,0,0,3,1,0,207,165,14836,11676,196,141,15335,11009
48,6,0,0,2,1,2,1,182,188,14836,11676,170,132,15336,11010
49,6,1,0,0,3,1,0,185,146,14837,11676,192,151,15339,11010
50,6,0,0,2,1,2,1,235,190,14837,11676,218,141,15340,11011
51,6,6,1,0,3,1,0,289,100,14843,11677,279,144,15343,11011
52,6,0,0,2,1,2,1,241,184,14843,11677,268,168,15344,11012
53,6,3,0,0,3,1,0,238,147,14846,11677,229,188,15347,11012
54,7,1,1,2,1,2,1,232,128,14847,11678,235,189,15348,11013
55,7,2,1,0,3,1,0,225,130,14849,11679,231,152,15351,11013
56,7,2,1,0,3,1,0,190,155,14851,11680,195,155,15354,11013
57,7,1,2,1,0,0,3,172,154,14852,11682,183,221,15354,11016
58,7,1,1,2,1,2,1,202,161,14853,11683,202,134,15355,11017
59,7,0,0,2,1,2,1,234,231,14853,11683,249,116,15356,11018
60,7,3,2,0,3,1,0,193,161,14856,11685,200,120,15359,11018
61,7,2,2,2,1,2,1,184,141,14858,11687,214,269,15360,11019
62,7,1,2,1,0,0,3,219,157,14859,11689,224,82,15360,11022
63,8,2,1,0,3,1,0,237,191,14861,11690,221,168,15363,11022
64,8,5,0,0,3,1,0,367,72,14866,11690,316,132,15366,11022
65,8,2,2,2,1,2,1,209,167,14868,11692,197,142,15367,11023
66,8,0,2,1,0,0,3,184,143,14868,11694,214,144,15367,11026
67,8,3,2,0,3,1,0,188,148,14871,11696,195,188,15370,11026
68,8,1,2,1,0,0,3,242,186,14872,11698,268,128,15370,11029
69,8,2,3,1,0,0,3,291,103,14874,11701,279,85,15370,11032
70,8,2,2,2,1,2,1,240,149,14876,11703,230,142,15371,11033
71,8,0,2,1,0,0,3,182,190,14876,11705,170,147,15371,11036
72,9,2,0,0,3,1,0,234,128,14878,11705,238,134,15374,11036
73,9,1,0,0,3,1,0,104,53,14879,11705,118,155,15377,11036
74,9,1,5,1,0,0,3,226,135,14880,11710,231,192,15377,11039
75,9,2,2,2,1,2,1,192,157,14882,11712,196,222,15378,11040
76,9,1,2,1,0,0,3,173,156,14883,11714,183,155,15378,11043
77,9,0,1,1,0,0,3,234,232,14883,11715,249,272,15378,11046
78,9,0,0,2,1,2,1,219,157,14883,11715,225,117,15379,11047
79,9,1,1,2,1,2,1,194,162,14884,11716,201,152,15380,11048
80,9,1,1,2,1,2,1,203,162,14885,11717,203,121,15381,11049
81,10,1,1,2,1,2,1,189,149,14886,11718,196,129,15382,11050
82,10,1,3,1,0,0,3,210,170,14887,11721,197,150,15382,11053
83,10,2,1,0,3,1,0,186,144,14889,11722,217,188,15385,11053
84,10,1,1,2,1,2,1,235,129,14890,11723,239,143,15386,11054
85,10,2,1,0,3,1,0,242,150,14892,11724,233,168,15389,11054
86,10,4,2,0,3,1,0,246,188,14896,11726,271,222,15392,11054
87,10,2,0,0,3,1,0,369,72,14898,11726,319,85,15395,11054
88,10,0,3,1,0,0,3,182,193,14898,11729,170,145,15395,11057
89,10,3,0,0,3,1,0,240,191,14901,11729,224,132,15398,11057
90,11,2,1,0,3,1,0,194,158,14903,11730,199,117,15401,11057
91,11,2,1,0,3,1,0,106,54,14905,11731,121,155,15404,11057
92,11,0,1,1,0,0,3,194,163,14905,11732,201,147,15404,11060
93,11,1,1,2,1,2,1,227,136,14906,11733,232,135,15405,11061
94,11,1,1,2,1,2,1,174,157,14907,11734,184,193,15406,11062
95,11,3,1,0,3,1,0,237,233,14910,11735,252,155,15409,11062
96,11,1,3,1,0,0,3,292,106,14911,11738,279,275,15409,11065
97,11,0,3,1,0,0,3,219,160,14911,11741,225,124,15409,11068
98,11,3,3,2,1,2,1,206,165,14914,11744,204,153,15410,11069
99,12,2,1,0,3,1,0,242,192,14916,11745,227,222,15413,11069
100,12,3,0,0,3,1,0,372,72,14919,11745,322,145,15416,11069
101,12,1,1,2,1,2,1,211,171,14920,11746,198,130,15417,11070
102,12,2,2,2,1,2,1,244,152,14922,11748,234,86,15418,11071
103,12,1,0,0,3,1,0,190,149,14923,11748,199,168,15421,11071
104,12,3,1,0,3,1,0,209,166,14926,11749,207,132,15424,11071
105,12,2,4,1,0,0,3,188,148,14928,11753,217,153,15424,11074
106,12,2,0,0,3,1,0,237,129,14930,11753,242,188,15427,11074
107,12,4,0,0,3,1,0,186,193,14934,11753,173,155,15430,11074
108,13,1,1,2,1,2,1,247,189,14935,11754,272,156,15431,11075
109,13,4,4,2,1,2,1,296,110,14939,11758,280,148,15432,11076
110,13,2,0,0,3,1,0,108,54,14941,11758,124,117,15435,11076
111,13,2,1,0,3,1,0,196,164,14943,11759,204,135,15438,11076
112,13,0,1,1,0,0,3,194,159,14943,11760,199,196,15438,11079
113,13,2,1,0,3,1,0,176,158,14945,11761,187,143,15441,11079
114,13,2,1,0,3,1,0,229,137,14947,11762,235,275,15444,11079
115,13,3,0,0,3,1,0,240,233,14950,11762,255,124,15447,11079
116,13,0,2,1,0,0,3,219,162,14950,11764,225,156,15447,11082
117,14,0,0,2,1,2,1,196,164,14950,11764,205,189,15448,11083
118,14,3,1,0,3,1,0,375,73,14953,11765,325,155,15451,11083
119,14,4,0,0,3,1,0,215,171,14957,11765,201,86,15454,11083
120,14,1,0,0,3,1,0,187,193,14958,11765,176,156,15457,11083
121,14,1,1,2,1,2,1,245,153,14959,11766,235,223,15458,11084
122,14,1,3,1,0,0,3,191,152,14960,11769,199,148,15458,11087
123,14,2,2,2,1,2,1,239,131,14962,11771,243,169,15459,11088
124,14,1,2,1,0,0,3,189,150,14963,11773,217,133,15459,11091
125,14,3,0,0,3,1,0,212,166,14966,11773,210,153,15462,11091
126,15,0,2,1,0,0,3,242,194,14966,11775,227,199,15462,11094
127,15,1,2,1,0,0,3,297,112,14967,11777,280,120,15462,11097
128,15,2,2,2,1,2,1,110,56,14969,11779,125,136,15463,11098
129,15,0,1,1,0,0,3,194,160,14969,11780,199,278,15463,11101
130,15,0,0,2,1,2,1,240,233,14969,11780,256,144,15464,11102
131,15,1,1,2,1,2,1,230,138,14970,11781,236,149,15465,11103
132,15,3,4,1,0,0,3,222,166,14973,11785,225,135,15465,11106
133,15,2,0,0,3,1,0,249,189,14975,11785,275,124,15468,11106
134,15,1,1,2,1,2,1,177,159,14976,11786,188,157,15469,11107
135,16,1,1,2,1,2,1,213,167,14977,11787,211,87,15470,11108
136,16,1,2,1,0,0,3,241,235,14978,11789,256,136,15470,11111
137,16,1,0,0,3,1,0,197,164,14979,11789,208,153,15473,11111
138,16,0,2,1,0,0,3,191,154,14979,11791,199,226,15473,11114
139,16,1,0,0,3,1,0,216,171,14980,11791,204,156,15476,11114
140,16,1,0,0,3,1,0,376,73,14981,11791,328,169,15479,11114
141,16,3,1,0,3,1,0,192,151,14984,11792,220,155,15482,11114
142,16,3,2,0,3,1,0,242,133,14987,11794,246,148,15485,11114
143,16,1,0,0,3,1,0,246,153,14988,11794,238,120,15488,11114
144,17,3,1,0,3,1,0,233,139,14991,11795,239,189,15491,11114
145,17,1,0,0,3,1,0,223,166,14992,11795,228,144,15494,11114
146,17,2,2,2,1,2,1,189,195,14994,11797,177,137,15495,11115
147,17,2,2,2,1,2,1,196,162,14996,11799,200,150,15496,11116
148,17,3,3,2,1,2,1,180,162,14999,11802,189,136,15497,11117
149,17,0,1,1,0,0,3,242,195,14999,11803,227,281,15497,11120
150,17,2,1,0,3,1,0,299,113,15001,11804,283,124,15500,11120
151,17,4,4,2,1,2,1,253,193,15005,11808,276,200,15501,11121
152,17,2,3,1,0,0,3,112,59,15007,11811,125,160,15501,11124
153,18,1,3,1,0,0,3,247,156,15008,11814,238,284,15501,11127
154,18,1,1,2,1,2,1,190,196,15009,11815,178,125,15502,11128
155,18,1,0,0,3,1,0,243,195,15010,11815,230,160,15505,11128
156,18,1,1,2,1,2,1,197,163,15011,11816,201,137,15506,11129
157,18,1,0,0,3,1,0,181,162,15012,11816,192,189,15509,11129
158,18,3,2,0,3,1,0,256,195,15015,11818,279,137,15512,11129
159,18,3,1,0,3,1,0,115,60,15018,11819,128,150,15515,11129
160,18,2,1,0,3,1,0,225,167,15020,11820,231,153,15518,11129
161,18,0,0,2,1,2,1,299,113,15020,11820,284,145,15519,11130
162,19,1,1,2,1,2,1,193,152,15021,11821,221,227,15520,11131
163,19,2,1,0,3,1,0,199,165,15023,11822,211,87,15523,11131
164,19,1,3,1,0,0,3,214,170,15024,11825,211,139,15523,11134
165,19,1,4,1,0,0,3,217,175,15025,11829,204,203,15523,11137
166,19,2,0,0,3,1,0,235,139,15027,11829,242,148,15526,11137
167,19,3,2,0,3,1,0,194,156,15030,11831,202,156,15529,11137
168,19,0,2,1,0,0,3,241,237,15030,11833,256,172,15529,11140
169,19,4,2,0,3,1,0,380,75,15034,11835,331,120,15532,11140
170,19,1,1,2,1,2,1,243,134,15035,11836,247,156,15533,11141
171,20,2,0,0,3,1,0,199,163,15037,11836,204,153,15536,11141
172,20,5,2,0,3,1,0,385,77,15042,11838,334,125,15539,11141
173,20,2,2,2,1,2,1,301,115,15044,11840,285,138,15540,11142
174,20,0,2,1,0,0,3,243,197,15044,11842,230,153,15540,11145
175,20,1,1,2,1,2,1,226,168,15045,11843,232,149,15541,11146
176,20,1,1,2,1,2,1,116,61,15046,11844,129,190,15542,11147
177,20,0,0,2,1,2,1,190,196,15046,11844,179,161,15543,11148
178,20,2,0,0,3,1,0,249,156,15048,11844,241,137,15546,11148
179,20,0,1,1,0,0,3,256,196,15048,11845,279,148,15546,11151
180,21,2,3,1,0,0,3,228,171,15050,11848,232,230,15546,11154
181,21,0,2,1,0,0,3,194,158,15050,11850,202,287,15546,11157
182,21,1,1,2,1,2,1,194,153,15051,11851,222,126,15547,11158
183,21,1,2,1,0,0,3,244,136,15052,11853,247,123,15547,11161
184,21,0,0,2,1,2,1,199,165,15052,11853,212,204,15548,11162
185,21,1,1,2,1,2,1,215,171,15053,11854,212,157,15549,11163
186,21,0,1,1,0,0,3,235,140,15053,11855,242,90,15549,11166
187,21,3,0,0,3,1,0,184,162,15056,11855,195,139,15552,11166
188,21,1,1,2,1,2,1,242,238,15057,11856,257,157,15553,11167
189,22,2,0,0,3,1,0,118,61,15059,11856,132,149,15556,11167
190,22,4,2,0,3,1,0,203,165,15063,11858,207,172,15559,11167
191,22,0,2,1,0,0,3,249,158,15063,11860,241,164,15559,11170
192,22,2,1,0,3,1,0,258,197,15065,11861,282,138,15562,11170
193,22,2,0,0,3,1,0,303,115,15067,11861,288,190,15565,11170
194,22,4,2,0,3,1,0,221,177,15071,11863,207,137,15568,11170
195,22,2,1,0,3,1,0,387,78,15073,11864,337,153,15571,11170
196,22,1,0,0,3,1,0,244,197,15074,11864,233,153,15574,11170
197,22,3,1,0,3,1,0,193,197,15077,11865,182,148,15577,11170
198,23,0,2,1,0,0,3,194,155,15077,11867,222,140,15577,11173
199,23,1,2,1,0,0,3,216,173,15078,11869,212,290,15577,11176
200,23,1,0,0,3,1,0,200,165,15079,11869,215,123,15580,11176
201,23,1,2,1,0,0,3,243,240,15080,11871,257,207,15580,11179
202,23,1,1,2,1,2,1,229,172,15081,11872,233,158,15581,11180
203,23,2,1,0,3,1,0,246,137,15083,11873,250,126,15584,11180
204,23,0,1,1,0,0,3,184,163,15083,11874,195,160,15584,11183
205,23,0,1,1,0,0,3,235,141,15083,11875,242,233,15584,11186
206,23,2,1,0,3,1,0,205,166,15085,11876,210,90,15587,11186
207,24,1,1,2,1,2,1,195,159,15086,11877,203,149,15588,11187
208,24,0,0,2,1,2,1,387,78,15086,11877,338,165,15589,11188
209,24,1,1,2,1,2,1,222,178,15087,11878,208,139,15590,11189
210,24,0,1,1,0,0,3,258,198,15087,11879,282,156,15590,11192
211,24,1,0,0,3,1,0,245,197,15088,11879,236,139,15593,11192
212,24,1,0,0,3,1,0,194,197,15089,11879,185,190,15596,11192
213,24,0,2,1,0,0,3,249,160,15089,11881,241,156,15596,11195
214,24,1,2,1,0,0,3,119,63,15090,11883,132,175,15596,11198
215,24,1,1,2,1,2,1,304,116,15091,11884,289,150,15597,11199
216,25,2,2,2,1,2,1,237,143,15093,11886,243,124,15598,11200
217,25,1,0,0,3,1,0,247,137,15094,11886,253,165,15601,11200
218,25,1,0,0,3,1,0,206,166,15095,11886,213,158,15604,11200
219,25,0,2,1,0,0,3,184,165,15095,11888,195,129,15604,11203
220,25,0,0,2,1,2,1,243,240,15095,11888,258,141,15605,11204
221,25,1,2,1,0,0,3,217,175,15096,11890,212,210,15605,11207
222,25,1,1,2,1,2,1,120,64,15097,11891,133,234,15606,11208
223,25,2,3,1,0,0,3,231,175,15099,11894,233,163,15606,11211
224,25,0,4,1,0,0,3,200,169,15099,11898,215,293,15606,11214
225,26,0,1,1,0,0,3,195,160,15099,11899,203,159,15606,11217
226,26,0,0,2,1,2,1,194,155,15099,11899,223,140,15607,11218
227,26,1,3,1,0,0,3,259,201,15100,11902,282,153,15607,11221
228,26,6,0,0,3,1,0,393,78,15106,11902,341,190,15610,11221
229,26,3,0,0,3,1,0,225,178,15109,11902,211,149,15613,11221
230,26,2,0,0,3,1,0,251,160,15111,11902,244,156,15616,11221
231,26,0,0,2,1,2,1,245,197,15111,11902,237,91,15617,11222
232,26,3,2,0,3,1,0,307,118,15114,11904,292,139,15620,11222
233,26,3,1,0,3,1,0,197,198,15117,11905,188,175,15623,11222
234,27,1,2,1,0,0,3,201,171,15118,11907,215,166,15623,11225
235,27,3,3,2,1,2,1,240,146,15121,11910,244,130,15624,11226
236,27,1,2,1,0,0,3,244,242,15122,11912,258,168,15624,11229
237,27,1,3,1,0,0,3,185,168,15123,11915,195,127,15624,11232
238,27,3,0,0,3,1,0,209,166,15126,11915,216,141,15627,11232
239,27,0,1,1,0,0,3,217,176,15126,11916,212,162,15627,11235
240,27,1,0,0,3,1,0,308,118,15127,11916,295,158,15630,11235
241,27,2,0,0,3,1,0,233,175,15129,11916,236,210,15633,11235
242,27,2,1,0,3,1,0,122,65,15131,11917,136,293,15636,11235
243,28,2,3,1,0,0,3,261,204,15133,11920,282,94,15636,11238
244,28,6,0,0,3,1,0,231,178,15139,11920,214,175,15639,11238
245,28,2,0,0,3,1,0,249,137,15141,11920,256,140,15642,11238
246,28,0,0,2,1,2,1,251,160,15141,11920,245,154,15643,11239
247,28,1,1,2,1,2,1,246,198,15142,11921,238,191,15644,11240
248,28,6,0,0,3,1,0,399,78,15148,11921,344,234,15647,11240
249,28,0,0,2,1,2,1,194,155,15148,11921,224,150,15648,11241
250,28,2,1,0,3,1,0,199,199,15150,11922,191,139,15651,11241
251,28,0,0,2,1,2,1,195,160,15150,11922,204,157,15652,11242
252,29,2,1,0,3,1,0,263,205,15152,11923,285,127,15655,11242
253,29,1,4,1,0,0,3,186,172,15153,11927,195,296,15655,11245
254,29,2,1,0,3,1,0,242,147,15155,11928,247,168,15658,11245
255,29,1,1,2,1,2,1,234,176,15156,11929,237,142,15659,11246
256,29,0,2,1,0,0,3,201,173,15156,11931,215,153,15659,11249
257,29,3,2,0,3,1,0,247,244,15159,11933,261,162,15662,11249
258,29,3,0,0,3,1,0,311,118,15162,11933,298,166,15665,11249
259,29,1,1,2,1,2,1,210,167,15163,11934,217,131,15666,11250
260,29,1,4,1,0,0,3,123,69,15164,11938,136,213,15666,11253
261,30,0,0,2,1,2,1,217,176,15164,11938,213,155,15667,11254
262,30,2,1,0,3,1,0,196,156,15166,11939,227,175,15670,11254
263,30,4,1,0,3,1,0,255,161,15170,11940,248,139,15673,11254
264,30,2,0,0,3,1,0,233,178,15172,11940,217,191,15676,11254
265,30,1,1,2,1,2,1,247,199,15173,11941,239,159,15677,11255
266,30,5,1,0,3,1,0,404,79,15178,11942,347,157,15680,11255
267,30,2,0,0,3,1,0,251,137,15180,11942,259,234,15683,11255
268,30,1,1,2,1,2,1,200,200,15181,11943,192,95,15684,11256
269,30,2,0,0,3,1,0,197,160,15183,11943,207,140,15687,11256
270,31,3,0,0,3,1,0,245,147,15186,11943,250,153,15690,11256
271,31,0,3,1,0,0,3,263,208,15186,11946,285,299,15690,11259
272,31,2,5,1,0,0,3,125,74,15188,11951,136,134,15690,11262
273,31,0,3,1,0,0,3,210,170,15188,11954,217,171,15690,11265
274,31,1,0,0,3,1,0,248,244,15189,11954,264,140,15693,11265
275,31,2,0,0,3,1,0,249,199,15191,11954,242,127,15696,11265
276,31,4,0,0,3,1,0,315,118,15195,11954,301,213,15699,11265
277,31,2,0,0,3,1,0,188,172,15197,11954,198,142,15702,11265
278,31,2,2,2,1,2,1,236,178,15199,11956,238,163,15703,11266
279,32,3,1,0,3,1,0,236,179,15202,11957,220,159,15706,11266
280,32,3,2,0,3,1,0,204,175,15205,11959,218,175,15709,11266
281,32,1,1,2,1,2,1,252,138,15206,11960,260,158,15710,11267
282,32,4,1,0,3,1,0,408,80,15210,11961,350,139,15713,11267
283,32,2,2,2,1,2,1,198,158,15212,11963,228,156,15714,11268
284,32,1,3,1,0,0,3,218,179,15213,11966,213,194,15714,11271
285,32,0,1,1,0,0,3,255,162,15213,11967,248,169,15714,11274
286,32,3,0,0,3,1,0,200,160,15216,11967,210,95,15717,11274
287,32,1,1,2,1,2,1,201,201,15217,11968,193,235,15718,11275
288,33,1,3,1,0,0,3,237,181,15218,11971,238,302,15718,11278
289,33,2,0,0,3,1,0,251,199,15220,11971,245,134,15721,11278
290,33,3,1,0,3,1,0,266,209,15223,11972,288,171,15724,11278
291,33,3,1,0,3,1,0,248,148,15226,11973,253,140,15727,11278
292,33,1,2,1,0,0,3,189,174,15227,11975,198,166,15727,11281
293,33,0,0,2,1,2,1,201,201,15227,11975,194,214,15728,11282
294,33,3,0,0,3,1,0,213,170,15230,11975,220,194,15731,11282
295,33,1,2,1,0,0,3,316,120,15231,11977,301,145,15731,11285
296,33,4,1,0,3,1,0,129,75,15235,11978,139,153,15734,11285
297,34,3,1,0,3,1,0,239,180,15238,11979,223,235,15737,11285
298,34,2,6,1,0,0,3,200,164,15240,11985,228,98,15737,11288
299,34,4,1,0,3,1,0,222,180,15244,11986,216,175,15740,11288
300,34,1,2,1,0,0,3,201,162,15245,11988,210,130,15740,11291
301,34,2,1,0,3,1,0,250,245,15247,11989,267,158,15743,11291
302,34,1,0,0,3,1,0,253,138,15248,11989,263,139,15746,11291
303,34,2,0,0,3,1,0,206,175,15250,11989,221,156,15749,11291
304,34,3,2,0,3,1,0,258,164,15253,11991,251,159,15752,11291
305,34,1,4,1,0,0,3,409,84,15254,11995,350,172,15752,11294
0,1,3,1,0,3,1,0,412,85,15257,11996,353,134,15755,11294
1,1,1,0,0,3,1,0,201,164,15258,11996,231,198,15758,11294
2,1,1,1,2,1,2,1,202,202,15259,11997,195,160,15759,11295
3,1,0,2,1,0,0,3,206,177,15259,11999,221,142,15759,11298
4,1,2,1,0,3,1,0,224,181,15261,12000,219,166,15762,11298
5,1,1,2,1,0,0,3,231,186,15262,12002,247,159,15762,11301
6,1,2,0,0,3,1,0,250,148,15264,12002,256,214,15765,11301
7,1,1,0,0,3,1,0,202,162,15265,12002,213,172,15768,11301
8,1,4,1,0,3,1,0,320,121,15269,12003,304,98,15771,11301
9,2,0,0,2,1,2,1,266,209,15269,12003,289,236,15772,11302
10,2,1,1,2,1,2,1,190,175,15270,12004,199,159,15773,11303
11,2,1,3,1,0,0,3,259,167,15271,12007,251,156,15773,11306
12,2,1,2,1,0,0,3,214,172,15272,12009,220,133,15773,11309
13,2,3,1,0,3,1,0,242,181,15275,12010,226,140,15776,11309
14,2,1,1,2,1,2,1,235,230,15276,12011,244,146,15777,11310
15,2,0,3,1,0,0,3,251,202,15276,12014,245,305,15777,11313
16,2,1,1,2,1,2,1,130,76,15277,12015,140,176,15778,11314
17,2,0,2,1,0,0,3,253,140,15277,12017,263,174,15778,11317
18,3,3,1,0,3,1,0,323,122,15280,12018,307,142,15781,11317
19,3,3,1,0,3,1,0,415,86,15283,12019,356,214,15784,11317
20,3,2,1,0,3,1,0,233,187,15285,12020,250,134,15787,11317
21,3,2,1,0,3,1,0,204,163,15287,12021,216,159,15790,11317
22,3,3,2,0,3,1,0,133,78,15290,12023,143,160,15793,11317
23,3,2,2,2,1,2,1,226,183,15292,12025,220,175,15794,11318
24,3,2,1,0,3,1,0,252,149,15294,12026,259,166,15797,11318
25,3,1,1,2,1,2,1,203,203,15295,12027,196,199,15798,11319
26,3,3,3,2,1,2,1,209,180,15298,12030,222,173,15799,11320
27,4,0,0,2,1,2,1,251,202,15298,12030,246,177,15800,11321
28,4,2,3,1,0,0,3,192,178,15300,12033,199,136,15800,11324
29,4,4,2,0,3,1,0,205,166,15304,12035,234,159,15803,11324
30,4,1,1,2,1,2,1,243,182,15305,12036,227,237,15804,11325
31,4,2,0,0,3,1,0,237,230,15307,12036,247,160,15807,11325
32,4,1,3,1,0,0,3,227,186,15308,12039,220,143,15807,11328
33,4,0,2,1,0,0,3,253,142,15308,12041,263,308,15807,11331
34,4,1,0,0,3,1,0,260,167,15309,12041,254,146,15810,11331
35,4,1,1,2,1,2,1,215,173,15310,12042,221,99,15811,11332
36,5,3,1,0,3,1,0,206,204,15313,12043,199,175,15814,11332
37,5,1,1,2,1,2,1,416,87,15314,12044,357,160,15815,11333
38,5,1,0,0,3,1,0,210,180,15315,12044,225,166,15818,11333
39,5,1,3,1,0,0,3,267,212,15316,12047,289,137,15818,11336
40,5,1,2,1,0,0,3,234,189,15317,12049,250,217,15818,11339
41,5,3,1,0,3,1,0,255,150,15320,12050,262,142,15821,11339
42,5,7,0,0,3,1,0,330,122,15327,12050,310,199,15824,11339
43,5,0,0,2,1,2,1,204,163,15327,12050,217,157,15825,11340
44,5,2,0,0,3,1,0,135,78,15329,12050,146,173,15828,11340
45,6,2,0,0,3,1,0,207,166,15331,12050,237,308,15831,11340
46,6,1,2,1,0,0,3,244,184,15332,12052,227,102,15831,11343
47,6,3,0,0,3,1,0,240,230,15335,12052,250,177,15834,11343
48,6,1,0,0,3,1,0,254,142,15336,12052,266,146,15837,11343
49,6,2,1,0,3,1,0,253,203,15338,12053,249,136,15840,11343
50,6,2,2,2,1,2,1,229,188,15340,12055,221,160,15841,11344
51,6,2,4,1,0,0,3,262,171,15342,12059,254,240,15841,11347
52,6,4,1,0,3,1,0,219,174,15346,12060,224,160,15844,11347
53,6,4,1,0,3,1,0,196,179,15350,12061,202,143,15847,11347
54,7,2,0,0,3,1,0,208,204,15352,12061,202,157,15850,11347
55,7,4,3,0,3,1,0,334,125,15356,12064,313,160,15853,11347
56,7,0,2,1,0,0,3,234,191,15356,12066,250,169,15853,11350
57,7,3,1,0,3,1,0,270,213,15359,12067,292,173,15856,11350
58,7,0,0,2,1,2,1,204,163,15359,12067,218,176,15857,11351
59,7,0,3,1,0,0,3,416,90,15359,12070,357,163,15857,11354
60,7,0,0,2,1,2,1,210,180,15359,12070,226,218,15858,11355
61,7,1,2,1,0,0,3,245,186,15360,12072,227,145,15858,11358
62,7,6,0,0,3,1,0,141,78,15366,12072,149,199,15861,11358
63,8,7,1,0,3,1,0,226,175,15373,12073,227,177,15864,11358
64,8,0,0,2,1,2,1,196,179,15373,12073,203,103,15865,11359
65,8,2,2,2,1,2,1,264,173,15375,12075,255,161,15866,11360
66,8,1,3,1,0,0,3,241,233,15376,12078,250,140,15866,11363
67,8,0,4,1,0,0,3,253,207,15376,12082,249,243,15866,11366
68,8,1,3,1,0,0,3,230,191,15377,12085,221,311,15866,11369
69,8,0,2,1,0,0,3,254,144,15377,12087,266,139,15866,11372
70,8,1,1,2,1,2,1,208,167,15378,12088,238,144,15867,11373
71,8,4,0,0,3,1,0,259,150,15382,12088,265,146,15870,11373
72,9,3,1,0,3,1,0,213,181,15385,12089,229,163,15873,11373
73,9,2,2,2,1,2,1,336,127,15387,12091,314,177,15874,11374
74,9,0,3,1,0,0,3,234,194,15387,12094,250,160,15874,11377
75,9,1,2,1,0,0,3,271,215,15388,12096,292,163,15874,11380
76,9,1,2,1,0,0,3,205,165,15389,12098,218,314,15874,11383
77,9,4,0,0,3,1,0,249,186,15393,12098,230,173,15877,11383
78,9,1,1,2,1,2,1,242,234,15394,12099,251,146,15878,11384
79,9,0,0,2,1,2,1,141,78,15394,12099,150,170,15879,11385
80,9,2,6,1,0,0,3,210,210,15396,12105,202,221,15879,11388
81,10,0,3,1,0,0,3,253,210,15396,12108,249,149,15879,11391
82,10,2,2,2,1,2,1,198,181,15398,12110,204,200,15880,11392
83,10,1,4,1,0,0,3,265,177,15399,12114,255,143,15880,11395
84,10,1,1,2,1,2,1,417,91,15400,12115,358,145,15881,11396
85,10,3,1,0,3,1,0,257,145,15403,12116,269,161,15884,11396
86,10,0,1,1,0,0,3,230,192,15403,12117,221,246,15884,11399
87,10,0,3,1,0,0,3,208,170,15403,12120,238,106,15884,11402
88,10,3,0,0,3,1,0,262,150,15406,12120,268,177,15887,11402
89,10,2,1,0,3,1,0,207,166,15408,12121,221,139,15890,11402
90,11,2,1,0,3,1,0,273,216,15410,12122,295,160,15893,11402
91,11,4,1,0,3,1,0,238,195,15414,12123,253,177,15896,11402
92,11,1,3,1,0,0,3,214,184,15415,12126,229,149,15896,11405
93,11,2,1,0,3,1,0,251,187,15417,12127,233,163,15899,11405
94,11,0,2,1,0,0,3,242,236,15417,12129,251,176,15899,11408
95,11,1,3,1,0,0,3,211,213,15418,12132,202,166,15899,11411
96,11,3,2,0,3,1,0,339,129,15421,12134,317,314,15902,11411
97,11,3,0,0,3,1,0,144,78,15424,12134,153,221,15905,11411
98,11,3,0,0,3,1,0,229,175,15427,12134,230,170,15908,11411
99,12,2,0,0,3,1,0,267,177,15429,12134,258,176,15911,11411
100,12,1,3,1,0,0,3,199,184,15430,12137,204,152,15911,11414
101,12,3,3,2,1,2,1,420,94,15433,12140,359,178,15912,11415
102,12,3,3,2,1,2,1,211,173,15436,12143,239,144,15913,11416
103,12,1,2,1,0,0,3,208,168,15437,12145,221,249,15913,11419
104,12,1,0,0,3,1,0,231,192,15438,12145,224,106,15916,11419
105,12,5,2,0,3,1,0,262,147,15443,12147,272,200,15919,11419
106,12,1,1,2,1,2,1,215,185,15444,12148,230,140,15920,11420
107,12,4,1,0,3,1,0,266,151,15448,12149,271,161,15923,11420
108,13,0,1,1,0,0,3,238,196,15448,12150,253,152,15923,11423
109,13,2,0,0,3,1,0,341,129,15450,12150,320,145,15926,11423
110,13,0,2,1,0,0,3,273,218,15450,12152,295,180,15926,11426
111,13,1,0,0,3,1,0,254,210,15451,12152,252,163,15929,11426
112,13,1,2,1,0,0,3,212,215,15452,12154,202,317,15929,11429
113,13,1,1,2,1,2,1,252,188,15453,12155,234,171,15930,11430
114,13,2,0,0,3,1,0,146,78,15455,12155,156,166,15933,11430
115,13,1,2,1,0,0,3,230,177,15456,12157,230,163,15933,11433
116,13,1,1,2,1,2,1,243,237,15457,12158,252,222,15934,11434
117,14,3,1,0,3,1,0,215,216,15460,12159,205,178,15937,11434
118,14,1,0,0,3,1,0,268,177,15461,12159,261,163,15940,11434
119,14,3,0,0,3,1,0,423,94,15464,12159,362,200,15943,11434
120,14,3,0,0,3,1,0,218,185,15467,12159,233,106,15946,11434
121,14,1,2,1,0,0,3,263,149,15468,12161,272,252,15946,11437
122,14,2,2,2,1,2,1,233,194,15470,12163,225,145,15947,11438
123,14,1,0,0,3,1,0,212,173,15471,12163,242,152,15950,11438
124,14,1,1,2,1,2,1,209,169,15472,12164,222,162,15951,11439
125,14,3,0,0,3,1,0,269,151,15475,12164,274,176,15954,11439
126,15,0,2,1,0,0,3,243,239,15475,12166,252,166,15954,11442
127,15,1,1,2,1,2,1,200,185,15476,12167,205,172,15955,11443
128,15,2,0,0,3,1,0,240,196,15478,12167,256,145,15958,11443
129,15,0,4,1,0,0,3,273,222,15478,12171,295,320,15958,11446
130,15,0,0,2,1,2,1,252,188,15478,12171,235,167,15959,11447
131,15,2,1,0,3,1,0,256,211,15480,12172,255,180,15962,11447
132,15,2,1,0,3,1,0,343,130,15482,12173,323,140,15965,11447
133,15,4,1,0,3,1,0,150,79,15486,12174,159,152,15968,11447
134,15,2,1,0,3,1,0,232,178,15488,12175,233,222,15971,11447
135,16,2,0,0,3,1,0,271,151,15490,12175,277,200,15974,11447
136,16,2,1,0,3,1,0,242,197,15492,12176,259,252,15977,11447
137,16,2,2,2,1,2,1,214,175,15494,12178,243,164,15978,11448
138,16,2,0,0,3,1,0,235,194,15496,12178,228,176,15981,11448
139,16,1,2,1,0,0,3,264,151,15497,12180,272,225,15981,11451
140,16,1,0,0,3,1,0,424,94,15498,12180,365,106,15984,11451
141,16,1,1,2,1,2,1,219,186,15499,12181,234,163,15985,11452
142,16,2,2,2,1,2,1,211,171,15501,12183,223,153,15986,11453
143,16,1,1,2,1,2,1,216,217,15502,12184,206,146,15987,11454
144,17,2,1,0,3,1,0,345,131,15504,12185,326,167,15990,11454
145,17,3,1,0,3,1,0,271,178,15507,12186,264,180,15993,11454
146,17,0,1,1,0,0,3,273,223,15507,12187,295,181,15993,11457
147,17,0,1,1,0,0,3,243,240,15507,12188,252,148,15993,11460
148,17,3,2,0,3,1,0,153,81,15510,12190,162,140,15996,11460
149,17,1,3,1,0,0,3,257,214,15511,12193,255,175,15996,11463
150,17,0,3,1,0,0,3,232,181,15511,12196,233,323,15996,11466
151,17,2,3,1,0,0,3,202,188,15513,12199,205,169,15996,11469
152,17,1,1,2,1,2,1,253,189,15514,12200,236,153,15997,11470
153,18,1,3,1,0,0,3,254,192,15515,12203,236,326,15997,11473
154,18,1,2,1,0,0,3,203,190,15516,12205,205,184,15997,11476
155,18,0,1,1,0,0,3,271,179,15516,12206,264,170,15997,11479
156,18,3,1,0,3,1,0,235,182,15519,12207,236,148,16000,11479
157,18,0,1,1,0,0,3,273,224,15519,12208,295,143,16000,11482
158,18,2,3,1,0,0,3,259,217,15521,12211,255,156,16000,11485
159,18,0,1,1,0,0,3,153,82,15521,12212,162,255,16000,11488
160,18,1,3,1,0,0,3,244,243,15522,12215,252,183,16000,11491
161,18,2,1,0,3,1,0,266,152,15524,12216,275,169,16003,11491
162,19,2,2,2,1,2,1,216,177,15526,12218,244,176,16004,11492
163,19,2,0,0,3,1,0,273,151,15528,12218,280,164,16007,11492
164,19,5,1,0,3,1,0,350,132,15533,12219,329,163,16010,11492
165,19,2,4,1,0,0,3,221,190,15535,12223,234,149,16010,11495
166,19,2,1,0,3,1,0,213,172,15537,12224,226,200,16013,11495
167,19,0,3,1,0,0,3,235,197,15537,12227,228,228,16013,11498
168,19,2,2,2,1,2,1,218,219,15539,12229,207,154,16014,11499
169,19,4,1,0,3,1,0,428,95,15543,12230,368,176,16017,11499
170,19,0,4,1,0,0,3,242,201,15543,12234,259,109,16017,11502
171,20,0,3,1,0,0,3,273,227,15543,12237,295,112,16017,11505
172,20,3,1,0,3,1,0,274,180,15546,12238,267,326,16020,11505
173,20,1,1,2,1,2,1,236,183,15547,12239,237,256,16021,11506
174,20,0,1,1,0,0,3,216,178,15547,12240,244,172,16021,11509
175,20,1,1,2,1,2,1,255,193,15548,12241,237,185,16022,11510
176,20,1,1,2,1,2,1,245,244,15549,12242,253,144,16023,11511
177,20,0,2,1,0,0,3,266,154,15549,12244,275,173,16023,11514
178,20,3,0,0,3,1,0,206,190,15552,12244,208,156,16026,11514
179,20,2,2,2,1,2,1,261,219,15554,12246,256,149,16027,11515
180,21,1,5,1,0,0,3,214,177,15555,12251,226,231,16027,11518
181,21,0,3,1,0,0,3,273,154,15555,12254,280,186,16027,11521
182,21,3,3,2,1,2,1,353,135,15558,12257,330,150,16028,11522
183,21,3,3,2,1,2,1,224,193,15561,12260,235,173,16029,11523
184,21,2,0,0,3,1,0,275,227,15563,12260,298,200,16032,11523
185,21,0,0,2,1,2,1,153,82,15563,12260,163,155,16033,11524
186,21,3,1,0,3,1,0,431,96,15566,12261,371,176,16036,11524
187,21,4,0,0,3,1,0,222,219,15570,12261,210,164,16039,11524
188,21,3,0,0,3,1,0,245,201,15573,12261,262,176,16042,11524
189,22,2,3,1,0,0,3,208,193,15575,12264,208,329,16042,11527
190,22,3,0,0,3,1,0,258,193,15578,12264,240,163,16045,11527
191,22,0,0,2,1,2,1,266,154,15578,12264,276,150,16046,11528
192,22,1,3,1,0,0,3,262,222,15579,12267,256,115,16046,11531
193,22,3,0,0,3,1,0,238,197,15582,12267,231,156,16049,11531
194,22,1,1,2,1,2,1,217,179,15583,12268,245,145,16050,11532
195,22,1,1,2,1,2,1,237,184,15584,12269,238,174,16051,11533
196,22,2,0,0,3,1,0,276,180,15586,12269,270,185,16054,11533
197,22,0,0,2,1,2,1,245,244,15586,12269,254,257,16055,11534
198,23,1,1,2,1,2,1,223,220,15587,12270,211,177,16056,11535
199,23,1,0,0,3,1,0,432,96,15588,12270,374,186,16059,11535
200,23,0,3,1,0,0,3,273,157,15588,12273,280,176,16059,11538
201,23,5,1,0,3,1,0,229,194,15593,12274,238,164,16062,11538
202,23,3,0,0,3,1,0,217,177,15596,12274,229,176,16065,11538
203,23,2,1,0,3,1,0,247,202,15598,12275,265,200,16068,11538
204,23,0,3,1,0,0,3,275,230,15598,12278,298,158,16068,11541
205,23,3,2,0,3,1,0,356,137,15601,12280,333,231,16071,11541
206,23,1,1,2,1,2,1,154,83,15602,12281,164,151,16072,11542
207,24,2,1,0,3,1,0,210,194,15604,12282,211,257,16075,11542
208,24,2,0,0,3,1,0,278,180,15606,12282,273,150,16078,11542
209,24,3,2,0,3,1,0,240,186,15609,12284,241,151,16081,11542
210,24,2,1,0,3,1,0,219,180,15611,12285,248,156,16084,11542
211,24,0,1,1,0,0,3,245,245,15611,12286,254,118,16084,11545
212,24,0,4,1,0,0,3,266,158,15611,12290,276,188,16084,11548
213,24,1,5,1,0,0,3,274,162,15612,12295,280,332,16084,11551
214,24,5,1,0,3,1,0,267,223,15617,12296,259,163,16087,11551
215,24,1,1,2,1,2,1,239,198,15618,12297,232,146,16088,11552
216,25,4,2,0,3,1,0,227,222,15622,12299,214,176,16091,11552
217,25,6,0,0,3,1,0,438,96,15628,12299,377,176,16094,11552
218,25,3,1,0,3,1,0,359,138,15631,12300,336,177,16097,11552
219,25,2,1,0,3,1,0,231,195,15633,12301,241,186,16100,11552
220,25,0,0,2,1,2,1,154,83,15633,12301,165,165,16101,11553
221,25,0,1,1,0,0,3,217,178,15633,12302,229,177,16101,11556
222,25,2,1,0,3,1,0,260,194,15635,12303,243,200,16104,11556
223,25,2,3,1,0,0,3,277,233,15637,12306,298,234,16104,11559
224,25,0,3,1,0,0,3,247,205,15637,12309,265,161,16104,11562
225,26,1,1,2,1,2,1,275,163,15638,12310,281,151,16105,11563
226,26,3,1,0,3,1,0,213,195,15641,12311,214,163,16108,11563
227,26,0,1,1,0,0,3,266,159,15641,12312,276,121,16108,11566
228,26,1,1,2,1,2,1,268,224,15642,12313,260,152,16109,11567
229,26,5,2,0,3,1,0,244,200,15647,12315,235,188,16112,11567
230,26,2,3,1,0,0,3,221,183,15649,12318,248,260,16112,11570
231,26,1,3,1,0,0,3,279,183,15650,12321,273,149,16112,11573
232,26,1,0,0,3,1,0,241,186,15651,12321,244,200,16115,11573
233,26,6,0,0,3,1,0,444,96,15657,12321,380,156,16118,11573
234,27,4,1,0,3,1,0,264,195,15661,12322,246,234,16121,11573
235,27,2,0,0,3,1,0,361,138,15663,12322,339,176,16124,11573
236,27,3,1,0,3,1,0,250,206,15666,12323,268,177,16127,11573
237,27,1,1,2,1,2,1,232,196,15667,12324,242,333,16128,11574
238,27,3,0,0,3,1,0,248,245,15670,12324,257,165,16131,11574
239,27,3,1,0,3,1,0,230,223,15673,12325,217,156,16134,11574
240,27,5,0,0,3,1,0,159,83,15678,12325,168,186,16137,11574
241,27,0,1,1,0,0,3,277,234,15678,12326,298,179,16137,11577
242,27,3,0,0,3,1,0,244,186,15681,12326,247,177,16140,11577
243,28,5,0,0,3,1,0,222,178,15686,12326,232,151,16143,11577
244,28,2,4,1,0,0,3,281,187,15688,12330,273,124,16143,11580
245,28,1,2,1,0,0,3,222,185,15689,12332,248,191,16143,11583
246,28,1,2,1,0,0,3,267,161,15690,12334,276,164,16143,11586
247,28,1,1,2,1,2,1,269,225,15691,12335,261,201,16144,11587
248,28,3,1,0,3,1,0,247,201,15694,12336,238,163,16147,11587
249,28,5,0,0,3,1,0,449,96,15699,12336,383,260,16150,11587
250,28,0,4,1,0,0,3,213,199,15699,12340,214,155,16150,11590
251,28,1,1,2,1,2,1,276,164,15700,12341,282,150,16151,11591
252,29,1,1,2,1,2,1,249,246,15701,12342,258,180,16152,11592
253,29,0,1,1,0,0,3,277,235,15701,12343,298,180,16152,11595
254,29,2,0,0,3,1,0,161,83,15703,12343,171,176,16155,11595
255,29,0,1,1,0,0,3,269,226,15703,12344,261,237,16155,11598
256,29,2,1,0,3,1,0,232,224,15705,12345,220,151,16158,11598
257,29,2,1,0,3,1,0,363,139,15707,12346,342,156,16161,11598
258,29,2,0,0,3,1,0,266,195,15709,12346,249,186,16164,11598
259,29,1,4,1,0,0,3,251,210,15710,12350,268,336,16164,11601
260,29,1,3,1,0,0,3,245,189,15711,12353,247,168,16164,11604
261,30,6,0,0,3,1,0,219,199,15717,12353,217,177,16167,11604
262,30,2,0,0,3,1,0,283,187,15719,12353,276,201,16170,11604
263,30,1,0,0,3,1,0,450,96,15720,12353,386,150,16173,11604
264,30,3,1,0,3,1,0,225,179,15723,12354,235,191,16176,11604
265,30,1,2,1,0,0,3,277,166,15724,12356,282,127,16176,11607
266,30,2,5,1,0,0,3,269,166,15726,12361,276,158,16176,11610
267,30,0,4,1,0,0,3,232,200,15726,12365,242,263,16176,11613
268,30,0,0,2,1,2,1,222,185,15726,12365,249,164,16177,11614
269,30,1,1,2,1,2,1,248,202,15727,12366,239,165,16178,11615
270,31,1,4,1,0,0,3,220,203,15728,12370,217,240,16178,11618
271,31,2,4,1,0,0,3,365,143,15730,12374,342,183,16178,11621
272,31,4,1,0,3,1,0,255,211,15734,12375,271,150,16181,11621
273,31,0,0,2,1,2,1,245,189,15734,12375,248,187,16182,11622
274,31,1,0,0,3,1,0,278,235,15735,12375,301,156,16185,11622
275,31,2,1,0,3,1,0,163,84,15737,12376,174,151,16188,11622
276,31,1,0,0,3,1,0,270,226,15738,12376,264,180,16191,11622
277,31,1,4,1,0,0,3,267,199,15739,12380,249,179,16191,11625
278,31,1,1,2,1,2,1,250,247,15740,12381,259,337,16192,11626
279,32,3,3,2,1,2,1,228,182,15743,12384,236,128,16193,11627
280,32,3,1,0,3,1,0,453,97,15746,12385,389,164,16196,11627
281,32,2,2,2,1,2,1,279,168,15748,12387,283,159,16197,11628
282,32,3,1,0,3,1,0,225,186,15751,12388,252,177,16200,11628
283,32,2,0,0,3,1,0,250,202,15753,12388,242,201,16203,11628
284,32,2,2,2,1,2,1,234,226,15755,12390,221,264,16204,11629
285,32,0,0,2,1,2,1,269,166,15755,12390,277,169,16205,11630
286,32,1,1,2,1,2,1,233,201,15756,12391,243,192,16206,11631
287,32,6,1,0,3,1,0,289,188,15762,12392,279,165,16209,11631
288,33,3,4,1,0,0,3,223,207,15765,12396,217,190,16209,11634
289,33,1,1,2,1,2,1,290,189,15766,12397,280,184,16210,11635
290,33,3,2,0,3,1,0,368,145,15769,12399,345,192,16213,11635
291,33,3,0,0,3,1,0,281,235,15772,12399,304,151,16216,11635
292,33,0,1,1,0,0,3,267,200,15772,12400,249,153,16216,11638
293,33,0,4,1,0,0,3,250,251,15772,12404,259,183,16216,11641
294,33,0,0,2,1,2,1,163,84,15772,12404,175,338,16217,11642
295,33,3,0,0,3,1,0,273,226,15775,12404,267,179,16220,11642
296,33,0,2,1,0,0,3,245,191,15775,12406,248,159,16220,11645
297,34,5,1,0,3,1,0,458,98,15780,12407,392,165,16223,11645
298,34,0,2,1,0,0,3,279,170,15780,12409,283,267,16223,11648
299,34,2,1,0,3,1,0,257,212,15782,12410,274,164,16226,11648
300,34,5,1,0,3,1,0,238,202,15787,12411,246,201,16229,11648
301,34,1,5,1,0,0,3,226,191,15788,12416,252,243,16229,11651
302,34,4,2,0,3,1,0,232,184,15792,12418,239,159,16232,11651
303,34,0,0,2,1,2,1,269,166,15792,12418,278,178,16233,11652
304,34,2,1,0,3,1,0,236,227,15794,12419,224,128,16236,11652
305,34,8,1,0,3,1,0,258,203,15802,12420,245,169,16239,11652
0,1,2,2,2,1,2,1,460,100,15804,12422,393,191,16240,11653
1,1,5,1,0,3,1,0,373,146,15809,12423,348,169,16243,11653
2,1,3,2,0,3,1,0,293,191,15812,12425,283,151,16246,11653
3,1,2,1,0,3,1,0,260,204,15814,12426,248,175,16249,11653
4,1,1,3,1,0,0,3,237,230,15815,12429,224,195,16249,11656
5,1,3,0,0,3,1,0,241,202,15818,12429,249,159,16252,11656
6,1,0,0,2,1,2,1,279,170,15818,12429,284,185,16253,11657
7,1,1,0,0,3,1,0,246,191,15819,12429,251,159,16256,11657
8,1,0,4,1,0,0,3,257,158,15819,12433,287,131,16256,11660
9,2,1,3,1,0,0,3,238,184,15820,12436,238,270,16256,11663
10,2,3,2,0,3,1,0,270,202,15823,12438,252,153,16259,11663
11,2,1,3,1,0,0,3,258,215,15824,12441,274,246,16259,11666
12,2,1,3,1,0,0,3,233,187,15825,12444,239,186,16259,11669
13,2,1,1,2,1,2,1,224,208,15826,12445,218,157,16260,11670
14,2,1,3,1,0,0,3,214,174,15827,12448,207,154,16260,11673
15,2,0,3,1,0,0,3,269,169,15827,12451,278,341,16260,11676
16,2,2,1,0,3,1,0,165,85,15829,12452,178,165,16263,11676
17,2,0,3,1,0,0,3,226,194,15829,12455,252,182,16263,11679
18,3,1,3,1,0,0,3,280,173,15830,12458,284,134,16263,11682
19,3,0,0,2,1,2,1,293,191,15830,12458,284,160,16264,11683
20,3,6,1,0,3,1,0,466,101,15836,12459,396,159,16267,11683
21,3,1,2,1,0,0,3,242,204,15837,12461,249,178,16267,11686
22,3,3,0,0,3,1,0,272,169,15840,12461,281,191,16270,11686
23,3,1,1,2,1,2,1,261,205,15841,12462,249,152,16271,11687
24,3,3,1,0,3,1,0,260,159,15844,12463,290,270,16274,11687
25,3,3,2,0,3,1,0,240,232,15847,12465,227,169,16277,11687
26,3,2,1,0,3,1,0,248,192,15849,12466,254,195,16280,11687
27,4,1,1,2,1,2,1,259,216,15850,12467,275,183,16281,11688
28,4,2,1,0,3,1,0,226,209,15852,12468,221,165,16284,11688
29,4,4,0,0,3,1,0,377,146,15856,12468,351,246,16287,11688
30,4,0,1,1,0,0,3,238,185,15856,12469,238,189,16287,11691
31,4,2,1,0,3,1,0,235,188,15858,12470,242,191,16290,11691
32,4,1,2,1,0,0,3,261,161,15859,12472,290,156,16290,11694
33,4,1,1,2,1,2,1,166,86,15860,12473,179,342,16291,11695
34,4,0,3,1,0,0,3,270,205,15860,12476,252,157,16291,11698
35,4,1,5,1,0,0,3,215,179,15861,12481,207,188,16291,11701
36,5,2,1,0,3,1,0,274,170,15863,12482,284,159,16294,11701
37,5,2,0,0,3,1,0,295,191,15865,12482,287,157,16297,11701
38,5,4,0,0,3,1,0,470,101,15869,12482,399,178,16300,11701
39,5,1,1,2,1,2,1,243,205,15870,12483,250,170,16301,11702
40,5,2,1,0,3,1,0,228,195,15872,12484,255,152,16304,11702
41,5,0,3,1,0,0,3,240,235,15872,12487,227,137,16304,11705
42,5,2,1,0,3,1,0,282,174,15874,12488,287,195,16307,11705
43,5,2,2,2,1,2,1,250,194,15876,12490,255,271,16308,11706
44,5,1,1,2,1,2,1,262,206,15877,12491,250,161,16309,11707
45,6,1,2,1,0,0,3,262,163,15878,12493,290,168,16309,11710
46,6,0,3,1,0,0,3,226,212,15878,12496,221,249,16309,11713
47,6,0,3,1,0,0,3,270,208,15878,12499,252,192,16309,11716
48,6,0,1,1,0,0,3,235,189,15878,12500,242,186,16309,11719
49,6,2,3,1,0,0,3,217,182,15880,12503,207,345,16309,11722
50,6,1,3,1,0,0,3,167,89,15881,12506,179,191,16309,11725
51,6,2,2,2,1,2,1,379,148,15883,12508,352,157,16310,11726
52,6,1,2,1,0,0,3,260,218,15884,12510,275,160,16310,11729
53,6,0,4,1,0,0,3,238,189,15884,12514,238,194,16310,11732
54,7,3,1,0,3,1,0,231,196,15887,12515,258,195,16313,11732
55,7,1,1,2,1,2,1,296,192,15888,12516,288,138,16314,11733
56,7,1,2,1,0,0,3,471,103,15889,12518,399,164,16314,11736
57,7,2,2,2,1,2,1,245,207,15891,12520,251,272,16315,11737
58,7,1,2,1,0,0,3,218,184,15892,12522,207,162,16315,11740
59,7,1,1,2,1,2,1,275,171,15893,12523,285,179,16316,11741
60,7,5,1,0,3,1,0,287,175,15898,12524,290,170,16319,11741
61,7,1,0,0,3,1,0,263,206,15899,12524,253,157,16322,11741
62,7,2,2,2,1,2,1,252,196,15901,12526,256,158,16323,11742
63,8,3,0,0,3,1,0,255,196,15904,12526,259,249,16326,11742
64,8,2,2,2,1,2,1,228,214,15906,12528,222,346,16327,11743
65,8,1,0,0,3,1,0,261,218,15907,12528,278,162,16330,11743
66,8,1,1,2,1,2,1,168,90,15908,12529,180,187,16331,11744
67,8,2,0,0,3,1,0,264,163,15910,12529,293,160,16334,11744
68,8,1,1,2,1,2,1,241,236,15911,12530,228,195,16335,11745
69,8,1,0,0,3,1,0,380,148,15912,12530,355,192,16338,11745
70,8,3,0,0,3,1,0,241,189,15915,12530,241,152,16341,11745
71,8,2,0,0,3,1,0,272,208,15917,12530,255,191,16344,11745
72,9,3,1,0,3,1,0,238,190,15920,12531,245,179,16347,11745
73,9,2,1,0,3,1,0,473,104,15922,12532,402,157,16350,11745
74,9,2,1,0,3,1,0,247,208,15924,12533,254,138,16353,11745
75,9,2,3,1,0,0,3,233,199,15926,12536,258,167,16353,11748
76,9,2,0,0,3,1,0,220,184,15928,12536,210,195,16356,11748
77,9,0,0,2,1,2,1,275,171,15928,12536,286,273,16357,11749
78,9,2,2,2,1,2,1,298,194,15930,12538,289,159,16358,11750
79,9,0,0,2,1,2,1,263,206,15930,12538,254,171,16359,11751
80,9,4,2,0,3,1,0,291,177,15934,12540,293,168,16362,11751
81,10,3,0,0,3,1,0,275,208,15937,12540,258,152,16365,11751
82,10,1,2,1,0,0,3,299,196,15938,12542,289,195,16365,11754
83,10,3,0,0,3,1,0,383,148,15941,12542,358,187,16368,11754
84,10,5,1,0,3,1,0,260,197,15946,12543,262,346,16371,11754
85,10,8,0,0,3,1,0,176,90,15954,12543,183,162,16374,11754
86,10,2,2,2,1,2,1,243,238,15956,12545,229,161,16375,11755
87,10,1,0,0,3,1,0,265,163,15957,12545,296,195,16378,11755
88,10,2,0,0,3,1,0,263,218,15959,12545,281,179,16381,11755
89,10,2,3,1,0,0,3,230,217,15961,12548,222,194,16381,11758
90,11,1,2,1,0,0,3,242,191,15962,12550,241,170,16381,11761
91,11,2,4,1,0,0,3,235,203,15964,12554,258,141,16381,11764
92,11,2,3,1,0,0,3,240,193,15966,12557,245,160,16381,11767
93,11,0,1,1,0,0,3,220,185,15966,12558,210,174,16381,11770
94,11,3,3,2,1,2,1,278,174,15969,12561,287,196,16382,11771
95,11,4,0,0,3,1,0,477,104,15973,12561,405,273,16385,11771
96,11,3,1,0,3,1,0,294,178,15976,12562,296,159,16388,11771
97,11,0,2,1,0,0,3,263,208,15976,12564,254,252,16388,11774
98,11,1,0,0,3,1,0,248,208,15977,12564,257,168,16391,11774
99,12,3,3,2,1,2,1,386,151,15980,12567,359,153,16392,11775
100,12,1,1,2,1,2,1,300,197,15981,12568,290,162,16393,11776
101,12,0,4,1,0,0,3,263,222,15981,12572,281,349,16393,11779
102,12,0,2,1,0,0,3,260,199,15981,12574,262,190,16393,11782
103,12,2,0,0,3,1,0,267,163,15983,12574,299,195,16396,11782
104,12,1,2,1,0,0,3,244,240,15984,12576,229,197,16396,11785
105,12,4,1,0,3,1,0,180,91,15988,12577,186,179,16399,11785
106,12,4,0,0,3,1,0,234,217,15992,12577,225,195,16402,11785
107,12,1,5,1,0,0,3,276,213,15993,12582,258,165,16402,11788
108,13,2,1,0,3,1,0,280,175,15995,12583,290,160,16405,11788
109,13,1,1,2,1,2,1,243,192,15996,12584,242,175,16406,11789
110,13,1,2,1,0,0,3,236,205,15997,12586,258,276,16406,11792
111,13,1,1,2,1,2,1,277,214,15998,12587,259,197,16407,11793
112,13,2,3,1,0,0,3,222,188,16000,12590,210,144,16407,11796
113,13,1,2,1,0,0,3,478,106,16001,12592,405,255,16407,11799
114,13,4,2,0,3,1,0,298,180,16005,12594,299,162,16410,11799
115,13,2,3,1,0,0,3,265,211,16007,12597,254,162,16410,11802
116,13,2,1,0,3,1,0,242,194,16009,12598,248,168,16413,11802
117,14,2,2,2,1,2,1,262,201,16011,12600,263,196,16414,11803
118,14,2,1,0,3,1,0,236,218,16013,12601,228,165,16417,11803
119,14,2,1,0,3,1,0,300,181,16015,12602,302,349,16420,11803
120,14,5,0,0,3,1,0,391,151,16020,12602,362,197,16423,11803
121,14,1,0,0,3,1,0,249,208,16021,12602,260,190,16426,11803
122,14,3,1,0,3,1,0,183,92,16024,12603,189,170,16429,11803
123,14,2,1,0,3,1,0,302,198,16026,12604,293,197,16432,11803
124,14,2,0,0,3,1,0,269,163,16028,12604,302,179,16435,11803
125,14,0,1,1,0,0,3,244,241,16028,12605,229,156,16435,11806
126,15,2,4,1,0,0,3,279,218,16030,12609,259,178,16435,11809
127,15,6,1,0,3,1,0,484,107,16036,12610,408,162,16438,11809
128,15,2,0,0,3,1,0,245,192,16038,12610,245,255,16441,11809
129,15,1,0,0,3,1,0,237,205,16039,12610,261,162,16444,11809
130,15,0,4,1,0,0,3,242,198,16039,12614,248,279,16444,11812
131,15,1,1,2,1,2,1,223,189,16040,12615,211,161,16445,11813
132,15,0,3,1,0,0,3,263,225,16040,12618,281,147,16445,11816
133,15,2,1,0,3,1,0,267,212,16042,12619,257,195,16448,11816
134,15,1,0,0,3,1,0,281,175,16043,12619,293,168,16451,11816
135,16,0,5,1,0,0,3,244,246,16043,12624,229,168,16451,11819
136,16,3,0,0,3,1,0,239,218,16046,12624,231,197,16454,11819
137,16,3,3,2,1,2,1,394,154,16049,12627,363,148,16455,11820
138,16,0,2,1,0,0,3,269,165,16049,12629,302,173,16455,11823
139,16,0,1,1,0,0,3,302,199,16049,12630,293,199,16455,11826
140,16,2,0,0,3,1,0,302,181,16051,12630,305,156,16458,11826
141,16,2,4,1,0,0,3,264,205,16053,12634,263,182,16458,11829
142,16,1,3,1,0,0,3,250,211,16054,12637,260,352,16458,11832
143,16,1,1,2,1,2,1,268,213,16055,12638,258,198,16459,11833
144,17,2,1,0,3,1,0,281,219,16057,12639,262,279,16462,11833
145,17,2,0,0,3,1,0,486,107,16059,12639,411,190,16465,11833
146,17,1,0,0,3,1,0,246,192,16060,12639,248,162,16468,11833
147,17,0,1,1,0,0,3,242,199,16060,12640,248,258,16468,11836
148,17,3,1,0,3,1,0,186,93,16063,12641,192,178,16471,11836
149,17,2,2,2,1,2,1,283,177,16065,12643,294,163,16472,11837
150,17,0,0,2,1,2,1,237,205,16065,12643,262,196,16473,11838
151,17,2,1,0,3,1,0,265,226,16067,12644,284,161,16476,11838
152,17,2,1,0,3,1,0,225,190,16069,12645,214,168,16479,11838
153,18,2,0,0,3,1,0,285,177,16071,12645,297,196,16482,11838
154,18,3,5,1,0,0,3,242,223,16074,12650,231,282,16482,11841
155,18,0,1,1,0,0,3,265,227,16074,12651,284,165,16482,11844
156,18,3,1,0,3,1,0,249,193,16077,12652,251,190,16485,11844
157,18,1,2,1,0,0,3,282,221,16078,12654,262,171,16485,11847
158,18,1,2,1,0,0,3,243,201,16079,12656,248,166,16485,11850
159,18,3,1,0,3,1,0,189,94,16082,12657,195,161,16488,11850
160,18,0,4,1,0,0,3,237,209,16082,12661,262,355,16488,11853
161,18,1,4,1,0,0,3,226,194,16083,12665,214,261,16488,11856
162,19,5,1,0,3,1,0,399,155,16088,12666,366,182,16491,11856
163,19,3,1,0,3,1,0,305,182,16091,12667,308,168,16494,11856
164,19,2,0,0,3,1,0,266,205,16093,12667,266,148,16497,11856
165,19,0,2,1,0,0,3,250,213,16093,12669,260,159,16497,11859
166,19,2,0,0,3,1,0,271,165,16095,12669,305,178,16500,11859
167,19,1,2,1,0,0,3,269,215,16096,12671,258,202,16500,11862
168,19,5,0,0,3,1,0,491,107,16101,12671,414,198,16503,11862
169,19,0,3,1,0,0,3,244,249,16101,12674,229,176,16503,11865
170,19,3,0,0,3,1,0,305,199,16104,12674,296,197,16506,11865
171,20,0,0,2,1,2,1,237,209,16104,12674,263,199,16507,11866
172,20,2,1,0,3,1,0,244,224,16106,12675,234,165,16510,11866
173,20,5,0,0,3,1,0,404,155,16111,12675,369,161,16513,11866
174,20,1,1,2,1,2,1,266,228,16112,12676,285,172,16514,11867
175,20,2,1,0,3,1,0,284,222,16114,12677,265,261,16517,11867
176,20,1,3,1,0,0,3,244,204,16115,12680,248,358,16517,11870
177,20,2,2,2,1,2,1,191,96,16117,12682,196,197,16518,11871
178,20,4,0,0,3,1,0,253,193,16121,12682,254,166,16521,11871
179,20,2,4,1,0,0,3,228,198,16123,12686,214,193,16521,11874
180,21,5,0,0,3,1,0,271,205,16128,12686,269,178,16524,11874
181,21,1,0,0,3,1,0,251,213,16129,12686,263,176,16527,11874
182,21,1,3,1,0,0,3,238,212,16130,12689,263,171,16527,11877
183,21,1,1,2,1,2,1,286,178,16131,12690,298,160,16528,11878
184,21,0,2,1,0,0,3,244,251,16131,12692,229,164,16528,11881
185,21,1,1,2,1,2,1,270,216,16132,12693,259,198,16529,11882
186,21,4,3,0,3,1,0,309,202,16136,12696,299,282,16532,11882
187,21,0,0,2,1,2,1,491,107,16136,12696,415,149,16533,11883
188,21,2,1,0,3,1,0,307,183,16138,12697,311,182,16536,11883
189,22,4,0,0,3,1,0,408,155,16142,12697,372,172,16539,11883
190,22,1,1,2,1,2,1,245,225,16143,12698,235,167,16540,11884
191,22,2,3,1,0,0,3,286,225,16145,12701,265,196,16540,11887
192,22,1,2,1,0,0,3,229,200,16146,12703,214,205,16540,11890
193,22,3,0,0,3,1,0,194,96,16149,12703,199,165,16543,11890
194,22,2,3,1,0,0,3,273,168,16151,12706,305,264,16543,11893
195,22,1,4,1,0,0,3,267,232,16152,12710,285,200,16543,11896
196,22,1,4,1,0,0,3,254,197,16153,12714,254,361,16543,11899
197,22,0,0,2,1,2,1,244,204,16153,12714,249,200,16544,11900
198,23,3,2,0,3,1,0,494,109,16156,12716,418,160,16547,11900
199,23,1,1,2,1,2,1,308,184,16157,12717,312,177,16548,11901
200,23,0,2,1,0,0,3,251,215,16157,12719,263,201,16548,11904
201,23,0,5,1,0,0,3,238,217,16157,12724,263,185,16548,11907
202,23,0,2,1,0,0,3,244,253,16157,12726,229,285,16548,11910
203,23,0,5,1,0,0,3,286,183,16157,12731,298,152,16548,11913
204,23,2,0,0,3,1,0,311,202,16159,12731,302,178,16551,11913
205,23,4,0,0,3,1,0,274,216,16163,12731,262,171,16554,11913
206,23,1,2,1,0,0,3,272,207,16164,12733,269,167,16554,11916
207,24,3,3,2,1,2,1,270,235,16167,12736,286,206,16555,11917
208,24,2,3,1,0,0,3,247,228,16169,12739,235,203,16555,11920
209,24,1,0,0,3,1,0,409,155,16170,12739,375,167,16558,11920
210,24,0,6,1,0,0,3,286,231,16170,12745,265,364,16558,11923
211,24,2,0,0,3,1,0,246,204,16172,12745,252,160,16561,11923
212,24,3,0,0,3,1,0,257,197,16175,12745,257,200,16564,11923
213,24,2,2,2,1,2,1,275,170,16177,12747,306,197,16565,11924
214,24,1,1,2,1,2,1,195,97,16178,12748,200,265,16566,11925
215,24,0,3,1,0,0,3,244,256,16178,12751,229,175,16566,11928
216,25,1,2,1,0,0,3,230,202,16179,12753,214,188,16566,11931
217,25,4,0,0,3,1,0,315,202,16183,12753,305,175,16569,11931
218,25,3,1,0,3,1,0,254,216,16186,12754,266,167,16572,11931
219,25,2,2,2,1,2,1,240,219,16188,12756,264,166,16573,11932
220,25,1,1,2,1,2,1,287,184,16189,12757,299,178,16574,11933
221,25,0,0,2,1,2,1,274,216,16189,12757,263,153,16575,11934
222,25,1,2,1,0,0,3,309,186,16190,12759,312,288,16575,11937
223,25,2,0,0,3,1,0,496,109,16192,12759,421,178,16578,11937
224,25,1,1,2,1,2,1,247,205,16193,12760,253,202,16579,11938
225,26,1,2,1,0,0,3,248,230,16194,12762,235,200,16579,11941
226,26,4,0,0,3,1,0,413,155,16198,12762,378,200,16582,11941
227,26,0,0,2,1,2,1,270,235,16198,12762,287,161,16583,11942
228,26,0,3,1,0,0,3,286,234,16198,12765,265,209,16583,11945
229,26,1,1,2,1,2,1,196,98,16199,12766,201,168,16584,11946
230,26,1,3,1,0,0,3,273,210,16200,12769,269,206,16584,11949
231,26,2,2,2,1,2,1,259,199,16202,12771,258,172,16585,11950
232,26,0,2,1,0,0,3,275,172,16202,12773,306,367,16585,11953
233,26,1,4,1,0,0,3,245,260,16203,12777,229,268,16585,11956
234,27,4,0,0,3,1,0,244,219,16207,12777,267,167,16588,11956
235,27,1,3,1,0,0,3,310,189,16208,12780,312,271,16588,11959
236,27,0,1,1,0,0,3,254,217,16208,12781,266,169,16588,11962
237,27,1,1,2,1,2,1,231,203,16209,12782,215,179,16589,11963
238,27,0,2,1,0,0,3,274,218,16209,12784,263,291,16589,11966
239,27,5,2,0,3,1,0,501,111,16214,12786,424,175,16592,11966
240,27,0,3,1,0,0,3,287,187,16214,12789,299,181,16592,11969
241,27,0,5,1,0,0,3,247,210,16214,12794,253,156,16592,11972
242,27,2,2,2,1,2,1,261,201,16216,12796,259,203,16593,11973
243,28,0,1,1,0,0,3,413,156,16216,12797,378,370,16593,11976
244,28,1,4,1,0,0,3,316,206,16217,12801,305,203,16593,11979
245,28,3,3,2,1,2,1,276,213,16220,12804,270,169,16594,11980
246,28,0,0,2,1,2,1,245,260,16220,12804,230,207,16595,11981
247,28,2,2,2,1,2,1,198,100,16222,12806,202,210,16596,11982
248,28,0,0,2,1,2,1,248,230,16222,12806,236,162,16597,11983
249,28,2,1,0,3,1,0,272,236,16224,12807,290,200,16600,11983
250,28,3,1,0,3,1,0,289,235,16227,12808,268,188,16603,11983
251,28,1,1,2,1,2,1,276,173,16228,12809,307,173,16604,11984
252,29,0,1,1,0,0,3,254,218,16228,12810,266,274,16604,11987
253,29,2,0,0,3,1,0,246,219,16230,12810,270,181,16607,11987
254,29,0,1,1,0,0,3,247,211,16230,12811,253,182,16607,11990
255,29,0,1,1,0,0,3,287,188,16230,12812,299,172,16607,11993
256,29,1,2,1,0,0,3,275,220,16231,12814,263,178,16607,11996
257,29,5,0,0,3,1,0,506,111,16236,12814,427,203,16610,11996
258,29,4,1,0,3,1,0,314,190,16240,12815,315,167,16613,11996
259,29,1,6,1,0,0,3,232,209,16241,12821,215,294,16613,11999
260,29,2,4,1,0,0,3,263,205,16243,12825,259,159,16613,12002
261,30,1,0,0,3,1,0,255,218,16244,12825,269,207,16616,12002
262,30,2,4,1,0,0,3,318,210,16246,12829,305,373,16616,12005
263,30,2,2,2,1,2,1,274,238,16248,12831,291,183,16617,12006
264,30,0,2,1,0,0,3,276,215,16248,12833,270,176,16617,12009
265,30,1,1,2,1,2,1,199,101,16249,12834,203,163,16618,12010
266,30,1,0,0,3,1,0,414,156,16250,12834,381,210,16621,12010
267,30,0,1,1,0,0,3,245,261,16250,12835,230,206,16621,12013
268,30,1,1,2,1,2,1,277,174,16251,12836,308,201,16622,12014
269,30,1,1,2,1,2,1,249,231,16252,12837,237,189,16623,12015
270,31,0,2,1,0,0,3,289,237,16252,12839,268,162,16623,12018
271,31,0,1,1,0,0,3,274,239,16252,12840,291,297,16623,12021
272,31,1,2,1,0,0,3,264,207,16253,12842,259,170,16623,12024
273,31,1,4,1,0,0,3,247,223,16254,12846,270,181,16623,12027
274,31,1,5,1,0,0,3,233,214,16255,12851,215,175,16623,12030
275,31,2,2,2,1,2,1,277,222,16257,12853,264,170,16624,12031
276,31,2,1,0,3,1,0,508,112,16259,12854,430,207,16627,12031
277,31,0,1,1,0,0,3,247,212,16259,12855,253,184,16627,12034
278,31,1,1,2,1,2,1,288,189,16260,12856,300,275,16628,12035
279,32,3,0,0,3,1,0,317,190,16263,12856,318,206,16631,12035
280,32,2,1,0,3,1,0,257,219,16265,12857,272,210,16634,12035
281,32,1,0,0,3,1,0,278,174,16266,12857,311,163,16637,12035
282,32,0,1,1,0,0,3,245,262,16266,12858,230,376,16637,12038
283,32,2,1,0,3,1,0,278,216,16268,12859,273,201,16640,12038
284,32,1,3,1,0,0,3,250,234,16269,12862,237,186,16640,12041
285,32,3,1,0,3,1,0,321,211,16272,12863,308,189,16643,12041
286,32,0,2,1,0,0,3,414,158,16272,12865,381,179,16643,12044
287,32,2,2,2,1,2,1,201,103,16274,12867,204,204,16644,12045
288,33,3,1,0,3,1,0,511,113,16277,12868,433,170,16647,12045
289,33,1,1,2,1,2,1,275,240,16278,12869,292,185,16648,12046
290,33,1,1,2,1,2,1,265,208,16279,12870,260,182,16649,12047
291,33,2,0,0,3,1,0,249,223,16281,12870,273,275,16652,12047
292,33,4,0,0,3,1,0,293,237,16285,12870,271,170,16655,12047
293,33,3,1,0,3,1,0,250,213,16288,12871,256,175,16658,12047
294,33,0,2,1,0,0,3,201,105,16288,12873,204,300,16658,12050
295,33,1,4,1,0,0,3,289,193,16289,12877,300,209,16658,12053
296,33,1,3,1,0,0,3,234,217,16290,12880,215,210,16658,12056
297,34,1,2,1,0,0,3,251,236,16291,12882,237,165,16658,12059
298,34,1,0,0,3,1,0,322,211,16292,12882,311,179,16661,12059
299,34,2,1,0,3,1,0,319,191,16294,12883,321,210,16664,12059
300,34,0,4,1,0,0,3,414,162,16294,12887,381,189,16664,12062
301,34,3,2,0,3,1,0,281,218,16297,12889,276,163,16667,12062
302,34,4,0,0,3,1,0,261,219,16301,12889,275,201,16670,12062
303,34,3,0,0,3,1,0,281,174,16304,12889,314,204,16673,12062
304,34,6,1,0,3,1,0,251,263,16310,12890,233,189,16676,12062
305,34,0,4,1,0,0,3,277,226,16310,12894,264,379,16676,12065
0,1,8,0,0,3,1,0,519,113,16318,12894,436,201,16679,12065
1,1,1,1,2,1,2,1,282,219,16319,12895,277,134,16680,12066
2,1,2,3,1,0,0,3,267,211,16321,12898,260,192,16680,12069
3,1,2,3,1,0,0,3,275,229,16323,12901,267,173,16680,12072
4,1,1,3,1,0,0,3,282,177,16324,12904,314,188,16680,12075
5,1,1,4,1,0,0,3,252,267,16325,12908,233,213,16680,12078
6,1,3,0,0,3,1,0,417,162,16328,12908,384,210,16683,12078
7,1,3,1,0,3,1,0,204,106,16331,12909,207,179,16686,12078
8,1,0,0,2,1,2,1,277,226,16331,12909,265,276,16687,12079
9,2,1,3,1,0,0,3,250,226,16332,12912,273,185,16687,12082
10,2,1,0,0,3,1,0,167,156,16333,12912,169,189,16690,12082
11,2,2,0,0,3,1,0,253,236,16335,12912,240,300,16693,12082
12,2,1,1,2,1,2,1,323,212,16336,12913,312,166,16694,12083
13,2,1,1,2,1,2,1,320,192,16337,12914,322,171,16695,12084
14,2,1,4,1,0,0,3,251,217,16338,12918,256,181,16695,12087
15,2,1,3,1,0,0,3,290,196,16339,12921,300,178,16695,12090
16,2,4,1,0,3,1,0,297,238,16343,12922,274,379,16698,12090
17,2,1,1,2,1,2,1,262,220,16344,12923,276,210,16699,12091
18,3,4,0,0,3,1,0,286,177,16348,12923,317,179,16702,12091
19,3,4,0,0,3,1,0,421,162,16352,12923,387,173,16705,12091
20,3,2,1,0,3,1,0,284,220,16354,12924,280,192,16708,12091
21,3,1,3,1,0,0,3,268,214,16355,12927,260,213,16708,12094
22,3,1,1,2,1,2,1,276,230,16356,12928,268,277,16709,12095
23,3,1,0,0,3,1,0,253,267,16357,12928,236,134,16712,12095
24,3,4,0,0,3,1,0,208,106,16361,12928,210,201,16715,12095
25,3,0,0,2,1,2,1,277,226,16361,12928,266,189,16716,12096
26,3,4,3,0,3,1,0,523,116,16365,12931,439,213,16719,12096
27,4,0,2,1,0,0,3,253,238,16365,12933,240,169,16719,12099
28,4,1,1,2,1,2,1,263,221,16366,12934,277,179,16720,12100
29,4,0,2,1,0,0,3,250,228,16366,12936,273,184,16720,12103
30,4,0,1,1,0,0,3,297,239,16366,12937,274,303,16720,12106
31,4,0,1,1,0,0,3,251,218,16366,12938,256,280,16720,12109
32,4,1,4,1,0,0,3,168,160,16367,12942,169,382,16720,12112
33,4,1,1,2,1,2,1,321,193,16368,12943,323,211,16721,12113
34,4,1,1,2,1,2,1,269,215,16369,12944,261,186,16722,12114
35,4,1,1,2,1,2,1,291,197,16370,12945,301,172,16723,12115
36,5,1,1,2,1,2,1,277,231,16371,12946,269,190,16724,12116
37,5,5,0,0,3,1,0,528,116,16376,12946,442,186,16727,12116
38,5,2,3,1,0,0,3,253,221,16378,12949,256,216,16727,12119
39,5,2,1,0,3,1,0,210,107,16380,12950,213,213,16730,12119
40,5,1,1,2,1,2,1,287,178,16381,12951,318,174,16731,12120
41,5,3,0,0,3,1,0,424,162,16384,12951,390,201,16734,12120
42,5,2,1,0,3,1,0,279,227,16386,12952,269,134,16737,12120
43,5,1,1,2,1,2,1,254,268,16387,12953,237,193,16738,12121
44,5,3,1,0,3,1,0,326,213,16390,12954,315,189,16741,12121
45,6,1,1,2,1,2,1,292,198,16391,12955,302,185,16742,12122
46,6,0,2,1,0,0,3,168,162,16391,12957,169,306,16742,12125
47,6,3,1,0,3,1,0,256,239,16394,12958,243,179,16745,12125
48,6,1,1,2,1,2,1,285,221,16395,12959,281,180,16746,12126
49,6,1,2,1,0,0,3,270,217,16396,12961,261,385,16746,12129
50,6,1,0,0,3,1,0,322,193,16397,12961,326,169,16749,12129
51,6,2,4,1,0,0,3,265,225,16399,12965,277,283,16749,12132
52,6,1,1,2,1,2,1,251,229,16400,12966,274,212,16750,12133
53,6,1,3,1,0,0,3,298,242,16401,12969,274,175,16750,12136
54,7,1,1,2,1,2,1,255,269,16402,12970,238,191,16751,12137
55,7,0,3,1,0,0,3,256,242,16402,12973,243,216,16751,12140
56,7,2,2,2,1,2,1,255,223,16404,12975,257,202,16752,12141
57,7,3,0,0,3,1,0,213,107,16407,12975,216,174,16755,12141
58,7,2,2,2,1,2,1,279,233,16409,12977,270,187,16756,12142
59,7,5,0,0,3,1,0,292,178,16414,12977,321,134,16759,12142
60,7,2,3,1,0,0,3,426,165,16416,12980,390,388,16759,12145
61,7,2,1,0,3,1,0,281,228,16418,12981,272,193,16762,12145
62,7,4,3,0,3,1,0,330,216,16422,12984,318,216,16765,12145
63,8,1,2,1,0,0,3,169,164,16423,12986,169,286,16765,12148
64,8,1,1,2,1,2,1,529,117,16424,12987,443,181,16766,12149
65,8,1,1,2,1,2,1,323,194,16425,12988,327,190,16767,12150
66,8,3,3,2,1,2,1,301,245,16428,12991,275,186,16768,12151
67,8,0,2,1,0,0,3,292,200,16428,12993,302,215,16768,12154
68,8,1,1,2,1,2,1,286,222,16429,12994,282,170,16769,12155
69,8,2,5,1,0,0,3,253,234,16431,12999,274,309,16769,12158
70,8,1,3,1,0,0,3,266,228,16432,13002,277,182,16769,12161
71,8,1,2,1,0,0,3,271,219,16433,13004,261,178,16769,12164
72,9,5,3,0,3,1,0,286,231,16438,13007,275,181,16772,12164
73,9,1,1,2,1,2,1,257,243,16439,13008,244,175,16773,12165
74,9,1,2,1,0,0,3,427,167,16440,13010,390,194,16773,12168
75,9,2,1,0,3,1,0,215,108,16442,13011,219,134,16776,12168
76,9,1,3,1,0,0,3,280,236,16443,13014,270,391,16776,12171
77,9,3,3,2,1,2,1,295,181,16446,13017,322,188,16777,12172
78,9,4,1,0,3,1,0,327,195,16450,13018,330,202,16780,12172
79,9,0,0,2,1,2,1,330,216,16450,13018,319,217,16781,12173
80,9,1,1,2,1,2,1,256,224,16451,13019,258,194,16782,12174
81,10,3,1,0,3,1,0,256,235,16454,13020,277,178,16785,12174
82,10,2,1,0,3,1,0,171,165,16456,13021,172,182,16788,12174
83,10,1,1,2,1,2,1,287,223,16457,13022,283,310,16789,12175
84,10,2,2,2,1,2,1,273,221,16459,13024,262,216,16790,12176
85,10,2,2,2,1,2,1,268,230,16461,13026,278,217,16791,12177
86,10,3,3,2,1,2,1,532,120,16464,13029,444,171,16792,12178
87,10,1,2,1,0,0,3,256,271,16465,13031,238,189,16792,12181
88,10,0,3,1,0,0,3,292,203,16465,13034,302,289,16792,12184
89,10,3,1,0,3,1,0,304,246,16468,13035,278,190,16795,12184
90,11,2,1,0,3,1,0,288,232,16470,13036,278,188,16798,12184
91,11,1,1,2,1,2,1,328,196,16471,13037,331,218,16799,12185
92,11,1,5,1,0,0,3,428,172,16472,13042,390,192,16799,12188
93,11,2,0,0,3,1,0,270,230,16474,13042,281,134,16802,12188
94,11,0,1,1,0,0,3,256,225,16474,13043,258,197,16802,12191
95,11,2,0,0,3,1,0,217,108,16476,13043,222,181,16805,12191
96,11,1,1,2,1,2,1,296,182,16477,13044,323,392,16806,12192
97,11,2,2,2,1,2,1,259,245,16479,13046,245,203,16807,12193
98,11,4,1,0,3,1,0,334,217,16483,13047,322,194,16810,12193
99,12,3,3,2,1,2,1,290,226,16486,13050,284,218,16811,12194
100,12,0,0,2,1,2,1,256,235,16486,13050,278,183,16812,12195
101,12,2,2,2,1,2,1,282,238,16488,13052,271,179,16813,12196
102,12,1,2,1,0,0,3,257,273,16489,13054,238,313,16813,12199
103,12,0,2,1,0,0,3,292,205,16489,13056,302,178,16813,12202
104,12,0,1,1,0,0,3,171,166,16489,13057,172,193,16813,12205
105,12,2,1,0,3,1,0,534,121,16491,13058,447,216,16816,12205
106,12,0,4,1,0,0,3,273,225,16491,13062,262,292,16816,12208
107,12,0,1,1,0,0,3,304,247,16491,13063,278,174,16816,12211
108,13,2,1,0,3,1,0,298,183,16493,13064,326,313,16819,12211
109,13,0,2,1,0,0,3,259,247,16493,13066,245,191,16819,12214
110,13,1,2,1,0,0,3,329,198,16494,13068,331,197,16819,12217
111,13,0,1,1,0,0,3,256,226,16494,13069,258,184,16819,12220
112,13,0,0,2,1,2,1,217,108,16494,13069,223,198,16820,12221
113,13,0,1,1,0,0,3,292,206,16494,13070,302,137,16820,12224
114,13,1,2,1,0,0,3,335,219,16495,13072,322,395,16820,12227
115,13,4,1,0,3,1,0,274,231,16499,13073,284,218,16823,12227
116,13,1,0,0,3,1,0,289,232,16500,13073,281,192,16826,12227
117,14,0,1,1,0,0,3,171,167,16500,13074,172,221,16826,12230
118,14,2,1,0,3,1,0,292,227,16502,13075,287,292,16829,12230
119,14,0,1,1,0,0,3,273,226,16502,13076,262,196,16829,12233
120,14,1,3,1,0,0,3,305,250,16503,13079,278,181,16829,12236
121,14,0,2,1,0,0,3,257,275,16503,13081,238,182,16829,12239
122,14,3,0,0,3,1,0,259,235,16506,13081,281,203,16832,12239
123,14,0,1,1,0,0,3,282,239,16506,13082,271,177,16832,12242
124,14,2,0,0,3,1,0,430,172,16508,13082,393,216,16835,12242
125,14,5,2,0,3,1,0,539,123,16513,13084,450,183,16838,12242
126,15,3,2,0,3,1,0,332,200,16516,13086,334,395,16841,12242
127,15,1,1,2,1,2,1,336,220,16517,13087,323,185,16842,12243
128,15,5,0,0,3,1,0,279,231,16522,13087,287,198,16845,12243
129,15,0,2,1,0,0,3,256,228,16522,13089,258,194,16845,12246
130,15,4,0,0,3,1,0,296,206,16526,13089,305,197,16848,12246
131,15,2,2,2,1,2,1,300,185,16528,13091,327,217,16849,12247
132,15,1,3,1,0,0,3,218,111,16529,13094,223,316,16849,12250
133,15,1,4,1,0,0,3,260,251,16530,13098,245,195,16849,12253
134,15,1,0,0,3,1,0,172,167,16531,13098,175,218,16852,12253
135,16,1,0,0,3,1,0,301,185,16532,13098,330,292,16855,12253
136,16,1,1,2,1,2,1,431,173,16533,13099,394,184,16856,12254
137,16,0,0,2,1,2,1,273,226,16533,13099,263,219,16857,12255
138,16,0,0,2,1,2,1,305,250,16533,13099,279,138,16858,12256
139,16,2,0,0,3,1,0,259,275,16535,13099,241,196,16861,12256
140,16,2,2,2,1,2,1,291,234,16537,13101,282,178,16862,12257
141,16,2,2,2,1,2,1,284,241,16539,13103,272,222,16863,12258
142,16,2,1,0,3,1,0,541,124,16541,13104,453,181,16866,12258
143,16,3,1,0,3,1,0,295,228,16544,13105,290,203,16869,12258
144,17,1,0,0,3,1,0,333,200,16545,13105,337,185,16872,12258
145,17,2,1,0,3,1,0,338,221,16547,13106,326,316,16875,12258
146,17,0,3,1,0,0,3,259,238,16547,13109,281,200,16875,12261
147,17,0,2,1,0,0,3,256,230,16547,13111,258,220,16875,12264
148,17,1,2,1,0,0,3,297,208,16548,13113,305,201,16875,12267
149,17,3,0,0,3,1,0,175,167,16551,13113,178,195,16878,12267
150,17,0,1,1,0,0,3,260,252,16551,13114,245,398,16878,12270
151,17,2,2,2,1,2,1,281,233,16553,13116,288,195,16879,12271
152,17,1,0,0,3,1,0,219,111,16554,13116,226,182,16882,12271
153,18,4,2,0,3,1,0,337,202,16558,13118,340,316,16885,12271
154,18,1,5,1,0,0,3,176,172,16559,13123,178,198,16885,12274
155,18,2,1,0,3,1,0,262,253,16561,13124,248,182,16888,12274
156,18,0,1,1,0,0,3,338,222,16561,13125,326,223,16888,12277
157,18,2,1,0,3,1,0,283,234,16563,13126,291,195,16891,12277
158,18,3,2,0,3,1,0,259,232,16566,13128,261,178,16894,12277
159,18,1,4,1,0,0,3,260,242,16567,13132,281,188,16894,12280
160,18,0,4,1,0,0,3,297,212,16567,13136,305,401,16894,12283
161,18,3,0,0,3,1,0,308,250,16570,13136,282,201,16897,12283
162,19,2,0,0,3,1,0,286,241,16572,13136,275,184,16900,12283
163,19,4,1,0,3,1,0,545,125,16576,13137,456,200,16903,12283
164,19,3,1,0,3,1,0,434,174,16579,13138,397,196,16906,12283
165,19,3,1,0,3,1,0,298,229,16582,13139,293,219,16909,12283
166,19,1,1,2,1,2,1,302,186,16583,13140,331,223,16910,12284
167,19,1,1,2,1,2,1,260,276,16584,13141,242,204,16911,12285
168,19,1,0,0,3,1,0,220,111,16585,13141,229,292,16914,12285
169,19,3,1,0,3,1,0,276,227,16588,13142,266,138,16917,12285
170,19,3,0,0,3,1,0,294,234,16591,13142,285,181,16920,12285
171,20,0,1,1,0,0,3,260,243,16591,13143,281,404,16920,12288
172,20,0,2,1,0,0,3,262,255,16591,13145,248,226,16920,12291
173,20,5,2,0,3,1,0,343,224,16596,13147,329,195,16923,12291
174,20,2,1,0,3,1,0,285,235,16598,13148,294,316,16926,12291
175,20,1,0,0,3,1,0,260,232,16599,13148,264,182,16929,12291
176,20,0,3,1,0,0,3,297,215,16599,13151,305,181,16929,12294
177,20,1,2,1,0,0,3,338,204,16600,13153,340,204,16929,12297
178,20,1,3,1,0,0,3,309,253,16601,13156,282,201,16929,12300
179,20,0,2,1,0,0,3,176,174,16601,13158,178,191,16929,12303
180,21,2,1,0,3,1,0,222,112,16603,13159,232,196,16932,12303
181,21,2,2,2,1,2,1,345,226,16605,13161,330,185,16933,12304
182,21,2,2,2,1,2,1,436,176,16607,13163,398,201,16934,12305
183,21,1,1,2,1,2,1,287,242,16608,13164,276,220,16935,12306
184,21,0,0,2,1,2,1,260,276,16608,13164,243,182,16936,12307
185,21,0,0,2,1,2,1,302,186,16608,13164,332,205,16937,12308
186,21,2,0,0,3,1,0,300,229,16610,13164,296,204,16940,12308
187,21,0,0,2,1,2,1,294,234,16610,13164,286,224,16941,12309
188,21,3,3,2,1,2,1,548,128,16613,13167,457,139,16942,12310
189,22,0,3,1,0,0,3,176,177,16613,13170,178,229,16942,12313
190,22,1,2,1,0,0,3,339,206,16614,13172,340,188,16942,12316
191,22,2,1,0,3,1,0,302,230,16616,13173,299,404,16945,12316
192,22,0,1,1,0,0,3,276,228,16616,13174,266,198,16945,12319
193,22,0,1,1,0,0,3,285,236,16616,13175,294,185,16945,12322
194,22,0,4,1,0,0,3,297,219,16616,13179,305,319,16945,12325
195,22,1,1,2,1,2,1,263,256,16617,13180,249,293,16946,12326
196,22,0,3,1,0,0,3,260,246,16617,13183,281,184,16946,12329
197,22,4,0,0,3,1,0,313,253,16621,13183,285,191,16949,12329
198,23,2,1,0,3,1,0,262,277,16623,13184,246,201,16952,12329
199,23,5,1,0,3,1,0,553,129,16628,13185,460,204,16955,12329
200,23,3,0,0,3,1,0,439,176,16631,13185,401,139,16958,12329
201,23,5,1,0,3,1,0,292,243,16636,13186,279,205,16961,12329
202,23,2,0,0,3,1,0,296,234,16638,13186,289,220,16964,12329
203,23,3,2,0,3,1,0,225,114,16641,13188,235,224,16967,12329
204,23,1,1,2,1,2,1,303,187,16642,13189,333,202,16968,12330
205,23,0,1,1,0,0,3,260,233,16642,13190,264,199,16968,12333
206,23,1,2,1,0,0,3,346,228,16643,13192,330,185,16968,12336
207,24,0,0,2,1,2,1,297,219,16643,13192,306,189,16969,12337
208,24,0,1,1,0,0,3,339,207,16643,13193,340,296,16969,12340
209,24,1,1,2,1,2,1,303,231,16644,13194,300,199,16970,12341
210,24,0,3,1,0,0,3,285,239,16644,13197,294,187,16970,12344
211,24,2,1,0,3,1,0,262,247,16646,13198,284,199,16973,12344
212,24,2,1,0,3,1,0,315,254,16648,13199,288,229,16976,12344
213,24,4,2,0,3,1,0,557,131,16652,13201,463,319,16979,12344
214,24,1,1,2,1,2,1,277,229,16653,13202,267,192,16980,12345
215,24,0,0,2,1,2,1,176,177,16653,13202,179,186,16981,12346
216,25,3,1,0,3,1,0,266,257,16656,13203,252,224,16984,12346
217,25,1,0,0,3,1,0,261,233,16657,13203,267,185,16987,12346
218,25,2,1,0,3,1,0,305,188,16659,13204,336,204,16990,12346
219,25,1,3,1,0,0,3,263,280,16660,13207,246,407,16990,12349
220,25,5,0,0,3,1,0,301,234,16665,13207,292,205,16993,12349
221,25,2,0,0,3,1,0,441,176,16667,13207,404,220,16996,12349
222,25,1,2,1,0,0,3,347,230,16668,13209,330,142,16996,12352
223,25,1,1,2,1,2,1,226,115,16669,13210,236,202,16997,12353
224,25,2,0,0,3,1,0,294,243,16671,13210,282,202,17000,12353
225,26,0,1,1,0,0,3,176,178,16671,13211,179,190,17000,12356
226,26,4,0,0,3,1,0,561,131,16675,13211,466,199,17003,12356
227,26,5,2,0,3,1,0,308,233,16680,13213,303,186,17006,12356
228,26,2,2,2,1,2,1,279,231,16682,13215,268,320,17007,12357
229,26,1,2,1,0,0,3,264,282,16683,13217,246,232,17007,12360
230,26,0,3,1,0,0,3,297,222,16683,13220,306,227,17007,12363
231,26,1,2,1,0,0,3,316,256,16684,13222,288,192,17007,12366
232,26,3,0,0,3,1,0,265,247,16687,13222,287,296,17010,12366
233,26,2,0,0,3,1,0,287,239,16689,13222,297,199,17013,12366
234,27,2,1,0,3,1,0,268,258,16691,13223,255,202,17016,12366
235,27,2,1,0,3,1,0,349,231,16693,13224,333,205,17019,12366
236,27,1,2,1,0,0,3,442,178,16694,13226,404,205,17019,12369
237,27,1,1,2,1,2,1,262,234,16695,13227,268,143,17020,12370
238,27,1,0,0,3,1,0,302,234,16696,13227,295,204,17023,12370
239,27,0,1,1,0,0,3,226,116,16696,13228,236,410,17023,12373
240,27,2,1,0,3,1,0,341,208,16698,13229,343,185,17026,12373
241,27,1,0,0,3,1,0,295,243,16699,13229,285,192,17029,12373
242,27,1,1,2,1,2,1,306,189,16700,13230,337,221,17030,12374
243,28,1,0,0,3,1,0,177,178,16701,13230,182,185,17033,12374
244,28,1,1,2,1,2,1,562,132,16702,13231,467,187,17034,12375
245,28,4,3,0,3,1,0,312,236,16706,13234,306,232,17037,12375
246,28,2,2,2,1,2,1,267,249,16708,13236,288,228,17038,12376
247,28,1,4,1,0,0,3,265,286,16709,13240,246,193,17038,12379
248,28,2,3,1,0,0,3,297,246,16711,13243,285,323,17038,12382
249,28,1,0,0,3,1,0,298,222,16712,13243,309,199,17041,12382
250,28,2,3,1,0,0,3,281,234,16714,13246,268,195,17041,12385
251,28,0,0,2,1,2,1,316,256,16714,13246,289,297,17042,12386
0,1,1,0,0,3,1,0,121,134,16715,13246,133,10,17045,12386
1,1,1,0,0,3,1,0,20,22,16716,13246,29,0,17048,12386
2,1,0,1,1,0,0,3,0,1,16716,13247,0,3,17048,12389
3,1,3,2,0,3,1,0,139,150,16719,13249,130,27,17051,12389
4,1,0,1,1,0,0,3,0,1,16719,13250,0,3,17051,12392
5,1,2,1,0,3,1,0,2,1,16721,13251,3,0,17054,12392
6,1,0,2,1,0,0,3,41,75,16721,13253,40,3,17054,12395
7,1,0,2,1,0,0,3,0,2,16721,13255,0,11,17054,12398
8,1,0,1,1,0,0,3,26,57,16721,13256,32,62,17054,12401
9,1,0,0,2,1,2,1,0,0,16721,13256,1,131,17055,12402
10,1,0,1,1,0,0,3,0,1,16721,13257,0,125,17055,12405
11,1,2,0,0,3,1,0,62,77,16723,13257,66,0,17058,12405
12,2,3,2,0,3,1,0,3,2,16726,13259,3,29,17061,12405
13,2,0,2,1,0,0,3,0,2,16726,13261,0,27,17061,12408
14,2,5,0,0,3,1,0,53,49,16731,13261,50,0,17064,12408
15,2,3,0,0,3,1,0,3,0,16734,13261,3,21,17067,12408
16,2,2,1,0,3,1,0,2,1,16736,13262,3,0,17070,12408
17,2,1,1,2,1,2,1,18,24,16737,13263,19,85,17071,12409
18,2,2,2,2,1,2,1,117,137,16739,13265,121,1,17072,12410
19,2,2,0,0,3,1,0,25,33,16741,13265,23,0,17075,12410
20,2,0,1,1,0,0,3,0,1,16741,13266,0,3,17075,12413
21,2,0,0,2,1,2,1,0,0,16741,13266,1,81,17076,12414
22,2,0,0,2,1,2,1,179,170,16741,13266,191,14,17077,12415
23,2,0,2,1,0,0,3,202,179,16741,13268,235,3,17077,12418
24,3,1,0,0,3,1,0,27,57,16742,13268,35,0,17080,12418
25,3,1,0,0,3,1,0,122,134,16743,13268,136,3,17083,12418
26,3,0,2,1,0,0,3,0,3,16743,13270,0,128,17083,12421
27,3,0,0,2,1,2,1,0,1,16743,13270,1,1,17084,12422
28,3,1,1,2,1,2,1,21,23,16744,13271,30,4,17085,12423
29,3,1,2,1,0,0,3,42,77,16745,13273,40,14,17085,12426
30,3,0,4,1,0,0,3,0,6,16745,13277,0,30,17085,12429
31,3,1,1,2,1,2,1,1,1,16746,13278,2,1,17086,12430
32,3,0,1,1,0,0,3,0,2,16746,13279,0,134,17086,12433
33,3,1,1,2,1,2,1,63,78,16747,13280,67,11,17087,12434
34,3,2,0,0,3,1,0,4,1,16749,13280,6,3,17090,12434
35,3,1,0,0,3,1,0,140,150,16750,13280,133,62,17093,12434
36,4,1,3,1,0,0,3,4,5,16751,13283,3,88,17093,12437
37,4,0,1,1,0,0,3,117,138,16751,13284,121,3,17093,12440
38,4,0,0,2,1,2,1,53,49,16751,13284,51,28,17094,12441
39,4,2,0,0,3,1,0,4,1,16753,13284,6,0,17097,12441
40,4,2,1,0,3,1,0,20,25,16755,13285,22,0,17100,12441
41,4,1,2,1,0,0,3,1,4,16756,13287,0,6,17100,12444
42,4,1,0,0,3,1,0,26,33,16757,13287,26,81,17103,12444
43,4,1,1,2,1,2,1,1,2,16758,13288,1,22,17104,12445
44,4,1,1,2,1,2,1,1,1,16759,13289,2,30,17105,12446
45,4,2,1,0,3,1,0,181,171,16761,13290,194,3,17108,12446
46,4,2,4,1,0,0,3,5,4,16763,13294,3,4,17108,12449
47,4,1,1,2,1,2,1,203,180,16764,13295,236,15,17109,12450
48,5,0,1,1,0,0,3,0,7,16764,13296,0,84,17109,12453
49,5,0,0,2,1,2,1,140,150,16764,13296,134,31,17110,12454
50,5,2,2,2,1,2,1,2,3,16766,13298,2,7,17111,12455
51,5,0,1,1,0,0,3,21,24,16766,13299,30,6,17111,12458
52,5,0,1,1,0,0,3,53,50,16766,13300,51,3,17111,12461
53,5,2,0,0,3,1,0,7,4,16768,13300,6,1,17114,12461
54,5,0,2,1,0,0,3,4,3,16768,13302,6,137,17114,12464
55,5,0,0,2,1,2,1,20,25,16768,13302,23,15,17115,12465
56,5,1,2,1,0,0,3,2,4,16769,13304,1,65,17115,12468
57,5,1,2,1,0,0,3,182,173,16770,13306,194,25,17115,12471
58,5,1,2,1,0,0,3,1,5,16771,13308,0,6,17115,12474
59,5,0,1,1,0,0,3,0,3,16771,13309,0,31,17115,12477
60,6,0,1,1,0,0,3,4,2,16771,13310,6,14,17115,12480
61,6,1,1,2,1,2,1,5,6,16772,13311,4,129,17116,12481
62,6,2,0,0,3,1,0,3,1,16774,13311,5,3,17119,12481
63,6,1,0,0,3,1,0,118,138,16775,13311,124,15,17122,12481
64,6,1,1,2,1,2,1,2,5,16776,13312,1,5,17123,12482
65,6,1,0,0,3,1,0,28,57,16777,13312,38,3,17126,12482
66,6,1,0,0,3,1,0,27,33,16778,13312,29,0,17129,12482
67,6,1,1,2,1,2,1,43,78,16779,13313,41,89,17130,12483
68,6,0,2,1,0,0,3,63,80,16779,13315,67,7,17130,12486
69,6,1,2,1,0,0,3,2,3,16780,13317,2,4,17130,12489
70,6,3,1,0,3,1,0,125,135,16783,13318,139,30,17133,12489
71,6,2,2,2,1,2,1,205,182,16785,13320,237,1,17134,12490
72,7,1,1,2,1,2,1,3,6,16786,13321,2,4,17135,12491
73,7,1,1,2,1,2,1,126,136,16787,13322,140,90,17136,12492
74,7,1,1,2,1,2,1,5,3,16788,13323,7,130,17137,12493
75,7,1,1,2,1,2,1,44,79,16789,13324,42,15,17138,12494
76,7,0,4,1,0,0,3,5,10,16789,13328,4,33,17138,12497
77,7,1,2,1,0,0,3,29,59,16790,13330,38,10,17138,12500
78,7,1,1,2,1,2,1,4,2,16791,13331,6,2,17139,12501
79,7,2,1,0,3,1,0,120,139,16793,13332,127,0,17142,12501
80,7,0,0,2,1,2,1,63,80,16793,13332,68,16,17143,12502
81,7,3,0,0,3,1,0,30,33,16796,13332,32,5,17146,12502
82,7,0,1,1,0,0,3,2,4,16796,13333,2,6,17146,12505
83,7,3,2,0,3,1,0,208,184,16799,13335,240,4,17149,12505
84,8,3,0,0,3,1,0,5,3,16802,13335,5,31,17152,12505
85,8,2,4,1,0,0,3,55,54,16804,13339,51,18,17152,12508
86,8,1,1,2,1,2,1,8,5,16805,13340,7,66,17153,12509
87,8,2,0,0,3,1,0,22,25,16807,13340,26,1,17156,12509
88,8,2,0,0,3,1,0,184,173,16809,13340,197,137,17159,12509
89,8,1,1,2,1,2,1,2,6,16810,13341,1,85,17160,12510
90,8,0,2,1,0,0,3,0,5,16810,13343,0,9,17160,12513
91,8,1,0,0,3,1,0,141,150,16811,13343,137,7,17163,12513
92,8,2,1,0,3,1,0,23,25,16813,13344,33,25,17166,12513
93,8,1,1,2,1,2,1,1,8,16814,13345,1,32,17167,12514
94,8,1,1,2,1,2,1,5,4,16815,13346,7,4,17168,12515
95,8,3,0,0,3,1,0,5,4,16818,13346,4,6,17171,12515
96,9,3,2,0,3,1,0,8,12,16821,13348,7,18,17174,12515
97,9,1,3,1,0,0,3,6,6,16822,13351,7,69,17174,12518
98,9,1,1,2,1,2,1,142,151,16823,13352,138,5,17175,12519
99,9,1,0,0,3,1,0,6,3,16824,13352,8,85,17178,12519
100,9,0,3,1,0,0,3,5,7,16824,13355,7,7,17178,12522
101,9,1,0,0,3,1,0,23,25,16825,13355,29,4,17181,12522
102,9,0,3,1,0,0,3,4,5,16825,13358,6,28,17181,12525
103,9,1,2,1,0,0,3,1,7,16826,13360,0,19,17181,12528
104,9,3,2,0,3,1,0,66,82,16829,13362,71,32,17184,12528
105,9,1,0,0,3,1,0,209,184,16830,13362,243,5,17187,12528
106,9,2,0,0,3,1,0,186,173,16832,13362,200,33,17190,12528
107,9,1,0,0,3,1,0,3,6,16833,13362,4,6,17193,12528
108,10,1,1,2,1,2,1,9,6,16834,13363,8,131,17194,12529
109,10,1,2,1,0,0,3,30,61,16835,13365,38,10,17194,12532
110,10,0,0,2,1,2,1,120,139,16835,13365,128,10,17195,12533
111,10,1,0,0,3,1,0,3,4,16836,13365,5,90,17198,12533
112,10,0,0,2,1,2,1,55,54,16836,13365,52,16,17199,12534
113,10,3,0,0,3,1,0,47,79,16839,13365,45,2,17202,12534
114,10,3,2,0,3,1,0,129,138,16842,13367,143,137,17205,12534
115,10,0,3,1,0,0,3,30,36,16842,13370,32,13,17205,12537
116,10,1,2,1,0,0,3,24,27,16843,13372,33,3,17205,12540
117,10,0,1,1,0,0,3,1,9,16843,13373,1,34,17205,12543
118,10,2,1,0,3,1,0,5,7,16845,13374,5,1,17208,12543
119,10,0,1,1,0,0,3,5,5,16845,13375,4,9,17208,12546
120,11,0,1,1,0,0,3,47,80,16845,13376,45,13,17208,12549
121,11,0,3,1,0,0,3,30,39,16845,13379,32,140,17208,12552
122,11,1,3,1,0,0,3,25,30,16846,13382,33,93,17208,12555
123,11,3,1,0,3,1,0,58,55,16849,13383,55,34,17211,12555
124,11,0,0,2,1,2,1,9,6,16849,13383,9,17,17212,12556
125,11,0,2,1,0,0,3,1,11,16849,13385,1,5,17212,12559
126,11,1,1,2,1,2,1,31,62,16850,13386,39,10,17213,12560
127,11,1,0,0,3,1,0,121,139,16851,13386,131,131,17216,12560
128,11,2,0,0,3,1,0,7,7,16853,13386,8,3,17219,12560
129,11,2,1,0,3,1,0,7,6,16855,13387,7,13,17222,12560
130,11,0,0,2,1,2,1,3,4,16855,13387,6,11,17223,12561
131,11,3,2,0,3,1,0,132,140,16858,13389,146,1,17226,12561
132,12,0,0,2,1,2,1,8,12,16858,13389,8,20,17227,12562
133,12,4,2,0,3,1,0,146,153,16862,13391,141,18,17230,12562
134,12,2,0,0,3,1,0,8,3,16864,13391,11,4,17233,12562
135,12,1,0,0,3,1,0,7,6,16865,13391,10,5,17236,12562
136,12,1,1,2,1,2,1,6,8,16866,13392,8,34,17237,12563
137,12,0,1,1,0,0,3,23,26,16866,13393,29,72,17237,12566
138,12,1,1,2,1,2,1,5,6,16867,13394,7,33,17238,12567
139,12,1,0,0,3,1,0,2,7,16868,13394,3,6,17241,12567
140,12,1,1,2,1,2,1,67,83,16869,13395,72,86,17242,12568
141,12,4,3,0,3,1,0,213,187,16873,13398,246,28,17245,12568
142,12,1,0,0,3,1,0,187,173,16874,13398,203,5,17248,12568
143,12,0,0,2,1,2,1,3,6,16874,13398,5,8,17249,12569
144,13,1,1,2,1,2,1,7,9,16875,13399,9,21,17250,12570
145,13,3,2,0,3,1,0,70,85,16878,13401,75,5,17253,12570
146,13,2,3,1,0,0,3,215,190,16880,13404,246,75,17253,12573
147,13,0,0,2,1,2,1,3,6,16880,13404,6,29,17254,12574
148,13,0,1,1,0,0,3,8,4,16880,13405,11,11,17254,12577
149,13,0,3,1,0,0,3,2,10,16880,13408,3,37,17254,12580
150,13,2,0,0,3,1,0,148,153,16882,13408,144,4,17257,12580
151,13,3,0,0,3,1,0,26,26,16885,13408,32,5,17260,12580
152,13,1,1,2,1,2,1,6,7,16886,13409,8,19,17261,12581
153,13,0,0,2,1,2,1,7,6,16886,13409,11,87,17262,12582
154,13,1,0,0,3,1,0,9,12,16887,13409,11,33,17265,12582
155,13,1,1,2,1,2,1,188,174,16888,13410,204,7,17266,12583
156,14,2,1,0,3,1,0,11,7,16890,13411,12,34,17269,12583
157,14,3,1,0,3,1,0,33,40,16893,13412,35,13,17272,12583
158,14,0,0,2,1,2,1,25,30,16893,13412,34,12,17273,12584
159,14,2,1,0,3,1,0,60,56,16895,13413,58,5,17276,12584
160,14,4,0,0,3,1,0,51,80,16899,13413,48,10,17279,12584
161,14,1,1,2,1,2,1,2,12,16900,13414,2,4,17280,12585
162,14,3,2,0,3,1,0,34,64,16903,13416,42,17,17283,12585
163,14,1,1,2,1,2,1,122,140,16904,13417,132,2,17284,12586
164,14,2,2,2,1,2,1,9,8,16906,13419,8,94,17285,12587
165,14,0,0,2,1,2,1,3,4,16906,13419,7,141,17286,12588
166,14,4,1,0,3,1,0,136,141,16910,13420,149,13,17289,12588
167,14,0,1,1,0,0,3,7,8,16910,13421,8,134,17289,12591
168,15,3,0,0,3,1,0,54,80,16913,13421,51,29,17292,12591
169,15,2,3,1,0,0,3,150,156,16915,13424,144,16,17292,12594
170,15,1,2,1,0,0,3,26,32,16916,13426,34,8,17292,12597
171,15,1,1,2,1,2,1,3,13,16917,13427,3,3,17293,12598
172,15,1,2,1,0,0,3,71,87,16918,13429,75,16,17293,12601
173,15,0,2,1,0,0,3,9,10,16918,13431,8,14,17293,12604
174,15,2,1,0,3,1,0,28,27,16920,13432,35,134,17296,12604
175,15,2,1,0,3,1,0,62,57,16922,13433,61,12,17299,12604
176,15,3,1,0,3,1,0,10,10,16925,13434,12,75,17302,12604
177,15,0,0,2,1,2,1,7,8,16925,13434,9,88,17303,12605
178,15,1,1,2,1,2,1,4,5,16926,13435,8,20,17304,12606
179,15,0,1,1,0,0,3,3,7,16926,13436,6,144,17304,12609
180,16,0,4,1,0,0,3,8,8,16926,13440,11,97,17304,12612
181,16,2,0,0,3,1,0,35,40,16928,13440,38,4,17307,12612
182,16,2,2,2,1,2,1,13,9,16930,13442,13,38,17308,12613
183,16,0,1,1,0,0,3,7,7,16930,13443,11,24,17308,12616
184,16,3,1,0,3,1,0,12,13,16933,13444,14,5,17311,12616
185,16,2,0,0,3,1,0,36,64,16935,13444,45,34,17314,12616
186,16,0,1,1,0,0,3,6,8,16935,13445,8,8,17314,12619
187,16,2,1,0,3,1,0,124,141,16937,13446,135,7,17317,12619
188,16,2,2,2,1,2,1,4,12,16939,13448,4,5,17318,12620
189,16,1,0,0,3,1,0,216,190,16940,13448,249,17,17321,12620
190,16,2,0,0,3,1,0,190,174,16942,13448,207,10,17324,12620
191,16,0,1,1,0,0,3,136,142,16942,13449,149,36,17324,12623
192,17,0,0,2,1,2,1,12,13,16942,13449,15,11,17325,12624
193,17,2,0,0,3,1,0,38,64,16944,13449,48,7,17328,12624
194,17,1,1,2,1,2,1,7,9,16945,13450,9,35,17329,12625
195,17,0,0,2,1,2,1,190,174,16945,13450,208,98,17330,12626
196,17,2,0,0,3,1,0,138,142,16947,13450,152,5,17333,12626
197,17,1,2,1,0,0,3,217,192,16948,13452,249,39,17333,12629
198,17,3,0,0,3,1,0,7,12,16951,13452,7,17,17336,12629
199,17,2,1,0,3,1,0,10,9,16953,13453,14,5,17339,12629
200,17,0,0,2,1,2,1,13,9,16953,13453,14,9,17340,12630
201,17,1,0,0,3,1,0,8,7,16954,13453,14,38,17343,12630
202,17,2,1,0,3,1,0,126,142,16956,13454,138,4,17346,12630
203,17,1,2,1,0,0,3,36,42,16957,13456,38,27,17346,12633
204,18,0,2,1,0,0,3,54,82,16957,13458,51,137,17346,12636
205,18,5,0,0,3,1,0,155,156,16962,13458,147,29,17349,12636
206,18,0,1,1,0,0,3,26,33,16962,13459,34,91,17349,12639
207,18,1,2,1,0,0,3,63,59,16963,13461,61,78,17349,12642
208,18,0,0,2,1,2,1,3,13,16963,13461,4,145,17350,12643
209,18,3,0,0,3,1,0,13,10,16966,13461,15,16,17353,12643
210,18,3,0,0,3,1,0,31,27,16969,13461,38,12,17356,12643
211,18,1,3,1,0,0,3,8,11,16970,13464,9,17,17356,12646
212,18,0,1,1,0,0,3,71,88,16970,13465,75,23,17356,12649
213,18,2,0,0,3,1,0,11,10,16972,13465,11,16,17359,12649
214,18,1,2,1,0,0,3,5,7,16973,13467,8,11,17359,12652
215,18,1,2,1,0,0,3,4,9,16974,13469,6,6,17359,12655
216,19,0,0,2,1,2,1,71,88,16974,13469,76,146,17360,12656
217,19,1,0,0,3,1,0,156,156,16975,13469,150,5,17363,12656
218,19,2,1,0,3,1,0,12,10,16977,13470,17,16,17366,12656
219,19,0,2,1,0,0,3,8,9,16977,13472,14,15,17366,12659
220,19,2,0,0,3,1,0,10,11,16979,13472,12,7,17369,12659
221,19,1,1,2,1,2,1,139,143,16980,13473,153,18,17370,12660
222,19,2,0,0,3,1,0,5,13,16982,13473,7,137,17373,12660
223,19,3,2,0,3,1,0,57,84,16985,13475,54,27,17376,12660
224,19,1,0,0,3,1,0,32,27,16986,13475,41,11,17379,12660
225,19,2,1,0,3,1,0,65,60,16988,13476,64,5,17382,12660
226,19,0,0,2,1,2,1,12,13,16988,13476,16,30,17383,12661
227,19,1,2,1,0,0,3,37,44,16989,13478,38,81,17383,12664
228,20,1,0,0,3,1,0,8,12,16990,13478,10,16,17386,12664
229,20,2,0,0,3,1,0,128,142,16992,13478,141,39,17389,12664
230,20,1,4,1,0,0,3,27,37,16993,13482,34,20,17389,12667
231,20,3,1,0,3,1,0,16,10,16996,13483,17,23,17392,12667
232,20,2,0,0,3,1,0,40,64,16998,13483,51,91,17395,12667
233,20,0,0,2,1,2,1,13,10,16998,13483,16,99,17396,12668
234,20,1,1,2,1,2,1,8,10,16999,13484,10,5,17397,12669
235,20,1,0,0,3,1,0,6,7,17000,13484,11,6,17400,12669
236,20,1,0,0,3,1,0,218,192,17001,13484,252,38,17403,12669
237,20,2,0,0,3,1,0,192,174,17003,13484,211,11,17406,12669
238,20,1,1,2,1,2,1,5,10,17004,13485,7,36,17407,12670
239,20,3,0,0,3,1,0,14,10,17007,13485,14,9,17410,12670
240,21,2,1,0,3,1,0,14,11,17009,13486,20,30,17413,12670
241,21,1,1,2,1,2,1,66,61,17010,13487,65,8,17414,12671
242,21,2,1,0,3,1,0,10,10,17012,13488,17,5,17417,12671
243,21,2,3,1,0,0,3,59,87,17014,13491,54,21,17417,12674
244,21,0,0,2,1,2,1,12,13,17014,13491,17,147,17418,12675
245,21,0,1,1,0,0,3,5,14,17014,13492,7,19,17418,12678
246,21,0,0,2,1,2,1,10,11,17014,13492,13,28,17419,12679
247,21,0,2,1,0,0,3,71,90,17014,13494,76,140,17419,12682
248,21,2,1,0,3,1,0,39,45,17016,13495,41,11,17422,12682
249,21,1,0,0,3,1,0,140,143,17017,13495,156,81,17425,12682
250,21,1,1,2,1,2,1,157,157,17018,13496,151,16,17426,12683
251,21,0,3,1,0,0,3,32,30,17018,13499,41,8,17426,12686
252,22,0,4,1,0,0,3,27,41,17018,13503,34,12,17426,12689
253,22,2,1,0,3,1,0,8,8,17020,13504,14,20,17429,12689
254,22,2,1,0,3,1,0,42,65,17022,13505,54,38,17432,12689
255,22,2,1,0,3,1,0,15,11,17024,13506,19,16,17435,12689
256,22,1,1,2,1,2,1,129,143,17025,13507,142,37,17436,12690
257,22,2,0,0,3,1,0,10,12,17027,13507,13,6,17439,12690
258,22,1,2,1,0,0,3,15,12,17028,13509,14,14,17439,12693
259,22,2,1,0,3,1,0,7,11,17030,13510,10,39,17442,12693
260,22,1,1,2,1,2,1,219,193,17031,13511,253,6,17443,12694
261,22,2,1,0,3,1,0,18,11,17033,13512,20,99,17446,12694
262,22,0,0,2,1,2,1,192,174,17033,13512,212,24,17447,12695
263,22,0,0,2,1,2,1,8,10,17033,13512,11,92,17448,12696
264,23,1,0,0,3,1,0,9,8,17034,13512,17,12,17451,12696
265,23,0,2,1,0,0,3,27,43,17034,13514,34,41,17451,12699
266,23,1,2,1,0,0,3,43,67,17035,13516,54,27,17451,12702
267,23,1,2,1,0,0,3,9,12,17036,13518,11,9,17451,12705
268,23,1,0,0,3,1,0,130,143,17037,13518,145,14,17454,12705
269,23,0,1,1,0,0,3,10,13,17037,13519,13,9,17454,12708
270,23,2,1,0,3,1,0,194,175,17039,13520,215,92,17457,12708
271,23,1,3,1,0,0,3,8,14,17040,13523,10,23,17457,12711
272,23,0,1,1,0,0,3,219,194,17040,13524,253,102,17457,12714
273,23,0,2,1,0,0,3,15,13,17040,13526,19,40,17457,12717
274,23,3,2,0,3,1,0,21,13,17043,13528,23,16,17460,12717
275,23,1,2,1,0,0,3,16,14,17044,13530,14,42,17460,12720
276,24,0,1,1,0,0,3,32,31,17044,13531,41,31,17460,12723
277,24,0,1,1,0,0,3,157,158,17044,13532,151,14,17460,12726
278,24,1,1,2,1,2,1,67,62,17045,13533,66,148,17461,12727
279,24,2,0,0,3,1,0,12,10,17047,13533,20,19,17464,12727
280,24,1,2,1,0,0,3,60,89,17048,13535,54,84,17464,12730
281,24,0,1,1,0,0,3,5,15,17048,13536,7,11,17464,12733
282,24,3,1,0,3,1,0,13,12,17051,13537,16,16,17467,12733
283,24,2,0,0,3,1,0,142,143,17053,13537,159,30,17470,12733
284,24,0,2,1,0,0,3,14,13,17053,13539,20,143,17470,12736
285,24,2,0,0,3,1,0,14,13,17055,13539,20,8,17473,12736
286,24,1,3,1,0,0,3,40,48,17056,13542,41,24,17473,12739
287,24,1,0,0,3,1,0,72,90,17057,13542,79,5,17476,12739
288,25,1,0,0,3,1,0,6,15,17058,13542,10,102,17479,12739
289,25,3,0,0,3,1,0,43,48,17061,13542,44,9,17482,12739
290,25,3,3,2,1,2,1,19,17,17064,13545,15,149,17483,12740
291,25,1,0,0,3,1,0,143,143,17065,13545,162,14,17486,12740
292,25,2,0,0,3,1,0,132,143,17067,13545,148,16,17489,12740
293,25,1,0,0,3,1,0,22,13,17068,13545,26,14,17492,12740
294,25,0,1,1,0,0,3,60,90,17068,13546,54,43,17492,12743
295,25,0,1,1,0,0,3,43,68,17068,13547,54,19,17492,12746
296,25,1,2,1,0,0,3,14,14,17069,13549,16,26,17492,12749
297,25,0,1,1,0,0,3,27,44,17069,13550,34,22,17492,12752
298,25,2,0,0,3,1,0,11,8,17071,13550,20,5,17495,12752
299,25,1,1,2,1,2,1,68,63,17072,13551,67,144,17496,12753
300,26,1,2,1,0,0,3,220,196,17073,13553,253,95,17496,12756
301,26,0,1,1,0,0,3,72,91,17073,13554,79,15,17496,12759
302,26,0,0,2,1,2,1,10,13,17073,13554,14,28,17497,12760
303,26,0,1,1,0,0,3,32,32,17073,13555,41,44,17497,12763
304,26,2,1,0,3,1,0,14,11,17075,13556,23,30,17500,12763
305,26,2,2,2,1,2,1,16,15,17077,13558,21,43,17501,12764
306,26,1,1,2,1,2,1,195,176,17078,13559,216,25,17502,12765
307,26,0,0,2,1,2,1,9,12,17078,13559,12,85,17503,12766
308,26,1,2,1,0,0,3,158,160,17079,13561,151,11,17503,12769
309,26,1,2,1,0,0,3,15,15,17080,13563,20,12,17503,12772
310,26,0,0,2,1,2,1,8,14,17080,13563,11,32,17504,12773
311,27,3,1,0,3,1,0,46,49,17083,13564,47,102,17507,12773
312,27,0,0,2,1,2,1,132,143,17083,13564,149,27,17508,12774
313,27,1,1,2,1,2,1,28,45,17084,13565,35,10,17509,12775
314,27,1,0,0,3,1,0,69,63,17085,13565,70,14,17512,12775
315,27,7,2,0,3,1,0,29,15,17092,13567,29,5,17515,12775
316,27,1,1,2,1,2,1,61,91,17093,13568,55,20,17516,12776
317,27,1,0,0,3,1,0,7,15,17094,13568,13,16,17519,12776
318,27,1,1,2,1,2,1,44,69,17095,13569,55,150,17520,12777
319,27,0,0,2,1,2,1,14,14,17095,13569,17,15,17521,12778
320,27,1,3,1,0,0,3,20,20,17096,13572,15,147,17521,12781
321,27,1,0,0,3,1,0,12,8,17097,13572,23,22,17524,12781
322,27,1,2,1,0,0,3,144,145,17098,13574,162,46,17524,12784
323,28,2,0,0,3,1,0,197,176,17100,13574,219,85,17527,12784
324,28,0,0,2,1,2,1,15,15,17100,13574,21,96,17528,12785
325,28,3,2,0,3,1,0,161,162,17103,13576,154,32,17531,12785
326,28,0,2,1,0,0,3,14,13,17103,13578,23,46,17531,12788
327,28,1,1,2,1,2,1,16,14,17104,13579,20,31,17532,12789
328,28,1,4,1,0,0,3,33,36,17105,13583,41,28,17532,12792
329,28,4,1,0,3,1,0,13,13,17109,13584,15,11,17535,12792
330,28,1,2,1,0,0,3,11,15,17110,13586,14,14,17535,12795
331,28,1,0,0,3,1,0,73,91,17111,13586,82,44,17538,12795
332,28,0,0,2,1,2,1,220,196,17111,13586,254,29,17539,12796
333,28,0,3,1,0,0,3,8,17,17111,13589,11,15,17539,12799
334,28,0,0,2,1,2,1,16,15,17111,13589,22,16,17540,12800
335,29,1,2,1,0,0,3,70,65,17112,13591,70,25,17540,12803
336,29,0,0,2,1,2,1,14,14,17112,13591,18,103,17541,12804
337,29,0,1,1,0,0,3,28,46,17112,13592,35,17,17541,12807
338,29,3,1,0,3,1,0,64,92,17115,13593,58,10,17544,12807
339,29,2,1,0,3,1,0,9,16,17117,13594,16,27,17547,12807
340,29,2,3,1,0,0,3,46,72,17119,13597,55,8,17547,12810
341,29,4,1,0,3,1,0,136,144,17123,13598,152,150,17550,12810
342,29,1,2,1,0,0,3,47,51,17124,13600,47,23,17550,12813
343,29,6,0,0,3,1,0,150,145,17130,13600,165,16,17553,12813
344,29,0,2,1,0,0,3,29,17,17130,13602,29,18,17553,12816
345,29,0,2,1,0,0,3,12,10,17130,13604,23,150,17553,12819
346,29,3,1,0,3,1,0,23,21,17133,13605,18,46,17556,12819
347,30,0,1,1,0,0,3,11,16,17133,13606,14,99,17556,12822
348,30,1,0,0,3,1,0,221,196,17134,13606,257,11,17559,12822
349,30,0,2,1,0,0,3,14,15,17134,13608,23,32,17559,12825
350,30,2,1,0,3,1,0,35,37,17136,13609,44,31,17562,12825
351,30,1,2,1,0,0,3,9,19,17137,13611,11,19,17562,12828
352,30,0,2,1,0,0,3,16,16,17137,13613,20,49,17562,12831
353,30,0,2,1,0,0,3,15,17,17137,13615,21,88,17562,12834
354,30,2,0,0,3,1,0,15,13,17139,13615,18,32,17565,12834
355,30,2,1,0,3,1,0,75,92,17141,13616,85,28,17568,12834
356,30,1,0,0,3,1,0,198,176,17142,13616,222,15,17571,12834
357,30,2,1,0,3,1,0,18,16,17144,13617,25,44,17574,12834
358,30,1,0,0,3,1,0,162,162,17145,13617,157,14,17577,12834
359,31,2,1,0,3,1,0,152,146,17147,13618,168,19,17580,12834
360,31,2,0,0,3,1,0,17,17,17149,13618,24,28,17583,12834
361,31,0,1,1,0,0,3,14,16,17149,13619,23,21,17583,12837
362,31,4,0,0,3,1,0,68,92,17153,13619,61,25,17586,12837
363,31,4,1,0,3,1,0,50,73,17157,13620,58,150,17589,12837
364,31,0,0,2,1,2,1,15,13,17157,13620,19,9,17590,12838
365,31,1,0,0,3,1,0,137,144,17158,13620,155,14,17593,12838
366,31,1,0,0,3,1,0,15,14,17159,13620,21,44,17596,12838
367,31,2,1,0,3,1,0,77,93,17161,13621,88,103,17599,12838
368,31,0,2,1,0,0,3,47,53,17161,13623,47,30,17599,12841
369,31,0,1,1,0,0,3,12,11,17161,13624,23,35,17599,12844
370,31,3,0,0,3,1,0,224,196,17164,13624,260,17,17602,12844
371,32,1,3,1,0,0,3,29,49,17165,13627,35,91,17602,12847
372,32,2,0,0,3,1,0,11,16,17167,13627,19,31,17605,12847
373,32,1,3,1,0,0,3,36,40,17168,13630,44,19,17605,12850
374,32,1,1,2,1,2,1,17,17,17169,13631,21,24,17606,12851
375,32,0,1,1,0,0,3,23,22,17169,13632,18,18,17606,12854
376,32,1,0,0,3,1,0,10,19,17170,13632,14,32,17609,12854
377,32,2,0,0,3,1,0,20,16,17172,13632,28,150,17612,12854
378,32,3,0,0,3,1,0,32,17,17175,13632,32,11,17615,12854
379,32,1,0,0,3,1,0,199,176,17176,13632,225,10,17618,12854
380,32,1,2,1,0,0,3,163,164,17177,13634,157,52,17618,12857
381,32,2,3,1,0,0,3,72,68,17179,13637,70,102,17618,12860
382,32,0,0,2,1,2,1,11,16,17179,13637,15,47,17619,12861
383,33,1,1,2,1,2,1,12,17,17180,13638,20,19,17620,12862
384,33,1,0,0,3,1,0,164,164,17181,13638,160,102,17623,12862
385,33,2,1,0,3,1,0,22,17,17183,13639,31,24,17626,12862
386,33,2,1,0,3,1,0,31,50,17185,13640,38,47,17629,12862
387,33,1,1,2,1,2,1,73,69,17186,13641,71,11,17630,12863
388,33,2,1,0,3,1,0,34,18,17188,13642,35,150,17633,12863
389,33,3,2,0,3,1,0,20,19,17191,13644,24,11,17636,12863
390,33,1,1,2,1,2,1,37,41,17192,13645,45,53,17637,12864
391,33,3,0,0,3,1,0,14,16,17195,13645,18,31,17640,12864
392,33,0,1,1,0,0,3,23,23,17195,13646,18,35,17640,12867
393,33,1,3,1,0,0,3,200,179,17196,13649,225,22,17640,12870
394,33,0,2,1,0,0,3,10,21,17196,13651,14,94,17640,12873
395,34,4,0,0,3,1,0,72,92,17200,13651,64,19,17643,12873
396,34,1,2,1,0,0,3,18,19,17201,13653,24,33,17643,12876
397,34,1,1,2,1,2,1,51,74,17202,13654,59,36,17644,12877
398,34,2,1,0,3,1,0,17,14,17204,13655,22,25,17647,12877
399,34,0,1,1,0,0,3,15,15,17204,13656,21,20,17647,12880
400,34,1,0,0,3,1,0,48,53,17205,13656,50,44,17650,12880
401,34,1,0,0,3,1,0,138,144,17206,13656,158,28,17653,12880
402,34,1,3,1,0,0,3,78,96,17207,13659,88,24,17653,12883
403,34,2,0,0,3,1,0,154,146,17209,13659,171,9,17656,12883
404,34,1,2,1,0,0,3,15,18,17210,13661,23,106,17656,12886
405,34,1,2,1,0,0,3,13,13,17211,13663,23,17,17656,12889
406,34,1,2,1,0,0,3,225,198,17212,13665,260,153,17656,12892
407,35,0,0,2,1,2,1,51,74,17212,13665,60,54,17657,12893
408,35,1,0,0,3,1,0,155,146,17213,13665,174,19,17660,12893
409,35,1,0,0,3,1,0,23,17,17214,13665,34,36,17663,12893
410,35,0,2,1,0,0,3,15,20,17214,13667,23,50,17663,12896
411,35,1,0,0,3,1,0,19,19,17215,13667,27,19,17666,12896
412,35,0,2,1,0,0,3,17,16,17215,13669,22,47,17666,12899
413,35,3,0,0,3,1,0,141,144,17218,13669,161,20,17669,12899
414,35,1,1,2,1,2,1,15,17,17219,13670,19,107,17670,12900
415,35,3,0,0,3,1,0,51,53,17222,13670,53,11,17673,12900
416,35,2,0,0,3,1,0,227,198,17224,13670,263,9,17676,12900
417,35,2,1,0,3,1,0,202,180,17226,13671,228,33,17679,12900
418,36,0,1,1,0,0,3,73,70,17226,13672,71,31,17679,12903
419,36,0,1,1,0,0,3,20,20,17226,13673,24,156,17679,12906
420,36,2,3,1,0,0,3,166,167,17228,13676,160,27,17679,12909
421,36,0,3,1,0,0,3,31,53,17228,13679,38,25,17679,12912
422,36,1,2,1,0,0,3,73,94,17229,13681,64,105,17679,12915
423,36,0,1,1,0,0,3,12,18,17229,13682,20,27,17679,12918
424,36,3,0,0,3,1,0,40,41,17232,13682,48,150,17682,12918
425,36,1,1,2,1,2,1,16,16,17233,13683,22,36,17683,12919
426,36,0,1,1,0,0,3,78,97,17233,13684,88,34,17683,12922
427,36,1,0,0,3,1,0,11,21,17234,13684,17,25,17686,12922
428,36,1,2,1,0,0,3,14,15,17235,13686,23,97,17686,12925
429,37,0,0,2,1,2,1,73,94,17235,13686,65,151,17687,12926
430,37,2,2,2,1,2,1,14,20,17237,13688,21,32,17688,12927
431,37,2,0,0,3,1,0,22,20,17239,13688,27,11,17691,12927
432,37,2,0,0,3,1,0,42,41,17241,13688,51,25,17694,12927
433,37,1,4,1,0,0,3,24,27,17242,13692,18,108,17694,12930
434,37,3,0,0,3,1,0,169,167,17245,13692,163,156,17697,12930
435,37,0,2,1,0,0,3,16,18,17245,13694,22,100,17697,12933
436,37,3,2,0,3,1,0,81,99,17248,13696,91,27,17700,12933
437,37,1,3,1,0,0,3,12,24,17249,13699,17,30,17700,12936
438,37,2,1,0,3,1,0,33,54,17251,13700,41,36,17703,12936
439,37,0,0,2,1,2,1,73,70,17251,13700,72,26,17704,12937
440,37,1,1,2,1,2,1,15,16,17252,13701,24,35,17705,12938
441,38,1,1,2,1,2,1,35,19,17253,13702,36,20,17706,12939
442,38,1,2,1,0,0,3,24,19,17254,13704,34,14,17706,12942
443,38,0,2,1,0,0,3,15,22,17254,13706,23,20,17706,12945
444,38,0,0,2,1,2,1,19,19,17254,13706,28,10,17707,12946
445,38,1,0,0,3,1,0,18,16,17255,13706,25,33,17710,12946
446,38,1,1,2,1,2,1,142,145,17256,13707,162,48,17711,12947
447,38,0,1,1,0,0,3,15,18,17256,13708,19,23,17711,12950
448,38,1,1,2,1,2,1,52,54,17257,13709,54,51,17712,12951
449,38,1,0,0,3,1,0,228,198,17258,13709,266,19,17715,12951
450,38,3,0,0,3,1,0,158,146,17261,13709,177,36,17718,12951
451,38,0,1,1,0,0,3,202,181,17261,13710,228,57,17718,12954
452,38,1,2,1,0,0,3,52,76,17262,13712,60,110,17718,12957
453,39,3,1,0,3,1,0,172,168,17265,13713,166,33,17721,12957
454,39,0,2,1,0,0,3,15,24,17265,13715,23,154,17721,12960
455,39,0,1,1,0,0,3,73,95,17265,13716,65,23,17721,12963
456,39,2,0,0,3,1,0,16,20,17267,13716,24,23,17724,12963
457,39,1,0,0,3,1,0,19,16,17268,13716,28,20,17727,12963
458,39,1,1,2,1,2,1,16,19,17269,13717,20,101,17728,12964
459,39,3,0,0,3,1,0,84,99,17272,13717,94,11,17731,12964
460,39,1,0,0,3,1,0,159,146,17273,13717,180,14,17734,12964
461,39,1,0,0,3,1,0,13,24,17274,13717,20,48,17737,12964
462,39,1,1,2,1,2,1,25,20,17275,13718,35,37,17738,12965
463,39,1,0,0,3,1,0,34,54,17276,13718,44,156,17741,12965
464,39,1,1,2,1,2,1,53,77,17277,13719,61,33,17742,12966
465,40,1,1,2,1,2,1,43,42,17278,13720,52,109,17743,12967
466,40,0,2,1,0,0,3,73,72,17278,13722,72,113,17743,12970
467,40,3,1,0,3,1,0,22,20,17281,13723,31,26,17746,12970
468,40,1,2,1,0,0,3,23,22,17282,13725,27,33,17746,12973
469,40,3,1,0,3,1,0,19,19,17285,13726,25,51,17749,12973
470,40,3,1,0,3,1,0,55,55,17288,13727,57,19,17752,12973
471,40,0,3,1,0,0,3,24,30,17288,13730,18,13,17752,12976
472,40,1,2,1,0,0,3,229,200,17289,13732,266,30,17752,12979
473,40,0,1,1,0,0,3,202,182,17289,13733,228,28,17752,12982
474,40,5,0,0,3,1,0,20,16,17294,13733,27,57,17755,12982
475,40,0,0,2,1,2,1,35,19,17294,13733,37,37,17756,12983
476,40,7,0,0,3,1,0,149,145,17301,13733,165,35,17759,12983
477,41,2,0,0,3,1,0,161,146,17303,13733,183,37,17762,12983
478,41,0,3,1,0,0,3,19,19,17303,13736,28,159,17762,12986
479,41,4,1,0,3,1,0,176,169,17307,13737,169,11,17765,12986
480,41,2,0,0,3,1,0,27,20,17309,13737,38,33,17768,12986
481,41,2,0,0,3,1,0,36,54,17311,13737,47,154,17771,12986
482,41,0,0,2,1,2,1,15,24,17311,13737,24,24,17772,12987
483,41,2,2,2,1,2,1,75,97,17313,13739,66,49,17773,12988
484,41,0,1,1,0,0,3,16,21,17313,13740,24,104,17773,12991
485,41,0,0,2,1,2,1,53,77,17313,13740,62,21,17774,12992
486,41,0,5,1,0,0,3,16,24,17313,13745,20,36,17774,12995
487,41,4,1,0,3,1,0,88,100,17317,13746,97,14,17777,12995
488,41,1,3,1,0,0,3,14,27,17318,13749,20,26,17777,12998
0,1,3,1,0,3,1,0,3,1,17321,13750,3,0,17780,12998
1,1,0,0,2,1,2,1,0,0,17321,13750,1,1,17781,12999
2,1,1,1,2,1,2,1,1,1,17322,13751,1,1,17782,13000
3,1,0,1,1,0,0,3,0,1,17322,13752,0,3,17782,13003
4,1,2,2,2,1,2,1,2,2,17324,13754,1,1,17783,13004
5,1,0,3,1,0,0,3,0,3,17324,13757,0,3,17783,13007
6,1,0,1,1,0,0,3,0,1,17324,13758,0,3,17783,13010
7,1,3,1,0,3,1,0,3,1,17327,13759,3,0,17786,13010
8,1,1,2,1,0,0,3,1,2,17328,13761,0,3,17786,13013
9,2,3,1,0,3,1,0,6,2,17331,13762,6,0,17789,13013
10,2,0,0,2,1,2,1,0,0,17331,13762,2,2,17790,13014
11,2,1,1,2,1,2,1,2,2,17332,13763,2,2,17791,13015
12,2,0,1,1,0,0,3,0,2,17332,13764,0,6,17791,13018
13,2,2,2,2,1,2,1,4,4,17334,13766,2,2,17792,13019
14,2,0,3,1,0,0,3,0,6,17334,13769,0,6,17792,13022
15,2,0,1,1,0,0,3,0,2,17334,13770,0,6,17792,13025
16,2,3,1,0,3,1,0,6,2,17337,13771,6,0,17795,13025
17,2,1,2,1,0,0,3,2,4,17338,13773,0,6,17795,13028
18,3,3,1,0,3,1,0,9,3,17341,13774,9,0,17798,13028
19,3,0,0,2,1,2,1,0,0,17341,13774,3,3,17799,13029
20,3,1,1,2,1,2,1,3,3,17342,13775,3,3,17800,13030
21,3,0,1,1,0,0,3,0,3,17342,13776,0,9,17800,13033
22,3,2,2,2,1,2,1,6,6,17344,13778,3,3,17801,13034
23,3,0,3,1,0,0,3,0,9,17344,13781,0,9,17801,13037
24,3,0,1,1,0,0,3,0,3,17344,13782,0,9,17801,13040
25,3,3,1,0,3,1,0,9,3,17347,13783,9,0,17804,13040
26,3,1,2,1,0,0,3,3,6,17348,13785,0,9,17804,13043
27,4,3,1,0,3,1,0,12,4,17351,13786,12,0,17807,13043
28,4,0,0,2,1,2,1,0,0,17351,13786,4,4,17808,13044
29,4,1,1,2,1,2,1,4,4,17352,13787,4,4,17809,13045
30,4,0,1,1,0,0,3,0,4,17352,13788,0,12,17809,13048
31,4,2,2,2,1,2,1,8,8,17354,13790,4,4,17810,13049
32,4,0,3,1,0,0,3,0,12,17354,13793,0,12,17810,13052
33,4,0,1,1,0,0,3,0,4,17354,13794,0,12,17810,13055
34,4,3,1,0,3,1,0,12,4,17357,13795,12,0,17813,13055
35,4,1,2,1,0,0,3,4,8,17358,13797,0,12,17813,13058
36,5,3,1,0,3,1,0,15,5,17361,13798,15,0,17816,13058
37,5,0,0,2,1,2,1,0,0,17361,13798,5,5,17817,13059
38,5,1,1,2,1,2,1,5,5,17362,13799,5,5,17818,13060
39,5,0,1,1,0,0,3,0,5,17362,13800,0,15,17818,13063
40,5,2,2,2,1,2,1,10,10,17364,13802,5,5,17819,13064
41,5,0,3,1,0,0,3,0,15,17364,13805,0,15,17819,13067
42,5,0,1,1,0,0,3,0,5,17364,13806,0,15,17819,13070
43,5,3,1,0,3,1,0,15,5,17367,13807,15,0,17822,13070
44,5,1,2,1,0,0,3,5,10,17368,13809,0,15,17822,13073
45,6,3,1,0,3,1,0,18,6,17371,13810,18,0,17825,13073
46,6,0,0,2,1,2,1,0,0,17371,13810,6,6,17826,13074
47,6,1,1,2,1,2,1,6,6,17372,13811,6,6,17827,13075
48,6,0,1,1,0,0,3,0,6,17372,13812,0,18,17827,13078
49,6,2,2,2,1,2,1,12,12,17374,13814,6,6,17828,13079
50,6,0,3,1,0,0,3,0,18,17374,13817,0,18,17828,13082
51,6,0,1,1,0,0,3,0,6,17374,13818,0,18,17828,13085
52,6,3,1,0,3,1,0,18,6,17377,13819,18,0,17831,13085
53,6,1,2,1,0,0,3,6,12,17378,13821,0,18,17831,13088
54,7,3,1,0,3,1,0,21,7,17381,13822,21,0,17834,13088
55,7,0,0,2,1,2,1,0,0,17381,13822,7,7,17835,13089
56,7,1,1,2,1,2,1,7,7,17382,13823,7,7,17836,13090
57,7,0,1,1,0,0,3,0,7,17382,13824,0,21,17836,13093
58,7,2,2,2,1,2,1,14,14,17384,13826,7,7,17837,13094
59,7,0,3,1,0,0,3,0,21,17384,13829,0,21,17837,13097
60,7,0,1,1,0,0,3,0,7,17384,13830,0,21,17837,13100
61,7,3,1,0,3,1,0,21,7,17387,13831,21,0,17840,13100
62,7,1,2,1,0,0,3,7,14,17388,13833,0,21,17840,13103
63,8,3,1,0,3,1,0,24,8,17391,13834,24,0,17843,13103
64,8,0,0,2,1,2,1,0,0,17391,13834,8,8,17844,13104
65,8,1,1,2,1,2,1,8,8,17392,13835,8,8,17845,13105
66,8,0,1,1,0,0,3,0,8,17392,13836,0,24,17845,13108
67,8,2,2,2,1,2,1,16,16,17394,13838,8,8,17846,13109
68,8,0,3,1,0,0,3,0,24,17394,13841,0,24,17846,13112
69,8,0,1,1,0,0,3,0,8,17394,13842,0,24,17846,13115
70,8,3,1,0,3,1,0,24,8,17397,13843,24,0,17849,13115
71,8,1,2,1,0,0,3,8,16,17398,13845,0,24,17849,13118
72,9,3,1,0,3,1,0,27,9,17401,13846,27,0,17852,13118
73,9,0,0,2,1,2,1,0,0,17401,13846,9,9,17853,13119
74,9,1,1,2,1,2,1,9,9,17402,13847,9,9,17854,13120
75,9,0,1,1,0,0,3,0,9,17402,13848,0,27,17854,13123
76,9,2,2,2,1,2,1,18,18,17404,13850,9,9,17855,13124
77,9,0,3,1,0,0,3,0,27,17404,13853,0,27,17855,13127
78,9,0,1,1,0,0,3,0,9,17404,13854,0,27,17855,13130
79,9,3,1,0,3,1,0,27,9,17407,13855,27,0,17858,13130
80,9,1,2,1,0,0,3,9,18,17408,13857,0,27,17858,13133
81,10,3,1,0,3,1,0,30,10,17411,13858,30,0,17861,13133
82,10,0,0,2,1,2,1,0,0,17411,13858,10,10,17862,13134
83,10,1,1,2,1,2,1,10,10,17412,13859,10,10,17863,13135
84,10,0,1,1,0,0,3,0,10,17412,13860,0,30,17863,13138
85,10,2,2,2,1,2,1,20,20,17414,13862,10,10,17864,13139
86,10,0,3,1,0,0,3,0,30,17414,13865,0,30,17864,13142
87,10,0,1,1,0,0,3,0,10,17414,13866,0,30,17864,13145
88,10,3,1,0,3,1,0,30,10,17417,13867,30,0,17867,13145
89,10,1,2,1,0,0,3,10,20,17418,13869,0,30,17867,13148
90,11,3,1,0,3,1,0,33,11,17421,13870,33,0,17870,13148
91,11,0,0,2,1,2,1,0,0,17421,13870,11,11,17871,13149
92,11,1,1,2,1,2,1,11,11,17422,13871,11,11,17872,13150
93,11,0,1,1,0,0,3,0,11,17422,13872,0,33,17872,13153
94,11,2,2,2,1,2,1,22,22,17424,13874,11,11,17873,13154
95,11,0,3,1,0,0,3,0,33,17424,13877,0,33,17873,13157
96,11,0,1,1,0,0,3,0,11,17424,13878,0,33,17873,13160
97,11,3,1,0,3,1,0,33,11,17427,13879,33,0,17876,13160
98,11,1,2,1,0,0,3,11,22,17428,13881,0,33,17876,13163
99,12,3,1,0,3,1,0,36,12,17431,13882,36,0,17879,13163
100,12,0,0,2,1,2,1,0,0,17431,13882,12,12,17880,13164
101,12,1,1,2,1,2,1,12,12,17432,13883,12,12,17881,13165
102,12,0,1,1,0,0,3,0,12,17432,13884,0,36,17881,13168
103,12,2,2,2,1,2,1,24,24,17434,13886,12,12,17882,13169
104,12,0,3,1,0,0,3,0,36,17434,13889,0,36,17882,13172
105,12,0,1,1,0,0,3,0,12,17434,13890,0,36,17882,13175
106,12,3,1,0,3,1,0,36,12,17437,13891,36,0,17885,13175
107,12,1,2,1,0,0,3,12,24,17438,13893,0,36,17885,13178
108,13,3,1,0,3,1,0,39,13,17441,13894,39,0,17888,13178
109,13,0,0,2,1,2,1,0,0,17441,13894,13,13,17889,13179
110,13,1,1,2,1,2,1,13,13,17442,13895,13,13,17890,13180
111,13,0,1,1,0,0,3,0,13,17442,13896,0,39,17890,13183
112,13,2,2,2,1,2,1,26,26,17444,13898,13,13,17891,13184
113,13,0,3,1,0,0,3,0,39,17444,13901,0,39,17891,13187
114,13,0,1,1,0,0,3,0,13,17444,13902,0,39,17891,13190
115,13,3,1,0,3,1,0,39,13,17447,13903,39,0,17894,13190
116,13,1,2,1,0,0,3,13,26,17448,13905,0,39,17894,13193
117,14,3,1,0,3,1,0,42,14,17451,13906,42,0,17897,13193
118,14,0,0,2,1,2,1,0,0,17451,13906,14,14,17898,13194
119,14,1,1,2,1,2,1,14,14,17452,13907,14,14,17899,13195
120,14,0,1,1,0,0,3,0,14,17452,13908,0,42,17899,13198
121,14,2,2,2,1,2,1,28,28,17454,13910,14,14,17900,13199
122,14,0,3,1,0,0,3,0,42,17454,13913,0,42,17900,13202
123,14,0,1,1,0,0,3,0,14,17454,13914,0,42,17900,13205
124,14,3,1,0,3,1,0,42,14,17457,13915,42,0,17903,13205
125,14,1,2,1,0,0,3,14,28,17458,13917,0,42,17903,13208
126,15,3,1,0,3,1,0,45,15,17461,13918,45,0,17906,13208
127,15,0,0,2,1,2,1,0,0,17461,13918,15,15,17907,13209
128,15,1,1,2,1,2,1,15,15,17462,13919,15,15,17908,13210
129,15,0,1,1,0,0,3,0,15,17462,13920,0,45,17908,13213
130,15,2,2,2,1,2,1,30,30,17464,13922,15,15,17909,13214
131,15,0,3,1,0,0,3,0,45,17464,13925,0,45,17909,13217
132,15,0,1,1,0,0,3,0,15,17464,13926,0,45,17909,13220
133,15,3,1,0,3,1,0,45,15,17467,13927,45,0,17912,13220
134,15,1,2,1,0,0,3,15,30,17468,13929,0,45,17912,13223
135,16,3,1,0,3,1,0,48,16,17471,13930,48,0,17915,13223
136,16,0,0,2,1,2,1,0,0,17471,13930,16,16,17916,13224
137,16,1,1,2,1,2,1,16,16,17472,13931,16,16,17917,13225
138,16,0,1,1,0,0,3,0,16,17472,13932,0,48,17917,13228
139,16,2,2,2,1,2,1,32,32,17474,13934,16,16,17918,13229
140,16,0,3,1,0,0,3,0,48,17474,13937,0,48,17918,13232
141,16,0,1,1,0,0,3,0,16,17474,13938,0,48,17918,13235
142,16,3,1,0,3,1,0,48,16,17477,13939,48,0,17921,13235
143,16,1,2,1,0,0,3,16,32,17478,13941,0,48,17921,13238
144,17,3,1,0,3,1,0,51,17,17481,13942,51,0,17924,13238
145,17,0,0,2,1,2,1,0,0,17481,13942,17,17,17925,13239
146,17,1,1,2,1,2,1,17,17,17482,13943,17,17,17926,13240
147,17,0,1,1,0,0,3,0,17,17482,13944,0,51,17926,13243
148,17,2,2,2,1,2,1,34,34,17484,13946,17,17,17927,13244
149,17,0,3,1,0,0,3,0,51,17484,13949,0,51,17927,13247
150,17,0,1,1,0,0,3,0,17,17484,13950,0,51,17927,13250
151,17,3,1,0,3,1,0,51,17,17487,13951,51,0,17930,13250
152,17,1,2,1,0,0,3,17,34,17488,13953,0,51,17930,13253
153,18,3,1,0,3,1,0,54,18,17491,13954,54,0,17933,13253
154,18,0,0,2,1,2,1,0,0,17491,13954,18,18,17934,13254
155,18,1,1,2,1,2,1,18,18,17492,13955,18,18,17935,13255
156,18,0,1,1,0,0,3,0,18,17492,13956,0,54,17935,13258
157,18,2,2,2,1,2,1,36,36,17494,13958,18,18,17936,13259
158,18,0,3,1,0,0,3,0,54,17494,13961,0,54,17936,13262
159,18,0,1,1,0,0,3,0,18,17494,13962,0,54,17936,13265
160,18,3,1,0,3,1,0,54,18,17497,13963,54,0,17939,13265
161,18,1,2,1,0,0,3,18,36,17498,13965,0,54,17939,13268
162,19,3,1,0,3,1,0,57,19,17501,13966,57,0,17942,13268
163,19,0,0,2,1,2,1,0,0,17501,13966,19,19,17943,13269
164,19,1,1,2,1,2,1,19,19,17502,13967,19,19,17944,13270
165,19,0,1,1,0,0,3,0,19,17502,13968,0,57,17944,13273
166,19,2,2,2,1,2,1,38,38,17504,13970,19,19,17945,13274
167,19,0,3,1,0,0,3,0,57,17504,13973,0,57,17945,13277
168,19,0,1,1,0,0,3,0,19,17504,13974,0,57,17945,13280
169,19,3,1,0,3,1,0,57,19,17507,13975,57,0,17948,13280
170,19,1,2,1,0,0,3,19,38,17508,13977,0,57,17948,13283
171,20,3,1,0,3,1,0,60,20,17511,13978,60,0,17951,13283
172,20,0,0,2,1,2,1,0,0,17511,13978,20,20,17952,13284
173,20,1,1,2,1,2,1,20,20,17512,13979,20,20,17953,13285
174,20,0,1,1,0,0,3,0,20,17512,13980,0,60,17953,13288
175,20,2,2,2,1,2,1,40,40,17514,13982,20,20,17954,13289
176,20,0,3,1,0,0,3,0,60,17514,13985,0,60,17954,13292
177,20,0,1,1,0,0,3,0,20,17514,13986,0,60,17954,13295
178,20,3,1,0,3,1,0,60,20,17517,13987,60,0,17957,13295
179,20,1,2,1,0,0,3,20,40,17518,13989,0,60,17957,13298
180,21,3,1,0,3,1,0,63,21,17521,13990,63,0,17960,13298
181,21,0,0,2,1,2,1,0,0,17521,13990,21,21,17961,13299
182,21,1,1,2,1,2,1,21,21,17522,13991,21,21,17962,13300
183,21,0,1,1,0,0,3,0,21,17522,13992,0,63,17962,13303
184,21,2,2,2,1,2,1,42,42,17524,13994,21,21,17963,13304
185,21,0,3,1,0,0,3,0,63,17524,13997,0,63,17963,13307
186,21,0,1,1,0,0,3,0,21,17524,13998,0,63,17963,13310
187,21,3,1,0,3,1,0,63,21,17527,13999,63,0,17966,13310
188,21,1,2,1,0,0,3,21,42,17528,14001,0,63,17966,13313
189,22,3,1,0,3,1,0,66,22,17531,14002,66,0,17969,13313
190,22,0,0,2,1,2,1,0,0,17531,14002,22,22,17970,13314
191,22,1,1,2,1,2,1,22,22,17532,14003,22,22,17971,13315
192,22,0,1,1,0,0,3,0,22,17532,14004,0,66,17971,13318
193,22,2,2,2,1,2,1,44,44,17534,14006,22,22,17972,13319
194,22,0,3,1,0,0,3,0,66,17534,14009,0,66,17972,13322
195,22,0,1,1,0,0,3,0,22,17534,14010,0,66,17972,13325
196,22,3,1,0,3,1,0,66,22,17537,14011,66,0,17975,13325
197,22,1,2,1,0,0,3,22,44,17538,14013,0,66,17975,13328
198,23,3,1,0,3,1,0,69,23,17541,14014,69,0,17978,13328
199,23,0,0,2,1,2,1,0,0,17541,14014,23,23,17979,13329
200,23,1,1,2,1,2,1,23,23,17542,14015,23,23,17980,13330
201,23,0,1,1,0,0,3,0,23,17542,14016,0,69,17980,13333
202,23,2,2,2,1,2,1,46,46,17544,14018,23,23,17981,13334
203,23,0,3,1,0,0,3,0,69,17544,14021,0,69,17981,13337
204,23,0,1,1,0,0,3,0,23,17544,14022,0,69,17981,13340
205,23,3,1,0,3,1,0,69,23,17547,14023,69,0,17984,13340
206,23,1,2,1,0,0,3,23,46,17548,14025,0,69,17984,13343
207,24,3,1,0,3,1,0,72,24,17551,14026,72,0,17987,13343
208,24,0,0,2,1,2,1,0,0,17551,14026,24,24,17988,13344
209,24,1,1,2,1,2,1,24,24,17552,14027,24,24,17989,13345
210,24,0,1,1,0,0,3,0,24,17552,14028,0,72,17989,13348
211,24,2,2,2,1,2,1,48,48,17554,14030,24,24,17990,13349
212,24,0,3,1,0,0,3,0,72,17554,14033,0,72,17990,13352
213,24,0,1,1,0,0,3,0,24,17554,14034,0,72,17990,13355
214,24,3,1,0,3,1,0,72,24,17557,14035,72,0,17993,13355
215,24,1,2,1,0,0,3,24,48,17558,14037,0,72,17993,13358
216,25,3,1,0,3,1,0,75,25,17561,14038,75,0,17996,13358
217,25,0,0,2,1,2,1,0,0,17561,14038,25,25,17997,13359
218,25,1,1,2,1,2,1,25,25,17562,14039,25,25,17998,13360
219,25,0,1,1,0,0,3,0,25,17562,14040,0,75,17998,13363
220,25,2,2,2,1,2,1,50,50,17564,14042,25,25,17999,13364
221,25,0,3,1,0,0,3,0,75,17564,14045,0,75,17999,13367
222,25,0,1,1,0,0,3,0,25,17564,14046,0,75,17999,13370
223,25,3,1,0,3,1,0,75,25,17567,14047,75,0,18002,13370
224,25,1,2,1,0,0,3,25,50,17568,14049,0,75,18002,13373
225,26,3,1,0,3,1,0,78,26,17571,14050,78,0,18005,13373
226,26,0,0,2,1,2,1,0,0,17571,14050,26,26,18006,13374
227,26,1,1,2,1,2,1,26,26,17572,14051,26,26,18007,13375
228,26,0,1,1,0,0,3,0,26,17572,14052,0,78,18007,13378
229,26,2,2,2,1,2,1,52,52,17574,14054,26,26,18008,13379
230,26,0,3,1,0,0,3,0,78,17574,14057,0,78,18008,13382
231,26,0,1,1,0,0,3,0,26,17574,14058,0,78,18008,13385
232,26,3,1,0,3,1,0,78,26,17577,14059,78,0,18011,13385
233,26,1,2,1,0,0,3,26,52,17578,14061,0,78,18011,13388
234,27,3,1,0,3,1,0,81,27,17581,14062,81,0,18014,13388
235,27,0,0,2,1,2,1,0,0,17581,14062,27,27,18015,13389
236,27,1,1,2,1,2,1,27,27,17582,14063,27,27,18016,13390
237,27,0,1,1,0,0,3,0,27,17582,14064,0,81,18016,13393
238,27,2,2,2,1,2,1,54,54,17584,14066,27,27,18017,13394
239,27,0,3,1,0,0,3,0,81,17584,14069,0,81,18017,13397
240,27,0,1,1,0,0,3,0,27,17584,14070,0,81,18017,13400
241,27,3,1,0,3,1,0,81,27,17587,14071,81,0,18020,13400
242,27,1,2,1,0,0,3,27,54,17588,14073,0,81,18020,13403
243,28,3,1,0,3,1,0,84,28,17591,14074,84,0,18023,13403
244,28,0,0,2,1,2,1,0,0,17591,14074,28,28,18024,13404
245,28,1,1,2,1,2,1,28,28,17592,14075,28,28,18025,13405
246,28,0,1,1,0,0,3,0,28,17592,14076,0,84,18025,13408
247,28,2,2,2,1,2,1,56,56,17594,14078,28,28,18026,13409
248,28,0,3,1,0,0,3,0,84,17594,14081,0,84,18026,13412
249,28,0,1,1,0,0,3,0,28,17594,14082,0,84,18026,13415
250,28,3,1,0,3,1,0,84,28,17597,14083,84,0,18029,13415
251,28,1,2,1,0,0,3,28,56,17598,14085,0,84,18029,13418
252,29,3,1,0,3,1,0,87,29,17601,14086,87,0,18032,13418
253,29,0,0,2,1,2,1,0,0,17601,14086,29,29,18033,13419
254,29,1,1,2,1,2,1,29,29,17602,14087,29,29,18034,13420
255,29,0,1,1,0,0,3,0,29,17602,14088,0,87,18034,13423
256,29,2,2,2,1,2,1,58,58,17604,14090,29,29,18035,13424
257,29,0,3,1,0,0,3,0,87,17604,14093,0,87,18035,13427
258,29,0,1,1,0,0,3,0,29,17604,14094,0,87,18035,13430
259,29,3,1,0,3,1,0,87,29,17607,14095,87,0,18038,13430
260,29,1,2,1,0,0,3,29,58,17608,14097,0,87,18038,13433
261,30,3,1,0,3,1,0,90,30,17611,14098,90,0,18041,13433
262,30,0,0,2,1,2,1,0,0,17611,14098,30,30,18042,13434
263,30,1,1,2,1,2,1,30,30,17612,14099,30,30,18043,13435
264,30,0,1,1,0,0,3,0,30,17612,14100,0,90,18043,13438
265,30,2,2,2,1,2,1,60,60,17614,14102,30,30,18044,13439
266,30,0,3,1,0,0,3,0,90,17614,14105,0,90,18044,13442
267,30,0,1,1,0,0,3,0,30,17614,14106,0,90,18044,13445
268,30,3,1,0,3,1,0,90,30,17617,14107,90,0,18047,13445
269,30,1,2,1,0,0,3,30,60,17618,14109,0,90,18047,13448
270,31,3,1,0,3,1,0,93,31,17621,14110,93,0,18050,13448
271,31,0,0,2,1,2,1,0,0,17621,14110,31,31,18051,13449
272,31,1,1,2,1,2,1,31,31,17622,14111,31,31,18052,13450
273,31,0,1,1,0,0,3,0,31,17622,14112,0,93,18052,13453
274,31,2,2,2,1,2,1,62,62,17624,14114,31,31,18053,13454
275,31,0,3,1,0,0,3,0,93,17624,14117,0,93,18053,13457
276,31,0,1,1,0,0,3,0,31,17624,14118,0,93,18053,13460
277,31,3,1,0,3,1,0,93,31,17627,14119,93,0,18056,13460
278,31,1,2,1,0,0,3,31,62,17628,14121,0,93,18056,13463
279,32,3,1,0,3,1,0,96,32,17631,14122,96,0,18059,13463
280,32,0,0,2,1,2,1,0,0,17631,14122,32,32,18060,13464
281,32,1,1,2,1,2,1,32,32,17632,14123,32,32,18061,13465
282,32,0,1,1,0,0,3,0,32,17632,14124,0,96,18061,13468
283,32,2,2,2,1,2,1,64,64,17634,14126,32,32,18062,13469
284,32,0,3,1,0,0,3,0,96,17634,14129,0,96,18062,13472
285,32,0,1,1,0,0,3,0,32,17634,14130,0,96,18062,13475
286,32,3,1,0,3,1,0,96,32,17637,14131,96,0,18065,13475
287,32,1,2,1,0,0,3,32,64,17638,14133,0,96,18065,13478
288,33,3,1,0,3,1,0,99,33,17641,14134,99,0,18068,13478
289,33,0,0,2,1,2,1,0,0,17641,14134,33,33,18069,13479
290,33,1,1,2,1,2,1,33,33,17642,14135,33,33,18070,13480
291,33,0,1,1,0,0,3,0,33,17642,14136,0,99,18070,13483
292,33,2,2,2,1,2,1,66,66,17644,14138,33,33,18071,13484
293,33,0,3,1,0,0,3,0,99,17644,14141,0,99,18071,13487
294,33,0,1,1,0,0,3,0,33,17644,14142,0,99,18071,13490
295,33,3,1,0,3,1,0,99,33,17647,14143,99,0,18074,13490
296,33,1,2,1,0,0,3,33,66,17648,14145,0,99,18074,13493
297,34,3,1,0,3,1,0,102,34,17651,14146,102,0,18077,13493
298,34,0,0,2,1,2,1,0,0,17651,14146,34,34,18078,13494
299,34,1,1,2,1,2,1,34,34,17652,14147,34,34,18079,13495
300,34,0,1,1,0,0,3,0,34,17652,14148,0,102,18079,13498
301,34,2,2,2,1,2,1,68,68,17654,14150,34,34,18080,13499
302,34,0,3,1,0,0,3,0,102,17654,14153,0,102,18080,13502
303,34,0,1,1,0,0,3,0,34,17654,14154,0,102,18080,13505
304,34,3,1,0,3,1,0,102,34,17657,14155,102,0,18083,13505
305,34,1,2,1,0,0,3,34,68,17658,14157,0,102,18083,13508
0,1,3,0,0,3,1,0,3,0,17661,14157,37,0,18086,13508
1,1,3,1,0,3,1,0,3,1,17664,14158,3,102,18089,13508
2,1,1,3,1,0,0,3,1,3,17665,14161,0,3,18089,13511
3,1,2,2,2,1,2,1,2,36,17667,14163,1,103,18090,13512
4,1,1,0,0,3,1,0,35,68,17668,14163,3,0,18093,13512
5,1,3,2,0,3,1,0,71,70,17671,14165,37,0,18096,13512
6,1,0,0,2,1,2,1,0,34,17671,14165,1,35,18097,13513
7,1,1,0,0,3,1,0,1,0,17672,14165,3,0,18100,13513
8,1,2,4,1,0,0,3,104,38,17674,14169,102,105,18100,13516
9,2,3,0,0,3,1,0,6,0,17677,14169,40,0,18103,13516
10,2,3,1,0,3,1,0,6,2,17680,14170,6,102,18106,13516
11,2,1,3,1,0,0,3,2,6,17681,14173,0,6,18106,13519
12,2,2,2,2,1,2,1,4,38,17683,14175,2,104,18107,13520
13,2,1,0,0,3,1,0,36,68,17684,14175,6,0,18110,13520
14,2,3,2,0,3,1,0,74,72,17687,14177,40,0,18113,13520
15,2,0,0,2,1,2,1,0,34,17687,14177,2,36,18114,13521
16,2,1,0,0,3,1,0,2,0,17688,14177,6,0,18117,13521
17,2,2,4,1,0,0,3,106,42,17690,14181,102,108,18117,13524
18,3,3,0,0,3,1,0,9,0,17693,14181,43,0,18120,13524
19,3,3,1,0,3,1,0,9,3,17696,14182,9,102,18123,13524
20,3,1,3,1,0,0,3,3,9,17697,14185,0,9,18123,13527
21,3,2,2,2,1,2,1,6,40,17699,14187,3,105,18124,13528
22,3,1,0,0,3,1,0,37,68,17700,14187,9,0,18127,13528
23,3,3,2,0,3,1,0,77,74,17703,14189,43,0,18130,13528
24,3,0,0,2,1,2,1,0,34,17703,14189,3,37,18131,13529
25,3,1,0,0,3,1,0,3,0,17704,14189,9,0,18134,13529
26,3,2,4,1,0,0,3,108,46,17706,14193,102,111,18134,13532
27,4,3,0,0,3,1,0,12,0,17709,14193,46,0,18137,13532
28,4,3,1,0,3,1,0,12,4,17712,14194,12,102,18140,13532
29,4,1,3,1,0,0,3,4,12,17713,14197,0,12,18140,13535
30,4,2,2,2,1,2,1,8,42,17715,14199,4,106,18141,13536
31,4,1,0,0,3,1,0,38,68,17716,14199,12,0,18144,13536
32,4,3,2,0,3,1,0,80,76,17719,14201,46,0,18147,13536
33,4,0,0,2,1,2,1,0,34,17719,14201,4,38,18148,13537
34,4,1,0,0,3,1,0,4,0,17720,14201,12,0,18151,13537
35,4,2,4,1,0,0,3,110,50,17722,14205,102,114,18151,13540
36,5,3,0,0,3,1,0,15,0,17725,14205,49,0,18154,13540
37,5,3,1,0,3,1,0,15,5,17728,14206,15,102,18157,13540
38,5,1,3,1,0,0,3,5,15,17729,14209,0,15,18157,13543
39,5,2,2,2,1,2,1,10,44,17731,14211,5,107,18158,13544
40,5,1,0,0,3,1,0,39,68,17732,14211,15,0,18161,13544
41,5,3,2,0,3,1,0,83,78,17735,14213,49,0,18164,13544
42,5,0,0,2,1,2,1,0,34,17735,14213,5,39,18165,13545
43,5,1,0,0,3,1,0,5,0,17736,14213,15,0,18168,13545
44,5,2,4,1,0,0,3,112,54,17738,14217,102,117,18168,13548
45,6,3,0,0,3,1,0,18,0,17741,14217,52,0,18171,13548
46,6,3,1,0,3,1,0,18,6,17744,14218,18,102,18174,13548
47,6,1,3,1,0,0,3,6,18,17745,14221,0,18,18174,13551
48,6,2,2,2,1,2,1,12,46,17747,14223,6,108,18175,13552
49,6,1,0,0,3,1,0,40,68,17748,14223,18,0,18178,13552
50,6,3,2,0,3,1,0,86,80,17751,14225,52,0,18181,13552
51,6,0,0,2,1,2,1,0,34,17751,14225,6,40,18182,13553
52,6,1,0,0,3,1,0,6,0,17752,14225,18,0,18185,13553
53,6,2,4,1,0,0,3,114,58,17754,14229,102,120,18185,13556
54,7,3,0,0,3,1,0,21,0,17757,14229,55,0,18188,13556
55,7,3,1,0,3,1,0,21,7,17760,14230,21,102,18191,13556
56,7,1,3,1,0,0,3,7,21,17761,14233,0,21,18191,13559
57,7,2,2,2,1,2,1,14,48,17763,14235,7,109,18192,13560
58,7,1,0,0,3,1,0,41,68,17764,14235,21,0,18195,13560
59,7,3,2,0,3,1,0,89,82,17767,14237,55,0,18198,13560
60,7,0,0,2,1,2,1,0,34,17767,14237,7,41,18199,13561
61,7,1,0,0,3,1,0,7,0,17768,14237,21,0,18202,13561
62,7,2,4,1,0,0,3,116,62,17770,14241,102,123,18202,13564
63,8,3,0,0,3,1,0,24,0,17773,14241,58,0,18205,13564
64,8,3,1,0,3,1,0,24,8,17776,14242,24,102,18208,13564
65,8,1,3,1,0,0,3,8,24,17777,14245,0,24,18208,13567
66,8,2,2,2,1,2,1,16,50,17779,14247,8,110,18209,13568
67,8,1,0,0,3,1,0,42,68,17780,14247,24,0,18212,13568
68,8,3,2,0,3,1,0,92,84,17783,14249,58,0,18215,13568
69,8,0,0,2,1,2,1,0,34,17783,14249,8,42,18216,13569
70,8,1,0,0,3,1,0,8,0,17784,14249,24,0,18219,13569
71,8,2,4,1,0,0,3,118,66,17786,14253,102,126,18219,13572
72,9,3,0,0,3,1,0,27,0,17789,14253,61,0,18222,13572
73,9,3,1,0,3,1,0,27,9,17792,14254,27,102,18225,13572
74,9,1,3,1,0,0,3,9,27,17793,14257,0,27,18225,13575
75,9,2,2,2,1,2,1,18,52,17795,14259,9,111,18226,13576
76,9,1,0,0,3,1,0,43,68,17796,14259,27,0,18229,13576
77,9,3,2,0,3,1,0,95,86,17799,14261,61,0,18232,13576
78,9,0,0,2,1,2,1,0,34,17799,14261,9,43,18233,13577
79,9,1,0,0,3,1,0,9,0,17800,14261,27,0,18236,13577
80,9,2,4,1,0,0,3,120,70,17802,14265,102,129,18236,13580
81,10,3,0,0,3,1,0,30,0,17805,14265,64,0,18239,13580
82,10,3,1,0,3,1,0,30,10,17808,14266,30,102,18242,13580
83,10,1,3,1,0,0,3,10,30,17809,14269,0,30,18242,13583
84,10,2,2,2,1,2,1,20,54,17811,14271,10,112,18243,13584
85,10,1,0,0,3,1,0,44,68,17812,14271,30,0,18246,13584
86,10,3,2,0,3,1,0,98,88,17815,14273,64,0,18249,13584
87,10,0,0,2,1,2,1,0,34,17815,14273,10,44,18250,13585
88,10,1,0,0,3,1,0,10,0,17816,14273,30,0,18253,13585
89,10,2,4,1,0,0,3,122,74,17818,14277,102,132,18253,13588
90,11,3,0,0,3,1,0,33,0,17821,14277,67,0,18256,13588
91,11,3,1,0,3,1,0,33,11,17824,14278,33,102,18259,13588
92,11,1,3,1,0,0,3,11,33,17825,14281,0,33,18259,13591
93,11,2,2,2,1,2,1,22,56,17827,14283,11,113,18260,13592
94,11,1,0,0,3,1,0,45,68,17828,14283,33,0,18263,13592
95,11,3,2,0,3,1,0,101,90,17831,14285,67,0,18266,13592
96,11,0,0,2,1,2,1,0,34,17831,14285,11,45,18267,13593
97,11,1,0,0,3,1,0,11,0,17832,14285,33,0,18270,13593
98,11,2,4,1,0,0,3,124,78,17834,14289,102,135,18270,13596
99,12,3,0,0,3,1,0,36,0,17837,14289,70,0,18273,13596
100,12,3,1,0,3,1,0,36,12,17840,14290,36,102,18276,13596
101,12,1,3,1,0,0,3,12,36,17841,14293,0,36,18276,13599
102,12,2,2,2,1,2,1,24,58,17843,14295,12,114,18277,13600
103,12,1,0,0,3,1,0,46,68,17844,14295,36,0,18280,13600
104,12,3,2,0,3,1,0,104,92,17847,14297,70,0,18283,13600
105,12,0,0,2,1,2,1,0,34,17847,14297,12,46,18284,13601
106,12,1,0,0,3,1,0,12,0,17848,14297,36,0,18287,13601
107,12,2,4,1,0,0,3,126,82,17850,14301,102,138,18287,13604
108,13,3,0,0,3,1,0,39,0,17853,14301,73,0,18290,13604
109,13,3,1,0,3,1,0,39,13,17856,14302,39,102,18293,13604
110,13,1,3,1,0,0,3,13,39,17857,14305,0,39,18293,13607
111,13,2,2,2,1,2,1,26,60,17859,14307,13,115,18294,13608
112,13,1,0,0,3,1,0,47,68,17860,14307,39,0,18297,13608
113,13,3,2,0,3,1,0,107,94,17863,14309,73,0,18300,13608
114,13,0,0,2,1,2,1,0,34,17863,14309,13,47,18301,13609
115,13,1,0,0,3,1,0,13,0,17864,14309,39,0,18304,13609
116,13,2,4,1,0,0,3,128,86,17866,14313,102,141,18304,13612
117,14,3,0,0,3,1,0,42,0,17869,14313,76,0,18307,13612
118,14,3,1,0,3,1,0,42,14,17872,14314,42,102,18310,13612
119,14,1,3,1,0,0,3,14,42,17873,14317,0,42,18310,13615
120,14,2,2,2,1,2,1,28,62,17875,14319,14,116,18311,13616
121,14,1,0,0,3,1,0,48,68,17876,14319,42,0,18314,13616
122,14,3,2,0,3,1,0,110,96,17879,14321,76,0,18317,13616
123,14,0,0,2,1,2,1,0,34,17879,14321,14,48,18318,13617
124,14,1,0,0,3,1,0,14,0,17880,14321,42,0,18321,13617
125,14,2,4,1,0,0,3,130,90,17882,14325,102,144,18321,13620
126,15,3,0,0,3,1,0,45,0,17885,14325,79,0,18324,13620
127,15,3,1,0,3,1,0,45,15,17888,14326,45,102,18327,13620
128,15,1,3,1,0,0,3,15,45,17889,14329,0,45,18327,13623
129,15,2,2,2,1,2,1,30,64,17891,14331,15,117,18328,13624
130,15,1,0,0,3,1,0,49,68,17892,14331,45,0,18331,13624
131,15,3,2,0,3,1,0,113,98,17895,14333,79,0,18334,13624
132,15,0,0,2,1,2,1,0,34,17895,14333,15,49,18335,13625
133,15,1,0,0,3,1,0,15,0,17896,14333,45,0,18338,13625
134,15,2,4,1,0,0,3,132,94,17898,14337,102,147,18338,13628
135,16,3,0,0,3,1,0,48,0,17901,14337,82,0,18341,13628
136,16,3,1,0,3,1,0,48,16,17904,14338,48,102,18344,13628
137,16,1,3,1,0,0,3,16,48,17905,14341,0,48,18344,13631
138,16,2,2,2,1,2,1,32,66,17907,14343,16,118,18345,13632
139,16,1,0,0,3,1,0,50,68,17908,14343,48,0,18348,13632
140,16,3,2,0,3,1,0,116,100,17911,14345,82,0,18351,13632
141,16,0,0,2,1,2,1,0,34,17911,14345,16,50,18352,13633
142,16,1,0,0,3,1,0,16,0,17912,14345,48,0,18355,13633
143,16,2,4,1,0,0,3,134,98,17914,14349,102,150,18355,13636
144,17,3,0,0,3,1,0,51,0,17917,14349,85,0,18358,13636
145,17,3,1,0,3,1,0,51,17,17920,14350,51,102,18361,13636
146,17,1,3,1,0,0,3,17,51,17921,14353,0,51,18361,13639
147,17,2,2,2,1,2,1,34,68,17923,14355,17,119,18362,13640
148,17,1,0,0,3,1,0,51,68,17924,14355,51,0,18365,13640
149,17,3,2,0,3,1,0,119,102,17927,14357,85,0,18368,13640
150,17,0,0,2,1,2,1,0,34,17927,14357,17,51,18369,13641
151,17,1,0,0,3,1,0,17,0,17928,14357,51,0,18372,13641
152,17,2,4,1,0,0,3,136,102,17930,14361,102,153,18372,13644
153,18,3,0,0,3,1,0,54,0,17933,14361,88,0,18375,13644
154,18,3,1,0,3,1,0,54,18,17936,14362,54,102,18378,13644
155,18,1,3,1,0,0,3,18,54,17937,14365,0,54,18378,13647
156,18,2,2,2,1,2,1,36,70,17939,14367,18,120,18379,13648
157,18,1,0,0,3,1,0,52,68,17940,14367,54,0,18382,13648
158,18,3,2,0,3,1,0,122,104,17943,14369,88,0,18385,13648
159,18,0,0,2,1,2,1,0,34,17943,14369,18,52,18386,13649
160,18,1,0,0,3,1,0,18,0,17944,14369,54,0,18389,13649
161,18,2,4,1,0,0,3,138,106,17946,14373,102,156,18389,13652
162,19,3,0,0,3,1,0,57,0,17949,14373,91,0,18392,13652
163,19,3,1,0,3,1,0,57,19,17952,14374,57,102,18395,13652
164,19,1,3,1,0,0,3,19,57,17953,14377,0,57,18395,13655
165,19,2,2,2,1,2,1,38,72,17955,14379,19,121,18396,13656
166,19,1,0,0,3,1,0,53,68,17956,14379,57,0,18399,13656
167,19,3,2,0,3,1,0,125,106,17959,14381,91,0,18402,13656
168,19,0,0,2,1,2,1,0,34,17959,14381,19,53,18403,13657
169,19,1,0,0,3,1,0,19,0,17960,14381,57,0,18406,13657
170,19,2,4,1,0,0,3,140,110,17962,14385,102,159,18406,13660
171,20,3,0,0,3,1,0,60,0,17965,14385,94,0,18409,13660
172,20,3,1,0,3,1,0,60,20,17968,14386,60,102,18412,13660
173,20,1,3,1,0,0,3,20,60,17969,14389,0,60,18412,13663
174,20,2,2,2,1,2,1,40,74,17971,14391,20,122,18413,13664
175,20,1,0,0,3,1,0,54,68,17972,14391,60,0,18416,13664
176,20,3,2,0,3,1,0,128,108,17975,14393,94,0,18419,13664
177,20,0,0,2,1,2,1,0,34,17975,14393,20,54,18420,13665
178,20,1,0,0,3,1,0,20,0,17976,14393,60,0,18423,13665
179,20,2,4,1,0,0,3,142,114,17978,14397,102,162,18423,13668
180,21,3,0,0,3,1,0,63,0,17981,14397,97,0,18426,13668
181,21,3,1,0,3,1,0,63,21,17984,14398,63,102,18429,13668
182,21,1,3,1,0,0,3,21,63,17985,14401,0,63,18429,13671
183,21,2,2,2,1,2,1,42,76,17987,14403,21,123,18430,13672
184,21,1,0,0,3,1,0,55,68,17988,14403,63,0,18433,13672
185,21,3,2,0,3,1,0,131,110,17991,14405,97,0,18436,13672
186,21,0,0,2,1,2,1,0,34,17991,14405,21,55,18437,13673
187,21,1,0,0,3,1,0,21,0,17992,14405,63,0,18440,13673
188,21,2,4,1,0,0,3,144,118,17994,14409,102,165,18440,13676
189,22,3,0,0,3,1,0,66,0,17997,14409,100,0,18443,13676
190,22,3,1,0,3,1,0,66,22,18000,14410,66,102,18446,13676
191,22,1,3,1,0,0,3,22,66,18001,14413,0,66,18446,13679
192,22,2,2,2,1,2,1,44,78,18003,14415,22,124,18447,13680
193,22,1,0,0,3,1,0,56,68,18004,14415,66,0,18450,13680
194,22,3,2,0,3,1,0,134,112,18007,14417,100,0,18453,13680
195,22,0,0,2,1,2,1,0,34,18007,14417,22,56,18454,13681
196,22,1,0,0,3,1,0,22,0,18008,14417,66,0,18457,13681
197,22,2,4,1,0,0,3,146,122,18010,14421,102,168,18457,13684
198,23,3,0,0,3,1,0,69,0,18013,14421,103,0,18460,13684
199,23,3,1,0,3,1,0,69,23,18016,14422,69,102,18463,13684
200,23,1,3,1,0,0,3,23,69,18017,14425,0,69,18463,13687
201,23,2,2,2,1,2,1,46,80,18019,14427,23,125,18464,13688
202,23,1,0,0,3,1,0,57,68,18020,14427,69,0,18467,13688
203,23,3,2,0,3,1,0,137,114,18023,14429,103,0,18470,13688
204,23,0,0,2,1,2,1,0,34,18023,14429,23,57,18471,13689
205,23,1,0,0,3,1,0,23,0,18024,14429,69,0,18474,13689
206,23,2,4,1,0,0,3,148,126,18026,14433,102,171,18474,13692
207,24,3,0,0,3,1,0,72,0,18029,14433,106,0,18477,13692
208,24,3,1,0,3,1,0,72,24,18032,14434,72,102,18480,13692
209,24,1,3,1,0,0,3,24,72,18033,14437,0,72,18480,13695
210,24,2,2,2,1,2,1,48,82,18035,14439,24,126,18481,13696
211,24,1,0,0,3,1,0,58,68,18036,14439,72,0,18484,13696
212,24,3,2,0,3,1,0,140,116,18039,14441,106,0,18487,13696
213,24,0,0,2,1,2,1,0,34,18039,14441,24,58,18488,13697
214,24,1,0,0,3,1,0,24,0,18040,14441,72,0,18491,13697
215,24,2,4,1,0,0,3,150,130,18042,14445,102,174,18491,13700
216,25,3,0,0,3,1,0,75,0,18045,14445,109,0,18494,13700
217,25,3,1,0,3,1,0,75,25,18048,14446,75,102,18497,13700
218,25,1,3,1,0,0,3,25,75,18049,14449,0,75,18497,13703
219,25,2,2,2,1,2,1,50,84,18051,14451,25,127,18498,13704
220,25,1,0,0,3,1,0,59,68,18052,14451,75,0,18501,13704
221,25,3,2,0,3,1,0,143,118,18055,14453,109,0,18504,13704
222,25,0,0,2,1,2,1,0,34,18055,14453,25,59,18505,13705
223,25,1,0,0,3,1,0,25,0,18056,14453,75,0,18508,13705
224,25,2,4,1,0,0,3,152,134,18058,14457,102,177,18508,13708
225,26,3,0,0,3,1,0,78,0,18061,14457,112,0,18511,13708
226,26,3,1,0,3,1,0,78,26,18064,14458,78,102,18514,13708
227,26,1,3,1,0,0,3,26,78,18065,14461,0,78,18514,13711
228,26,2,2,2,1,2,1,52,86,18067,14463,26,128,18515,13712
229,26,1,0,0,3,1,0,60,68,18068,14463,78,0,18518,13712
230,26,3,2,0,3,1,0,146,120,18071,14465,112,0,18521,13712
231,26,0,0,2,1,2,1,0,34,18071,14465,26,60,18522,13713
232,26,1,0,0,3,1,0,26,0,18072,14465,78,0,18525,13713
233,26,2,4,1,0,0,3,154,138,18074,14469,102,180,18525,13716
234,27,3,0,0,3,1,0,81,0,18077,14469,115,0,18528,13716
235,27,3,1,0,3,1,0,81,27,18080,14470,81,102,18531,13716
236,27,1,3,1,0,0,3,27,81,18081,14473,0,81,18531,13719
237,27,2,2,2,1,2,1,54,88,18083,14475,27,129,18532,13720
238,27,1,0,0,3,1,0,61,68,18084,14475,81,0,18535,13720
239,27,3,2,0,3,1,0,149,122,18087,14477,115,0,18538,13720
240,27,0,0,2,1,2,1,0,34,18087,14477,27,61,18539,13721
241,27,1,0,0,3,1,0,27,0,18088,14477,81,0,18542,13721
242,27,2,4,1,0,0,3,156,142,18090,14481,102,183,18542,13724
243,28,3,0,0,3,1,0,84,0,18093,14481,118,0,18545,13724
244,28,3,1,0,3,1,0,84,28,18096,14482,84,102,18548,13724
245,28,1,3,1,0,0,3,28,84,18097,14485,0,84,18548,13727
246,28,2,2,2,1,2,1,56,90,18099,14487,28,130,18549,13728
247,28,1,0,0,3,1,0,62,68,18100,14487,84,0,18552,13728
248,28,3,2,0,3,1,0,152,124,18103,14489,118,0,18555,13728
249,28,0,0,2,1,2,1,0,34,18103,14489,28,62,18556,13729
250,28,1,0,0,3,1,0,28,0,18104,14489,84,0,18559,13729
251,28,2,4,1,0,0,3,158,146,18106,14493,102,186,18559,13732
252,29,3,0,0,3,1,0,87,0,18109,14493,121,0,18562,13732
253,29,3,1,0,3,1,0,87,29,18112,14494,87,102,18565,13732
254,29,1,3,1,0,0,3,29,87,18113,14497,0,87,18565,13735
255,29,2,2,2,1,2,1,58,92,18115,14499,29,131,18566,13736
256,29,1,0,0,3,1,0,63,68,18116,14499,87,0,18569,13736
257,29,3,2,0,3,1,0,155,126,18119,14501,121,0,18572,13736
258,29,0,0,2,1,2,1,0,34,18119,14501,29,63,18573,13737
259,29,1,0,0,3,1,0,29,0,18120,14501,87,0,18576,13737
260,29,2,4,1,0,0,3,160,150,18122,14505,102,189,18576,13740
261,30,3,0,0,3,1,0,90,0,18125,14505,124,0,18579,13740
262,30,3,1,0,3,1,0,90,30,18128,14506,90,102,18582,13740
263,30,1,3,1,0,0,3,30,90,18129,14509,0,90,18582,13743
264,30,2,2,2,1,2,1,60,94,18131,14511,30,132,18583,13744
265,30,1,0,0,3,1,0,64,68,18132,14511,90,0,18586,13744
266,30,3,2,0,3,1,0,158,128,18135,14513,124,0,18589,13744
267,30,0,0,2,1,2,1,0,34,18135,14513,30,64,18590,13745
268,30,1,0,0,3,1,0,30,0,18136,14513,90,0,18593,13745
269,30,2,4,1,0,0,3,162,154,18138,14517,102,192,18593,13748
270,31,3,0,0,3,1,0,93,0,18141,14517,127,0,18596,13748
271,31,3,1,0,3,1,0,93,31,18144,14518,93,102,18599,13748
272,31,1,3,1,0,0,3,31,93,18145,14521,0,93,18599,13751
273,31,2,2,2,1,2,1,62,96,18147,14523,31,133,18600,13752
274,31,1,0,0,3,1,0,65,68,18148,14523,93,0,18603,13752
275,31,3,2,0,3,1,0,161,130,18151,14525,127,0,18606,13752
276,31,0,0,2,1,2,1,0,34,18151,14525,31,65,18607,13753
277,31,1,0,0,3,1,0,31,0,18152,14525,93,0,18610,13753
278,31,2,4,1,0,0,3,164,158,18154,14529,102,195,18610,13756
279,32,3,0,0,3,1,0,96,0,18157,14529,130,0,18613,13756
280,32,3,1,0,3,1,0,96,32,18160,14530,96,102,18616,13756
281,32,1,3,1,0,0,3,32,96,18161,14533,0,96,18616,13759
282,32,2,2,2,1,2,1,64,98,18163,14535,32,134,18617,13760
283,32,1,0,0,3,1,0,66,68,18164,14535,96,0,18620,13760
284,32,3,2,0,3,1,0,164,132,18167,14537,130,0,18623,13760
285,32,0,0,2,1,2,1,0,34,18167,14537,32,66,18624,13761
286,32,1,0,0,3,1,0,32,0,18168,14537,96,0,18627,13761
287,32,2,4,1,0,0,3,166,162,18170,14541,102,198,18627,13764
288,33,3,0,0,3,1,0,99,0,18173,14541,133,0,18630,13764
289,33,3,1,0,3,1,0,99,33,18176,14542,99,102,18633,13764
290,33,1,3,1,0,0,3,33,99,18177,14545,0,99,18633,13767
291,33,2,2,2,1,2,1,66,100,18179,14547,33,135,18634,13768
292,33,1,0,0,3,1,0,67,68,18180,14547,99,0,18637,13768
293,33,3,2,0,3,1,0,167,134,18183,14549,133,0,18640,13768
294,33,0,0,2,1,2,1,0,34,18183,14549,33,67,18641,13769
295,33,1,0,0,3,1,0,33,0,18184,14549,99,0,18644,13769
296,33,2,4,1,0,0,3,168,166,18186,14553,102,201,18644,13772
297,34,3,0,0,3,1,0,102,0,18189,14553,136,0,18647,13772
298,34,3,1,0,3,1,0,102,34,18192,14554,102,102,18650,13772
299,34,1,3,1,0,0,3,34,102,18193,14557,0,102,18650,13775
300,34,2,2,2,1,2,1,68,102,18195,14559,34,136,18651,13776
301,34,1,0,0,3,1,0,68,68,18196,14559,102,0,18654,13776
302,34,3,2,0,3,1,0,170,136,18199,14561,136,0,18657,13776
303,34,0,0,2,1,2,1,0,34,18199,14561,34,68,18658,13777
304,34,1,0,0,3,1,0,34,0,18200,14561,102,0,18661,13777
305,34,2,4,1,0,0,3,170,170,18202,14565,102,204,18661,13780
0,1,2,0,0,3,1,0,2,0,18204,14565,3,0,18664,13780
1,1,0,2,1,0,0,3,102,36,18204,14567,102,3,18664,13783
2,1,1,1,2,1,2,1,1,103,18205,14568,1,1,18665,13784
3,1,1,2,1,0,0,3,35,36,18206,14570,34,105,18665,13787
4,1,2,3,1,0,0,3,104,3,18208,14573,136,3,18665,13790
5,1,2,1,0,3,1,0,104,35,18210,14574,105,0,18668,13790
6,1,1,2,1,0,0,3,1,2,18211,14576,0,207,18668,13793
7,2,2,0,0,3,1,0,4,0,18213,14576,6,0,18671,13793
8,2,0,2,1,0,0,3,102,38,18213,14578,102,6,18671,13796
9,2,1,1,2,1,2,1,2,104,18214,14579,2,2,18672,13797
10,2,1,2,1,0,0,3,36,38,18215,14581,34,108,18672,13800
11,2,2,3,1,0,0,3,106,6,18217,14584,136,6,18672,13803
12,2,2,1,0,3,1,0,106,36,18219,14585,108,0,18675,13803
13,2,1,2,1,0,0,3,2,4,18220,14587,0,210,18675,13806
14,3,2,0,0,3,1,0,6,0,18222,14587,9,0,18678,13806
15,3,0,2,1,0,0,3,102,40,18222,14589,102,9,18678,13809
16,3,1,1,2,1,2,1,3,105,18223,14590,3,3,18679,13810
17,3,1,2,1,0,0,3,37,40,18224,14592,34,111,18679,13813
18,3,2,3,1,0,0,3,108,9,18226,14595,136,9,18679,13816
19,3,2,1,0,3,1,0,108,37,18228,14596,111,0,18682,13816
20,3,1,2,1,0,0,3,3,6,18229,14598,0,213,18682,13819
21,4,2,0,0,3,1,0,8,0,18231,14598,12,0,18685,13819
22,4,0,2,1,0,0,3,102,42,18231,14600,102,12,18685,13822
23,4,1,1,2,1,2,1,4,106,18232,14601,4,4,18686,13823
24,4,1,2,1,0,0,3,38,42,18233,14603,34,114,18686,13826
25,4,2,3,1,0,0,3,110,12,18235,14606,136,12,18686,13829
26,4,2,1,0,3,1,0,110,38,18237,14607,114,0,18689,13829
27,4,1,2,1,0,0,3,4,8,18238,14609,0,216,18689,13832
28,5,2,0,0,3,1,0,10,0,18240,14609,15,0,18692,13832
29,5,0,2,1,0,0,3,102,44,18240,14611,102,15,18692,13835
30,5,1,1,2,1,2,1,5,107,18241,14612,5,5,18693,13836
31,5,1,2,1,0,0,3,39,44,18242,14614,34,117,18693,13839
32,5,2,3,1,0,0,3,112,15,18244,14617,136,15,18693,13842
33,5,2,1,0,3,1,0,112,39,18246,14618,117,0,18696,13842
34,5,1,2,1,0,0,3,5,10,18247,14620,0,219,18696,13845
35,6,2,0,0,3,1,0,12,0,18249,14620,18,0,18699,13845
36,6,0,2,1,0,0,3,102,46,18249,14622,102,18,18699,13848
37,6,1,1,2,1,2,1,6,108,18250,14623,6,6,18700,13849
38,6,1,2,1,0,0,3,40,46,18251,14625,34,120,18700,13852
39,6,2,3,1,0,0,3,114,18,18253,14628,136,18,18700,13855
40,6,2,1,0,3,1,0,114,40,18255,14629,120,0,18703,13855
41,6,1,2,1,0,0,3,6,12,18256,14631,0,222,18703,13858
42,7,2,0,0,3,1,0,14,0,18258,14631,21,0,18706,13858
43,7,0,2,1,0,0,3,102,48,18258,14633,102,21,18706,13861
44,7,1,1,2,1,2,1,7,109,18259,14634,7,7,18707,13862
45,7,1,2,1,0,0,3,41,48,18260,14636,34,123,18707,13865
46,7,2,3,1,0,0,3,116,21,18262,14639,136,21,18707,13868
47,7,2,1,0,3,1,0,116,41,18264,14640,123,0,18710,13868
48,7,1,2,1,0,0,3,7,14,18265,14642,0,225,18710,13871
49,8,2,0,0,3,1,0,16,0,18267,14642,24,0,18713,13871
50,8,0,2,1,0,0,3,102,50,18267,14644,102,24,18713,13874
51,8,1,1,2,1,2,1,8,110,18268,14645,8,8,18714,13875
52,8,1,2,1,0,0,3,42,50,18269,14647,34,126,18714,13878
53,8,2,3,1,0,0,3,118,24,18271,14650,136,24,18714,13881
54,8,2,1,0,3,1,0,118,42,18273,14651,126,0,18717,13881
55,8,1,2,1,0,0,3,8,16,18274,14653,0,228,18717,13884
56,9,2,0,0,3,1,0,18,0,18276,14653,27,0,18720,13884
57,9,0,2,1,0,0,3,102,52,18276,14655,102,27,18720,13887
58,9,1,1,2,1,2,1,9,111,18277,14656,9,9,18721,13888
59,9,1,2,1,0,0,3,43,52,18278,14658,34,129,18721,13891
60,9,2,3,1,0,0,3,120,27,18280,14661,136,27,18721,13894
61,9,2,1,0,3,1,0,120,43,18282,14662,129,0,18724,13894
62,9,1,2,1,0,0,3,9,18,18283,14664,0,231,18724,13897
63,10,2,0,0,3,1,0,20,0,18285,14664,30,0,18727,13897
64,10,0,2,1,0,0,3,102,54,18285,14666,102,30,18727,13900
65,10,1,1,2,1,2,1,10,112,18286,14667,10,10,18728,13901
66,10,1,2,1,0,0,3,44,54,18287,14669,34,132,18728,13904
67,10,2,3,1,0,0,3,122,30,18289,14672,136,30,18728,13907
68,10,2,1,0,3,1,0,122,44,18291,14673,132,0,18731,13907
69,10,1,2,1,0,0,3,10,20,18292,14675,0,234,18731,13910
70,11,2,0,0,3,1,0,22,0,18294,14675,33,0,18734,13910
71,11,0,2,1,0,0,3,102,56,18294,14677,102,33,18734,13913
72,11,1,1,2,1,2,1,11,113,18295,14678,11,11,18735,13914
73,11,1,2,1,0,0,3,45,56,18296,14680,34,135,18735,13917
74,11,2,3,1,0,0,3,124,33,18298,14683,136,33,18735,13920
75,11,2,1,0,3,1,0,124,45,18300,14684,135,0,18738,13920
76,11,1,2,1,0,0,3,11,22,18301,14686,0,237,18738,13923
77,12,2,0,0,3,1,0,24,0,18303,14686,36,0,18741,13923
78,12,0,2,1,0,0,3,102,58,18303,14688,102,36,18741,13926
79,12,1,1,2,1,2,1,12,114,18304,14689,12,12,18742,13927
80,12,1,2,1,0,0,3,46,58,18305,14691,34,138,18742,13930
81,12,2,3,1,0,0,3,126,36,18307,14694,136,36,18742,13933
82,12,2,1,0,3,1,0,126,46,18309,14695,138,0,18745,13933
83,12,1,2,1,0,0,3,12,24,18310,14697,0,240,18745,13936
84,13,2,0,0,3,1,0,26,0,18312,14697,39,0,18748,13936
85,13,0,2,1,0,0,3,102,60,18312,14699,102,39,18748,13939
86,13,1,1,2,1,2,1,13,115,18313,14700,13,13,18749,13940
87,13,1,2,1,0,0,3,47,60,18314,14702,34,141,18749,13943
88,13,2,3,1,0,0,3,128,39,18316,14705,136,39,18749,13946
89,13,2,1,0,3,1,0,128,47,18318,14706,141,0,18752,13946
90,13,1,2,1,0,0,3,13,26,18319,14708,0,243,18752,13949
91,14,2,0,0,3,1,0,28,0,18321,14708,42,0,18755,13949
92,14,0,2,1,0,0,3,102,62,18321,14710,102,42,18755,13952
93,14,1,1,2,1,2,1,14,116,18322,14711,14,14,18756,13953
94,14,1,2,1,0,0,3,48,62,18323,14713,34,144,18756,13956
95,14,2,3,1,0,0,3,130,42,18325,14716,136,42,18756,13959
96,14,2,1,0,3,1,0,130,48,18327,14717,144,0,18759,13959
97,14,1,2,1,0,0,3,14,28,18328,14719,0,246,18759,13962
98,15,2,0,0,3,1,0,30,0,18330,14719,45,0,18762,13962
99,15,0,2,1,0,0,3,102,64,18330,14721,102,45,18762,13965
100,15,1,1,2,1,2,1,15,117,18331,14722,15,15,18763,13966
101,15,1,2,1,0,0,3,49,64,18332,14724,34,147,18763,13969
102,15,2,3,1,0,0,3,132,45,18334,14727,136,45,18763,13972
103,15,2,1,0,3,1,0,132,49,18336,14728,147,0,18766,13972
104,15,1,2,1,0,0,3,15,30,18337,14730,0,249,18766,13975
105,16,2,0,0,3,1,0,32,0,18339,14730,48,0,18769,13975
106,16,0,2,1,0,0,3,102,66,18339,14732,102,48,18769,13978
107,16,1,1,2,1,2,1,16,118,18340,14733,16,16,18770,13979
108,16,1,2,1,0,0,3,50,66,18341,14735,34,150,18770,13982
109,16,2,3,1,0,0,3,134,48,18343,14738,136,48,18770,13985
110,16,2,1,0,3,1,0,134,50,18345,14739,150,0,18773,13985
111,16,1,2,1,0,0,3,16,32,18346,14741,0,252,18773,13988
112,17,2,0,0,3,1,0,34,0,18348,14741,51,0,18776,13988
113,17,0,2,1,0,0,3,102,68,18348,14743,102,51,18776,13991
114,17,1,1,2,1,2,1,17,119,18349,14744,17,17,18777,13992
115,17,1,2,1,0,0,3,51,68,18350,14746,34,153,18777,13995
116,17,2,3,1,0,0,3,136,51,18352,14749,136,51,18777,13998
117,17,2,1,0,3,1,0,136,51,18354,14750,153,0,18780,13998
118,17,1,2,1,0,0,3,17,34,18355,14752,0,255,18780,14001
119,18,2,0,0,3,1,0,36,0,18357,14752,54,0,18783,14001
120,18,0,2,1,0,0,3,102,70,18357,14754,102,54,18783,14004
121,18,1,1,2,1,2,1,18,120,18358,14755,18,18,18784,14005
122,18,1,2,1,0,0,3,52,70,18359,14757,34,156,18784,14008
123,18,2,3,1,0,0,3,138,54,18361,14760,136,54,18784,14011
124,18,2,1,0,3,1,0,138,52,18363,14761,156,0,18787,14011
125,18,1,2,1,0,0,3,18,36,18364,14763,0,258,18787,14014
126,19,2,0,0,3,1,0,38,0,18366,14763,57,0,18790,14014
127,19,0,2,1,0,0,3,102,72,18366,14765,102,57,18790,14017
128,19,1,1,2,1,2,1,19,121,18367,14766,19,19,18791,14018
129,19,1,2,1,0,0,3,53,72,18368,14768,34,159,18791,14021
130,19,2,3,1,0,0,3,140,57,18370,14771,136,57,18791,14024
131,19,2,1,0,3,1,0,140,53,18372,14772,159,0,18794,14024
132,19,1,2,1,0,0,3,19,38,18373,14774,0,261,18794,14027
133,20,2,0,0,3,1,0,40,0,18375,14774,60,0,18797,14027
134,20,0,2,1,0,0,3,102,74,18375,14776,102,60,18797,14030
135,20,1,1,2,1,2,1,20,122,18376,14777,20,20,18798,14031
136,20,1,2,1,0,0,3,54,74,18377,14779,34,162,18798,14034
137,20,2,3,1,0,0,3,142,60,18379,14782,136,60,18798,14037
138,20,2,1,0,3,1,0,142,54,18381,14783,162,0,18801,14037
139,20,1,2,1,0,0,3,20,40,18382,14785,0,264,18801,14040
140,21,2,0,0,3,1,0,42,0,18384,14785,63,0,18804,14040
141,21,0,2,1,0,0,3,102,76,18384,14787,102,63,18804,14043
142,21,1,1,2,1,2,1,21,123,18385,14788,21,21,18805,14044
143,21,1,2,1,0,0,3,55,76,18386,14790,34,165,18805,14047
144,21,2,3,1,0,0,3,144,63,18388,14793,136,63,18805,14050
145,21,2,1,0,3,1,0,144,55,18390,14794,165,0,18808,14050
146,21,1,2,1,0,0,3,21,42,18391,14796,0,267,18808,14053
147,22,2,0,0,3,1,0,44,0,18393,14796,66,0,18811,14053
148,22,0,2,1,0,0,3,102,78,18393,14798,102,66,18811,14056
149,22,1,1,2,1,2,1,22,124,18394,14799,22,22,18812,14057
150,22,1,2,1,0,0,3,56,78,18395,14801,34,168,18812,14060
151,22,2,3,1,0,0,3,146,66,18397,14804,136,66,18812,14063
152,22,2,1,0,3,1,0,146,56,18399,14805,168,0,18815,14063
153,22,1,2,1,0,0,3,22,44,18400,14807,0,270,18815,14066
154,23,2,0,0,3,1,0,46,0,18402,14807,69,0,18818,14066
155,23,0,2,1,0,0,3,102,80,18402,14809,102,69,18818,14069
156,23,1,1,2,1,2,1,23,125,18403,14810,23,23,18819,14070
157,23,1,2,1,0,0,3,57,80,18404,14812,34,171,18819,14073
158,23,2,3,1,0,0,3,148,69,18406,14815,136,69,18819,14076
159,23,2,1,0,3,1,0,148,57,18408,14816,171,0,18822,14076
160,23,1,2,1,0,0,3,23,46,18409,14818,0,273,18822,14079
161,24,2,0,0,3,1,0,48,0,18411,14818,72,0,18825,14079
162,24,0,2,1,0,0,3,102,82,18411,14820,102,72,18825,14082
163,24,1,1,2,1,2,1,24,126,18412,14821,24,24,18826,14083
164,24,1,2,1,0,0,3,58,82,18413,14823,34,174,18826,14086
165,24,2,3,1,0,0,3,150,72,18415,14826,136,72,18826,14089
166,24,2,1,0,3,1,0,150,58,18417,14827,174,0,18829,14089
167,24,1,2,1,0,0,3,24,48,18418,14829,0,276,18829,14092
168,25,2,0,0,3,1,0,50,0,18420,14829,75,0,18832,14092
169,25,0,2,1,0,0,3,102,84,18420,14831,102,75,18832,14095
170,25,1,1,2,1,2,1,25,127,18421,14832,25,25,18833,14096
171,25,1,2,1,0,0,3,59,84,18422,14834,34,177,18833,14099
172,25,2,3,1,0,0,3,152,75,18424,14837,136,75,18833,14102
173,25,2,1,0,3,1,0,152,59,18426,14838,177,0,18836,14102
174,25,1,2,1,0,0,3,25,50,18427,14840,0,279,18836,14105
175,26,2,0,0,3,1,0,52,0,18429,14840,78,0,18839,14105
176,26,0,2,1,0,0,3,102,86,18429,14842,102,78,18839,14108
177,26,1,1,2,1,2,1,26,128,18430,14843,26,26,18840,14109
178,26,1,2,1,0,0,3,60,86,18431,14845,34,180,18840,14112
179,26,2,3,1,0,0,3,154,78,18433,14848,136,78,18840,14115
180,26,2,1,0,3,1,0,154,60,18435,14849,180,0,18843,14115
181,26,1,2,1,0,0,3,26,52,18436,14851,0,282,18843,14118
182,27,2,0,0,3,1,0,54,0,18438,14851,81,0,18846,14118
183,27,0,2,1,0,0,3,102,88,18438,14853,102,81,18846,14121
184,27,1,1,2,1,2,1,27,129,18439,14854,27,27,18847,14122
185,27,1,2,1,0,0,3,61,88,18440,14856,34,183,18847,14125
186,27,2,3,1,0,0,3,156,81,18442,14859,136,81,18847,14128
187,27,2,1,0,3,1,0,156,61,18444,14860,183,0,18850,14128
188,27,1,2,1,0,0,3,27,54,18445,14862,0,285,18850,14131
189,28,2,0,0,3,1,0,56,0,18447,14862,84,0,18853,14131
190,28,0,2,1,0,0,3,102,90,18447,14864,102,84,18853,14134
191,28,1,1,2,1,2,1,28,130,18448,14865,28,28,18854,14135
192,28,1,2,1,0,0,3,62,90,18449,14867,34,186,18854,14138
193,28,2,3,1,0,0,3,158,84,18451,14870,136,84,18854,14141
194,28,2,1,0,3,1,0,158,62,18453,14871,186,0,18857,14141
195,28,1,2,1,0,0,3,28,56,18454,14873,0,288,18857,14144
196,29,2,0,0,3,1,0,58,0,18456,14873,87,0,18860,14144
197,29,0,2,1,0,0,3,102,92,18456,14875,102,87,18860,14147
198,29,1,1,2,1,2,1,29,131,18457,14876,29,29,18861,14148
199,29,1,2,1,0,0,3,63,92,18458,14878,34,189,18861,14151
200,29,2,3,1,0,0,3,160,87,18460,14881,136,87,18861,14154
201,29,2,1,0,3,1,0,160,63,18462,14882,189,0,18864,14154
202,29,1,2,1,0,0,3,29,58,18463,14884,0,291,18864,14157
203,30,2,0,0,3,1,0,60,0,18465,14884,90,0,18867,14157
204,30,0,2,1,0,0,3,102,94,18465,14886,102,90,18867,14160
205,30,1,1,2,1,2,1,30,132,18466,14887,30,30,18868,14161
206,30,1,2,1,0,0,3,64,94,18467,14889,34,192,18868,14164
207,30,2,3,1,0,0,3,162,90,18469,14892,136,90,18868,14167
208,30,2,1,0,3,1,0,162,64,18471,14893,192,0,18871,14167
209,30,1,2,1,0,0,3,30,60,18472,14895,0,294,18871,14170
210,31,2,0,0,3,1,0,62,0,18474,14895,93,0,18874,14170
211,31,0,2,1,0,0,3,102,96,18474,14897,102,93,18874,14173
212,31,1,1,2,1,2,1,31,133,18475,14898,31,31,18875,14174
213,31,1,2,1,0,0,3,65,96,18476,14900,34,195,18875,14177
214,31,2,3,1,0,0,3,164,93,18478,14903,136,93,18875,14180
215,31,2,1,0,3,1,0,164,65,18480,14904,195,0,18878,14180
216,31,1,2,1,0,0,3,31,62,18481,14906,0,297,18878,14183
217,32,2,0,0,3,1,0,64,0,18483,14906,96,0,18881,14183
218,32,0,2,1,0,0,3,102,98,18483,14908,102,96,18881,14186
219,32,1,1,2,1,2,1,32,134,18484,14909,32,32,18882,14187
220,32,1,2,1,0,0,3,66,98,18485,14911,34,198,18882,14190
221,32,2,3,1,0,0,3,166,96,18487,14914,136,96,18882,14193
222,32,2,1,0,3,1,0,166,66,18489,14915,198,0,18885,14193
223,32,1,2,1,0,0,3,32,64,18490,14917,0,300,18885,14196
224,33,2,0,0,3,1,0,66,0,18492,14917,99,0,18888,14196
225,33,0,2,1,0,0,3,102,100,18492,14919,102,99,18888,14199
226,33,1,1,2,1,2,1,33,135,18493,14920,33,33,18889,14200
227,33,1,2,1,0,0,3,67,100,18494,14922,34,201,18889,14203
228,33,2,3,1,0,0,3,168,99,18496,14925,136,99,18889,14206
229,33,2,1,0,3,1,0,168,67,18498,14926,201,0,18892,14206
230,33,1,2,1,0,0,3,33,66,18499,14928,0,303,18892,14209
231,34,2,0,0,3,1,0,68,0,18501,14928,102,0,18895,14209
232,34,0,2,1,0,0,3,102,102,18501,14930,102,102,18895,14212
233,34,1,1,2,1,2,1,34,136,18502,14931,34,34,18896,14213
234,34,1,2,1,0,0,3,68,102,18503,14933,34,204,18896,14216
235,34,2,3,1,0,0,3,170,102,18505,14936,136,102,18896,14219
236,34,2,1,0,3,1,0,170,68,18507,14937,204,0,18899,14219
237,34,1,2,1,0,0,3,34,68,18508,14939,0,306,18899,14222
0,1,2,1,0,3,1,0,2,35,18510,14940,37,102,18902,14222
1,1,0,0,2,1,2,1,170,102,18510,14940,137,1,18903,14223
2,1,2,2,2,1,2,1,2,2,18512,14942,1,205,18904,14224
3,1,2,0,0,3,1,0,2,0,18514,14942,3,0,18907,14224
4,1,2,2,2,1,2,1,36,2,18516,14944,103,1,18908,14225
5,1,2,3,1,0,0,3,104,105,18518,14947,102,71,18908,14228
6,1,2,2,2,1,2,1,36,138,18520,14949,35,1,18909,14229
7,1,2,2,2,1,2,1,2,2,18522,14951,1,1,18910,14230
8,1,2,0,0,3,1,0,2,0,18524,14951,3,0,18913,14230
9,1,3,0,0,3,1,0,3,0,18527,14951,3,0,18916,14230
10,2,2,1,0,3,1,0,4,36,18529,14952,40,102,18919,14230
11,2,0,0,2,1,2,1,170,102,18529,14952,138,2,18920,14231
12,2,2,2,2,1,2,1,4,4,18531,14954,2,206,18921,14232
13,2,2,0,0,3,1,0,4,0,18533,14954,6,0,18924,14232
14,2,2,2,2,1,2,1,38,4,18535,14956,104,2,18925,14233
15,2,2,3,1,0,0,3,106,108,18537,14959,102,74,18925,14236
16,2,2,2,2,1,2,1,38,140,18539,14961,36,2,18926,14237
17,2,2,2,2,1,2,1,4,4,18541,14963,2,2,18927,14238
18,2,2,0,0,3,1,0,4,0,18543,14963,6,0,18930,14238
19,2,3,0,0,3,1,0,6,0,18546,14963,6,0,18933,14238
20,3,2,1,0,3,1,0,6,37,18548,14964,43,102,18936,14238
21,3,0,0,2,1,2,1,170,102,18548,14964,139,3,18937,14239
22,3,2,2,2,1,2,1,6,6,18550,14966,3,207,18938,14240
23,3,2,0,0,3,1,0,6,0,18552,14966,9,0,18941,14240
24,3,2,2,2,1,2,1,40,6,18554,14968,105,3,18942,14241
25,3,2,3,1,0,0,3,108,111,18556,14971,102,77,18942,14244
26,3,2,2,2,1,2,1,40,142,18558,14973,37,3,18943,14245
27,3,2,2,2,1,2,1,6,6,18560,14975,3,3,18944,14246
28,3,2,0,0,3,1,0,6,0,18562,14975,9,0,18947,14246
29,3,3,0,0,3,1,0,9,0,18565,14975,9,0,18950,14246
30,4,2,1,0,3,1,0,8,38,18567,14976,46,102,18953,14246
31,4,0,0,2,1,2,1,170,102,18567,14976,140,4,18954,14247
32,4,2,2,2,1,2,1,8,8,18569,14978,4,208,18955,14248
33,4,2,0,0,3,1,0,8,0,18571,14978,12,0,18958,14248
34,4,2,2,2,1,2,1,42,8,18573,14980,106,4,18959,14249
35,4,2,3,1,0,0,3,110,114,18575,14983,102,80,18959,14252
36,4,2,2,2,1,2,1,42,144,18577,14985,38,4,18960,14253
37,4,2,2,2,1,2,1,8,8,18579,14987,4,4,18961,14254
38,4,2,0,0,3,1,0,8,0,18581,14987,12,0,18964,14254
39,4,3,0,0,3,1,0,12,0,18584,14987,12,0,18967,14254
40,5,2,1,0,3,1,0,10,39,18586,14988,49,102,18970,14254
41,5,0,0,2,1,2,1,170,102,18586,14988,141,5,18971,14255
42,5,2,2,2,1,2,1,10,10,18588,14990,5,209,18972,14256
43,5,2,0,0,3,1,0,10,0,18590,14990,15,0,18975,14256
44,5,2,2,2,1,2,1,44,10,18592,14992,107,5,18976,14257
45,5,2,3,1,0,0,3,112,117,18594,14995,102,83,18976,14260
46,5,2,2,2,1,2,1,44,146,18596,14997,39,5,18977,14261
47,5,2,2,2,1,2,1,10,10,18598,14999,5,5,18978,14262
48,5,2,0,0,3,1,0,10,0,18600,14999,15,0,18981,14262
49,5,3,0,0,3,1,0,15,0,18603,14999,15,0,18984,14262
50,6,2,1,0,3,1,0,12,40,18605,15000,52,102,18987,14262
51,6,0,0,2,1,2,1,170,102,18605,15000,142,6,18988,14263
52,6,2,2,2,1,2,1,12,12,18607,15002,6,210,18989,14264
53,6,2,0,0,3,1,0,12,0,18609,15002,18,0,18992,14264
54,6,2,2,2,1,2,1,46,12,18611,15004,108,6,18993,14265
55,6,2,3,1,0,0,3,114,120,18613,15007,102,86,18993,14268
56,6,2,2,2,1,2,1,46,148,18615,15009,40,6,18994,14269
57,6,2,2,2,1,2,1,12,12,18617,15011,6,6,18995,14270
58,6,2,0,0,3,1,0,12,0,18619,15011,18,0,18998,14270
59,6,3,0,0,3,1,0,18,0,18622,15011,18,0,19001,14270
60,7,2,1,0,3,1,0,14,41,18624,15012,55,102,19004,14270
61,7,0,0,2,1,2,1,170,102,18624,15012,143,7,19005,14271
62,7,2,2,2,1,2,1,14,14,18626,15014,7,211,19006,14272
63,7,2,0,0,3,1,0,14,0,18628,15014,21,0,19009,14272
64,7,2,2,2,1,2,1,48,14,18630,15016,109,7,19010,14273
65,7,2,3,1,0,0,3,116,123,18632,15019,102,89,19010,14276
66,7,2,2,2,1,2,1,48,150,18634,15021,41,7,19011,14277
67,7,2,2,2,1,2,1,14,14,18636,15023,7,7,19012,14278
68,7,2,0,0,3,1,0,14,0,18638,15023,21,0,19015,14278
69,7,3,0,0,3,1,0,21,0,18641,15023,21,0,19018,14278
70,8,2,1,0,3,1,0,16,42,18643,15024,58,102,19021,14278
71,8,0,0,2,1,2,1,170,102,18643,15024,144,8,19022,14279
72,8,2,2,2,1,2,1,16,16,18645,15026,8,212,19023,14280
73,8,2,0,0,3,1,0,16,0,18647,15026,24,0,19026,14280
74,8,2,2,2,1,2,1,50,16,18649,15028,110,8,19027,14281
75,8,2,3,1,0,0,3,118,126,18651,15031,102,92,19027,14284
76,8,2,2,2,1,2,1,50,152,18653,15033,42,8,19028,14285
77,8,2,2,2,1,2,1,16,16,18655,15035,8,8,19029,14286
78,8,2,0,0,3,1,0,16,0,18657,15035,24,0,19032,14286
79,8,3,0,0,3,1,0,24,0,18660,15035,24,0,19035,14286
80,9,2,1,0,3,1,0,18,43,18662,15036,61,102,19038,14286
81,9,0,0,2,1,2,1,170,102,18662,15036,145,9,19039,14287
82,9,2,2,2,1,2,1,18,18,18664,15038,9,213,19040,14288
83,9,2,0,0,3,1,0,18,0,18666,15038,27,0,19043,14288
84,9,2,2,2,1,2,1,52,18,18668,15040,111,9,19044,14289
85,9,2,3,1,0,0,3,120,129,18670,15043,102,95,19044,14292
86,9,2,2,2,1,2,1,52,154,18672,15045,43,9,19045,14293
87,9,2,2,2,1,2,1,18,18,18674,15047,9,9,19046,14294
88,9,2,0,0,3,1,0,18,0,18676,15047,27,0,19049,14294
89,9,3,0,0,3,1,0,27,0,18679,15047,27,0,19052,14294
90,10,2,1,0,3,1,0,20,44,18681,15048,64,102,19055,14294
91,10,0,0,2,1,2,1,170,102,18681,15048,146,10,19056,14295
92,10,2,2,2,1,2,1,20,20,18683,15050,10,214,19057,14296
93,10,2,0,0,3,1,0,20,0,18685,15050,30,0,19060,14296
94,10,2,2,2,1,2,1,54,20,18687,15052,112,10,19061,14297
95,10,2,3,1,0,0,3,122,132,18689,15055,102,98,19061,14300
96,10,2,2,2,1,2,1,54,156,18691,15057,44,10,19062,14301
97,10,2,2,2,1,2,1,20,20,18693,15059,10,10,19063,14302
98,10,2,0,0,3,1,0,20,0,18695,15059,30,0,19066,14302
99,10,3,0,0,3,1,0,30,0,18698,15059,30,0,19069,14302
100,11,2,1,0,3,1,0,22,45,18700,15060,67,102,19072,14302
101,11,0,0,2,1,2,1,170,102,18700,15060,147,11,19073,14303
102,11,2,2,2,1,2,1,22,22,18702,15062,11,215,19074,14304
103,11,2,0,0,3,1,0,22,0,18704,15062,33,0,19077,14304
104,11,2,2,2,1,2,1,56,22,18706,15064,113,11,19078,14305
105,11,2,3,1,0,0,3,124,135,18708,15067,102,101,19078,14308
106,11,2,2,2,1,2,1,56,158,18710,15069,45,11,19079,14309
107,11,2,2,2,1,2,1,22,22,18712,15071,11,11,19080,14310
108,11,2,0,0,3,1,0,22,0,18714,15071,33,0,19083,14310
109,11,3,0,0,3,1,0,33,0,18717,15071,33,0,19086,14310
110,12,2,1,0,3,1,0,24,46,18719,15072,70,102,19089,14310
111,12,0,0,2,1,2,1,170,102,18719,15072,148,12,19090,14311
112,12,2,2,2,1,2,1,24,24,18721,15074,12,216,19091,14312
113,12,2,0,0,3,1,0,24,0,18723,15074,36,0,19094,14312
114,12,2,2,2,1,2,1,58,24,18725,15076,114,12,19095,14313
115,12,2,3,1,0,0,3,126,138,18727,15079,102,104,19095,14316
116,12,2,2,2,1,2,1,58,160,18729,15081,46,12,19096,14317
117,12,2,2,2,1,2,1,24,24,18731,15083,12,12,19097,14318
118,12,2,0,0,3,1,0,24,0,18733,15083,36,0,19100,14318
119,12,3,0,0,3,1,0,36,0,18736,15083,36,0,19103,14318
120,13,2,1,0,3,1,0,26,47,18738,15084,73,102,19106,14318
121,13,0,0,2,1,2,1,170,102,18738,15084,149,13,19107,14319
122,13,2,2,2,1,2,1,26,26,18740,15086,13,217,19108,14320
123,13,2,0,0,3,1,0,26,0,18742,15086,39,0,19111,14320
124,13,2,2,2,1,2,1,60,26,18744,15088,115,13,19112,14321
125,13,2,3,1,0,0,3,128,141,18746,15091,102,107,19112,14324
126,13,2,2,2,1,2,1,60,162,18748,15093,47,13,19113,14325
127,13,2,2,2,1,2,1,26,26,18750,15095,13,13,19114,14326
128,13,2,0,0,3,1,0,26,0,18752,15095,39,0,19117,14326
129,13,3,0,0,3,1,0,39,0,18755,15095,39,0,19120,14326
130,14,2,1,0,3,1,0,28,48,18757,15096,76,102,19123,14326
131,14,0,0,2,1,2,1,170,102,18757,15096,150,14,19124,14327
132,14,2,2,2,1,2,1,28,28,18759,15098,14,218,19125,14328
133,14,2,0,0,3,1,0,28,0,18761,15098,42,0,19128,14328
134,14,2,2,2,1,2,1,62,28,18763,15100,116,14,19129,14329
135,14,2,3,1,0,0,3,130,144,18765,15103,102,110,19129,14332
136,14,2,2,2,1,2,1,62,164,18767,15105,48,14,19130,14333
137,14,2,2,2,1,2,1,28,28,18769,15107,14,14,19131,14334
138,14,2,0,0,3,1,0,28,0,18771,15107,42,0,19134,14334
139,14,3,0,0,3,1,0,42,0,18774,15107,42,0,19137,14334
140,15,2,1,0,3,1,0,30,49,18776,15108,79,102,19140,14334
141,15,0,0,2,1,2,1,170,102,18776,15108,151,15,19141,14335
142,15,2,2,2,1,2,1,30,30,18778,15110,15,219,19142,14336
143,15,2,0,0,3,1,0,30,0,18780,15110,45,0,19145,14336
144,15,2,2,2,1,2,1,64,30,18782,15112,117,15,19146,14337
145,15,2,3,1,0,0,3,132,147,18784,15115,102,113,19146,14340
146,15,2,2,2,1,2,1,64,166,18786,15117,49,15,19147,14341
147,15,2,2,2,1,2,1,30,30,18788,15119,15,15,19148,14342
148,15,2,0,0,3,1,0,30,0,18790,15119,45,0,19151,14342
149,15,3,0,0,3,1,0,45,0,18793,15119,45,0,19154,14342
150,16,2,1,0,3,1,0,32,50,18795,15120,82,102,19157,14342
151,16,0,0,2,1,2,1,170,102,18795,15120,152,16,19158,14343
152,16,2,2,2,1,2,1,32,32,18797,15122,16,220,19159,14344
153,16,2,0,0,3,1,0,32,0,18799,15122,48,0,19162,14344
154,16,2,2,2,1,2,1,66,32,18801,15124,118,16,19163,14345
155,16,2,3,1,0,0,3,134,150,18803,15127,102,116,19163,14348
156,16,2,2,2,1,2,1,66,168,18805,15129,50,16,19164,14349
157,16,2,2,2,1,2,1,32,32,18807,15131,16,16,19165,14350
158,16,2,0,0,3,1,0,32,0,18809,15131,48,0,19168,14350
159,16,3,0,0,3,1,0,48,0,18812,15131,48,0,19171,14350
160,17,2,1,0,3,1,0,34,51,18814,15132,85,102,19174,14350
161,17,0,0,2,1,2,1,170,102,18814,15132,153,17,19175,14351
162,17,2,2,2,1,2,1,34,34,18816,15134,17,221,19176,14352
163,17,2,0,0,3,1,0,34,0,18818,15134,51,0,19179,14352
164,17,2,2,2,1,2,1,68,34,18820,15136,119,17,19180,14353
165,17,2,3,1,0,0,3,136,153,18822,15139,102,119,19180,14356
166,17,2,2,2,1,2,1,68,170,18824,15141,51,17,19181,14357
167,17,2,2,2,1,2,1,34,34,18826,15143,17,17,19182,14358
168,17,2,0,0,3,1,0,34,0,18828,15143,51,0,19185,14358
169,17,3,0,0,3,1,0,51,0,18831,15143,51,0,19188,14358
170,18,2,1,0,3,1,0,36,52,18833,15144,88,102,19191,14358
171,18,0,0,2,1,2,1,170,102,18833,15144,154,18,19192,14359
172,18,2,2,2,1,2,1,36,36,18835,15146,18,222,19193,14360
173,18,2,0,0,3,1,0,36,0,18837,15146,54,0,19196,14360
174,18,2,2,2,1,2,1,70,36,18839,15148,120,18,19197,14361
175,18,2,3,1,0,0,3,138,156,18841,15151,102,122,19197,14364
176,18,2,2,2,1,2,1,70,172,18843,15153,52,18,19198,14365
177,18,2,2,2,1,2,1,36,36,18845,15155,18,18,19199,14366
178,18,2,0,0,3,1,0,36,0,18847,15155,54,0,19202,14366
179,18,3,0,0,3,1,0,54,0,18850,15155,54,0,19205,14366
180,19,2,1,0,3,1,0,38,53,18852,15156,91,102,19208,14366
181,19,0,0,2,1,2,1,170,102,18852,15156,155,19,19209,14367
182,19,2,2,2,1,2,1,38,38,18854,15158,19,223,19210,14368
183,19,2,0,0,3,1,0,38,0,18856,15158,57,0,19213,14368
184,19,2,2,2,1,2,1,72,38,18858,15160,121,19,19214,14369
185,19,2,3,1,0,0,3,140,159,18860,15163,102,125,19214,14372
186,19,2,2,2,1,2,1,72,174,18862,15165,53,19,19215,14373
187,19,2,2,2,1,2,1,38,38,18864,15167,19,19,19216,14374
188,19,2,0,0,3,1,0,38,0,18866,15167,57,0,19219,14374
189,19,3,0,0,3,1,0,57,0,18869,15167,57,0,19222,14374
190,20,2,1,0,3,1,0,40,54,18871,15168,94,102,19225,14374
191,20,0,0,2,1,2,1,170,102,18871,15168,156,20,19226,14375
192,20,2,2,2,1,2,1,40,40,18873,15170,20,224,19227,14376
193,20,2,0,0,3,1,0,40,0,18875,15170,60,0,19230,14376
194,20,2,2,2,1,2,1,74,40,18877,15172,122,20,19231,14377
195,20,2,3,1,0,0,3,142,162,18879,15175,102,128,19231,14380
196,20,2,2,2,1,2,1,74,176,18881,15177,54,20,19232,14381
197,20,2,2,2,1,2,1,40,40,18883,15179,20,20,19233,14382
198,20,2,0,0,3,1,0,40,0,18885,15179,60,0,19236,14382
199,20,3,0,0,3,1,0,60,0,18888,15179,60,0,19239,14382
200,21,2,1,0,3,1,0,42,55,18890,15180,97,102,19242,14382
201,21,0,0,2,1,2,1,170,102,18890,15180,157,21,19243,14383
202,21,2,2,2,1,2,1,42,42,18892,15182,21,225,19244,14384
203,21,2,0,0,3,1,0,42,0,18894,15182,63,0,19247,14384
204,21,2,2,2,1,2,1,76,42,18896,15184,123,21,19248,14385
205,21,2,3,1,0,0,3,144,165,18898,15187,102,131,19248,14388
206,21,2,2,2,1,2,1,76,178,18900,15189,55,21,19249,14389
207,21,2,2,2,1,2,1,42,42,18902,15191,21,21,19250,14390
208,21,2,0,0,3,1,0,42,0,18904,15191,63,0,19253,14390
209,21,3,0,0,3,1,0,63,0,18907,15191,63,0,19256,14390
210,22,2,1,0,3,1,0,44,56,18909,15192,100,102,19259,14390
211,22,0,0,2,1,2,1,170,102,18909,15192,158,22,19260,14391
212,22,2,2,2,1,2,1,44,44,18911,15194,22,226,19261,14392
213,22,2,0,0,3,1,0,44,0,18913,15194,66,0,19264,14392
214,22,2,2,2,1,2,1,78,44,18915,15196,124,22,19265,14393
215,22,2,3,1,0,0,3,146,168,18917,15199,102,134,19265,14396
216,22,2,2,2,1,2,1,78,180,18919,15201,56,22,19266,14397
217,22,2,2,2,1,2,1,44,44,18921,15203,22,22,19267,14398
218,22,2,0,0,3,1,0,44,0,18923,15203,66,0,19270,14398
219,22,3,0,0,3,1,0,66,0,18926,15203,66,0,19273,14398
220,23,2,1,0,3,1,0,46,57,18928,15204,103,102,19276,14398
221,23,0,0,2,1,2,1,170,102,18928,15204,159,23,19277,14399
222,23,2,2,2,1,2,1,46,46,18930,15206,23,227,19278,14400
223,23,2,0,0,3,1,0,46,0,18932,15206,69,0,19281,14400
224,23,2,2,2,1,2,1,80,46,18934,15208,125,23,19282,14401
225,23,2,3,1,0,0,3,148,171,18936,15211,102,137,19282,14404
226,23,2,2,2,1,2,1,80,182,18938,15213,57,23,19283,14405
227,23,2,2,2,1,2,1,46,46,18940,15215,23,23,19284,14406
228,23,2,0,0,3,1,0,46,0,18942,15215,69,0,19287,14406
229,23,3,0,0,3,1,0,69,0,18945,15215,69,0,19290,14406
230,24,2,1,0,3,1,0,48,58,18947,15216,106,102,19293,14406
231,24,0,0,2,1,2,1,170,102,18947,15216,160,24,19294,14407
232,24,2,2,2,1,2,1,48,48,18949,15218,24,228,19295,14408
233,24,2,0,0,3,1,0,48,0,18951,15218,72,0,19298,14408
234,24,2,2,2,1,2,1,82,48,18953,15220,126,24,19299,14409
235,24,2,3,1,0,0,3,150,174,18955,15223,102,140,19299,14412
236,24,2,2,2,1,2,1,82,184,18957,15225,58,24,19300,14413
237,24,2,2,2,1,2,1,48,48,18959,15227,24,24,19301,14414
238,24,2,0,0,3,1,0,48,0,18961,15227,72,0,19304,14414
239,24,3,0,0,3,1,0,72,0,18964,15227,72,0,19307,14414
240,25,2,1,0,3,1,0,50,59,18966,15228,109,102,19310,14414
241,25,0,0,2,1,2,1,170,102,18966,15228,161,25,19311,14415
242,25,2,2,2,1,2,1,50,50,18968,15230,25,229,19312,14416
243,25,2,0,0,3,1,0,50,0,18970,15230,75,0,19315,14416
244,25,2,2,2,1,2,1,84,50,18972,15232,127,25,19316,14417
245,25,2,3,1,0,0,3,152,177,18974,15235,102,143,19316,14420
246,25,2,2,2,1,2,1,84,186,18976,15237,59,25,19317,14421
247,25,2,2,2,1,2,1,50,50,18978,15239,25,25,19318,14422
248,25,2,0,0,3,1,0,50,0,18980,15239,75,0,19321,14422
249,25,3,0,0,3,1,0,75,0,18983,15239,75,0,19324,14422
250,26,2,1,0,3,1,0,52,60,18985,15240,112,102,19327,14422
251,26,0,0,2,1,2,1,170,102,18985,15240,162,26,19328,14423
252,26,2,2,2,1,2,1,52,52,18987,15242,26,230,19329,14424
253,26,2,0,0,3,1,0,52,0,18989,15242,78,0,19332,14424
254,26,2,2,2,1,2,1,86,52,18991,15244,128,26,19333,14425
255,26,2,3,1,0,0,3,154,180,18993,15247,102,146,19333,14428
256,26,2,2,2,1,2,1,86,188,18995,15249,60,26,19334,14429
257,26,2,2,2,1,2,1,52,52,18997,15251,26,26,19335,14430
258,26,2,0,0,3,1,0,52,0,18999,15251,78,0,19338,14430
259,26,3,0,0,3,1,0,78,0,19002,15251,78,0,19341,14430
260,27,2,1,0,3,1,0,54,61,19004,15252,115,102,19344,14430
261,27,0,0,2,1,2,1,170,102,19004,15252,163,27,19345,14431
262,27,2,2,2,1,2,1,54,54,19006,15254,27,231,19346,14432
263,27,2,0,0,3,1,0,54,0,19008,15254,81,0,19349,14432
264,27,2,2,2,1,2,1,88,54,19010,15256,129,27,19350,14433
265,27,2,3,1,0,0,3,156,183,19012,15259,102,149,19350,14436
266,27,2,2,2,1,2,1,88,190,19014,15261,61,27,19351,14437
267,27,2,2,2,1,2,1,54,54,19016,15263,27,27,19352,14438
268,27,2,0,0,3,1,0,54,0,19018,15263,81,0,19355,14438
269,27,3,0,0,3,1,0,81,0,19021,15263,81,0,19358,14438
270,28,2,1,0,3,1,0,56,62,19023,15264,118,102,19361,14438
271,28,0,0,2,1,2,1,170,102,19023,15264,164,28,19362,14439
272,28,2,2,2,1,2,1,56,56,19025,15266,28,232,19363,14440
273,28,2,0,0,3,1,0,56,0,19027,15266,84,0,19366,14440
274,28,2,2,2,1,2,1,90,56,19029,15268,130,28,19367,14441
275,28,2,3,1,0,0,3,158,186,19031,15271,102,152,19367,14444
276,28,2,2,2,1,2,1,90,192,19033,15273,62,28,19368,14445
277,28,2,2,2,1,2,1,56,56,19035,15275,28,28,19369,14446
278,28,2,0,0,3,1,0,56,0,19037,15275,84,0,19372,14446
279,28,3,0,0,3,1,0,84,0,19040,15275,84,0,19375,14446
280,29,2,1,0,3,1,0,58,63,19042,15276,121,102,19378,14446
281,29,0,0,2,1,2,1,170,102,19042,15276,165,29,19379,14447
282,29,2,2,2,1,2,1,58,58,19044,15278,29,233,19380,14448
283,29,2,0,0,3,1,0,58,0,19046,15278,87,0,19383,14448
284,29,2,2,2,1,2,1,92,58,19048,15280,131,29,19384,14449
285,29,2,3,1,0,0,3,160,189,19050,15283,102,155,19384,14452
286,29,2,2,2,1,2,1,92,194,19052,15285,63,29,19385,14453
287,29,2,2,2,1,2,1,58,58,19054,15287,29,29,19386,14454
288,29,2,0,0,3,1,0,58,0,19056,15287,87,0,19389,14454
289,29,3,0,0,3,1,0,87,0,19059,15287,87,0,19392,14454
290,30,2,1,0,3,1,0,60,64,19061,15288,124,102,19395,14454
291,30,0,0,2,1,2,1,170,102,19061,15288,166,30,19396,14455
292,30,2,2,2,1,2,1,60,60,19063,15290,30,234,19397,14456
293,30,2,0,0,3,1,0,60,0,19065,15290,90,0,19400,14456
294,30,2,2,2,1,2,1,94,60,19067,15292,132,30,19401,14457
295,30,2,3,1,0,0,3,162,192,19069,15295,102,158,19401,14460
296,30,2,2,2,1,2,1,94,196,19071,15297,64,30,19402,14461
297,30,2,2,2,1,2,1,60,60,19073,15299,30,30,19403,14462
298,30,2,0,0,3,1,0,60,0,19075,15299,90,0,19406,14462
299,30,3,0,0,3,1,0,90,0,19078,15299,90,0,19409,14462
300,31,2,1,0,3,1,0,62,65,19080,15300,127,102,19412,14462
301,31,0,0,2,1,2,1,170,102,19080,15300,167,31,19413,14463
302,31,2,2,2,1,2,1,62,62,19082,15302,31,235,19414,14464
303,31,2,0,0,3,1,0,62,0,19084,15302,93,0,19417,14464
304,31,2,2,2,1,2,1,96,62,19086,15304,133,31,19418,14465
305,31,2,3,1,0,0,3,164,195,19088,15307,102,161,19418,14468
306,31,2,2,2,1,2,1,96,198,19090,15309,65,31,19419,14469
307,31,2,2,2,1,2,1,62,62,19092,15311,31,31,19420,14470
308,31,2,0,0,3,1,0,62,0,19094,15311,93,0,19423,14470
309,31,3,0,0,3,1,0,93,0,19097,15311,93,0,19426,14470
310,32,2,1,0,3,1,0,64,66,19099,15312,130,102,19429,14470
311,32,0,0,2,1,2,1,170,102,19099,15312,168,32,19430,14471
312,32,2,2,2,1,2,1,64,64,19101,15314,32,236,19431,14472
313,32,2,0,0,3,1,0,64,0,19103,15314,96,0,19434,14472
314,32,2,2,2,1,2,1,98,64,19105,15316,134,32,19435,14473
315,32,2,3,1,0,0,3,166,198,19107,15319,102,164,19435,14476
316,32,2,2,2,1,2,1,98,200,19109,15321,66,32,19436,14477
317,32,2,2,2,1,2,1,64,64,19111,15323,32,32,19437,14478
318,32,2,0,0,3,1,0,64,0,19113,15323,96,0,19440,14478
319,32,3,0,0,3,1,0,96,0,19116,15323,96,0,19443,14478
320,33,2,1,0,3,1,0,66,67,19118,15324,133,102,19446,14478
321,33,0,0,2,1,2,1,170,102,19118,15324,169,33,19447,14479
322,33,2,2,2,1,2,1,66,66,19120,15326,33,237,19448,14480
323,33,2,0,0,3,1,0,66,0,19122,15326,99,0,19451,14480
324,33,2,2,2,1,2,1,100,66,19124,15328,135,33,19452,14481
325,33,2,3,1,0,0,3,168,201,19126,15331,102,167,19452,14484
326,33,2,2,2,1,2,1,100,202,19128,15333,67,33,19453,14485
327,33,2,2,2,1,2,1,66,66,19130,15335,33,33,19454,14486
328,33,2,0,0,3,1,0,66,0,19132,15335,99,0,19457,14486
329,33,3,0,0,3,1,0,99,0,19135,15335,99,0,19460,14486
330,34,2,1,0,3,1,0,68,68,19137,15336,136,102,19463,14486
331,34,0,0,2,1,2,1,170,102,19137,15336,170,34,19464,14487
332,34,2,2,2,1,2,1,68,68,19139,15338,34,238,19465,14488
333,34,2,0,0,3,1,0,68,0,19141,15338,102,0,19468,14488
334,34,2,2,2,1,2,1,102,68,19143,15340,136,34,19469,14489
335,34,2,3,1,0,0,3,170,204,19145,15343,102,170,19469,14492
336,34,2,2,2,1,2,1,102,204,19147,15345,68,34,19470,14493
337,34,2,2,2,1,2,1,68,68,19149,15347,34,34,19471,14494
338,34,2,0,0,3,1,0,68,0,19151,15347,102,0,19474,14494
339,34,3,0,0,3,1,0,102,0,19154,15347,102,0,19477,14494
340,35,2,1,0,3,1,0,70,69,19156,15348,139,102,19480,14494
341,35,0,0,2,1,2,1,170,102,19156,15348,171,35,19481,14495
342,35,2,2,2,1,2,1,70,70,19158,15350,35,239,19482,14496
343,35,2,0,0,3,1,0,70,0,19160,15350,105,0,19485,14496
344,35,2,2,2,1,2,1,104,70,19162,15352,137,35,19486,14497
345,35,2,3,1,0,0,3,172,207,19164,15355,102,173,19486,14500
346,35,2,2,2,1,2,1,104,206,19166,15357,69,35,19487,14501
347,35,2,2,2,1,2,1,70,70,19168,15359,35,35,19488,14502
348,35,2,0,0,3,1,0,70,0,19170,15359,105,0,19491,14502
349,35,3,0,0,3,1,0,105,0,19173,15359,105,0,19494,14502
350,36,2,1,0,3,1,0,72,70,19175,15360,142,102,19497,14502
351,36,0,0,2,1,2,1,170,102,19175,15360,172,36,19498,14503
352,36,2,2,2,1,2,1,72,72,19177,15362,36,240,19499,14504
353,36,2,0,0,3,1,0,72,0,19179,15362,108,0,19502,14504
354,36,2,2,2,1,2,1,106,72,19181,15364,138,36,19503,14505
355,36,2,3,1,0,0,3,174,210,19183,15367,102,176,19503,14508
356,36,2,2,2,1,2,1,106,208,19185,15369,70,36,19504,14509
357,36,2,2,2,1,2,1,72,72,19187,15371,36,36,19505,14510
358,36,2,0,0,3,1,0,72,0,19189,15371,108,0,19508,14510
359,36,3,0,0,3,1,0,108,0,19192,15371,108,0,19511,14510
360,37,2,1,0,3,1,0,74,71,19194,15372,145,102,19514,14510
361,37,0,0,2,1,2,1,170,102,19194,15372,173,37,19515,14511
362,37,2,2,2,1,2,1,74,74,19196,15374,37,241,19516,14512
363,37,2,0,0,3,1,0,74,0,19198,15374,111,0,19519,14512
364,37,2,2,2,1,2,1,108,74,19200,15376,139,37,19520,14513
365,37,2,3,1,0,0,3,176,213,19202,15379,102,179,19520,14516
366,37,2,2,2,1,2,1,108,210,19204,15381,71,37,19521,14517
367,37,2,2,2,1,2,1,74,74,19206,15383,37,37,19522,14518
368,37,2,0,0,3,1,0,74,0,19208,15383,111,0,19525,14518
369,37,3,0,0,3,1,0,111,0,19211,15383,111,0,19528,14518
370,38,2,1,0,3,1,0,76,72,19213,15384,148,102,19531,14518
371,38,0,0,2,1,2,1,170,102,19213,15384,174,38,19532,14519
372,38,2,2,2,1,2,1,76,76,19215,15386,38,242,19533,14520
373,38,2,0,0,3,1,0,76,0,19217,15386,114,0,19536,14520
374,38,2,2,2,1,2,1,110,76,19219,15388,140,38,19537,14521
375,38,2,3,1,0,0,3,178,216,19221,15391,102,182,19537,14524
376,38,2,2,2,1,2,1,110,212,19223,15393,72,38,19538,14525
377,38,2,2,2,1,2,1,76,76,19225,15395,38,38,19539,14526
378,38,2,0,0,3,1,0,76,0,19227,15395,114,0,19542,14526
379,38,3,0,0,3,1,0,114,0,19230,15395,114,0,19545,14526
0,1,3,2,0,3,1,0,71,70,19233,15397,105,102,19548,14526
1,1,2,0,0,3,1,0,70,0,19235,15397,105,306,19551,14526
2,1,1,2,1,0,0,3,1,2,19236,15399,0,3,19551,14529
3,1,1,1,2,1,2,1,1,1,19237,15400,1,1,19552,14530
4,1,2,1,0,3,1,0,172,69,19239,15401,207,0,19555,14530
5,1,1,1,2,1,2,1,1,1,19240,15402,1,183,19556,14531
6,1,0,2,1,0,0,3,76,74,19240,15404,148,3,19556,14534
7,1,2,0,0,3,1,0,78,76,19242,15404,41,0,19559,14534
8,1,0,0,2,1,2,1,0,0,19242,15404,1,1,19560,14535
9,1,2,2,2,1,2,1,2,2,19244,15406,1,39,19561,14536
10,2,3,2,0,3,1,0,74,72,19247,15408,108,102,19564,14536
11,2,2,0,0,3,1,0,72,0,19249,15408,108,306,19567,14536
12,2,1,2,1,0,0,3,2,4,19250,15410,0,6,19567,14539
13,2,1,1,2,1,2,1,2,2,19251,15411,2,2,19568,14540
14,2,2,1,0,3,1,0,174,70,19253,15412,210,0,19571,14540
15,2,1,1,2,1,2,1,2,2,19254,15413,2,184,19572,14541
16,2,0,2,1,0,0,3,76,76,19254,15415,148,6,19572,14544
17,2,2,0,0,3,1,0,80,76,19256,15415,44,0,19575,14544
18,2,0,0,2,1,2,1,0,0,19256,15415,2,2,19576,14545
19,2,2,2,2,1,2,1,4,4,19258,15417,2,40,19577,14546
20,3,3,2,0,3,1,0,77,74,19261,15419,111,102,19580,14546
21,3,2,0,0,3,1,0,74,0,19263,15419,111,306,19583,14546
22,3,1,2,1,0,0,3,3,6,19264,15421,0,9,19583,14549
23,3,1,1,2,1,2,1,3,3,19265,15422,3,3,19584,14550
24,3,2,1,0,3,1,0,176,71,19267,15423,213,0,19587,14550
25,3,1,1,2,1,2,1,3,3,19268,15424,3,185,19588,14551
26,3,0,2,1,0,0,3,76,78,19268,15426,148,9,19588,14554
27,3,2,0,0,3,1,0,82,76,19270,15426,47,0,19591,14554
28,3,0,0,2,1,2,1,0,0,19270,15426,3,3,19592,14555
29,3,2,2,2,1,2,1,6,6,19272,15428,3,41,19593,14556
30,4,3,2,0,3,1,0,80,76,19275,15430,114,102,19596,14556
31,4,2,0,0,3,1,0,76,0,19277,15430,114,306,19599,14556
32,4,1,2,1,0,0,3,4,8,19278,15432,0,12,19599,14559
33,4,1,1,2,1,2,1,4,4,19279,15433,4,4,19600,14560
34,4,2,1,0,3,1,0,178,72,19281,15434,216,0,19603,14560
35,4,1,1,2,1,2,1,4,4,19282,15435,4,186,19604,14561
36,4,0,2,1,0,0,3,76,80,19282,15437,148,12,19604,14564
37,4,2,0,0,3,1,0,84,76,19284,15437,50,0,19607,14564
38,4,0,0,2,1,2,1,0,0,19284,15437,4,4,19608,14565
39,4,2,2,2,1,2,1,8,8,19286,15439,4,42,19609,14566
40,5,3,2,0,3,1,0,83,78,19289,15441,117,102,19612,14566
41,5,2,0,0,3,1,0,78,0,19291,15441,117,306,19615,14566
42,5,1,2,1,0,0,3,5,10,19292,15443,0,15,19615,14569
43,5,1,1,2,1,2,1,5,5,19293,15444,5,5,19616,14570
44,5,2,1,0,3,1,0,180,73,19295,15445,219,0,19619,14570
45,5,1,1,2,1,2,1,5,5,19296,15446,5,187,19620,14571
46,5,0,2,1,0,0,3,76,82,19296,15448,148,15,19620,14574
47,5,2,0,0,3,1,0,86,76,19298,15448,53,0,19623,14574
48,5,0,0,2,1,2,1,0,0,19298,15448,5,5,19624,14575
49,5,2,2,2,1,2,1,10,10,19300,15450,5,43,19625,14576
50,6,3,2,0,3,1,0,86,80,19303,15452,120,102,19628,14576
51,6,2,0,0,3,1,0,80,0,19305,15452,120,306,19631,14576
52,6,1,2,1,0,0,3,6,12,19306,15454,0,18,19631,14579
53,6,1,1,2,1,2,1,6,6,19307,15455,6,6,19632,14580
54,6,2,1,0,3,1,0,182,74,19309,15456,222,0,19635,14580
55,6,1,1,2,1,2,1,6,6,19310,15457,6,188,19636,14581
56,6,0,2,1,0,0,3,76,84,19310,15459,148,18,19636,14584
57,6,2,0,0,3,1,0,88,76,19312,15459,56,0,19639,14584
58,6,0,0,2,1,2,1,0,0,19312,15459,6,6,19640,14585
59,6,2,2,2,1,2,1,12,12,19314,15461,6,44,19641,14586
60,7,3,2,0,3,1,0,89,82,19317,15463,123,102,19644,14586
61,7,2,0,0,3,1,0,82,0,19319,15463,123,306,19647,14586
62,7,1,2,1,0,0,3,7,14,19320,15465,0,21,19647,14589
63,7,1,1,2,1,2,1,7,7,19321,15466,7,7,19648,14590
64,7,2,1,0,3,1,0,184,75,19323,15467,225,0,19651,14590
65,7,1,1,2,1,2,1,7,7,19324,15468,7,189,19652,14591
66,7,0,2,1,0,0,3,76,86,19324,15470,148,21,19652,14594
67,7,2,0,0,3,1,0,90,76,19326,15470,59,0,19655,14594
68,7,0,0,2,1,2,1,0,0,19326,15470,7,7,19656,14595
69,7,2,2,2,1,2,1,14,14,19328,15472,7,45,19657,14596
70,8,3,2,0,3,1,0,92,84,19331,15474,126,102,19660,14596
71,8,2,0,0,3,1,0,84,0,19333,15474,126,306,19663,14596
72,8,1,2,1,0,0,3,8,16,19334,15476,0,24,19663,14599
73,8,1,1,2,1,2,1,8,8,19335,15477,8,8,19664,14600
74,8,2,1,0,3,1,0,186,76,19337,15478,228,0,19667,14600
75,8,1,1,2,1,2,1,8,8,19338,15479,8,190,19668,14601
76,8,0,2,1,0,0,3,76,88,19338,15481,148,24,19668,14604
77,8,2,0,0,3,1,0,92,76,19340,15481,62,0,19671,14604
78,8,0,0,2,1,2,1,0,0,19340,15481,8,8,19672,14605
79,8,2,2,2,1,2,1,16,16,19342,15483,8,46,19673,14606
80,9,3,2,0,3,1,0,95,86,19345,15485,129,102,19676,14606
81,9,2,0,0,3,1,0,86,0,19347,15485,129,306,19679,14606
82,9,1,2,1,0,0,3,9,18,19348,15487,0,27,19679,14609
83,9,1,1,2,1,2,1,9,9,19349,15488,9,9,19680,14610
84,9,2,1,0,3,1,0,188,77,19351,15489,231,0,19683,14610
85,9,1,1,2,1,2,1,9,9,19352,15490,9,191,19684,14611
86,9,0,2,1,0,0,3,76,90,19352,15492,148,27,19684,14614
87,9,2,0,0,3,1,0,94,76,19354,15492,65,0,19687,14614
88,9,0,0,2,1,2,1,0,0,19354,15492,9,9,19688,14615
89,9,2,2,2,1,2,1,18,18,19356,15494,9,47,19689,14616
90,10,3,2,0,3,1,0,98,88,19359,15496,132,102,19692,14616
91,10,2,0,0,3,1,0,88,0,19361,15496,132,306,19695,14616
92,10,1,2,1,0,0,3,10,20,19362,15498,0,30,19695,14619
93,10,1,1,2,1,2,1,10,10,19363,15499,10,10,19696,14620
94,10,2,1,0,3,1,0,190,78,19365,15500,234,0,19699,14620
95,10,1,1,2,1,2,1,10,10,19366,15501,10,192,19700,14621
96,10,0,2,1,0,0,3,76,92,19366,15503,148,30,19700,14624
97,10,2,0,0,3,1,0,96,76,19368,15503,68,0,19703,14624
98,10,0,0,2,1,2,1,0,0,19368,15503,10,10,19704,14625
99,10,2,2,2,1,2,1,20,20,19370,15505,10,48,19705,14626
100,11,3,2,0,3,1,0,101,90,19373,15507,135,102,19708,14626
101,11,2,0,0,3,1,0,90,0,19375,15507,135,306,19711,14626
102,11,1,2,1,0,0,3,11,22,19376,15509,0,33,19711,14629
103,11,1,1,2,1,2,1,11,11,19377,15510,11,11,19712,14630
104,11,2,1,0,3,1,0,192,79,19379,15511,237,0,19715,14630
105,11,1,1,2,1,2,1,11,11,19380,15512,11,193,19716,14631
106,11,0,2,1,0,0,3,76,94,19380,15514,148,33,19716,14634
107,11,2,0,0,3,1,0,98,76,19382,15514,71,0,19719,14634
108,11,0,0,2,1,2,1,0,0,19382,15514,11,11,19720,14635
109,11,2,2,2,1,2,1,22,22,19384,15516,11,49,19721,14636
110,12,3,2,0,3,1,0,104,92,19387,15518,138,102,19724,14636
111,12,2,0,0,3,1,0,92,0,19389,15518,138,306,19727,14636
112,12,1,2,1,0,0,3,12,24,19390,15520,0,36,19727,14639
113,12,1,1,2,1,2,1,12,12,19391,15521,12,12,19728,14640
114,12,2,1,0,3,1,0,194,80,19393,15522,240,0,19731,14640
115,12,1,1,2,1,2,1,12,12,19394,15523,12,194,19732,14641
116,12,0,2,1,0,0,3,76,96,19394,15525,148,36,19732,14644
117,12,2,0,0,3,1,0,100,76,19396,15525,74,0,19735,14644
118,12,0,0,2,1,2,1,0,0,19396,15525,12,12,19736,14645
119,12,2,2,2,1,2,1,24,24,19398,15527,12,50,19737,14646
120,13,3,2,0,3,1,0,107,94,19401,15529,141,102,19740,14646
121,13,2,0,0,3,1,0,94,0,19403,15529,141,306,19743,14646
122,13,1,2,1,0,0,3,13,26,19404,15531,0,39,19743,14649
123,13,1,1,2,1,2,1,13,13,19405,15532,13,13,19744,14650
124,13,2,1,0,3,1,0,196,81,19407,15533,243,0,19747,14650
125,13,1,1,2,1,2,1,13,13,19408,15534,13,195,19748,14651
126,13,0,2,1,0,0,3,76,98,19408,15536,148,39,19748,14654
127,13,2,0,0,3,1,0,102,76,19410,15536,77,0,19751,14654
128,13,0,0,2,1,2,1,0,0,19410,15536,13,13,19752,14655
129,13,2,2,2,1,2,1,26,26,19412,15538,13,51,19753,14656
130,14,3,2,0,3,1,0,110,96,19415,15540,144,102,19756,14656
131,14,2,0,0,3,1,0,96,0,19417,15540,144,306,19759,14656
132,14,1,2,1,0,0,3,14,28,19418,15542,0,42,19759,14659
133,14,1,1,2,1,2,1,14,14,19419,15543,14,14,19760,14660
134,14,2,1,0,3,1,0,198,82,19421,15544,246,0,19763,14660
135,14,1,1,2,1,2,1,14,14,19422,15545,14,196,19764,14661
136,14,0,2,1,0,0,3,76,100,19422,15547,148,42,19764,14664
137,14,2,0,0,3,1,0,104,76,19424,15547,80,0,19767,14664
138,14,0,0,2,1,2,1,0,0,19424,15547,14,14,19768,14665
139,14,2,2,2,1,2,1,28,28,19426,15549,14,52,19769,14666
140,15,3,2,0,3,1,0,113,98,19429,15551,147,102,19772,14666
141,15,2,0,0,3,1,0,98,0,19431,15551,147,306,19775,14666
142,15,1,2,1,0,0,3,15,30,19432,15553,0,45,19775,14669
143,15,1,1,2,1,2,1,15,15,19433,15554,15,15,19776,14670
144,15,2,1,0,3,1,0,200,83,19435,15555,249,0,19779,14670
145,15,1,1,2,1,2,1,15,15,19436,15556,15,197,19780,14671
146,15,0,2,1,0,0,3,76,102,19436,15558,148,45,19780,14674
147,15,2,0,0,3,1,0,106,76,19438,15558,83,0,19783,14674
148,15,0,0,2,1,2,1,0,0,19438,15558,15,15,19784,14675
149,15,2,2,2,1,2,1,30,30,19440,15560,15,53,19785,14676
150,16,3,2,0,3,1,0,116,100,19443,15562,150,102,19788,14676
151,16,2,0,0,3,1,0,100,0,19445,15562,150,306,19791,14676
152,16,1,2,1,0,0,3,16,32,19446,15564,0,48,19791,14679
153,16,1,1,2,1,2,1,16,16,19447,15565,16,16,19792,14680
154,16,2,1,0,3,1,0,202,84,19449,15566,252,0,19795,14680
155,16,1,1,2,1,2,1,16,16,19450,15567,16,198,19796,14681
156,16,0,2,1,0,0,3,76,104,19450,15569,148,48,19796,14684
157,16,2,0,0,3,1,0,108,76,19452,15569,86,0,19799,14684
158,16,0,0,2,1,2,1,0,0,19452,15569,16,16,19800,14685
159,16,2,2,2,1,2,1,32,32,19454,15571,16,54,19801,14686
160,17,3,2,0,3,1,0,119,102,19457,15573,153,102,19804,14686
161,17,2,0,0,3,1,0,102,0,19459,15573,153,306,19807,14686
162,17,1,2,1,0,0,3,17,34,19460,15575,0,51,19807,14689
163,17,1,1,2,1,2,1,17,17,19461,15576,17,17,19808,14690
164,17,2,1,0,3,1,0,204,85,19463,15577,255,0,19811,14690
165,17,1,1,2,1,2,1,17,17,19464,15578,17,199,19812,14691
166,17,0,2,1,0,0,3,76,106,19464,15580,148,51,19812,14694
167,17,2,0,0,3,1,0,110,76,19466,15580,89,0,19815,14694
168,17,0,0,2,1,2,1,0,0,19466,15580,17,17,19816,14695
169,17,2,2,2,1,2,1,34,34,19468,15582,17,55,19817,14696
170,18,3,2,0,3,1,0,122,104,19471,15584,156,102,19820,14696
171,18,2,0,0,3,1,0,104,0,19473,15584,156,306,19823,14696
172,18,1,2,1,0,0,3,18,36,19474,15586,0,54,19823,14699
173,18,1,1,2,1,2,1,18,18,19475,15587,18,18,19824,14700
174,18,2,1,0,3,1,0,206,86,19477,15588,258,0,19827,14700
175,18,1,1,2,1,2,1,18,18,19478,15589,18,200,19828,14701
176,18,0,2,1,0,0,3,76,108,19478,15591,148,54,19828,14704
177,18,2,0,0,3,1,0,112,76,19480,15591,92,0,19831,14704
178,18,0,0,2,1,2,1,0,0,19480,15591,18,18,19832,14705
179,18,2,2,2,1,2,1,36,36,19482,15593,18,56,19833,14706
180,19,3,2,0,3,1,0,125,106,19485,15595,159,102,19836,14706
181,19,2,0,0,3,1,0,106,0,19487,15595,159,306,19839,14706
182,19,1,2,1,0,0,3,19,38,19488,15597,0,57,19839,14709
183,19,1,1,2,1,2,1,19,19,19489,15598,19,19,19840,14710
184,19,2,1,0,3,1,0,208,87,19491,15599,261,0,19843,14710
185,19,1,1,2,1,2,1,19,19,19492,15600,19,201,19844,14711
186,19,0,2,1,0,0,3,76,110,19492,15602,148,57,19844,14714
187,19,2,0,0,3,1,0,114,76,19494,15602,95,0,19847,14714
188,19,0,0,2,1,2,1,0,0,19494,15602,19,19,19848,14715
189,19,2,2,2,1,2,1,38,38,19496,15604,19,57,19849,14716
190,20,3,2,0,3,1,0,128,108,19499,15606,162,102,19852,14716
191,20,2,0,0,3,1,0,108,0,19501,15606,162,306,19855,14716
192,20,1,2,1,0,0,3,20,40,19502,15608,0,60,19855,14719
193,20,1,1,2,1,2,1,20,20,19503,15609,20,20,19856,14720
194,20,2,1,0,3,1,0,210,88,19505,15610,264,0,19859,14720
195,20,1,1,2,1,2,1,20,20,19506,15611,20,202,19860,14721
196,20,0,2,1,0,0,3,76,112,19506,15613,148,60,19860,14724
197,20,2,0,0,3,1,0,116,76,19508,15613,98,0,19863,14724
198,20,0,0,2,1,2,1,0,0,19508,15613,20,20,19864,14725
199,20,2,2,2,1,2,1,40,40,19510,15615,20,58,19865,14726
200,21,3,2,0,3,1,0,131,110,19513,15617,165,102,19868,14726
201,21,2,0,0,3,1,0,110,0,19515,15617,165,306,19871,14726
202,21,1,2,1,0,0,3,21,42,19516,15619,0,63,19871,14729
203,21,1,1,2,1,2,1,21,21,19517,15620,21,21,19872,14730
204,21,2,1,0,3,1,0,212,89,19519,15621,267,0,19875,14730
205,21,1,1,2,1,2,1,21,21,19520,15622,21,203,19876,14731
206,21,0,2,1,0,0,3,76,114,19520,15624,148,63,19876,14734
207,21,2,0,0,3,1,0,118,76,19522,15624,101,0,19879,14734
208,21,0,0,2,1,2,1,0,0,19522,15624,21,21,19880,14735
209,21,2,2,2,1,2,1,42,42,19524,15626,21,59,19881,14736
210,22,3,2,0,3,1,0,134,112,19527,15628,168,102,19884,14736
211,22,2,0,0,3,1,0,112,0,19529,15628,168,306,19887,14736
212,22,1,2,1,0,0,3,22,44,19530,15630,0,66,19887,14739
213,22,1,1,2,1,2,1,22,22,19531,15631,22,22,19888,14740
214,22,2,1,0,3,1,0,214,90,19533,15632,270,0,19891,14740
215,22,1,1,2,1,2,1,22,22,19534,15633,22,204,19892,14741
216,22,0,2,1,0,0,3,76,116,19534,15635,148,66,19892,14744
217,22,2,0,0,3,1,0,120,76,19536,15635,104,0,19895,14744
218,22,0,0,2,1,2,1,0,0,19536,15635,22,22,19896,14745
219,22,2,2,2,1,2,1,44,44,19538,15637,22,60,19897,14746
220,23,3,2,0,3,1,0,137,114,19541,15639,171,102,19900,14746
221,23,2,0,0,3,1,0,114,0,19543,15639,171,306,19903,14746
222,23,1,2,1,0,0,3,23,46,19544,15641,0,69,19903,14749
223,23,1,1,2,1,2,1,23,23,19545,15642,23,23,19904,14750
224,23,2,1,0,3,1,0,216,91,19547,15643,273,0,19907,14750
225,23,1,1,2,1,2,1,23,23,19548,15644,23,205,19908,14751
226,23,0,2,1,0,0,3,76,118,19548,15646,148,69,19908,14754
227,23,2,0,0,3,1,0,122,76,19550,15646,107,0,19911,14754
228,23,0,0,2,1,2,1,0,0,19550,15646,23,23,19912,14755
229,23,2,2,2,1,2,1,46,46,19552,15648,23,61,19913,14756
230,24,3,2,0,3,1,0,140,116,19555,15650,174,102,19916,14756
231,24,2,0,0,3,1,0,116,0,19557,15650,174,306,19919,14756
232,24,1,2,1,0,0,3,24,48,19558,15652,0,72,19919,14759
233,24,1,1,2,1,2,1,24,24,19559,15653,24,24,19920,14760
234,24,2,1,0,3,1,0,218,92,19561,15654,276,0,19923,14760
235,24,1,1,2,1,2,1,24,24,19562,15655,24,206,19924,14761
236,24,0,2,1,0,0,3,76,120,19562,15657,148,72,19924,14764
237,24,2,0,0,3,1,0,124,76,19564,15657,110,0,19927,14764
238,24,0,0,2,1,2,1,0,0,19564,15657,24,24,19928,14765
239,24,2,2,2,1,2,1,48,48,19566,15659,24,62,19929,14766
240,25,3,2,0,3,1,0,143,118,19569,15661,177,102,19932,14766
241,25,2,0,0,3,1,0,118,0,19571,15661,177,306,19935,14766
242,25,1,2,1,0,0,3,25,50,19572,15663,0,75,19935,14769
243,25,1,1,2,1,2,1,25,25,19573,15664,25,25,19936,14770
244,25,2,1,0,3,1,0,220,93,19575,15665,279,0,19939,14770
245,25,1,1,2,1,2,1,25,25,19576,15666,25,207,19940,14771
246,25,0,2,1,0,0,3,76,122,19576,15668,148,75,19940,14774
247,25,2,0,0,3,1,0,126,76,19578,15668,113,0,19943,14774
248,25,0,0,2,1,2,1,0,0,19578,15668,25,25,19944,14775
249,25,2,2,2,1,2,1,50,50,19580,15670,25,63,19945,14776
250,26,3,2,0,3,1,0,146,120,19583,15672,180,102,19948,14776
251,26,2,0,0,3,1,0,120,0,19585,15672,180,306,19951,14776
252,26,1,2,1,0,0,3,26,52,19586,15674,0,78,19951,14779
253,26,1,1,2,1,2,1,26,26,19587,15675,26,26,19952,14780
254,26,2,1,0,3,1,0,222,94,19589,15676,282,0,19955,14780
255,26,1,1,2,1,2,1,26,26,19590,15677,26,208,19956,14781
256,26,0,2,1,0,0,3,76,124,19590,15679,148,78,19956,14784
257,26,2,0,0,3,1,0,128,76,19592,15679,116,0,19959,14784
258,26,0,0,2,1,2,1,0,0,19592,15679,26,26,19960,14785
259,26,2,2,2,1,2,1,52,52,19594,15681,26,64,19961,14786
260,27,3,2,0,3,1,0,149,122,19597,15683,183,102,19964,14786
261,27,2,0,0,3,1,0,122,0,19599,15683,183,306,19967,14786
262,27,1,2,1,0,0,3,27,54,19600,15685,0,81,19967,14789
263,27,1,1,2,1,2,1,27,27,19601,15686,27,27,19968,14790
264,27,2,1,0,3,1,0,224,95,19603,15687,285,0,19971,14790
265,27,1,1,2,1,2,1,27,27,19604,15688,27,209,19972,14791
266,27,0,2,1,0,0,3,76,126,19604,15690,148,81,19972,14794
267,27,2,0,0,3,1,0,130,76,19606,15690,119,0,19975,14794
268,27,0,0,2,1,2,1,0,0,19606,15690,27,27,19976,14795
269,27,2,2,2,1,2,1,54,54,19608,15692,27,65,19977,14796
270,28,3,2,0,3,1,0,152,124,19611,15694,186,102,19980,14796
271,28,2,0,0,3,1,0,124,0,19613,15694,186,306,19983,14796
272,28,1,2,1,0,0,3,28,56,19614,15696,0,84,19983,14799
273,28,1,1,2,1,2,1,28,28,19615,15697,28,28,19984,14800
274,28,2,1,0,3,1,0,226,96,19617,15698,288,0,19987,14800
275,28,1,1,2,1,2,1,28,28,19618,15699,28,210,19988,14801
276,28,0,2,1,0,0,3,76,128,19618,15701,148,84,19988,14804
277,28,2,0,0,3,1,0,132,76,19620,15701,122,0,19991,14804
278,28,0,0,2,1,2,1,0,0,19620,15701,28,28,19992,14805
279,28,2,2,2,1,2,1,56,56,19622,15703,28,66,19993,14806
280,29,3,2,0,3,1,0,155,126,19625,15705,189,102,19996,14806
281,29,2,0,0,3,1,0,126,0,19627,15705,189,306,19999,14806
282,29,1,2,1,0,0,3,29,58,19628,15707,0,87,19999,14809
283,29,1,1,2,1,2,1,29,29,19629,15708,29,29,20000,14810
284,29,2,1,0,3,1,0,228,97,19631,15709,291,0,20003,14810
285,29,1,1,2,1,2,1,29,29,19632,15710,29,211,20004,14811
286,29,0,2,1,0,0,3,76,130,19632,15712,148,87,20004,14814
287,29,2,0,0,3,1,0,134,76,19634,15712,125,0,20007,14814
288,29,0,0,2,1,2,1,0,0,19634,15712,29,29,20008,14815
289,29,2,2,2,1,2,1,58,58,19636,15714,29,67,20009,14816
0,1,1,2,1,0,0,3,1,2,19637,15716,0,90,20009,14819
1,1,2,0,0,3,1,0,2,0,19639,15716,3,0,20012,14819
2,1,1,6,1,0,0,3,59,64,19640,15722,29,3,20012,14822
3,1,1,2,1,0,0,3,229,99,19641,15724,291,245,20012,14825
4,1,6,1,0,3,1,0,6,1,19647,15725,3,0,20015,14825
5,1,2,2,2,1,2,1,70,104,19649,15727,35,212,20016,14826
6,1,0,4,1,0,0,3,76,4,19649,15731,114,3,20016,14829
7,1,0,0,2,1,2,1,76,130,19649,15731,149,103,20017,14830
8,1,0,0,2,1,2,1,178,216,19649,15731,103,103,20018,14831
9,1,4,2,0,3,1,0,130,2,19653,15733,192,67,20021,14831
10,2,1,2,1,0,0,3,2,4,19654,15735,0,93,20021,14834
11,2,2,0,0,3,1,0,4,0,19656,15735,6,0,20024,14834
12,2,1,6,1,0,0,3,60,70,19657,15741,29,6,20024,14837
13,2,1,2,1,0,0,3,230,101,19658,15743,291,248,20024,14840
14,2,6,1,0,3,1,0,12,2,19664,15744,6,0,20027,14840
15,2,2,2,2,1,2,1,72,106,19666,15746,36,213,20028,14841
16,2,0,4,1,0,0,3,76,8,19666,15750,114,6,20028,14844
17,2,0,0,2,1,2,1,76,130,19666,15750,150,104,20029,14845
18,2,0,0,2,1,2,1,178,216,19666,15750,104,104,20030,14846
19,2,4,2,0,3,1,0,134,4,19670,15752,195,67,20033,14846
20,3,1,2,1,0,0,3,3,6,19671,15754,0,96,20033,14849
21,3,2,0,0,3,1,0,6,0,19673,15754,9,0,20036,14849
22,3,1,6,1,0,0,3,61,76,19674,15760,29,9,20036,14852
23,3,1,2,1,0,0,3,231,103,19675,15762,291,251,20036,14855
24,3,6,1,0,3,1,0,18,3,19681,15763,9,0,20039,14855
25,3,2,2,2,1,2,1,74,108,19683,15765,37,214,20040,14856
26,3,0,4,1,0,0,3,76,12,19683,15769,114,9,20040,14859
27,3,0,0,2,1,2,1,76,130,19683,15769,151,105,20041,14860
28,3,0,0,2,1,2,1,178,216,19683,15769,105,105,20042,14861
29,3,4,2,0,3,1,0,138,6,19687,15771,198,67,20045,14861
30,4,1,2,1,0,0,3,4,8,19688,15773,0,99,20045,14864
31,4,2,0,0,3,1,0,8,0,19690,15773,12,0,20048,14864
32,4,1,6,1,0,0,3,62,82,19691,15779,29,12,20048,14867
33,4,1,2,1,0,0,3,232,105,19692,15781,291,254,20048,14870
34,4,6,1,0,3,1,0,24,4,19698,15782,12,0,20051,14870
35,4,2,2,2,1,2,1,76,110,19700,15784,38,215,20052,14871
36,4,0,4,1,0,0,3,76,16,19700,15788,114,12,20052,14874
37,4,0,0,2,1,2,1,76,130,19700,15788,152,106,20053,14875
38,4,0,0,2,1,2,1,178,216,19700,15788,106,106,20054,14876
39,4,4,2,0,3,1,0,142,8,19704,15790,201,67,20057,14876
40,5,1,2,1,0,0,3,5,10,19705,15792,0,102,20057,14879
41,5,2,0,0,3,1,0,10,0,19707,15792,15,0,20060,14879
42,5,1,6,1,0,0,3,63,88,19708,15798,29,15,20060,14882
43,5,1,2,1,0,0,3,233,107,19709,15800,291,257,20060,14885
44,5,6,1,0,3,1,0,30,5,19715,15801,15,0,20063,14885
45,5,2,2,2,1,2,1,78,112,19717,15803,39,216,20064,14886
46,5,0,4,1,0,0,3,76,20,19717,15807,114,15,20064,14889
47,5,0,0,2,1,2,1,76,130,19717,15807,153,107,20065,14890
48,5,0,0,2,1,2,1,178,216,19717,15807,107,107,20066,14891
49,5,4,2,0,3,1,0,146,10,19721,15809,204,67,20069,14891
50,6,1,2,1,0,0,3,6,12,19722,15811,0,105,20069,14894
51,6,2,0,0,3,1,0,12,0,19724,15811,18,0,20072,14894
52,6,1,6,1,0,0,3,64,94,19725,15817,29,18,20072,14897
53,6,1,2,1,0,0,3,234,109,19726,15819,291,260,20072,14900
54,6,6,1,0,3,1,0,36,6,19732,15820,18,0,20075,14900
55,6,2,2,2,1,2,1,80,114,19734,15822,40,217,20076,14901
56,6,0,4,1,0,0,3,76,24,19734,15826,114,18,20076,14904
57,6,0,0,2,1,2,1,76,130,19734,15826,154,108,20077,14905
58,6,0,0,2,1,2,1,178,216,19734,15826,108,108,20078,14906
59,6,4,2,0,3,1,0,150,12,19738,15828,207,67,20081,14906
60,7,1,2,1,0,0,3,7,14,19739,15830,0,108,20081,14909
61,7,2,0,0,3,1,0,14,0,19741,15830,21,0,20084,14909
62,7,1,6,1,0,0,3,65,100,19742,15836,29,21,20084,14912
63,7,1,2,1,0,0,3,235,111,19743,15838,291,263,20084,14915
64,7,6,1,0,3,1,0,42,7,19749,15839,21,0,20087,14915
65,7,2,2,2,1,2,1,82,116,19751,15841,41,218,20088,14916
66,7,0,4,1,0,0,3,76,28,19751,15845,114,21,20088,14919
67,7,0,0,2,1,2,1,76,130,19751,15845,155,109,20089,14920
68,7,0,0,2,1,2,1,178,216,19751,15845,109,109,20090,14921
69,7,4,2,0,3,1,0,154,14,19755,15847,210,67,20093,14921
70,8,1,2,1,0,0,3,8,16,19756,15849,0,111,20093,14924
71,8,2,0,0,3,1,0,16,0,19758,15849,24,0,20096,14924
72,8,1,6,1,0,0,3,66,106,19759,15855,29,24,20096,14927
73,8,1,2,1,0,0,3,236,113,19760,15857,291,266,20096,14930
74,8,6,1,0,3,1,0,48,8,19766,15858,24,0,20099,14930
75,8,2,2,2,1,2,1,84,118,19768,15860,42,219,20100,14931
76,8,0,4,1,0,0,3,76,32,19768,15864,114,24,20100,14934
77,8,0,0,2,1,2,1,76,130,19768,15864,156,110,20101,14935
78,8,0,0,2,1,2,1,178,216,19768,15864,110,110,20102,14936
79,8,4,2,0,3,1,0,158,16,19772,15866,213,67,20105,14936
80,9,1,2,1,0,0,3,9,18,19773,15868,0,114,20105,14939
81,9,2,0,0,3,1,0,18,0,19775,15868,27,0,20108,14939
82,9,1,6,1,0,0,3,67,112,19776,15874,29,27,20108,14942
83,9,1,2,1,0,0,3,237,115,19777,15876,291,269,20108,14945
84,9,6,1,0,3,1,0,54,9,19783,15877,27,0,20111,14945
85,9,2,2,2,1,2,1,86,120,19785,15879,43,220,20112,14946
86,9,0,4,1,0,0,3,76,36,19785,15883,114,27,20112,14949
87,9,0,0,2,1,2,1,76,130,19785,15883,157,111,20113,14950
88,9,0,0,2,1,2,1,178,216,19785,15883,111,111,20114,14951
89,9,4,2,0,3,1,0,162,18,19789,15885,216,67,20117,14951
90,10,1,2,1,0,0,3,10,20,19790,15887,0,117,20117,14954
91,10,2,0,0,3,1,0,20,0,19792,15887,30,0,20120,14954
92,10,1,6,1,0,0,3,68,118,19793,15893,29,30,20120,14957
93,10,1,2,1,0,0,3,238,117,19794,15895,291,272,20120,14960
94,10,6,1,0,3,1,0,60,10,19800,15896,30,0,20123,14960
95,10,2,2,2,1,2,1,88,122,19802,15898,44,221,20124,14961
96,10,0,4,1,0,0,3,76,40,19802,15902,114,30,20124,14964
97,10,0,0,2,1,2,1,76,130,19802,15902,158,112,20125,14965
98,10,0,0,2,1,2,1,178,216,19802,15902,112,112,20126,14966
99,10,4,2,0,3,1,0,166,20,19806,15904,219,67,20129,14966
100,11,1,2,1,0,0,3,11,22,19807,15906,0,120,20129,14969
101,11,2,0,0,3,1,0,22,0,19809,15906,33,0,20132,14969
102,11,1,6,1,0,0,3,69,124,19810,15912,29,33,20132,14972
103,11,1,2,1,0,0,3,239,119,19811,15914,291,275,20132,14975
104,11,6,1,0,3,1,0,66,11,19817,15915,33,0,20135,14975
105,11,2,2,2,1,2,1,90,124,19819,15917,45,222,20136,14976
106,11,0,4,1,0,0,3,76,44,19819,15921,114,33,20136,14979
107,11,0,0,2,1,2,1,76,130,19819,15921,159,113,20137,14980
108,11,0,0,2,1,2,1,178,216,19819,15921,113,113,20138,14981
109,11,4,2,0,3,1,0,170,22,19823,15923,222,67,20141,14981
110,12,1,2,1,0,0,3,12,24,19824,15925,0,123,20141,14984
111,12,2,0,0,3,1,0,24,0,19826,15925,36,0,20144,14984
112,12,1,6,1,0,0,3,70,130,19827,15931,29,36,20144,14987
113,12,1,2,1,0,0,3,240,121,19828,15933,291,278,20144,14990
114,12,6,1,0,3,1,0,72,12,19834,15934,36,0,20147,14990
115,12,2,2,2,1,2,1,92,126,19836,15936,46,223,20148,14991
116,12,0,4,1,0,0,3,76,48,19836,15940,114,36,20148,14994
117,12,0,0,2,1,2,1,76,130,19836,15940,160,114,20149,14995
118,12,0,0,2,1,2,1,178,216,19836,15940,114,114,20150,14996
119,12,4,2,0,3,1,0,174,24,19840,15942,225,67,20153,14996
120,13,1,2,1,0,0,3,13,26,19841,15944,0,126,20153,14999
121,13,2,0,0,3,1,0,26,0,19843,15944,39,0,20156,14999
122,13,1,6,1,0,0,3,71,136,19844,15950,29,39,20156,15002
123,13,1,2,1,0,0,3,241,123,19845,15952,291,281,20156,15005
124,13,6,1,0,3,1,0,78,13,19851,15953,39,0,20159,15005
125,13,2,2,2,1,2,1,94,128,19853,15955,47,224,20160,15006
126,13,0,4,1,0,0,3,76,52,19853,15959,114,39,20160,15009
127,13,0,0,2,1,2,1,76,130,19853,15959,161,115,20161,15010
128,13,0,0,2,1,2,1,178,216,19853,15959,115,115,20162,15011
129,13,4,2,0,3,1,0,178,26,19857,15961,228,67,20165,15011
130,14,1,2,1,0,0,3,14,28,19858,15963,0,129,20165,15014
131,14,2,0,0,3,1,0,28,0,19860,15963,42,0,20168,15014
132,14,1,6,1,0,0,3,72,142,19861,15969,29,42,20168,15017
133,14,1,2,1,0,0,3,242,125,19862,15971,291,284,20168,15020
134,14,6,1,0,3,1,0,84,14,19868,15972,42,0,20171,15020
135,14,2,2,2,1,2,1,96,130,19870,15974,48,225,20172,15021
136,14,0,4,1,0,0,3,76,56,19870,15978,114,42,20172,15024
137,14,0,0,2,1,2,1,76,130,19870,15978,162,116,20173,15025
138,14,0,0,2,1,2,1,178,216,19870,15978,116,116,20174,15026
139,14,4,2,0,3,1,0,182,28,19874,15980,231,67,20177,15026
140,15,1,2,1,0,0,3,15,30,19875,15982,0,132,20177,15029
141,15,2,0,0,3,1,0,30,0,19877,15982,45,0,20180,15029
142,15,1,6,1,0,0,3,73,148,19878,15988,29,45,20180,15032
143,15,1,2,1,0,0,3,243,127,19879,15990,291,287,20180,15035
144,15,6,1,0,3,1,0,90,15,19885,15991,45,0,20183,15035
145,15,2,2,2,1,2,1,98,132,19887,15993,49,226,20184,15036
146,15,0,4,1,0,0,3,76,60,19887,15997,114,45,20184,15039
147,15,0,0,2,1,2,1,76,130,19887,15997,163,117,20185,15040
148,15,0,0,2,1,2,1,178,216,19887,15997,117,117,20186,15041
149,15,4,2,0,3,1,0,186,30,19891,15999,234,67,20189,15041
150,16,1,2,1,0,0,3,16,32,19892,16001,0,135,20189,15044
151,16,2,0,0,3,1,0,32,0,19894,16001,48,0,20192,15044
152,16,1,6,1,0,0,3,74,154,19895,16007,29,48,20192,15047
153,16,1,2,1,0,0,3,244,129,19896,16009,291,290,20192,15050
154,16,6,1,0,3,1,0,96,16,19902,16010,48,0,20195,15050
155,16,2,2,2,1,2,1,100,134,19904,16012,50,227,20196,15051
156,16,0,4,1,0,0,3,76,64,19904,16016,114,48,20196,15054
157,16,0,0,2,1,2,1,76,130,19904,16016,164,118,20197,15055
158,16,0,0,2,1,2,1,178,216,19904,16016,118,118,20198,15056
159,16,4,2,0,3,1,0,190,32,19908,16018,237,67,20201,15056
160,17,1,2,1,0,0,3,17,34,19909,16020,0,138,20201,15059
161,17,2,0,0,3,1,0,34,0,19911,16020,51,0,20204,15059
162,17,1,6,1,0,0,3,75,160,19912,16026,29,51,20204,15062
163,17,1,2,1,0,0,3,245,131,19913,16028,291,293,20204,15065
164,17,6,1,0,3,1,0,102,17,19919,16029,51,0,20207,15065
165,17,2,2,2,1,2,1,102,136,19921,16031,51,228,20208,15066
166,17,0,4,1,0,0,3,76,68,19921,16035,114,51,20208,15069
167,17,0,0,2,1,2,1,76,130,19921,16035,165,119,20209,15070
168,17,0,0,2,1,2,1,178,216,19921,16035,119,119,20210,15071
169,17,4,2,0,3,1,0,194,34,19925,16037,240,67,20213,15071
170,18,1,2,1,0,0,3,18,36,19926,16039,0,141,20213,15074
171,18,2,0,0,3,1,0,36,0,19928,16039,54,0,20216,15074
172,18,1,6,1,0,0,3,76,166,19929,16045,29,54,20216,15077
173,18,1,2,1,0,0,3,246,133,19930,16047,291,296,20216,15080
174,18,6,1,0,3,1,0,108,18,19936,16048,54,0,20219,15080
175,18,2,2,2,1,2,1,104,138,19938,16050,52,229,20220,15081
176,18,0,4,1,0,0,3,76,72,19938,16054,114,54,20220,15084
177,18,0,0,2,1,2,1,76,130,19938,16054,166,120,20221,15085
178,18,0,0,2,1,2,1,178,216,19938,16054,120,120,20222,15086
179,18,4,2,0,3,1,0,198,36,19942,16056,243,67,20225,15086
180,19,1,2,1,0,0,3,19,38,19943,16058,0,144,20225,15089
181,19,2,0,0,3,1,0,38,0,19945,16058,57,0,20228,15089
182,19,1,6,1,0,0,3,77,172,19946,16064,29,57,20228,15092
183,19,1,2,1,0,0,3,247,135,19947,16066,291,299,20228,15095
184,19,6,1,0,3,1,0,114,19,19953,16067,57,0,20231,15095
185,19,2,2,2,1,2,1,106,140,19955,16069,53,230,20232,15096
186,19,0,4,1,0,0,3,76,76,19955,16073,114,57,20232,15099
187,19,0,0,2,1,2,1,76,130,19955,16073,167,121,20233,15100
188,19,0,0,2,1,2,1,178,216,19955,16073,121,121,20234,15101
189,19,4,2,0,3,1,0,202,38,19959,16075,246,67,20237,15101
190,20,1,2,1,0,0,3,20,40,19960,16077,0,147,20237,15104
191,20,2,0,0,3,1,0,40,0,19962,16077,60,0,20240,15104
192,20,1,6,1,0,0,3,78,178,19963,16083,29,60,20240,15107
193,20,1,2,1,0,0,3,248,137,19964,16085,291,302,20240,15110
194,20,6,1,0,3,1,0,120,20,19970,16086,60,0,20243,15110
195,20,2,2,2,1,2,1,108,142,19972,16088,54,231,20244,15111
196,20,0,4,1,0,0,3,76,80,19972,16092,114,60,20244,15114
197,20,0,0,2,1,2,1,76,130,19972,16092,168,122,20245,15115
198,20,0,0,2,1,2,1,178,216,19972,16092,122,122,20246,15116
199,20,4,2,0,3,1,0,206,40,19976,16094,249,67,20249,15116
200,21,1,2,1,0,0,3,21,42,19977,16096,0,150,20249,15119
201,21,2,0,0,3,1,0,42,0,19979,16096,63,0,20252,15119
202,21,1,6,1,0,0,3,79,184,19980,16102,29,63,20252,15122
203,21,1,2,1,0,0,3,249,139,19981,16104,291,305,20252,15125
204,21,6,1,0,3,1,0,126,21,19987,16105,63,0,20255,15125
205,21,2,2,2,1,2,1,110,144,19989,16107,55,232,20256,15126
206,21,0,4,1,0,0,3,76,84,19989,16111,114,63,20256,15129
207,21,0,0,2,1,2,1,76,130,19989,16111,169,123,20257,15130
208,21,0,0,2,1,2,1,178,216,19989,16111,123,123,20258,15131
209,21,4,2,0,3,1,0,210,42,19993,16113,252,67,20261,15131
210,22,1,2,1,0,0,3,22,44,19994,16115,0,153,20261,15134
211,22,2,0,0,3,1,0,44,0,19996,16115,66,0,20264,15134
212,22,1,6,1,0,0,3,80,190,19997,16121,29,66,20264,15137
213,22,1,2,1,0,0,3,250,141,19998,16123,291,308,20264,15140
214,22,6,1,0,3,1,0,132,22,20004,16124,66,0,20267,15140
215,22,2,2,2,1,2,1,112,146,20006,16126,56,233,20268,15141
216,22,0,4,1,0,0,3,76,88,20006,16130,114,66,20268,15144
217,22,0,0,2,1,2,1,76,130,20006,16130,170,124,20269,15145
218,22,0,0,2,1,2,1,178,216,20006,16130,124,124,20270,15146
219,22,4,2,0,3,1,0,214,44,20010,16132,255,67,20273,15146
220,23,1,2,1,0,0,3,23,46,20011,16134,0,156,20273,15149
221,23,2,0,0,3,1,0,46,0,20013,16134,69,0,20276,15149
222,23,1,6,1,0,0,3,81,196,20014,16140,29,69,20276,15152
223,23,1,2,1,0,0,3,251,143,20015,16142,291,311,20276,15155
224,23,6,1,0,3,1,0,138,23,20021,16143,69,0,20279,15155
225,23,2,2,2,1,2,1,114,148,20023,16145,57,234,20280,15156
226,23,0,4,1,0,0,3,76,92,20023,16149,114,69,20280,15159
227,23,0,0,2,1,2,1,76,130,20023,16149,171,125,20281,15160
228,23,0,0,2,1,2,1,178,216,20023,16149,125,125,20282,15161
229,23,4,2,0,3,1,0,218,46,20027,16151,258,67,20285,15161
230,24,1,2,1,0,0,3,24,48,20028,16153,0,159,20285,15164
231,24,2,0,0,3,1,0,48,0,20030,16153,72,0,20288,15164
232,24,1,6,1,0,0,3,82,202,20031,16159,29,72,20288,15167
233,24,1,2,1,0,0,3,252,145,20032,16161,291,314,20288,15170
234,24,6,1,0,3,1,0,144,24,20038,16162,72,0,20291,15170
235,24,2,2,2,1,2,1,116,150,20040,16164,58,235,20292,15171
236,24,0,4,1,0,0,3,76,96,20040,16168,114,72,20292,15174
237,24,0,0,2,1,2,1,76,130,20040,16168,172,126,20293,15175
238,24,0,0,2,1,2,1,178,216,20040,16168,126,126,20294,15176
239,24,4,2,0,3,1,0,222,48,20044,16170,261,67,20297,15176
240,25,1,2,1,0,0,3,25,50,20045,16172,0,162,20297,15179
241,25,2,0,0,3,1,0,50,0,20047,16172,75,0,20300,15179
242,25,1,6,1,0,0,3,83,208,20048,16178,29,75,20300,15182
243,25,1,2,1,0,0,3,253,147,20049,16180,291,317,20300,15185
244,25,6,1,0,3,1,0,150,25,20055,16181,75,0,20303,15185
245,25,2,2,2,1,2,1,118,152,20057,16183,59,236,20304,15186
246,25,0,4,1,0,0,3,76,100,20057,16187,114,75,20304,15189
247,25,0,0,2,1,2,1,76,130,20057,16187,173,127,20305,15190
248,25,0,0,2,1,2,1,178,216,20057,16187,127,127,20306,15191
249,25,4,2,0,3,1,0,226,50,20061,16189,264,67,20309,15191
250,26,1,2,1,0,0,3,26,52,20062,16191,0,165,20309,15194
251,26,2,0,0,3,1,0,52,0,20064,16191,78,0,20312,15194
252,26,1,6,1,0,0,3,84,214,20065,16197,29,78,20312,15197
253,26,1,2,1,0,0,3,254,149,20066,16199,291,320,20312,15200
254,26,6,1,0,3,1,0,156,26,20072,16200,78,0,20315,15200
255,26,2,2,2,1,2,1,120,154,20074,16202,60,237,20316,15201
256,26,0,4,1,0,0,3,76,104,20074,16206,114,78,20316,15204
257,26,0,0,2,1,2,1,76,130,20074,16206,174,128,20317,15205
258,26,0,0,2,1,2,1,178,216,20074,16206,128,128,20318,15206
259,26,4,2,0,3,1,0,230,52,20078,16208,267,67,20321,15206
260,27,1,2,1,0,0,3,27,54,20079,16210,0,168,20321,15209
261,27,2,0,0,3,1,0,54,0,20081,16210,81,0,20324,15209
262,27,1,6,1,0,0,3,85,220,20082,16216,29,81,20324,15212
263,27,1,2,1,0,0,3,255,151,20083,16218,291,323,20324,15215
264,27,6,1,0,3,1,0,162,27,20089,16219,81,0,20327,15215
265,27,2,2,2,1,2,1,122,156,20091,16221,61,238,20328,15216
266,27,0,4,1,0,0,3,76,108,20091,16225,114,81,20328,15219
267,27,0,0,2,1,2,1,76,130,20091,16225,175,129,20329,15220
268,27,0,0,2,1,2,1,178,216,20091,16225,129,129,20330,15221
269,27,4,2,0,3,1,0,234,54,20095,16227,270,67,20333,15221
270,28,1,2,1,0,0,3,28,56,20096,16229,0,171,20333,15224
271,28,2,0,0,3,1,0,56,0,20098,16229,84,0,20336,15224
272,28,1,6,1,0,0,3,86,226,20099,16235,29,84,20336,15227
273,28,1,2,1,0,0,3,256,153,20100,16237,291,326,20336,15230
274,28,6,1,0,3,1,0,168,28,20106,16238,84,0,20339,15230
275,28,2,2,2,1,2,1,124,158,20108,16240,62,239,20340,15231
276,28,0,4,1,0,0,3,76,112,20108,16244,114,84,20340,15234
277,28,0,0,2,1,2,1,76,130,20108,16244,176,130,20341,15235
278,28,0,0,2,1,2,1,178,216,20108,16244,130,130,20342,15236
279,28,4,2,0,3,1,0,238,56,20112,16246,273,67,20345,15236
280,29,1,2,1,0,0,3,29,58,20113,16248,0,174,20345,15239
281,29,2,0,0,3,1,0,58,0,20115,16248,87,0,20348,15239
282,29,1,6,1,0,0,3,87,232,20116,16254,29,87,20348,15242
283,29,1,2,1,0,0,3,257,155,20117,16256,291,329,20348,15245
284,29,6,1,0,3,1,0,174,29,20123,16257,87,0,20351,15245
285,29,2,2,2,1,2,1,126,160,20125,16259,63,240,20352,15246
286,29,0,4,1,0,0,3,76,116,20125,16263,114,87,20352,15249
287,29,0,0,2,1,2,1,76,130,20125,16263,177,131,20353,15250
288,29,0,0,2,1,2,1,178,216,20125,16263,131,131,20354,15251
289,29,4,2,0,3,1,0,242,58,20129,16265,276,67,20357,15251
290,30,1,2,1,0,0,3,30,60,20130,16267,0,177,20357,15254
291,30,2,0,0,3,1,0,60,0,20132,16267,90,0,20360,15254
292,30,1,6,1,0,0,3,88,238,20133,16273,29,90,20360,15257
293,30,1,2,1,0,0,3,258,157,20134,16275,291,332,20360,15260
294,30,6,1,0,3,1,0,180,30,20140,16276,90,0,20363,15260
295,30,2,2,2,1,2,1,128,162,20142,16278,64,241,20364,15261
296,30,0,4,1,0,0,3,76,120,20142,16282,114,90,20364,15264
297,30,0,0,2,1,2,1,76,130,20142,16282,178,132,20365,15265
298,30,0,0,2,1,2,1,178,216,20142,16282,132,132,20366,15266
299,30,4,2,0,3,1,0,246,60,20146,16284,279,67,20369,15266
300,31,1,2,1,0,0,3,31,62,20147,16286,0,180,20369,15269
301,31,2,0,0,3,1,0,62,0,20149,16286,93,0,20372,15269
302,31,1,6,1,0,0,3,89,244,20150,16292,29,93,20372,15272
303,31,1,2,1,0,0,3,259,159,20151,16294,291,335,20372,15275
304,31,6,1,0,3,1,0,186,31,20157,16295,93,0,20375,15275
305,31,2,2,2,1,2,1,130,164,20159,16297,65,242,20376,15276
306,31,0,4,1,0,0,3,76,124,20159,16301,114,93,20376,15279
307,31,0,0,2,1,2,1,76,130,20159,16301,179,133,20377,15280
308,31,0,0,2,1,2,1,178,216,20159,16301,133,133,20378,15281
309,31,4,2,0,3,1,0,250,62,20163,16303,282,67,20381,15281
310,32,1,2,1,0,0,3,32,64,20164,16305,0,183,20381,15284
311,32,2,0,0,3,1,0,64,0,20166,16305,96,0,20384,15284
312,32,1,6,1,0,0,3,90,250,20167,16311,29,96,20384,15287
313,32,1,2,1,0,0,3,260,161,20168,16313,291,338,20384,15290
314,32,6,1,0,3,1,0,192,32,20174,16314,96,0,20387,15290
315,32,2,2,2,1,2,1,132,166,20176,16316,66,243,20388,15291
316,32,0,4,1,0,0,3,76,128,20176,16320,114,96,20388,15294
317,32,0,0,2,1,2,1,76,130,20176,16320,180,134,20389,15295
318,32,0,0,2,1,2,1,178,216,20176,16320,134,134,20390,15296
319,32,4,2,0,3,1,0,254,64,20180,16322,285,67,20393,15296
320,33,1,2,1,0,0,3,33,66,20181,16324,0,186,20393,15299
321,33,2,0,0,3,1,0,66,0,20183,16324,99,0,20396,15299
322,33,1,6,1,0,0,3,91,256,20184,16330,29,99,20396,15302
323,33,1,2,1,0,0,3,261,163,20185,16332,291,341,20396,15305
324,33,6,1,0,3,1,0,198,33,20191,16333,99,0,20399,15305
325,33,2,2,2,1,2,1,134,168,20193,16335,67,244,20400,15306
326,33,0,4,1,0,0,3,76,132,20193,16339,114,99,20400,15309
327,33,0,0,2,1,2,1,76,130,20193,16339,181,135,20401,15310
328,33,0,0,2,1,2,1,178,216,20193,16339,135,135,20402,15311
329,33,4,2,0,3,1,0,258,66,20197,16341,288,67,20405,15311
330,34,1,2,1,0,0,3,34,68,20198,16343,0,189,20405,15314
331,34,2,0,0,3,1,0,68,0,20200,16343,102,0,20408,15314
332,34,1,6,1,0,0,3,92,262,20201,16349,29,102,20408,15317
333,34,1,2,1,0,0,3,262,165,20202,16351,291,344,20408,15320
334,34,6,1,0,3,1,0,204,34,20208,16352,102,0,20411,15320
335,34,2,2,2,1,2,1,136,170,20210,16354,68,245,20412,15321
336,34,0,4,1,0,0,3,76,136,20210,16358,114,102,20412,15324
337,34,0,0,2,1,2,1,76,130,20210,16358,182,136,20413,15325
338,34,0,0,2,1,2,1,178,216,20210,16358,136,136,20414,15326
339,34,4,2,0,3,1,0,262,68,20214,16360,291,67,20417,15326
0,1,2,2,2,1,2,1,2,2,20216,16362,1,1,20418,15327
1,1,1,2,1,0,0,3,1,2,20217,16364,0,3,20418,15330
2,1,0,0,2,1,2,1,0,0,20217,16364,1,1,20419,15331
3,1,1,2,1,0,0,3,1,2,20218,16366,0,3,20419,15334
4,1,0,0,2,1,2,1,0,0,20218,16366,1,1,20420,15335
5,1,3,1,0,3,1,0,3,1,20221,16367,3,0,20423,15335
6,1,1,1,2,1,2,1,1,1,20222,16368,1,1,20424,15336
7,1,2,1,0,3,1,0,2,1,20224,16369,3,0,20427,15336
8,1,2,0,0,3,1,0,2,0,20226,16369,3,0,20430,15336
9,1,1,0,0,3,1,0,1,0,20227,16369,3,0,20433,15336
10,2,1,1,2,1,2,1,1,1,20228,16370,1,1,20434,15337
11,2,1,2,1,0,0,3,1,2,20229,16372,0,3,20434,15340
12,2,0,3,1,0,0,3,0,3,20229,16375,0,3,20434,15343
13,2,3,2,0,3,1,0,3,2,20232,16377,3,0,20437,15343
14,2,3,2,0,3,1,0,3,2,20235,16379,3,0,20440,15343
15,2,0,1,1,0,0,3,0,1,20235,16380,0,3,20440,15346
16,2,1,2,1,0,0,3,1,2,20236,16382,0,3,20440,15349
17,2,3,2,0,3,1,0,3,2,20239,16384,3,0,20443,15349
18,2,0,0,2,1,2,1,0,0,20239,16384,1,1,20444,15350
19,2,0,0,2,1,2,1,0,0,20239,16384,1,1,20445,15351
20,3,2,2,2,1,2,1,3,4,20241,16386,1,2,20446,15352
21,3,1,0,0,3,1,0,1,0,20242,16386,4,0,20449,15352
22,3,2,0,0,3,1,0,3,2,20244,16386,3,1,20452,15352
23,3,1,1,2,1,2,1,1,1,20245,16387,2,4,20453,15353
24,3,0,0,2,1,2,1,1,1,20245,16387,2,1,20454,15354
25,3,2,1,0,3,1,0,4,1,20247,16388,6,0,20457,15354
26,3,1,1,2,1,2,1,3,3,20248,16389,2,2,20458,15355
27,3,0,0,2,1,2,1,1,0,20248,16389,4,4,20459,15356
28,3,0,0,2,1,2,1,2,1,20248,16389,4,2,20460,15357
29,3,1,2,1,0,0,3,4,3,20249,16391,3,3,20460,15360
30,4,0,1,1,0,0,3,0,2,20249,16392,0,6,20460,15363
31,4,2,0,0,3,1,0,3,2,20251,16392,3,0,20463,15363
32,4,0,2,1,0,0,3,0,5,20251,16394,0,6,20463,15366
33,4,3,1,0,3,1,0,6,3,20254,16395,6,3,20466,15366
34,4,0,1,1,0,0,3,3,3,20254,16396,3,4,20466,15369
35,4,0,2,1,0,0,3,3,4,20254,16398,3,3,20466,15372
36,4,2,0,0,3,1,0,2,0,20256,16398,4,1,20469,15372
37,4,1,1,2,1,2,1,1,1,20257,16399,2,4,20470,15373
38,4,3,1,0,3,1,0,5,2,20260,16400,7,1,20473,15373
39,4,1,1,2,1,2,1,2,3,20261,16401,1,1,20474,15374
40,5,1,1,2,1,2,1,4,4,20262,16402,3,5,20475,15375
41,5,1,1,2,1,2,1,2,1,20263,16403,5,3,20476,15376
42,5,1,2,1,0,0,3,2,2,20264,16405,4,7,20476,15379
43,5,4,0,0,3,1,0,8,3,20268,16405,6,0,20479,15379
44,5,2,1,0,3,1,0,3,2,20270,16406,5,0,20482,15379
45,5,0,1,1,0,0,3,4,2,20270,16407,6,4,20482,15382
46,5,1,4,1,0,0,3,4,8,20271,16411,1,5,20482,15385
47,5,0,0,2,1,2,1,1,1,20271,16411,2,2,20483,15386
48,5,2,1,0,3,1,0,3,2,20273,16412,5,3,20486,15386
49,5,2,2,2,1,2,1,5,4,20275,16414,4,3,20487,15387
50,6,0,1,1,0,0,3,3,3,20275,16415,3,8,20487,15390
51,6,0,0,2,1,2,1,2,0,20275,16415,5,7,20488,15391
52,6,0,2,1,0,0,3,0,7,20275,16417,0,6,20488,15394
53,6,3,0,0,3,1,0,9,3,20278,16417,9,4,20491,15394
54,6,4,0,0,3,1,0,9,2,20282,16417,10,4,20494,15394
55,6,1,1,2,1,2,1,4,4,20283,16418,4,4,20495,15395
56,6,0,3,1,0,0,3,0,5,20283,16421,0,4,20495,15398
57,6,1,0,0,3,1,0,2,1,20284,16421,5,1,20498,15398
58,6,0,0,2,1,2,1,8,3,20284,16421,7,7,20499,15399
59,6,2,0,0,3,1,0,4,3,20286,16421,4,0,20502,15399
60,7,2,2,2,1,2,1,6,6,20288,16423,4,8,20503,15400
61,7,0,0,2,1,2,1,3,4,20288,16423,4,4,20504,15401
62,7,2,1,0,3,1,0,5,4,20290,16424,6,3,20507,15401
63,7,2,1,0,3,1,0,7,5,20292,16425,7,0,20510,15401
64,7,3,1,0,3,1,0,5,3,20295,16426,7,0,20513,15401
65,7,1,2,1,0,0,3,4,4,20296,16428,5,10,20513,15404
66,7,0,1,1,0,0,3,2,2,20296,16429,5,7,20513,15407
67,7,1,0,0,3,1,0,2,1,20297,16429,5,3,20516,15407
68,7,1,1,2,1,2,1,5,3,20298,16430,7,6,20517,15408
69,7,0,2,1,0,0,3,4,10,20298,16432,1,4,20517,15411
70,8,0,4,1,0,0,3,0,9,20298,16436,0,4,20517,15414
71,8,1,0,0,3,1,0,5,3,20299,16436,7,2,20520,15414
72,8,0,1,1,0,0,3,2,1,20299,16437,5,9,20520,15417
73,8,2,3,1,0,0,3,2,10,20301,16440,0,3,20520,15420
74,8,3,0,0,3,1,0,12,2,20304,16440,13,4,20523,15420
75,8,2,1,0,3,1,0,6,5,20306,16441,7,8,20526,15420
76,8,1,1,2,1,2,1,10,4,20307,16442,10,5,20527,15421
77,8,3,1,0,3,1,0,5,2,20310,16443,8,4,20530,15421
78,8,0,0,2,1,2,1,8,3,20310,16443,8,5,20531,15422
79,8,3,1,0,3,1,0,6,3,20313,16444,8,7,20534,15422
80,9,0,1,1,0,0,3,6,7,20313,16445,4,7,20534,15425
81,9,0,0,2,1,2,1,2,1,20313,16445,6,1,20535,15426
82,9,0,0,2,1,2,1,3,4,20313,16445,5,4,20536,15427
83,9,1,0,0,3,1,0,8,5,20314,16445,10,8,20539,15427
84,9,2,0,0,3,1,0,7,3,20316,16445,10,0,20542,15427
85,9,0,2,1,0,0,3,5,5,20316,16447,7,7,20542,15430
86,9,0,0,2,1,2,1,4,10,20316,16447,2,11,20543,15431
87,9,2,1,0,3,1,0,7,5,20318,16448,9,3,20546,15431
88,9,2,1,0,3,1,0,6,5,20320,16449,8,7,20549,15431
89,9,3,1,0,3,1,0,5,3,20323,16450,8,6,20552,15431
90,10,0,2,1,0,0,3,5,5,20323,16452,7,12,20552,15434
91,10,1,0,0,3,1,0,5,10,20324,16452,5,5,20555,15434
92,10,0,2,1,0,0,3,2,3,20324,16454,5,6,20555,15437
93,10,1,0,0,3,1,0,3,10,20325,16454,3,2,20558,15437
94,10,0,1,1,0,0,3,6,4,20325,16455,8,7,20558,15440
95,10,1,1,2,1,2,1,11,5,20326,16456,11,9,20559,15441
96,10,1,3,1,0,0,3,13,5,20327,16459,13,10,20559,15444
97,10,1,1,2,1,2,1,1,10,20328,16460,1,4,20560,15445
98,10,2,3,1,0,0,3,10,6,20330,16463,8,7,20560,15448
99,10,1,3,1,0,0,3,6,5,20331,16466,8,8,20560,15451
100,11,2,0,0,3,1,0,8,7,20333,16466,7,5,20563,15451
101,11,2,0,0,3,1,0,4,1,20335,16466,9,7,20566,15451
102,11,2,3,1,0,0,3,5,7,20337,16469,5,11,20566,15454
103,11,2,0,0,3,1,0,9,5,20339,16469,12,1,20569,15454
104,11,2,1,0,3,1,0,7,4,20341,16470,11,0,20572,15454
105,11,1,1,2,1,2,1,6,6,20342,16471,8,5,20573,15455
106,11,1,1,2,1,2,1,7,6,20343,16472,8,7,20574,15456
107,11,1,1,2,1,2,1,8,4,20344,16473,11,8,20575,15457
108,11,2,2,2,1,2,1,4,5,20346,16475,6,8,20576,15458
109,11,0,0,2,1,2,1,8,5,20346,16475,11,12,20577,15459
110,12,3,2,0,3,1,0,4,12,20349,16477,4,9,20580,15459
111,12,1,1,2,1,2,1,6,6,20350,16478,8,7,20581,15460
112,12,1,2,1,0,0,3,12,7,20351,16480,11,5,20581,15463
113,12,1,1,2,1,2,1,14,6,20352,16481,14,8,20582,15464
114,12,1,1,2,1,2,1,7,5,20353,16482,9,5,20583,15465
115,12,2,0,0,3,1,0,7,10,20355,16482,8,7,20586,15465
116,12,3,1,0,3,1,0,9,6,20358,16483,11,12,20589,15465
117,12,0,4,1,0,0,3,3,14,20358,16487,3,7,20589,15468
118,12,2,0,0,3,1,0,8,5,20360,16487,11,10,20592,15468
119,12,2,1,0,3,1,0,12,7,20362,16488,11,8,20595,15468
120,13,2,1,0,3,1,0,8,7,20364,16489,11,11,20598,15468
121,13,1,1,2,1,2,1,5,2,20365,16490,10,1,20599,15469
122,13,1,1,2,1,2,1,9,6,20366,16491,12,6,20600,15470
123,13,0,0,2,1,2,1,4,5,20366,16491,7,2,20601,15471
124,13,1,0,0,3,1,0,9,4,20367,16491,14,10,20604,15471
125,13,2,5,1,0,0,3,7,12,20369,16496,5,10,20604,15474
126,13,2,1,0,3,1,0,10,8,20371,16497,10,12,20607,15474
127,13,1,1,2,1,2,1,10,6,20372,16498,13,9,20608,15475
128,13,1,0,0,3,1,0,8,4,20373,16498,14,5,20611,15475
129,13,1,1,2,1,2,1,8,7,20374,16499,9,8,20612,15476
130,14,2,0,0,3,1,0,5,14,20376,16499,6,7,20615,15476
131,14,2,1,0,3,1,0,14,8,20378,16500,14,9,20618,15476
132,14,2,1,0,3,1,0,9,6,20380,16501,12,12,20621,15476
133,14,1,1,2,1,2,1,13,8,20381,16502,12,9,20622,15477
134,14,2,0,0,3,1,0,16,6,20383,16502,17,5,20625,15477
135,14,0,1,1,0,0,3,6,7,20383,16503,8,11,20625,15480
136,14,0,1,1,0,0,3,8,6,20383,16504,11,10,20625,15483
137,14,2,4,1,0,0,3,6,16,20385,16508,4,11,20625,15486
138,14,2,1,0,3,1,0,11,7,20387,16509,14,7,20628,15486
139,14,1,3,1,0,0,3,8,13,20388,16512,8,8,20628,15489
140,15,2,0,0,3,1,0,12,6,20390,16512,16,12,20631,15489
141,15,4,0,0,3,1,0,13,6,20394,16512,15,10,20634,15489
142,15,1,1,2,1,2,1,5,6,20395,16513,8,6,20635,15490
143,15,1,1,2,1,2,1,6,15,20396,16514,7,9,20636,15491
144,15,3,0,0,3,1,0,11,7,20399,16514,12,2,20639,15491
145,15,1,1,2,1,2,1,9,8,20400,16515,12,11,20640,15492
146,15,1,2,1,0,0,3,11,10,20401,16517,10,13,20640,15495
147,15,0,3,1,0,0,3,7,15,20401,16520,5,4,20640,15498
148,15,2,2,2,1,2,1,10,6,20403,16522,15,10,20641,15499
149,15,4,1,0,3,1,0,9,3,20407,16523,13,6,20644,15499
150,16,1,1,2,1,2,1,7,17,20408,16524,5,12,20645,15500
151,16,1,1,2,1,2,1,9,14,20409,16525,9,10,20646,15501
152,16,1,0,0,3,1,0,10,6,20410,16525,15,7,20649,15501
153,16,2,1,0,3,1,0,18,7,20412,16526,20,7,20652,15501
154,16,1,0,0,3,1,0,7,7,20413,16526,11,9,20655,15501
155,16,1,2,1,0,0,3,10,6,20414,16528,14,11,20655,15504
156,16,6,3,0,3,1,0,17,10,20420,16531,17,5,20658,15504
157,16,1,0,0,3,1,0,9,6,20421,16531,14,11,20661,15504
158,16,3,1,0,3,1,0,17,9,20424,16532,17,12,20664,15504
159,16,2,2,2,1,2,1,15,10,20426,16534,13,12,20665,15505
160,17,0,1,1,0,0,3,7,18,20426,16535,5,14,20665,15508
161,17,0,0,2,1,2,1,9,3,20426,16535,14,11,20666,15509
162,17,0,0,2,1,2,1,7,15,20426,16535,6,7,20667,15510
163,17,3,0,0,3,1,0,15,6,20429,16535,19,6,20670,15510
164,17,1,0,0,3,1,0,7,15,20430,16535,10,4,20673,15510
165,17,1,2,1,0,0,3,12,9,20431,16537,12,13,20673,15513
166,17,1,1,2,1,2,1,12,11,20432,16538,11,12,20674,15514
167,17,2,0,0,3,1,0,12,6,20434,16538,18,13,20677,15514
168,17,0,2,1,0,0,3,5,8,20434,16540,8,12,20677,15517
169,17,0,0,2,1,2,1,9,8,20434,16540,13,13,20678,15518
170,18,1,1,2,1,2,1,11,7,20435,16541,15,11,20679,15519
171,18,1,1,2,1,2,1,10,7,20436,16542,15,13,20680,15520
172,18,1,0,0,3,1,0,11,6,20437,16542,18,7,20683,15520
173,18,2,0,0,3,1,0,17,10,20439,16542,16,2,20686,15520
174,18,3,0,0,3,1,0,10,7,20442,16542,14,5,20689,15520
175,18,2,2,2,1,2,1,19,11,20444,16544,18,8,20690,15521
176,18,1,1,2,1,2,1,19,8,20445,16545,21,13,20691,15522
177,18,1,1,2,1,2,1,14,7,20446,16546,16,12,20692,15523
178,18,3,0,0,3,1,0,20,10,20449,16546,20,12,20695,15523
179,18,2,0,0,3,1,0,11,14,20451,16546,12,9,20698,15523
180,19,0,0,2,1,2,1,15,6,20451,16546,20,12,20699,15524
181,19,0,0,2,1,2,1,7,18,20451,16546,6,8,20700,15525
182,19,0,0,2,1,2,1,9,3,20451,16546,15,13,20701,15526
183,19,1,0,0,3,1,0,8,15,20452,16546,9,13,20704,15526
184,19,1,1,2,1,2,1,21,11,20453,16547,21,13,20705,15527
185,19,1,1,2,1,2,1,13,7,20454,16548,19,12,20706,15528
186,19,2,1,0,3,1,0,7,9,20456,16549,11,4,20709,15528
187,19,2,0,0,3,1,0,9,15,20458,16549,13,13,20712,15528
188,19,2,1,0,3,1,0,14,10,20460,16550,15,13,20715,15528
189,19,2,2,2,1,2,1,11,10,20462,16552,14,7,20716,15529
190,20,1,1,2,1,2,1,13,12,20463,16553,12,9,20717,15530
191,20,1,3,1,0,0,3,10,6,20464,16556,15,12,20717,15533
192,20,2,1,0,3,1,0,13,15,20466,16557,15,13,20720,15533
193,20,3,0,0,3,1,0,16,7,20469,16557,22,5,20723,15533
194,20,2,1,0,3,1,0,13,8,20471,16558,18,7,20726,15533
195,20,0,2,1,0,0,3,10,9,20471,16560,15,17,20726,15536
196,20,2,1,0,3,1,0,21,12,20473,16561,21,4,20729,15536
197,20,4,0,0,3,1,0,15,6,20477,16561,21,2,20732,15536
198,20,1,0,0,3,1,0,11,7,20478,16561,17,12,20735,15536
199,20,2,1,0,3,1,0,16,8,20480,16562,19,13,20738,15536
200,21,1,2,1,0,0,3,8,20,20481,16564,6,16,20738,15539
201,21,2,0,0,3,1,0,10,15,20483,16564,12,12,20741,15539
202,21,2,0,0,3,1,0,17,6,20485,16564,23,13,20744,15539
203,21,2,1,0,3,1,0,19,11,20487,16565,19,13,20747,15539
204,21,5,1,0,3,1,0,24,9,20492,16566,24,13,20750,15539
205,21,2,1,0,3,1,0,16,11,20494,16567,18,12,20753,15539
206,21,1,0,0,3,1,0,22,11,20495,16567,24,7,20756,15539
207,21,2,0,0,3,1,0,13,10,20497,16567,17,8,20759,15539
208,21,1,2,1,0,0,3,10,17,20498,16569,13,15,20759,15542
209,21,0,0,2,1,2,1,7,9,20498,16569,12,14,20760,15543
210,22,2,1,0,3,1,0,12,7,20500,16570,18,12,20763,15543
211,22,0,2,1,0,0,3,10,17,20500,16572,12,8,20763,15546
212,22,1,1,2,1,2,1,14,16,20501,16573,16,8,20764,15547
213,22,1,0,0,3,1,0,17,8,20502,16573,22,2,20767,15547
214,22,1,2,1,0,0,3,14,10,20503,16575,18,16,20767,15550
215,22,1,0,0,3,1,0,11,9,20504,16575,18,4,20770,15550
216,22,1,0,0,3,1,0,16,6,20505,16575,24,16,20773,15550
217,22,1,1,2,1,2,1,14,13,20506,16576,13,18,20774,15551
218,22,2,0,0,3,1,0,13,7,20508,16576,20,9,20777,15551
219,22,0,0,2,1,2,1,16,7,20508,16576,23,14,20778,15552
220,23,0,0,2,1,2,1,8,20,20508,16576,7,16,20779,15553
221,23,1,2,1,0,0,3,14,12,20509,16578,17,15,20779,15556
222,23,3,1,0,3,1,0,10,10,20512,16579,15,8,20782,15556
223,23,3,1,0,3,1,0,13,18,20515,16580,16,12,20785,15556
224,23,0,0,2,1,2,1,21,12,20515,16580,22,8,20786,15557
225,23,1,2,1,0,0,3,25,11,20516,16582,24,17,20786,15560
226,23,1,4,1,0,0,3,20,15,20517,16586,19,15,20786,15563
227,23,2,0,0,3,1,0,18,6,20519,16586,27,8,20789,15563
228,23,3,0,0,3,1,0,19,11,20522,16586,21,13,20792,15563
229,23,2,0,0,3,1,0,24,11,20524,16586,27,13,20795,15563
230,24,4,0,0,3,1,0,20,7,20528,16586,26,12,20798,15563
231,24,1,1,2,1,2,1,15,14,20529,16587,14,3,20799,15564
232,24,2,0,0,3,1,0,14,7,20531,16587,21,9,20802,15564
233,24,2,2,2,1,2,1,12,19,20533,16589,13,9,20803,15565
234,24,2,3,1,0,0,3,16,19,20535,16592,16,7,20803,15568
235,24,2,1,0,3,1,0,19,9,20537,16593,25,16,20806,15568
236,24,5,1,0,3,1,0,22,7,20542,16594,26,14,20809,15568
237,24,1,0,0,3,1,0,15,10,20543,16594,21,18,20812,15568
238,24,0,3,1,0,0,3,11,12,20543,16597,18,19,20812,15571
239,24,1,2,1,0,0,3,14,9,20544,16599,20,16,20812,15574
240,25,1,1,2,1,2,1,9,21,20545,16600,8,14,20813,15575
241,25,2,2,2,1,2,1,12,12,20547,16602,16,16,20814,15576
242,25,2,0,0,3,1,0,20,6,20549,16602,30,8,20817,15576
243,25,0,2,1,0,0,3,20,17,20549,16604,19,11,20817,15579
244,25,0,0,2,1,2,1,25,11,20549,16604,25,17,20818,15580
245,25,0,0,2,1,2,1,19,11,20549,16604,22,9,20819,15581
246,25,3,0,0,3,1,0,17,12,20552,16604,20,12,20822,15581
247,25,1,2,1,0,0,3,14,20,20553,16606,16,20,20822,15584
248,25,2,1,0,3,1,0,23,13,20555,16607,25,13,20825,15584
249,25,1,1,2,1,2,1,25,12,20556,16608,28,16,20826,15585
250,26,1,0,0,3,1,0,13,19,20557,16608,16,16,20829,15585
251,26,0,0,2,1,2,1,22,7,20557,16608,27,13,20830,15586
252,26,0,1,1,0,0,3,15,11,20557,16609,21,19,20830,15589
253,26,0,0,2,1,2,1,11,12,20557,16609,19,9,20831,15590
254,26,0,1,1,0,0,3,14,10,20557,16610,20,10,20831,15593
255,26,0,0,2,1,2,1,19,11,20557,16610,23,10,20832,15594
256,26,1,0,0,3,1,0,16,14,20558,16610,17,19,20835,15594
257,26,1,3,1,0,0,3,15,10,20559,16613,21,17,20835,15597
258,26,5,0,0,3,1,0,25,7,20564,16613,29,3,20838,15597
259,26,1,2,1,0,0,3,20,11,20565,16615,25,21,20838,15600
260,27,0,2,1,0,0,3,20,8,20565,16617,30,23,20838,15603
261,27,3,3,2,1,2,1,12,24,20568,16620,9,10,20839,15604
262,27,0,1,1,0,0,3,16,20,20568,16621,16,16,20839,15607
263,27,2,0,0,3,1,0,16,20,20570,16621,19,16,20842,15607
264,27,1,0,0,3,1,0,12,12,20571,16621,22,12,20845,15607
265,27,2,0,0,3,1,0,22,17,20573,16621,22,14,20848,15607
266,27,0,2,1,0,0,3,25,13,20573,16623,25,19,20848,15610
267,27,0,1,1,0,0,3,17,13,20573,16624,20,13,20848,15613
268,27,2,1,0,3,1,0,27,13,20575,16625,31,9,20851,15613
269,27,2,2,2,1,2,1,25,15,20577,16627,26,18,20852,15614
270,28,2,0,0,3,1,0,18,14,20579,16627,20,10,20855,15614
271,28,1,2,1,0,0,3,16,12,20580,16629,21,24,20855,15617
272,28,0,0,2,1,2,1,22,7,20580,16629,28,17,20856,15618
273,28,1,4,1,0,0,3,16,15,20581,16633,21,12,20856,15621
274,28,1,1,2,1,2,1,15,11,20582,16634,21,12,20857,15622
275,28,2,2,2,1,2,1,21,13,20584,16636,24,18,20858,15623
276,28,1,1,2,1,2,1,26,8,20585,16637,30,20,20859,15624
277,28,2,0,0,3,1,0,15,19,20587,16637,19,3,20862,15624
278,28,0,1,1,0,0,3,12,13,20587,16638,16,16,20862,15627
279,28,2,1,0,3,1,0,22,12,20589,16639,28,19,20865,15627
280,29,0,2,1,0,0,3,12,26,20589,16641,9,16,20865,15630
281,29,3,1,0,3,1,0,30,14,20592,16642,34,16,20868,15630
282,29,0,0,2,1,2,1,16,20,20592,16642,20,19,20869,15631
283,29,0,0,2,1,2,1,25,15,20592,16642,27,11,20870,15632
284,29,0,0,2,1,2,1,20,8,20592,16642,31,13,20871,15633
285,29,2,1,0,3,1,0,27,14,20594,16643,28,14,20874,15633
286,29,0,1,1,0,0,3,15,12,20594,16644,21,21,20874,15636
287,29,2,2,2,1,2,1,14,14,20596,16646,23,20,20875,15637
288,29,1,1,2,1,2,1,23,18,20597,16647,23,10,20876,15638
289,29,0,1,1,0,0,3,16,21,20597,16648,16,26,20876,15641
290,30,2,2,2,1,2,1,20,16,20599,16650,21,18,20877,15642
291,30,0,0,2,1,2,1,17,13,20599,16650,21,4,20878,15643
292,30,1,2,1,0,0,3,16,21,20600,16652,19,22,20878,15646
293,30,1,1,2,1,2,1,23,8,20601,16653,29,11,20879,15647
294,30,1,0,0,3,1,0,13,13,20602,16653,19,24,20882,15647
295,30,1,1,2,1,2,1,22,14,20603,16654,25,17,20883,15648
296,30,2,0,0,3,1,0,18,12,20605,16654,24,20,20886,15648
297,30,2,2,2,1,2,1,24,14,20607,16656,29,17,20887,15649
298,30,1,1,2,1,2,1,17,16,20608,16657,22,13,20888,15650
299,30,3,0,0,3,1,0,29,8,20611,16657,33,12,20891,15650
300,31,1,1,2,1,2,1,17,22,20612,16658,17,15,20892,15651
301,31,3,2,0,3,1,0,17,16,20615,16660,26,16,20895,15651
302,31,1,2,1,0,0,3,21,10,20616,16662,31,14,20895,15654
303,31,2,1,0,3,1,0,25,19,20618,16663,26,17,20898,15654
304,31,3,2,0,3,1,0,30,16,20621,16665,31,16,20901,15654
305,31,0,1,1,0,0,3,15,13,20621,16666,21,16,20901,15657
306,31,1,1,2,1,2,1,31,15,20622,16667,35,20,20902,15658
307,31,0,1,1,0,0,3,12,27,20622,16668,9,13,20902,15661
308,31,1,2,1,0,0,3,18,18,20623,16670,22,29,20902,15664
309,31,1,0,0,3,1,0,26,15,20624,16670,30,20,20905,15664
310,32,1,1,2,1,2,1,21,17,20625,16671,22,13,20906,15665
311,32,2,0,0,3,1,0,19,13,20627,16671,24,18,20909,15665
312,32,2,2,2,1,2,1,20,14,20629,16673,25,23,20910,15666
313,32,1,1,2,1,2,1,17,22,20630,16674,20,18,20911,15667
314,32,1,0,0,3,1,0,14,13,20631,16674,22,20,20914,15667
315,32,0,0,2,1,2,1,16,20,20631,16674,21,5,20915,15668
316,32,1,1,2,1,2,1,23,15,20632,16675,26,12,20916,15669
317,32,1,1,2,1,2,1,24,9,20633,16676,30,25,20917,15670
318,32,3,2,0,3,1,0,32,10,20636,16678,36,21,20920,15670
319,32,4,2,0,3,1,0,28,16,20640,16680,32,13,20923,15670
320,33,2,3,1,0,0,3,19,25,20642,16683,17,17,20923,15673
321,33,5,0,0,3,1,0,36,15,20647,16683,38,5,20926,15673
322,33,0,0,2,1,2,1,21,10,20647,16683,32,21,20927,15674
323,33,1,0,0,3,1,0,31,16,20648,16683,34,17,20930,15674
324,33,3,1,0,3,1,0,29,16,20651,16684,33,13,20933,15674
325,33,1,1,2,1,2,1,29,17,20652,16685,33,17,20934,15675
326,33,0,0,2,1,2,1,18,18,20652,16685,23,16,20935,15676
327,33,0,4,1,0,0,3,17,20,20652,16689,26,19,20935,15679
328,33,2,0,0,3,1,0,17,13,20654,16689,24,20,20938,15679
329,33,1,1,2,1,2,1,26,20,20655,16690,27,17,20939,15680
330,34,0,1,1,0,0,3,12,28,20655,16691,9,21,20939,15683
331,34,1,0,0,3,1,0,22,17,20656,16691,25,21,20942,15683
332,34,0,4,1,0,0,3,19,17,20656,16695,24,15,20942,15686
333,34,0,0,2,1,2,1,20,14,20656,16695,26,14,20943,15687
334,34,1,1,2,1,2,1,18,23,20657,16696,21,14,20944,15688
335,34,0,0,2,1,2,1,24,9,20657,16696,31,19,20945,15689
336,34,1,1,2,1,2,1,15,14,20658,16697,23,24,20946,15690
337,34,0,1,1,0,0,3,16,21,20658,16698,21,28,20946,15693
338,34,2,0,0,3,1,0,25,15,20660,16698,29,20,20949,15693
339,34,3,2,0,3,1,0,35,12,20663,16700,39,29,20952,15693
340,35,2,2,2,1,2,1,31,18,20665,16702,34,18,20953,15694
341,35,1,2,1,0,0,3,27,22,20666,16704,27,31,20953,15697
342,35,4,0,0,3,1,0,26,17,20670,16704,28,20,20956,15697
343,35,1,0,0,3,1,0,20,25,20671,16704,20,21,20959,15697
344,35,3,1,0,3,1,0,21,19,20674,16705,26,17,20962,15697
345,35,3,2,0,3,1,0,20,22,20677,16707,29,5,20965,15697
346,35,1,1,2,1,2,1,22,11,20678,16708,33,20,20966,15698
347,35,3,0,0,3,1,0,34,16,20681,16708,37,17,20969,15698
348,35,0,0,2,1,2,1,17,13,20681,16708,25,14,20970,15699
349,35,3,0,0,3,1,0,32,17,20684,16708,36,16,20973,15699
350,36,1,0,0,3,1,0,13,28,20685,16708,12,19,20976,15699
351,36,2,0,0,3,1,0,20,23,20687,16708,24,21,20979,15699
352,36,1,1,2,1,2,1,16,15,20688,16709,24,15,20980,15700
353,36,3,0,0,3,1,0,19,21,20691,16709,24,14,20983,15700
354,36,1,2,1,0,0,3,28,24,20692,16711,27,23,20983,15703
355,36,1,1,2,1,2,1,26,16,20693,16712,30,18,20984,15704
356,36,2,2,2,1,2,1,26,11,20695,16714,32,30,20985,15705
357,36,1,1,2,1,2,1,21,15,20696,16715,27,21,20986,15706
358,36,1,0,0,3,1,0,20,17,20697,16715,27,24,20989,15706
359,36,1,0,0,3,1,0,37,15,20698,16715,41,15,20992,15706
360,37,0,1,1,0,0,3,26,18,20698,16716,28,19,20992,15709
361,37,0,1,1,0,0,3,20,26,20698,16717,20,8,20992,15712
362,37,0,0,2,1,2,1,35,12,20698,16717,40,21,20993,15713
363,37,2,2,2,1,2,1,34,19,20700,16719,37,15,20994,15714
364,37,0,1,1,0,0,3,21,20,20700,16720,26,20,20994,15717
365,37,2,0,0,3,1,0,22,22,20702,16720,32,17,20997,15717
366,37,2,2,2,1,2,1,33,20,20704,16722,35,32,20998,15718
367,37,0,2,1,0,0,3,22,13,20704,16724,33,21,20998,15721
368,37,2,1,0,3,1,0,36,17,20706,16725,40,21,21001,15721
369,37,2,0,0,3,1,0,19,13,20708,16725,28,21,21004,15721
370,38,1,3,1,0,0,3,14,31,20709,16728,12,18,21004,15724
371,38,2,0,0,3,1,0,22,17,20711,16728,30,21,21007,15724
372,38,0,2,1,0,0,3,21,17,20711,16730,27,22,21007,15727
373,38,2,2,2,1,2,1,22,25,20713,16732,25,31,21008,15728
374,38,3,2,0,3,1,0,40,17,20716,16734,44,23,21011,15728
375,38,1,2,1,0,0,3,27,13,20717,16736,32,21,21011,15731
376,38,0,2,1,0,0,3,16,17,20717,16738,24,24,21011,15734
377,38,4,0,0,3,1,0,23,21,20721,16738,27,15,21014,15734
378,38,1,1,2,1,2,1,29,25,20722,16739,28,25,21015,15735
379,38,2,1,0,3,1,0,28,17,20724,16740,33,14,21018,15735
0,1,2,2,2,1,2,1,23,19,20726,16742,28,1,21019,15736
1,1,1,0,0,3,1,0,23,25,20727,16742,28,15,21022,15736
2,1,2,2,2,1,2,1,36,21,20729,16744,38,19,21023,15737
3,1,3,1,0,3,1,0,24,21,20732,16745,29,21,21026,15737
4,1,1,1,2,1,2,1,24,22,20733,16746,28,33,21027,15738
5,1,1,3,1,0,0,3,23,25,20734,16749,32,27,21027,15741
6,1,0,1,1,0,0,3,33,21,20734,16750,35,20,21027,15744
7,1,0,2,1,0,0,3,0,2,20734,16752,0,25,21027,15747
8,1,1,5,1,0,0,3,1,5,20735,16757,0,26,21027,15750
9,1,1,2,1,0,0,3,23,19,20736,16759,30,24,21027,15753
10,2,1,1,2,1,2,1,28,14,20737,16760,33,22,21028,15754
11,2,1,1,2,1,2,1,36,13,20738,16761,41,1,21029,15755
12,2,1,1,2,1,2,1,23,14,20739,16762,34,26,21030,15756
13,2,1,0,0,3,1,0,30,25,20740,16762,31,21,21033,15756
14,2,1,2,1,0,0,3,37,19,20741,16764,40,24,21033,15759
15,2,2,0,0,3,1,0,21,13,20743,16764,31,0,21036,15759
16,2,0,0,2,1,2,1,28,17,20743,16764,34,20,21037,15760
17,2,2,2,2,1,2,1,28,20,20745,16766,29,32,21038,15761
18,2,1,0,0,3,1,0,1,0,20746,16766,3,14,21041,15761
19,2,0,1,1,0,0,3,40,18,20746,16767,44,24,21041,15764
20,3,1,1,2,1,2,1,24,20,20747,16768,31,22,21042,15765
21,3,1,1,2,1,2,1,24,20,20748,16769,29,28,21043,15766
22,3,1,2,1,0,0,3,24,27,20749,16771,28,36,21043,15769
23,3,2,0,0,3,1,0,3,5,20751,16771,3,20,21046,15769
24,3,1,1,2,1,2,1,24,26,20752,16772,33,26,21047,15770
25,3,1,1,2,1,2,1,1,3,20753,16773,1,2,21048,15771
26,3,4,0,0,3,1,0,28,21,20757,16773,32,26,21051,15771
27,3,1,2,1,0,0,3,25,24,20758,16775,28,22,21051,15774
28,3,2,1,0,3,1,0,35,22,20760,16776,38,15,21054,15774
29,3,0,0,2,1,2,1,36,21,20760,16776,39,25,21055,15775
30,4,4,1,0,3,1,0,32,21,20764,16777,32,1,21058,15775
31,4,0,1,1,0,0,3,1,1,20764,16778,3,3,21058,15778
32,4,2,1,0,3,1,0,30,15,20766,16779,36,21,21061,15778
33,4,0,0,2,1,2,1,24,26,20766,16779,34,21,21062,15779
34,4,1,2,1,0,0,3,29,19,20767,16781,34,25,21062,15782
35,4,2,1,0,3,1,0,38,14,20769,16782,44,24,21065,15782
36,4,3,2,0,3,1,0,26,16,20772,16784,37,24,21068,15782
37,4,2,1,0,3,1,0,39,20,20774,16785,43,25,21071,15782
38,4,1,3,1,0,0,3,22,16,20775,16788,31,29,21071,15785
39,4,3,2,0,3,1,0,43,20,20778,16790,47,32,21074,15785
40,5,3,1,0,3,1,0,4,4,20781,16791,4,15,21077,15785
41,5,0,0,2,1,2,1,24,20,20781,16791,32,3,21078,15786
42,5,0,1,1,0,0,3,24,28,20781,16792,28,29,21078,15789
43,5,1,2,1,0,0,3,4,7,20782,16794,3,31,21078,15792
44,5,1,3,1,0,0,3,31,28,20783,16797,31,39,21078,15795
45,5,1,1,2,1,2,1,40,21,20784,16798,44,21,21079,15796
46,5,0,1,1,0,0,3,36,22,20784,16799,39,29,21079,15799
47,5,1,0,0,3,1,0,29,21,20785,16799,35,14,21082,15799
48,5,0,0,2,1,2,1,25,24,20785,16799,29,23,21083,15800
49,5,1,0,0,3,1,0,36,22,20786,16799,41,21,21086,15800
50,6,1,1,2,1,2,1,33,22,20787,16800,33,25,21087,15801
51,6,2,2,2,1,2,1,26,22,20789,16802,30,25,21088,15802
52,6,3,0,0,3,1,0,33,15,20792,16802,39,25,21091,15802
53,6,3,0,0,3,1,0,27,26,20795,16802,37,1,21094,15802
54,6,3,2,0,3,1,0,25,18,20798,16804,34,25,21097,15802
55,6,4,0,0,3,1,0,33,19,20802,16804,37,3,21100,15802
56,6,2,2,2,1,2,1,45,22,20804,16806,48,23,21101,15803
57,6,2,2,2,1,2,1,3,3,20806,16808,4,30,21102,15804
58,6,1,1,2,1,2,1,27,17,20807,16809,38,22,21103,15805
59,6,2,0,0,3,1,0,40,14,20809,16809,47,32,21106,15805
60,7,1,1,2,1,2,1,25,21,20810,16810,33,40,21107,15806
61,7,1,3,1,0,0,3,5,7,20811,16813,4,28,21107,15809
62,7,1,0,0,3,1,0,25,28,20812,16813,31,31,21110,15809
63,7,1,0,0,3,1,0,5,7,20813,16813,6,21,21113,15809
64,7,1,1,2,1,2,1,34,16,20814,16814,40,24,21114,15810
65,7,2,0,0,3,1,0,38,22,20816,16814,42,3,21117,15810
66,7,1,1,2,1,2,1,26,25,20817,16815,30,16,21118,15811
67,7,2,1,0,3,1,0,38,23,20819,16816,44,14,21121,15811
68,7,2,6,1,0,0,3,42,27,20821,16822,44,32,21121,15814
69,7,1,1,2,1,2,1,32,29,20822,16823,32,30,21122,15815
70,8,2,4,1,0,0,3,5,7,20824,16827,4,28,21122,15818
71,8,1,1,2,1,2,1,46,23,20825,16828,49,22,21123,15819
72,8,3,1,0,3,1,0,43,15,20828,16829,50,25,21126,15819
73,8,1,1,2,1,2,1,28,27,20829,16830,38,4,21127,15820
74,8,1,0,0,3,1,0,26,18,20830,16830,37,22,21130,15820
75,8,1,1,2,1,2,1,34,20,20831,16831,38,33,21131,15821
76,8,0,3,1,0,0,3,29,24,20831,16834,35,33,21131,15824
77,8,4,1,0,3,1,0,37,23,20835,16835,36,23,21134,15824
78,8,1,1,2,1,2,1,27,23,20836,16836,31,2,21135,15825
79,8,1,1,2,1,2,1,28,18,20837,16837,39,26,21136,15826
80,9,1,1,2,1,2,1,26,29,20838,16838,32,15,21137,15827
81,9,1,1,2,1,2,1,6,8,20839,16839,7,3,21138,15828
82,9,2,0,0,3,1,0,36,16,20841,16839,43,16,21141,15828
83,9,1,1,2,1,2,1,27,26,20842,16840,31,4,21142,15829
84,9,1,1,2,1,2,1,33,30,20843,16841,33,25,21143,15830
85,9,3,0,0,3,1,0,45,27,20846,16841,47,30,21146,15830
86,9,2,2,2,1,2,1,27,23,20848,16843,34,29,21147,15831
87,9,2,0,0,3,1,0,48,23,20850,16843,52,32,21150,15831
88,9,1,1,2,1,2,1,39,23,20851,16844,43,22,21151,15832
89,9,2,0,0,3,1,0,40,23,20853,16844,47,31,21154,15832
90,10,1,3,1,0,0,3,38,26,20854,16847,36,43,21154,15835
91,10,1,1,2,1,2,1,28,24,20855,16848,32,29,21155,15836
92,10,1,2,1,0,0,3,6,9,20856,16850,4,29,21155,15839
93,10,3,1,0,3,1,0,46,16,20859,16851,53,22,21158,15839
94,10,5,3,0,3,1,0,34,27,20864,16854,38,4,21161,15839
95,10,0,0,2,1,2,1,26,18,20864,16854,38,34,21162,15840
96,10,3,0,0,3,1,0,31,27,20867,16854,41,25,21165,15840
97,10,1,3,1,0,0,3,6,10,20868,16857,4,36,21165,15843
98,10,3,0,0,3,1,0,37,20,20871,16857,41,23,21168,15843
99,10,2,0,0,3,1,0,30,18,20873,16857,42,22,21171,15843
100,11,1,1,2,1,2,1,28,24,20874,16858,35,23,21172,15844
101,11,1,3,1,0,0,3,27,32,20875,16861,32,32,21172,15847
102,11,2,0,0,3,1,0,41,23,20877,16861,46,3,21175,15847
103,11,1,0,0,3,1,0,28,26,20878,16861,34,15,21178,15847
104,11,1,0,0,3,1,0,34,30,20879,16861,36,16,21181,15847
105,11,1,1,2,1,2,1,46,28,20880,16862,48,5,21182,15848
106,11,0,0,2,1,2,1,36,16,20880,16862,44,31,21183,15849
107,11,0,1,1,0,0,3,38,27,20880,16863,36,35,21183,15852
108,11,2,0,0,3,1,0,42,23,20882,16863,50,4,21186,15852
109,11,3,1,0,3,1,0,51,24,20885,16864,55,31,21189,15852
110,12,0,2,1,0,0,3,6,12,20885,16866,4,28,21189,15855
111,12,3,1,0,3,1,0,31,25,20888,16867,35,22,21192,15855
112,12,2,3,1,0,0,3,8,11,20890,16870,7,37,21192,15858
113,12,3,1,0,3,1,0,9,10,20893,16871,7,25,21195,15858
114,12,2,0,0,3,1,0,36,27,20895,16871,41,22,21198,15858
115,12,4,2,0,3,1,0,46,25,20899,16873,53,29,21201,15858
116,12,2,0,0,3,1,0,48,16,20901,16873,56,29,21204,15858
117,12,1,1,2,1,2,1,32,28,20902,16874,42,24,21205,15859
118,12,1,0,0,3,1,0,27,18,20903,16874,41,35,21208,15859
119,12,0,0,2,1,2,1,37,20,20903,16874,42,44,21209,15860
120,13,1,1,2,1,2,1,52,25,20904,16875,56,6,21210,15861
121,13,3,0,0,3,1,0,30,32,20907,16875,35,4,21213,15861
122,13,2,0,0,3,1,0,38,16,20909,16875,47,3,21216,15861
123,13,2,0,0,3,1,0,43,23,20911,16875,49,15,21219,15861
124,13,2,1,0,3,1,0,30,27,20913,16876,37,23,21222,15861
125,13,1,1,2,1,2,1,31,19,20914,16877,43,17,21223,15862
126,13,1,1,2,1,2,1,35,31,20915,16878,37,33,21224,15863
127,13,2,1,0,3,1,0,48,29,20917,16879,51,31,21227,15863
128,13,2,0,0,3,1,0,40,27,20919,16879,39,31,21230,15863
129,13,1,1,2,1,2,1,29,25,20920,16880,36,37,21231,15864
130,14,0,0,2,1,2,1,27,18,20920,16880,42,45,21232,15865
131,14,1,2,1,0,0,3,49,18,20921,16882,56,38,21232,15868
132,14,2,2,2,1,2,1,8,14,20923,16884,5,30,21233,15869
133,14,2,0,0,3,1,0,10,11,20925,16884,10,28,21236,15869
134,14,2,1,0,3,1,0,11,11,20927,16885,10,22,21239,15869
135,14,0,2,1,0,0,3,32,30,20927,16887,42,32,21239,15872
136,14,1,0,0,3,1,0,37,27,20928,16887,44,37,21242,15872
137,14,2,0,0,3,1,0,33,25,20930,16887,38,24,21245,15872
138,14,2,1,0,3,1,0,39,21,20932,16888,45,25,21248,15872
139,14,0,1,1,0,0,3,46,26,20932,16889,53,25,21248,15875
140,15,2,0,0,3,1,0,31,25,20934,16889,39,30,21251,15875
141,15,1,2,1,0,0,3,31,29,20935,16891,37,7,21251,15878
142,15,3,2,0,3,1,0,34,21,20938,16893,46,6,21254,15878
143,15,3,1,0,3,1,0,38,32,20941,16894,40,3,21257,15878
144,15,1,3,1,0,0,3,49,32,20942,16897,51,36,21257,15881
145,15,2,0,0,3,1,0,29,18,20944,16897,45,17,21260,15881
146,15,2,0,0,3,1,0,54,25,20946,16897,59,23,21263,15881
147,15,0,3,1,0,0,3,40,30,20946,16900,39,34,21263,15884
148,15,1,0,0,3,1,0,39,16,20947,16900,50,15,21266,15884
149,15,3,0,0,3,1,0,46,23,20950,16900,52,37,21269,15884
150,16,1,2,1,0,0,3,31,34,20951,16902,35,40,21269,15887
151,16,2,3,1,0,0,3,10,17,20953,16905,5,48,21269,15890
152,16,2,2,2,1,2,1,35,27,20955,16907,39,33,21270,15891
153,16,0,0,2,1,2,1,10,11,20955,16907,11,25,21271,15892
154,16,2,1,0,3,1,0,13,12,20957,16908,13,17,21274,15892
155,16,4,0,0,3,1,0,41,27,20961,16908,47,22,21277,15892
156,16,2,0,0,3,1,0,34,30,20963,16908,45,38,21280,15892
157,16,2,0,0,3,1,0,33,25,20965,16908,42,25,21283,15892
158,16,3,2,0,3,1,0,49,28,20968,16910,56,25,21286,15892
159,16,3,2,0,3,1,0,52,20,20971,16912,59,31,21289,15892
160,17,2,2,2,1,2,1,33,31,20973,16914,38,4,21290,15893
161,17,1,1,2,1,2,1,35,22,20974,16915,47,24,21291,15894
162,17,2,0,0,3,1,0,40,32,20976,16915,43,30,21294,15894
163,17,0,1,1,0,0,3,49,33,20976,16916,51,40,21294,15897
164,17,2,1,0,3,1,0,31,19,20978,16917,48,6,21297,15897
165,17,1,0,0,3,1,0,40,21,20979,16917,48,36,21300,15897
166,17,0,0,2,1,2,1,46,23,20979,16917,53,29,21301,15898
167,17,2,1,0,3,1,0,42,31,20981,16918,42,15,21304,15898
168,17,2,0,0,3,1,0,56,25,20983,16918,62,7,21307,15898
169,17,0,1,1,0,0,3,39,17,20983,16919,50,37,21307,15901
170,18,1,0,0,3,1,0,36,27,20984,16919,42,25,21310,15901
171,18,1,2,1,0,0,3,32,36,20985,16921,35,28,21310,15904
172,18,1,2,1,0,0,3,11,13,20986,16923,11,36,21310,15907
173,18,2,1,0,3,1,0,48,24,20988,16924,56,22,21313,15907
174,18,1,1,2,1,2,1,42,28,20989,16925,48,32,21314,15908
175,18,2,0,0,3,1,0,36,30,20991,16925,48,17,21317,15908
176,18,2,1,0,3,1,0,54,21,20993,16926,62,6,21320,15908
177,18,1,0,0,3,1,0,11,17,20994,16926,8,38,21323,15908
178,18,1,0,0,3,1,0,34,25,20995,16926,45,25,21326,15908
179,18,0,0,2,1,2,1,49,28,20995,16926,57,49,21327,15909
180,19,1,3,1,0,0,3,34,34,20996,16929,38,43,21327,15912
181,19,2,2,2,1,2,1,44,33,20998,16931,43,8,21328,15913
182,19,4,2,0,3,1,0,17,14,21002,16933,16,36,21331,15913
183,19,4,4,2,1,2,1,60,29,21006,16937,63,16,21332,15914
184,19,0,0,2,1,2,1,39,17,21006,16937,51,31,21333,15915
185,19,1,0,0,3,1,0,36,22,21007,16937,50,29,21336,15915
186,19,0,2,1,0,0,3,49,35,21007,16939,51,7,21336,15918
187,19,0,0,2,1,2,1,31,19,21007,16939,49,25,21337,15919
188,19,1,0,0,3,1,0,41,21,21008,16939,51,37,21340,15919
189,19,0,1,1,0,0,3,40,33,21008,16940,43,43,21340,15922
190,20,2,1,0,3,1,0,13,18,21010,16941,11,25,21343,15922
191,20,2,1,0,3,1,0,36,26,21012,16942,48,17,21346,15922
192,20,1,0,0,3,1,0,37,27,21013,16942,45,16,21349,15922
193,20,0,2,1,0,0,3,32,38,21013,16944,35,41,21349,15925
194,20,3,1,0,3,1,0,14,14,21016,16945,14,6,21352,15925
195,20,1,0,0,3,1,0,43,28,21017,16945,51,37,21355,15925
196,20,2,2,2,1,2,1,36,36,21019,16947,39,23,21356,15926
197,20,3,1,0,3,1,0,52,29,21022,16948,60,32,21359,15926
198,20,1,0,0,3,1,0,41,33,21023,16948,46,25,21362,15926
199,20,2,0,0,3,1,0,50,24,21025,16948,59,49,21365,15926
200,21,1,3,1,0,0,3,45,36,21026,16951,43,31,21365,15929
201,21,0,1,1,0,0,3,37,28,21026,16952,45,46,21365,15932
202,21,1,1,2,1,2,1,40,18,21027,16953,52,26,21366,15933
203,21,3,1,0,3,1,0,57,22,21030,16954,65,8,21369,15933
204,21,0,1,1,0,0,3,36,31,21030,16955,48,39,21369,15936
205,21,1,0,0,3,1,0,32,19,21031,16955,52,31,21372,15936
206,21,3,0,0,3,1,0,63,29,21034,16955,66,36,21375,15936
207,21,0,0,2,1,2,1,17,14,21034,16955,17,30,21376,15937
208,21,1,2,1,0,0,3,42,23,21035,16957,51,10,21376,15940
209,21,1,2,1,0,0,3,37,24,21036,16959,50,46,21376,15943
210,22,1,2,1,0,0,3,15,16,21037,16961,14,20,21376,15946
211,22,0,0,2,1,2,1,36,36,21037,16961,40,42,21377,15947
212,22,1,1,2,1,2,1,14,19,21038,16962,12,17,21378,15948
213,22,1,0,0,3,1,0,44,28,21039,16962,54,25,21381,15948
214,22,3,1,0,3,1,0,55,30,21042,16963,63,6,21384,15948
215,22,2,0,0,3,1,0,38,26,21044,16963,51,32,21387,15948
216,22,2,2,2,1,2,1,52,26,21046,16965,60,38,21388,15949
217,22,2,1,0,3,1,0,34,39,21048,16966,38,25,21391,15949
218,22,4,2,0,3,1,0,45,35,21052,16968,49,23,21394,15949
219,22,0,1,1,0,0,3,49,36,21052,16969,51,52,21394,15952
220,23,1,1,2,1,2,1,46,37,21053,16970,44,24,21395,15953
221,23,1,2,1,0,0,3,58,24,21054,16972,65,34,21395,15956
222,23,3,0,0,3,1,0,47,28,21057,16972,57,10,21398,15956
223,23,1,0,0,3,1,0,43,23,21058,16972,54,31,21401,15956
224,23,1,0,0,3,1,0,38,24,21059,16972,53,26,21404,15956
225,23,1,1,2,1,2,1,38,29,21060,16973,46,9,21405,15957
226,23,4,5,1,0,0,3,67,34,21064,16978,66,33,21405,15960
227,23,0,0,2,1,2,1,36,31,21064,16978,49,47,21406,15961
228,23,0,1,1,0,0,3,32,20,21064,16979,52,39,21406,15964
229,23,2,0,0,3,1,0,19,14,21066,16979,20,46,21409,15964
230,24,0,0,2,1,2,1,14,19,21066,16979,13,26,21410,15965
231,24,2,2,2,1,2,1,36,41,21068,16981,39,7,21411,15966
232,24,3,0,0,3,1,0,18,16,21071,16981,17,17,21414,15966
233,24,0,1,1,0,0,3,40,19,21071,16982,52,55,21414,15969
234,24,0,3,1,0,0,3,36,39,21071,16985,40,35,21414,15972
235,24,0,0,2,1,2,1,49,36,21071,16985,52,26,21415,15973
236,24,1,1,2,1,2,1,53,27,21072,16986,61,21,21416,15974
237,24,1,0,0,3,1,0,39,26,21073,16986,54,38,21419,15974
238,24,4,0,0,3,1,0,49,35,21077,16986,52,42,21422,15974
239,24,2,2,2,1,2,1,57,32,21079,16988,64,40,21423,15975
240,25,2,1,0,3,1,0,16,20,21081,16989,16,9,21426,15975
241,25,0,0,2,1,2,1,46,37,21081,16989,45,40,21427,15976
242,25,2,0,0,3,1,0,21,14,21083,16989,23,31,21430,15976
243,25,1,0,0,3,1,0,48,28,21084,16989,60,33,21433,15976
244,25,1,0,0,3,1,0,37,31,21085,16989,52,34,21436,15976
245,25,2,0,0,3,1,0,45,23,21087,16989,57,24,21439,15976
246,25,4,4,2,1,2,1,62,28,21091,16993,66,48,21440,15977
247,25,1,0,0,3,1,0,39,29,21092,16993,49,46,21443,15977
248,25,2,0,0,3,1,0,34,20,21094,16993,55,26,21446,15977
249,25,1,1,2,1,2,1,39,25,21095,16994,54,56,21447,15978
250,26,1,1,2,1,2,1,19,17,21096,16995,18,41,21448,15979
251,26,2,2,2,1,2,1,69,36,21098,16997,67,27,21449,15980
252,26,0,1,1,0,0,3,53,28,21098,16998,61,38,21449,15983
253,26,2,0,0,3,1,0,38,39,21100,16998,43,38,21452,15983
254,26,0,2,1,0,0,3,49,37,21100,17000,52,10,21452,15986
255,26,1,1,2,1,2,1,50,37,21101,17001,53,22,21453,15987
256,26,1,2,1,0,0,3,40,28,21102,17003,54,20,21453,15990
257,26,0,0,2,1,2,1,36,41,21102,17003,40,27,21454,15991
258,26,4,1,0,3,1,0,61,33,21106,17004,67,10,21457,15991
259,26,0,2,1,0,0,3,40,21,21106,17006,52,45,21457,15994
260,27,1,0,0,3,1,0,17,20,21107,17006,19,46,21460,15994
261,27,0,2,1,0,0,3,39,31,21107,17008,49,36,21460,15997
262,27,2,3,1,0,0,3,23,17,21109,17011,23,29,21460,16000
263,27,1,1,2,1,2,1,38,32,21110,17012,53,32,21461,16001
264,27,1,1,2,1,2,1,35,21,21111,17013,56,25,21462,16002
265,27,1,2,1,0,0,3,46,25,21112,17015,57,43,21462,16005
266,27,2,1,0,3,1,0,64,29,21114,17016,69,56,21465,16005
267,27,1,2,1,0,0,3,20,19,21115,17018,18,51,21465,16008
268,27,1,1,2,1,2,1,40,26,21116,17019,55,28,21466,16009
269,27,3,0,0,3,1,0,51,28,21119,17019,63,34,21469,16009
270,28,0,2,1,0,0,3,46,39,21119,17021,45,13,21469,16012
271,28,1,1,2,1,2,1,41,29,21120,17022,55,11,21470,16013
272,28,2,2,2,1,2,1,38,43,21122,17024,41,52,21471,16014
273,28,2,1,0,3,1,0,42,22,21124,17025,55,27,21474,16014
274,28,1,2,1,0,0,3,54,30,21125,17027,61,12,21474,16017
275,28,1,0,0,3,1,0,39,39,21126,17027,46,41,21477,16017
276,28,0,1,1,0,0,3,49,38,21126,17028,52,41,21477,16020
277,28,0,1,1,0,0,3,40,27,21126,17029,55,41,21477,16023
278,28,2,0,0,3,1,0,52,37,21128,17029,56,20,21480,16023
279,28,4,0,0,3,1,0,73,36,21132,17029,70,22,21483,16023
280,29,1,1,2,1,2,1,18,21,21133,17030,20,26,21484,16024
281,29,0,1,1,0,0,3,39,32,21133,17031,49,35,21484,16027
282,29,0,3,1,0,0,3,23,20,21133,17034,23,59,21484,16030
283,29,2,1,0,3,1,0,66,30,21135,17035,72,29,21487,16030
284,29,1,0,0,3,1,0,52,28,21136,17035,66,43,21490,16030
285,29,1,1,2,1,2,1,39,33,21137,17036,54,47,21491,16031
286,29,1,0,0,3,1,0,47,25,21138,17036,60,45,21494,16031
287,29,2,0,0,3,1,0,22,19,21140,17036,21,34,21497,16031
288,29,1,0,0,3,1,0,36,21,21141,17036,59,28,21500,16031
289,29,1,1,2,1,2,1,62,34,21142,17037,68,37,21501,16032
290,30,2,0,0,3,1,0,48,39,21144,17037,48,22,21504,16032
291,30,1,1,2,1,2,1,42,30,21145,17038,56,13,21505,16033
292,30,0,1,1,0,0,3,42,23,21145,17039,55,16,21505,16036
293,30,2,3,1,0,0,3,51,41,21147,17042,52,23,21505,16039
294,30,2,1,0,3,1,0,54,38,21149,17043,59,27,21508,16039
295,30,2,1,0,3,1,0,41,40,21151,17044,49,52,21511,16039
296,30,0,0,2,1,2,1,38,43,21151,17044,42,12,21512,16040
297,30,2,1,0,3,1,0,75,37,21153,17045,73,41,21515,16040
298,30,1,1,2,1,2,1,41,28,21154,17046,56,42,21516,16041
299,30,1,3,1,0,0,3,55,33,21155,17049,61,44,21516,16044
300,31,1,1,2,1,2,1,19,22,21156,17050,21,44,21517,16045
301,31,3,1,0,3,1,0,42,33,21159,17051,52,59,21520,16045
302,31,0,2,1,0,0,3,22,21,21159,17053,21,38,21520,16048
303,31,1,3,1,0,0,3,24,23,21160,17056,23,48,21520,16051
304,31,2,1,0,3,1,0,54,29,21162,17057,69,29,21523,16051
305,31,2,0,0,3,1,0,49,25,21164,17057,63,41,21526,16051
306,31,2,1,0,3,1,0,68,31,21166,17058,75,28,21529,16051
307,31,1,0,0,3,1,0,39,43,21167,17058,45,37,21532,16051
308,31,2,0,0,3,1,0,41,33,21169,17058,57,26,21535,16051
309,31,2,1,0,3,1,0,64,35,21171,17059,71,47,21538,16051
310,32,4,1,0,3,1,0,79,38,21175,17060,76,12,21541,16051
311,32,2,1,0,3,1,0,44,24,21177,17061,58,44,21544,16051
312,32,2,2,2,1,2,1,43,42,21179,17063,50,38,21545,16052
313,32,2,1,0,3,1,0,53,42,21181,17064,55,27,21548,16052
314,32,1,0,0,3,1,0,55,38,21182,17064,62,13,21551,16052
315,32,0,3,1,0,0,3,49,28,21182,17067,63,19,21551,16055
316,32,1,1,2,1,2,1,49,40,21183,17068,49,53,21552,16056
317,32,3,1,0,3,1,0,44,29,21186,17069,59,23,21555,16056
318,32,1,1,2,1,2,1,56,34,21187,17070,62,35,21556,16057
319,32,3,0,0,3,1,0,39,21,21190,17070,62,42,21559,16057
320,33,0,1,1,0,0,3,42,34,21190,17071,52,51,21559,16060
321,33,1,4,1,0,0,3,40,47,21191,17075,45,47,21559,16063
322,33,0,2,1,0,0,3,22,23,21191,17077,21,62,21559,16066
323,33,2,1,0,3,1,0,26,24,21193,17078,26,41,21562,16066
324,33,1,0,0,3,1,0,55,29,21194,17078,72,22,21565,16066
325,33,1,0,0,3,1,0,42,33,21195,17078,60,28,21568,16066
326,33,2,1,0,3,1,0,44,31,21197,17079,59,47,21571,16066
327,33,0,0,2,1,2,1,19,22,21197,17079,22,39,21572,16067
328,33,6,1,0,3,1,0,70,36,21203,17080,74,29,21575,16067
329,33,3,2,0,3,1,0,71,33,21206,17082,78,26,21578,16067
330,34,0,1,1,0,0,3,39,22,21206,17083,62,47,21578,16070
331,34,2,1,0,3,1,0,46,25,21208,17084,61,47,21581,16070
332,34,4,0,0,3,1,0,53,40,21212,17084,52,27,21584,16070
333,34,1,1,2,1,2,1,44,43,21213,17085,51,36,21585,16071
334,34,3,1,0,3,1,0,47,30,21216,17086,62,12,21588,16071
335,34,1,0,0,3,1,0,54,42,21217,17086,58,13,21591,16071
336,34,0,3,1,0,0,3,55,41,21217,17089,62,41,21591,16074
337,34,2,0,0,3,1,0,51,28,21219,17089,66,23,21594,16074
338,34,2,1,0,3,1,0,81,39,21221,17090,79,53,21597,16074
339,34,1,3,1,0,0,3,27,27,21222,17093,26,45,21597,16077
340,35,2,2,2,1,2,1,57,31,21224,17095,73,20,21598,16078
341,35,2,1,0,3,1,0,21,23,21226,17096,25,29,21601,16078
342,35,2,0,0,3,1,0,46,31,21228,17096,62,51,21604,16078
343,35,0,0,2,1,2,1,42,34,21228,17096,53,42,21605,16079
344,35,1,0,0,3,1,0,41,47,21229,17096,48,26,21608,16079
345,35,4,1,0,3,1,0,75,34,21233,17097,81,22,21611,16079
346,35,1,0,0,3,1,0,57,34,21234,17097,65,39,21614,16079
347,35,0,1,1,0,0,3,42,34,21234,17098,60,65,21614,16082
348,35,2,0,0,3,1,0,72,36,21236,17098,77,47,21617,16082
349,35,0,2,1,0,0,3,22,25,21236,17100,21,31,21617,16085
350,36,2,1,0,3,1,0,29,28,21238,17101,29,12,21620,16085
351,36,1,1,2,1,2,1,76,35,21239,17102,82,28,21621,16086
352,36,3,4,1,0,0,3,54,32,21242,17106,66,56,21621,16089
353,36,2,4,1,0,0,3,55,44,21244,17110,52,44,21621,16092
354,36,3,0,0,3,1,0,84,39,21247,17110,82,36,21624,16092
355,36,0,0,2,1,2,1,46,25,21247,17110,62,14,21625,16093
356,36,0,0,2,1,2,1,54,42,21247,17110,59,48,21626,16094
357,36,1,0,0,3,1,0,56,41,21248,17110,65,39,21629,16094
358,36,0,0,2,1,2,1,39,22,21248,17110,63,24,21630,16095
359,36,0,2,1,0,0,3,47,32,21248,17112,62,50,21630,16098
360,37,1,1,2,1,2,1,22,24,21249,17113,26,46,21631,16099
361,37,1,0,0,3,1,0,47,31,21250,17113,65,26,21634,16099
362,37,1,0,0,3,1,0,43,34,21251,17113,56,22,21637,16099
363,37,1,3,1,0,0,3,42,50,21252,17116,48,32,21637,16102
364,37,1,1,2,1,2,1,23,26,21253,17117,22,43,21638,16103
365,37,3,0,0,3,1,0,60,34,21256,17117,68,31,21641,16103
366,37,1,0,0,3,1,0,58,31,21257,17117,76,65,21644,16103
367,37,3,2,0,3,1,0,47,45,21260,17119,54,47,21647,16103
368,37,1,1,2,1,2,1,43,35,21261,17120,61,21,21648,16104
369,37,3,0,0,3,1,0,75,36,21264,17120,80,51,21651,16104
370,38,1,2,1,0,0,3,56,46,21265,17122,52,53,21651,16107
371,38,0,1,1,0,0,3,29,29,21265,17123,29,31,21651,16110
372,38,4,1,0,3,1,0,88,40,21269,17124,85,39,21654,16110
373,38,1,2,1,0,0,3,47,27,21270,17126,62,59,21654,16113
374,38,3,4,1,0,0,3,79,39,21273,17130,82,27,21654,16116
375,38,5,0,0,3,1,0,52,32,21278,17130,65,14,21657,16116
376,38,2,3,1,0,0,3,56,45,21280,17133,59,47,21657,16119
377,38,1,0,0,3,1,0,57,41,21281,17133,68,48,21660,16119
378,38,0,2,1,0,0,3,39,24,21281,17135,63,15,21660,16122
379,38,3,1,0,3,1,0,57,33,21284,17136,69,36,21663,16122
0,1,1,1,2,1,2,1,59,32,21285,17137,77,44,21664,16123
1,1,1,0,0,3,1,0,48,45,21286,17137,57,31,21667,16123
2,1,1,2,1,0,0,3,57,47,21287,17139,59,68,21667,16126
3,1,0,1,1,0,0,3,0,1,21287,17140,0,25,21667,16129
4,1,2,3,1,0,0,3,31,32,21289,17143,29,50,21667,16132
5,1,2,3,1,0,0,3,59,44,21291,17146,68,3,21667,16135
6,1,0,1,1,0,0,3,43,36,21291,17147,61,18,21667,16138
7,1,2,2,2,1,2,1,77,38,21293,17149,81,27,21668,16139
8,1,0,1,1,0,0,3,52,33,21293,17150,65,49,21668,16142
9,1,0,1,1,0,0,3,0,1,21293,17151,0,51,21668,16145
10,2,1,1,2,1,2,1,89,41,21294,17152,86,40,21669,16146
11,2,4,1,0,3,1,0,83,40,21298,17153,85,0,21672,16146
12,2,2,1,0,3,1,0,49,28,21300,17154,65,53,21675,16146
13,2,2,1,0,3,1,0,2,1,21302,17155,3,0,21678,16146
14,2,1,0,0,3,1,0,44,34,21303,17155,59,21,21681,16146
15,2,2,1,0,3,1,0,41,25,21305,17156,66,47,21684,16146
16,2,0,0,2,1,2,1,57,33,21305,17156,70,28,21685,16147
17,2,1,0,0,3,1,0,48,31,21306,17156,68,51,21688,16147
18,2,2,0,0,3,1,0,62,34,21308,17156,71,32,21691,16147
19,2,0,0,2,1,2,1,22,24,21308,17156,27,60,21692,16148
20,3,1,1,2,1,2,1,32,33,21309,17157,30,50,21693,16149
21,3,2,2,2,1,2,1,45,38,21311,17159,62,69,21694,16150
22,3,0,1,1,0,0,3,48,46,21311,17160,57,47,21694,16153
23,3,2,2,2,1,2,1,2,3,21313,17162,1,28,21695,16154
24,3,1,0,0,3,1,0,1,1,21314,17162,3,32,21698,16154
25,3,3,2,0,3,1,0,55,35,21317,17164,68,3,21701,16154
26,3,3,0,0,3,1,0,60,33,21320,17164,73,18,21704,16154
27,3,4,0,0,3,1,0,61,47,21324,17164,62,31,21707,16154
28,3,0,1,1,0,0,3,59,33,21324,17165,77,54,21707,16157
29,3,0,0,2,1,2,1,77,38,21324,17165,82,51,21708,16158
30,4,3,2,0,3,1,0,86,42,21327,17167,88,25,21711,16158
31,4,2,0,0,3,1,0,24,24,21329,17167,30,21,21714,16158
32,4,3,0,0,3,1,0,52,28,21332,17167,68,40,21717,16158
33,4,1,3,1,0,0,3,60,47,21333,17170,68,56,21717,16161
34,4,0,3,1,0,0,3,2,4,21333,17173,3,50,21717,16164
35,4,2,1,0,3,1,0,46,35,21335,17174,62,0,21720,16164
36,4,1,1,2,1,2,1,42,26,21336,17175,67,1,21721,16165
37,4,1,1,2,1,2,1,49,32,21337,17176,69,29,21722,16166
38,4,3,1,0,3,1,0,65,35,21340,17177,74,51,21725,16166
39,4,1,2,1,0,0,3,90,43,21341,17179,86,63,21725,16169
40,5,2,0,0,3,1,0,79,38,21343,17179,85,47,21728,16169
41,5,3,1,0,3,1,0,4,2,21346,17180,6,56,21731,16169
42,5,1,1,2,1,2,1,3,4,21347,17181,2,70,21732,16170
43,5,0,1,1,0,0,3,61,48,21347,17182,62,35,21732,16173
44,5,3,0,0,3,1,0,35,33,21350,17182,33,3,21735,16173
45,5,4,2,0,3,1,0,49,40,21354,17184,65,31,21738,16173
46,5,0,0,2,1,2,1,60,33,21354,17184,74,52,21739,16174
47,5,1,2,1,0,0,3,56,37,21355,17186,68,31,21739,16177
48,5,2,0,0,3,1,0,88,42,21357,17186,91,18,21742,16177
49,5,0,1,1,0,0,3,48,47,21357,17187,57,57,21742,16180
50,6,1,1,2,1,2,1,60,34,21358,17188,78,51,21743,16181
51,6,0,4,1,0,0,3,2,8,21358,17192,3,66,21743,16184
52,6,1,1,2,1,2,1,53,29,21359,17193,69,30,21744,16185
53,6,3,1,0,3,1,0,63,48,21362,17194,71,0,21747,16185
54,6,2,1,0,3,1,0,48,36,21364,17195,65,25,21750,16185
55,6,2,0,0,3,1,0,6,2,21366,17195,9,40,21753,16185
56,6,2,2,2,1,2,1,44,28,21368,17197,68,52,21754,16186
57,6,2,2,2,1,2,1,51,34,21370,17199,70,19,21755,16187
58,6,1,0,0,3,1,0,66,35,21371,17199,77,21,21758,16187
59,6,1,1,2,1,2,1,91,44,21372,17200,87,51,21759,16188
60,7,2,0,0,3,1,0,58,37,21374,17200,71,70,21762,16188
61,7,2,0,0,3,1,0,81,38,21376,17200,88,35,21765,16188
62,7,1,0,0,3,1,0,25,24,21377,17200,33,31,21768,16188
63,7,0,2,1,0,0,3,48,49,21377,17202,57,59,21768,16191
64,7,0,2,1,0,0,3,3,6,21377,17204,2,50,21768,16194
65,7,1,1,2,1,2,1,36,34,21378,17205,34,32,21769,16195
66,7,2,2,2,1,2,1,51,42,21380,17207,66,4,21770,16196
67,7,4,1,0,3,1,0,64,34,21384,17208,77,57,21773,16196
68,7,0,0,2,1,2,1,61,48,21384,17208,63,2,21774,16197
69,7,0,2,1,0,0,3,88,44,21384,17210,91,55,21774,16200
70,8,4,0,0,3,1,0,65,48,21388,17210,66,40,21777,16200
71,8,2,3,1,0,0,3,62,37,21390,17213,78,24,21777,16203
72,8,0,1,1,0,0,3,63,49,21390,17214,71,55,21777,16206
73,8,2,0,0,3,1,0,93,44,21392,17214,90,19,21780,16206
74,8,3,2,0,3,1,0,5,10,21395,17216,6,0,21783,16206
75,8,3,1,0,3,1,0,9,3,21398,17217,12,30,21786,16206
76,8,2,2,2,1,2,1,46,30,21400,17219,69,26,21787,16207
77,8,1,1,2,1,2,1,49,37,21401,17220,66,56,21788,16208
78,8,1,1,2,1,2,1,54,30,21402,17221,70,52,21789,16209
79,8,2,2,2,1,2,1,68,37,21404,17223,78,67,21790,16210
80,9,1,1,2,1,2,1,52,35,21405,17224,71,71,21791,16211
81,9,1,0,0,3,1,0,82,38,21406,17224,91,2,21794,16211
82,9,1,1,2,1,2,1,49,50,21407,17225,58,36,21795,16212
83,9,0,4,1,0,0,3,36,38,21407,17229,34,53,21795,16215
84,9,1,1,2,1,2,1,52,43,21408,17230,67,52,21796,16216
85,9,2,1,0,3,1,0,60,38,21410,17231,74,59,21799,16216
86,9,6,1,0,3,1,0,70,35,21416,17232,80,32,21802,16216
87,9,0,0,2,1,2,1,25,24,21416,17232,34,5,21803,16217
88,9,1,0,0,3,1,0,89,44,21417,17232,94,31,21806,16217
89,9,1,0,0,3,1,0,4,6,21418,17232,5,57,21809,16217
90,10,2,0,0,3,1,0,67,48,21420,17232,69,55,21812,16217
91,10,2,1,0,3,1,0,95,45,21422,17233,93,26,21815,16217
92,10,0,1,1,0,0,3,49,51,21422,17234,58,70,21815,16220
93,10,3,1,0,3,1,0,65,38,21425,17235,81,30,21818,16220
94,10,1,1,2,1,2,1,10,4,21426,17236,13,1,21819,16221
95,10,3,1,0,3,1,0,49,31,21429,17237,72,31,21822,16221
96,10,4,4,2,1,2,1,58,34,21433,17241,71,20,21823,16222
97,10,3,1,0,3,1,0,8,11,21436,17242,9,56,21826,16222
98,10,2,1,0,3,1,0,65,50,21438,17243,74,24,21829,16222
99,10,1,4,1,0,0,3,69,41,21439,17247,78,55,21829,16225
100,11,2,0,0,3,1,0,51,37,21441,17247,69,32,21832,16225
101,11,1,2,1,0,0,3,83,40,21442,17249,91,55,21832,16228
102,11,1,1,2,1,2,1,5,7,21443,17250,6,60,21833,16229
103,11,0,2,1,0,0,3,36,40,21443,17252,34,74,21833,16232
104,11,2,1,0,3,1,0,54,44,21445,17253,70,40,21836,16232
105,11,1,0,0,3,1,0,61,38,21446,17253,77,2,21839,16232
106,11,3,1,0,3,1,0,73,36,21449,17254,83,36,21842,16232
107,11,0,2,1,0,0,3,25,26,21449,17256,34,60,21842,16235
108,11,5,2,0,3,1,0,94,46,21454,17258,97,5,21845,16235
109,11,1,0,0,3,1,0,53,35,21455,17258,74,53,21848,16235
110,12,1,3,1,0,0,3,50,54,21456,17261,58,58,21848,16238
111,12,1,0,0,3,1,0,96,45,21457,17261,96,31,21851,16238
112,12,2,0,0,3,1,0,69,48,21459,17261,72,1,21854,16238
113,12,2,3,1,0,0,3,10,14,21461,17264,9,29,21854,16241
114,12,1,2,1,0,0,3,11,6,21462,17266,13,27,21854,16244
115,12,2,4,1,0,0,3,51,35,21464,17270,72,23,21854,16247
116,12,2,2,2,1,2,1,71,43,21466,17272,79,31,21855,16248
117,12,0,4,1,0,0,3,58,38,21466,17276,71,59,21855,16251
118,12,1,1,2,1,2,1,66,51,21467,17277,75,56,21856,16252
119,12,1,1,2,1,2,1,66,39,21468,17278,82,71,21857,16253
120,13,2,0,0,3,1,0,60,38,21470,17278,74,74,21860,16253
121,13,1,2,1,0,0,3,84,42,21471,17280,91,61,21860,16256
122,13,0,1,1,0,0,3,25,27,21471,17281,34,39,21860,16259
123,13,3,3,2,1,2,1,8,10,21474,17284,7,41,21861,16260
124,13,2,2,2,1,2,1,38,42,21476,17286,35,56,21862,16261
125,13,3,0,0,3,1,0,54,37,21479,17286,72,5,21865,16261
126,13,1,1,2,1,2,1,74,37,21480,17287,84,61,21866,16262
127,13,3,0,0,3,1,0,97,46,21483,17287,100,2,21869,16262
128,13,1,0,0,3,1,0,55,44,21484,17287,73,53,21872,16262
129,13,1,0,0,3,1,0,54,35,21485,17287,77,60,21875,16262
130,14,1,0,0,3,1,0,70,48,21486,17287,75,29,21878,16262
131,14,4,0,0,3,1,0,88,42,21490,17287,94,1,21881,16262
132,14,1,1,2,1,2,1,51,55,21491,17288,59,24,21882,16263
133,14,0,1,1,0,0,3,66,52,21491,17289,75,34,21882,16266
134,14,2,1,0,3,1,0,12,15,21493,17290,12,32,21885,16266
135,14,0,0,2,1,2,1,11,6,21493,17290,14,32,21886,16267
136,14,0,1,1,0,0,3,61,39,21493,17291,77,30,21886,16270
137,14,1,0,0,3,1,0,67,39,21494,17291,85,59,21889,16270
138,14,3,0,0,3,1,0,54,35,21497,17291,75,56,21892,16270
139,14,1,0,0,3,1,0,72,43,21498,17291,82,74,21895,16270
140,15,0,0,2,1,2,1,25,27,21498,17291,35,57,21896,16271
141,15,1,0,0,3,1,0,98,46,21499,17291,103,61,21899,16271
142,15,1,1,2,1,2,1,39,43,21500,17292,36,42,21900,16272
143,15,2,2,2,1,2,1,56,37,21502,17294,78,40,21901,16273
144,15,0,0,2,1,2,1,96,45,21502,17294,97,6,21902,16274
145,15,2,1,0,3,1,0,57,45,21504,17295,76,71,21905,16274
146,15,1,0,0,3,1,0,75,37,21505,17295,87,2,21908,16274
147,15,1,2,1,0,0,3,55,39,21506,17297,72,63,21908,16277
148,15,2,3,1,0,0,3,10,13,21508,17300,7,64,21908,16280
149,15,1,0,0,3,1,0,61,38,21509,17300,77,53,21911,16280
150,16,0,0,2,1,2,1,54,35,21509,17300,76,7,21912,16281
151,16,4,0,0,3,1,0,92,42,21513,17300,97,30,21915,16281
152,16,1,1,2,1,2,1,52,56,21514,17301,60,30,21916,16282
153,16,1,1,2,1,2,1,11,14,21515,17302,8,35,21917,16283
154,16,1,1,2,1,2,1,67,53,21516,17303,76,75,21918,16284
155,16,3,0,0,3,1,0,70,39,21519,17303,88,24,21921,16284
156,16,2,2,2,1,2,1,63,41,21521,17305,78,33,21922,16285
157,16,0,0,2,1,2,1,11,6,21521,17305,15,60,21923,16286
158,16,0,3,1,0,0,3,72,46,21521,17308,82,35,21923,16289
159,16,0,1,1,0,0,3,70,49,21521,17309,75,59,21923,16292
160,17,1,0,0,3,1,0,58,45,21522,17309,79,64,21926,16292
161,17,0,4,1,0,0,3,75,41,21522,17313,87,74,21926,16295
162,17,2,0,0,3,1,0,98,45,21524,17313,100,53,21929,16295
163,17,2,0,0,3,1,0,27,27,21526,17313,38,2,21932,16295
164,17,2,0,0,3,1,0,41,43,21528,17313,39,1,21935,16295
165,17,2,0,0,3,1,0,63,38,21530,17313,80,40,21938,16295
166,17,1,1,2,1,2,1,99,47,21531,17314,104,43,21939,16296
167,17,1,2,1,0,0,3,56,41,21532,17316,72,64,21939,16299
168,17,1,2,1,0,0,3,13,17,21533,17318,12,66,21939,16302
169,17,0,0,2,1,2,1,56,37,21533,17318,79,58,21940,16303
170,18,2,0,0,3,1,0,65,41,21535,17318,81,30,21943,16303
171,18,0,1,1,0,0,3,54,36,21535,17319,76,69,21943,16306
172,18,3,2,0,3,1,0,14,16,21538,17321,11,24,21946,16306
173,18,1,2,1,0,0,3,68,55,21539,17323,76,36,21946,16309
174,18,4,0,0,3,1,0,74,39,21543,17323,91,7,21949,16309
175,18,3,2,0,3,1,0,61,47,21546,17325,82,30,21952,16309
176,18,1,1,2,1,2,1,12,7,21547,17326,16,76,21953,16310
177,18,1,1,2,1,2,1,53,57,21548,17327,61,61,21954,16311
178,18,0,2,1,0,0,3,70,51,21548,17329,75,38,21954,16314
179,18,1,0,0,3,1,0,93,42,21549,17329,100,59,21957,16314
180,19,0,3,1,0,0,3,56,44,21549,17332,72,77,21957,16317
181,19,4,1,0,3,1,0,102,46,21553,17333,103,64,21960,16317
182,19,2,4,1,0,0,3,29,31,21555,17337,38,67,21960,16320
183,19,2,2,2,1,2,1,65,40,21557,17339,81,3,21961,16321
184,19,0,0,2,1,2,1,56,37,21557,17339,80,2,21962,16322
185,19,3,0,0,3,1,0,102,47,21560,17339,107,35,21965,16322
186,19,4,2,0,3,1,0,17,19,21564,17341,15,43,21968,16322
187,19,2,1,0,3,1,0,77,42,21566,17342,90,30,21971,16322
188,19,2,0,0,3,1,0,56,36,21568,17342,79,40,21974,16322
189,19,1,0,0,3,1,0,73,46,21569,17342,85,58,21977,16322
190,20,2,2,2,1,2,1,72,53,21571,17344,76,54,21978,16323
191,20,0,0,2,1,2,1,93,42,21571,17344,101,25,21979,16324
192,20,1,2,1,0,0,3,15,18,21572,17346,11,62,21979,16327
193,20,2,0,0,3,1,0,76,39,21574,17346,94,38,21982,16327
194,20,0,2,1,0,0,3,65,43,21574,17348,81,64,21982,16330
195,20,2,2,2,1,2,1,55,59,21576,17350,62,77,21983,16331
196,20,0,2,1,0,0,3,41,45,21576,17352,39,39,21983,16334
197,20,1,2,1,0,0,3,13,9,21577,17354,16,10,21983,16337
198,20,5,0,0,3,1,0,66,47,21582,17354,85,30,21986,16337
199,20,3,1,0,3,1,0,71,56,21585,17355,79,69,21989,16337
200,21,0,0,2,1,2,1,102,47,21585,17355,108,31,21990,16338
201,21,1,0,0,3,1,0,72,56,21586,17355,82,3,21993,16338
202,21,3,2,0,3,1,0,76,48,21589,17357,88,64,21996,16338
203,21,2,1,0,3,1,0,58,37,21591,17358,82,43,21999,16338
204,21,0,1,1,0,0,3,56,45,21591,17359,72,61,21999,16341
205,21,3,2,0,3,1,0,68,42,21594,17361,84,2,22002,16341
206,21,1,1,2,1,2,1,30,32,21595,17362,39,31,22003,16342
207,21,0,2,1,0,0,3,17,21,21595,17364,15,70,22003,16345
208,21,0,2,1,0,0,3,102,48,21595,17366,103,38,22003,16348
209,21,0,1,1,0,0,3,56,38,21595,17367,80,80,22003,16351
210,22,0,2,1,0,0,3,77,44,21595,17369,90,65,22003,16354
211,22,2,2,2,1,2,1,67,45,21597,17371,82,70,22004,16355
212,22,1,1,2,1,2,1,42,46,21598,17372,40,26,22005,16356
213,22,2,1,0,3,1,0,57,60,21600,17373,65,38,22008,16356
214,22,2,0,0,3,1,0,78,39,21602,17373,97,40,22011,16356
215,22,2,1,0,3,1,0,17,19,21604,17374,14,39,22014,16356
216,22,1,1,2,1,2,1,14,10,21605,17375,17,55,22015,16357
217,22,3,0,0,3,1,0,75,53,21608,17375,79,10,22018,16357
218,22,0,1,1,0,0,3,66,48,21608,17376,85,67,22018,16360
219,22,1,0,0,3,1,0,94,42,21609,17376,104,77,22021,16360
220,23,0,4,1,0,0,3,58,41,21609,17380,82,83,22021,16363
221,23,2,2,2,1,2,1,70,44,21611,17382,85,71,22022,16364
222,23,1,2,1,0,0,3,73,58,21612,17384,82,64,22022,16367
223,23,1,1,2,1,2,1,103,49,21613,17385,104,3,22023,16368
224,23,0,0,2,1,2,1,17,21,21613,17385,16,32,22024,16369
225,23,0,2,1,0,0,3,56,47,21613,17387,72,41,22024,16372
226,23,2,0,0,3,1,0,58,38,21615,17387,83,31,22027,16372
227,23,3,1,0,3,1,0,33,33,21618,17388,42,65,22030,16372
228,23,3,1,0,3,1,0,81,40,21621,17389,100,3,22033,16372
229,23,0,1,1,0,0,3,76,49,21621,17390,88,46,22033,16375
230,24,3,1,0,3,1,0,97,43,21624,17391,107,10,22036,16375
231,24,4,1,0,3,1,0,79,54,21628,17392,82,64,22039,16375
232,24,1,1,2,1,2,1,67,49,21629,17393,86,39,22040,16376
233,24,0,0,2,1,2,1,17,19,21629,17393,15,41,22041,16377
234,24,1,0,0,3,1,0,34,33,21630,17393,45,67,22044,16377
235,24,2,1,0,3,1,0,79,45,21632,17394,93,39,22047,16377
236,24,1,2,1,0,0,3,58,62,21633,17396,65,6,22047,16380
237,24,1,1,2,1,2,1,43,47,21634,17397,41,71,22048,16381
238,24,2,0,0,3,1,0,69,45,21636,17397,85,55,22051,16381
239,24,1,3,1,0,0,3,103,50,21637,17400,108,80,22051,16384
240,25,2,0,0,3,1,0,105,49,21639,17400,107,71,22054,16384
241,25,1,0,0,3,1,0,77,49,21640,17400,91,31,22057,16384
242,25,1,1,2,1,2,1,57,48,21641,17401,73,27,22058,16385
243,25,1,0,0,3,1,0,82,40,21642,17401,103,46,22061,16385
244,25,2,2,2,1,2,1,60,43,21644,17403,83,4,22062,16386
245,25,2,1,0,3,1,0,72,45,21646,17404,88,32,22065,16386
246,25,0,1,1,0,0,3,17,22,21646,17405,16,44,22065,16389
247,25,0,4,1,0,0,3,58,42,21646,17409,83,68,22065,16392
248,25,1,1,2,1,2,1,15,11,21647,17410,18,65,22066,16393
249,25,3,2,0,3,1,0,76,60,21650,17412,85,83,22069,16393
250,26,2,0,0,3,1,0,69,49,21652,17412,89,6,22072,16393
251,26,2,2,2,1,2,1,71,47,21654,17414,86,42,22073,16394
252,26,0,3,1,0,0,3,58,65,21654,17417,65,68,22073,16397
253,26,1,3,1,0,0,3,35,36,21655,17420,45,83,22073,16400
254,26,0,1,1,0,0,3,43,48,21655,17421,41,67,22073,16403
255,26,0,0,2,1,2,1,17,19,21655,17421,16,11,22074,16404
256,26,0,0,2,1,2,1,79,45,21655,17421,94,56,22075,16405
257,26,3,1,0,3,1,0,106,51,21658,17422,111,39,22078,16405
258,26,0,2,1,0,0,3,58,44,21658,17424,83,42,22078,16408
259,26,2,0,0,3,1,0,99,43,21660,17424,110,71,22081,16408
260,27,2,0,0,3,1,0,84,40,21662,17424,106,71,22084,16408
261,27,1,0,0,3,1,0,16,11,21663,17424,21,83,22087,16408
262,27,1,0,0,3,1,0,18,22,21664,17424,19,27,22090,16408
263,27,1,2,1,0,0,3,77,62,21665,17426,85,49,22090,16411
264,27,0,0,2,1,2,1,60,43,21665,17426,84,33,22091,16412
265,27,4,0,0,3,1,0,83,54,21669,17426,85,44,22094,16412
266,27,1,1,2,1,2,1,73,46,21670,17427,89,32,22095,16413
267,27,1,1,2,1,2,1,58,49,21671,17428,74,69,22096,16414
268,27,2,1,0,3,1,0,79,50,21673,17429,94,4,22099,16414
269,27,2,1,0,3,1,0,107,50,21675,17430,110,67,22102,16414
270,28,2,2,2,1,2,1,73,49,21677,17432,87,69,22103,16415
271,28,2,1,0,3,1,0,101,44,21679,17433,113,49,22106,16415
272,28,1,0,0,3,1,0,36,36,21680,17433,48,39,22109,16415
273,28,5,1,0,3,1,0,48,49,21685,17434,44,42,22112,16415
274,28,1,3,1,0,0,3,80,48,21686,17437,94,86,22112,16418
275,28,4,2,0,3,1,0,21,21,21690,17439,19,6,22115,16418
276,28,0,1,1,0,0,3,58,50,21690,17440,74,59,22115,16421
277,28,2,0,0,3,1,0,71,49,21692,17440,92,67,22118,16421
278,28,1,0,0,3,1,0,59,44,21693,17440,86,11,22121,16421
279,28,0,0,2,1,2,1,106,51,21693,17440,112,72,22122,16422
280,29,0,0,2,1,2,1,79,50,21693,17440,95,28,22123,16423
281,29,4,1,0,3,1,0,22,23,21697,17441,22,69,22126,16423
282,29,1,1,2,1,2,1,85,41,21698,17442,107,5,22127,16424
283,29,1,2,1,0,0,3,108,52,21699,17444,110,36,22127,16427
284,29,4,0,0,3,1,0,77,46,21703,17444,92,42,22130,16427
285,29,1,0,0,3,1,0,17,11,21704,17444,24,71,22133,16427
286,29,1,1,2,1,2,1,78,63,21705,17445,86,33,22134,16428
287,29,1,0,0,3,1,0,59,65,21706,17445,68,44,22137,16428
288,29,0,0,2,1,2,1,60,43,21706,17445,85,68,22138,16429
289,29,2,2,2,1,2,1,85,56,21708,17447,86,84,22139,16430
290,30,1,0,0,3,1,0,102,44,21709,17447,116,67,22142,16430
291,30,2,2,2,1,2,1,23,23,21711,17449,20,70,22143,16431
292,30,0,2,1,0,0,3,73,51,21711,17451,87,52,22143,16434
293,30,1,1,2,1,2,1,60,45,21712,17452,87,40,22144,16435
294,30,3,4,1,0,0,3,83,52,21715,17456,94,14,22144,16438
295,30,2,2,2,1,2,1,50,51,21717,17458,45,7,22145,16439
296,30,2,3,1,0,0,3,38,39,21719,17461,48,62,22145,16442
297,30,0,1,1,0,0,3,71,50,21719,17462,92,75,22145,16445
298,30,1,2,1,0,0,3,59,52,21720,17464,74,89,22145,16448
299,30,1,2,1,0,0,3,107,53,21721,17466,112,45,22145,16451
300,31,1,0,0,3,1,0,80,50,21722,17466,98,68,22148,16451
301,31,0,2,1,0,0,3,73,53,21722,17468,87,87,22148,16454
302,31,0,0,2,1,2,1,78,63,21722,17468,87,29,22149,16455
303,31,1,0,0,3,1,0,60,65,21723,17468,71,5,22152,16455
304,31,3,4,1,0,0,3,63,47,21726,17472,85,47,22152,16458
305,31,4,0,0,3,1,0,26,23,21730,17472,25,42,22155,16458
306,31,3,1,0,3,1,0,88,42,21733,17473,110,33,22158,16458
307,31,1,0,0,3,1,0,86,56,21734,17473,89,36,22161,16458
308,31,1,0,0,3,1,0,18,11,21735,17473,27,69,22164,16458
309,31,5,0,0,3,1,0,113,52,21740,17473,113,40,22167,16458
310,32,0,0,2,1,2,1,83,52,21740,17473,95,71,22168,16459
311,32,0,1,1,0,0,3,23,24,21740,17474,20,90,22168,16462
312,32,1,1,2,1,2,1,39,40,21741,17475,49,53,22169,16463
313,32,4,2,0,3,1,0,64,47,21745,17477,90,67,22172,16463
314,32,4,1,0,3,1,0,81,47,21749,17478,95,14,22175,16463
315,32,0,2,1,0,0,3,59,54,21749,17480,74,10,22175,16466
316,32,4,2,0,3,1,0,54,53,21753,17482,48,71,22178,16466
317,32,3,0,0,3,1,0,74,50,21756,17482,95,45,22181,16466
318,32,3,1,0,3,1,0,110,54,21759,17483,115,62,22184,16466
319,32,0,0,2,1,2,1,113,52,21759,17483,114,76,22185,16467
320,33,1,2,1,0,0,3,89,44,21760,17485,110,72,22185,16470
321,33,1,0,0,3,1,0,81,50,21761,17485,101,42,22188,16470
322,33,1,2,1,0,0,3,27,25,21762,17487,25,92,22188,16473
323,33,3,1,0,3,1,0,63,66,21765,17488,74,36,22191,16473
324,33,0,1,1,0,0,3,63,48,21765,17489,85,43,22191,16476
325,33,2,2,2,1,2,1,80,65,21767,17491,88,69,22192,16477
326,33,0,1,1,0,0,3,18,12,21767,17492,27,36,22192,16480
327,33,3,0,0,3,1,0,105,44,21770,17492,119,47,22195,16480
328,33,4,2,0,3,1,0,90,58,21774,17494,92,29,22198,16480
329,33,1,2,1,0,0,3,74,55,21775,17496,87,8,22198,16483
330,34,3,3,2,1,2,1,116,55,21778,17499,115,46,22199,16484
331,34,0,1,1,0,0,3,81,48,21778,17500,95,79,22199,16487
332,34,0,0,2,1,2,1,83,52,21778,17500,96,54,22200,16488
333,34,2,1,0,3,1,0,41,41,21780,17501,52,67,22203,16488
334,34,0,0,2,1,2,1,64,47,21780,17501,91,11,22204,16489
335,34,0,2,1,0,0,3,59,56,21780,17503,74,74,22204,16492
336,34,0,0,2,1,2,1,27,25,21780,17503,26,63,22205,16493
337,34,1,1,2,1,2,1,111,55,21781,17504,116,72,22206,16494
338,34,3,1,0,3,1,0,77,51,21784,17505,98,8,22209,16494
339,34,0,1,1,0,0,3,54,54,21784,17506,48,93,22209,16497
340,35,0,0,2,1,2,1,90,58,21784,17506,93,70,22210,16498
341,35,2,1,0,3,1,0,83,51,21786,17507,104,14,22213,16498
342,35,1,1,2,1,2,1,19,13,21787,17508,28,30,22214,16499
343,35,1,0,0,3,1,0,24,24,21788,17508,23,36,22217,16499
344,35,1,0,0,3,1,0,81,65,21789,17508,91,43,22220,16499
345,35,4,2,0,3,1,0,67,50,21793,17510,88,92,22223,16499
346,35,2,1,0,3,1,0,91,45,21795,17511,113,42,22226,16499
347,35,0,3,1,0,0,3,74,58,21795,17514,87,50,22226,16502
348,35,0,3,1,0,0,3,63,69,21795,17517,74,75,22226,16505
349,35,1,1,2,1,2,1,106,45,21796,17518,120,37,22227,16506
350,36,3,0,0,3,1,0,119,55,21799,17518,118,11,22230,16506
351,36,2,1,0,3,1,0,85,52,21801,17519,107,63,22233,16506
352,36,3,2,0,3,1,0,67,49,21804,17521,94,54,22236,16506
353,36,0,1,1,0,0,3,41,42,21804,17522,52,11,22236,16509
354,36,0,2,1,0,0,3,59,58,21804,17524,74,49,22236,16512
355,36,3,1,0,3,1,0,30,26,21807,17525,29,67,22239,16512
356,36,4,1,0,3,1,0,87,53,21811,17526,99,74,22242,16512
357,36,3,1,0,3,1,0,84,49,21814,17527,98,72,22245,16512
358,36,4,0,0,3,1,0,58,54,21818,17527,51,50,22248,16512
359,36,0,1,1,0,0,3,111,56,21818,17528,116,96,22248,16515
360,37,1,1,2,1,2,1,75,59,21819,17529,88,31,22249,16516
361,37,1,0,0,3,1,0,20,13,21820,17529,31,43,22252,16516
362,37,1,0,0,3,1,0,25,24,21821,17529,26,70,22255,16516
363,37,0,0,2,1,2,1,91,45,21821,17529,114,93,22256,16517
364,37,2,0,0,3,1,0,92,58,21823,17529,96,79,22259,16517
365,37,1,2,1,0,0,3,64,71,21824,17531,74,17,22259,16520
366,37,3,1,0,3,1,0,109,46,21827,17532,123,42,22262,16520
367,37,1,2,1,0,0,3,82,67,21828,17534,91,66,22262,16523
368,37,2,0,0,3,1,0,60,54,21830,17534,54,37,22265,16523
369,37,1,1,2,1,2,1,78,52,21831,17535,99,76,22266,16524
370,38,2,0,0,3,1,0,69,50,21833,17535,91,67,22269,16524
371,38,1,2,1,0,0,3,60,60,21834,17537,74,57,22269,16527
372,38,1,1,2,1,2,1,120,56,21835,17538,119,73,22270,16528
373,38,2,1,0,3,1,0,89,54,21837,17539,102,11,22273,16528
374,38,2,1,0,3,1,0,69,50,21839,17540,97,36,22276,16528
375,38,0,0,2,1,2,1,30,26,21839,17540,30,50,22277,16529
376,38,0,2,1,0,0,3,41,44,21839,17542,52,53,22277,16532
377,38,1,3,1,0,0,3,85,52,21840,17545,98,99,22277,16535
378,38,0,0,2,1,2,1,85,52,21840,17545,108,12,22278,16536
379,38,2,0,0,3,1,0,113,56,21842,17545,119,74,22281,16536
0,1,1,1,2,1,2,1,92,46,21843,17546,115,100,22282,16537
1,1,0,2,1,0,0,3,69,52,21843,17548,97,23,22282,16540
2,1,1,1,2,1,2,1,61,55,21844,17549,55,51,22283,16541
3,1,1,0,0,3,1,0,121,56,21845,17549,122,43,22286,16541
4,1,4,0,0,3,1,0,117,56,21849,17549,122,53,22289,16541
5,1,0,0,2,1,2,1,0,0,21849,17549,1,18,22290,16542
6,1,2,1,0,3,1,0,77,60,21851,17550,91,12,22293,16542
7,1,3,0,0,3,1,0,92,54,21854,17550,105,66,22296,16542
8,1,0,1,1,0,0,3,41,45,21854,17551,52,76,22296,16545
9,1,1,3,1,0,0,3,1,3,21855,17554,0,82,22296,16548
10,2,1,3,1,0,0,3,83,70,21856,17557,91,79,22296,16551
11,2,2,0,0,3,1,0,87,52,21858,17557,111,36,22299,16551
12,2,2,0,0,3,1,0,32,26,21860,17557,33,37,22302,16551
13,2,2,1,0,3,1,0,80,53,21862,17558,102,74,22305,16551
14,2,2,1,0,3,1,0,22,14,21864,17559,34,93,22308,16551
15,2,1,0,0,3,1,0,93,58,21865,17559,99,0,22311,16551
16,2,1,1,2,1,2,1,70,51,21866,17560,92,71,22312,16552
17,2,4,1,0,3,1,0,20,18,21870,17561,27,67,22315,16552
18,2,2,1,0,3,1,0,87,53,21872,17562,101,0,22318,16552
19,2,1,1,2,1,2,1,110,47,21873,17563,124,32,22319,16553
20,3,0,0,2,1,2,1,20,18,21873,17563,28,67,22320,16554
21,3,0,1,1,0,0,3,92,55,21873,17564,105,85,22320,16557
22,3,1,0,0,3,1,0,70,52,21874,17564,100,18,22323,16557
23,3,1,2,1,0,0,3,62,57,21875,17566,55,77,22323,16560
24,3,2,0,0,3,1,0,3,3,21877,17566,3,43,22326,16560
25,3,0,1,1,0,0,3,117,57,21877,17567,122,15,22326,16563
26,3,2,1,0,3,1,0,94,47,21879,17568,118,51,22329,16563
27,3,1,0,0,3,1,0,122,56,21880,17568,125,76,22332,16563
28,3,0,0,2,1,2,1,41,45,21880,17568,53,54,22333,16564
29,3,1,2,1,0,0,3,1,2,21881,17570,1,103,22333,16567
30,4,2,1,0,3,1,0,64,58,21883,17571,58,79,22336,16567
31,4,2,0,0,3,1,0,112,47,21885,17571,127,0,22339,16567
32,4,2,1,0,3,1,0,34,27,21887,17572,36,67,22342,16567
33,4,1,0,0,3,1,0,88,53,21888,17572,104,37,22345,16567
34,4,0,0,2,1,2,1,22,14,21888,17572,35,1,22346,16568
35,4,0,0,2,1,2,1,77,60,21888,17572,92,94,22347,16569
36,4,0,0,2,1,2,1,83,70,21888,17572,92,33,22348,16570
37,4,2,1,0,3,1,0,95,59,21890,17573,102,71,22351,16570
38,4,2,2,2,1,2,1,82,55,21892,17575,103,68,22352,16571
39,4,1,2,1,0,0,3,88,54,21893,17577,111,26,22352,16574
40,5,0,2,1,0,0,3,70,54,21893,17579,100,106,22352,16577
41,5,1,1,2,1,2,1,71,52,21894,17580,93,86,22353,16578
42,5,2,3,1,0,0,3,43,48,21896,17583,53,39,22353,16581
43,5,1,1,2,1,2,1,4,4,21897,17584,4,19,22354,16582
44,5,0,0,2,1,2,1,94,47,21897,17584,119,16,22355,16583
45,5,1,0,0,3,1,0,2,2,21898,17584,4,51,22358,16583
46,5,1,3,1,0,0,3,93,58,21899,17587,105,79,22358,16586
47,5,1,0,0,3,1,0,21,18,21900,17587,31,43,22361,16586
48,5,0,2,1,0,0,3,122,58,21900,17589,125,57,22361,16589
49,5,0,0,2,1,2,1,117,57,21900,17589,123,78,22362,16590
50,6,1,2,1,0,0,3,96,61,21901,17591,102,70,22362,16593
51,6,0,0,2,1,2,1,34,27,21901,17591,37,87,22363,16594
52,6,2,2,2,1,2,1,66,60,21903,17593,59,69,22364,16595
53,6,1,1,2,1,2,1,23,15,21904,17594,36,1,22365,16596
54,6,2,0,0,3,1,0,79,60,21906,17594,95,33,22368,16596
55,6,0,2,1,0,0,3,83,72,21906,17596,92,97,22368,16599
56,6,3,3,2,1,2,1,91,56,21909,17599,105,72,22369,16600
57,6,3,1,0,3,1,0,120,58,21912,17600,126,1,22372,16600
58,6,4,0,0,3,1,0,86,55,21916,17600,106,37,22375,16600
59,6,1,1,2,1,2,1,113,48,21917,17601,128,27,22376,16601
60,7,3,0,0,3,1,0,125,58,21920,17601,128,39,22379,16601
61,7,2,1,0,3,1,0,90,55,21922,17602,114,79,22382,16601
62,7,2,1,0,3,1,0,45,49,21924,17603,56,79,22385,16601
63,7,0,0,2,1,2,1,70,54,21924,17603,101,17,22386,16602
64,7,5,1,0,3,1,0,9,5,21929,17604,7,51,22389,16602
65,7,2,0,0,3,1,0,4,2,21931,17604,7,57,22392,16602
66,7,1,0,0,3,1,0,72,52,21932,17604,96,43,22395,16602
67,7,0,1,1,0,0,3,93,59,21932,17605,105,109,22395,16605
68,7,3,0,0,3,1,0,24,18,21935,17605,34,19,22398,16605
69,7,0,0,2,1,2,1,94,47,21935,17605,120,79,22399,16606
70,8,0,2,1,0,0,3,91,58,21935,17607,105,90,22399,16609
71,8,2,0,0,3,1,0,115,48,21937,17607,131,70,22402,16609
72,8,1,1,2,1,2,1,67,61,21938,17608,60,73,22403,16610
73,8,0,0,2,1,2,1,120,58,21938,17608,127,98,22404,16611
74,8,1,0,0,3,1,0,87,55,21939,17608,109,1,22407,16611
75,8,2,2,2,1,2,1,98,63,21941,17610,103,20,22408,16612
76,8,2,0,0,3,1,0,85,72,21943,17610,95,37,22411,16612
77,8,1,3,1,0,0,3,80,63,21944,17613,95,4,22411,16615
78,8,1,1,2,1,2,1,46,50,21945,17614,57,70,22412,16616
79,8,1,1,2,1,2,1,24,16,21946,17615,37,28,22413,16617
80,9,4,1,0,3,1,0,38,28,21950,17616,40,43,22416,16617
81,9,2,1,0,3,1,0,26,19,21952,17617,37,79,22419,16617
82,9,2,0,0,3,1,0,11,5,21954,17617,10,79,22422,16617
83,9,3,0,0,3,1,0,128,58,21957,17617,131,33,22425,16617
84,9,3,0,0,3,1,0,7,2,21960,17617,10,39,22428,16617
85,9,1,0,0,3,1,0,73,52,21961,17617,99,57,22431,16617
86,9,1,1,2,1,2,1,94,60,21962,17618,106,18,22432,16618
87,9,5,1,0,3,1,0,99,48,21967,17619,123,79,22435,16618
88,9,4,1,0,3,1,0,74,55,21971,17620,104,51,22438,16618
89,9,1,2,1,0,0,3,91,57,21972,17622,114,112,22438,16621
90,10,1,2,1,0,0,3,25,18,21973,17624,37,73,22438,16624
91,10,1,0,0,3,1,0,88,55,21974,17624,112,90,22441,16624
92,10,4,0,0,3,1,0,119,48,21978,17624,134,20,22444,16624
93,10,0,1,1,0,0,3,46,51,21978,17625,57,7,22444,16627
94,10,1,2,1,0,0,3,68,63,21979,17627,60,4,22444,16630
95,10,0,1,1,0,0,3,99,49,21979,17628,123,101,22444,16633
96,10,2,2,2,1,2,1,82,65,21981,17630,96,38,22445,16634
97,10,2,2,2,1,2,1,87,74,21983,17632,96,29,22446,16635
98,10,3,2,0,3,1,0,101,65,21986,17634,106,43,22449,16635
99,10,1,1,2,1,2,1,121,59,21987,17635,128,74,22450,16636
100,11,0,1,1,0,0,3,7,3,21987,17636,10,104,22450,16639
101,11,2,3,1,0,0,3,93,60,21989,17639,114,21,22450,16642
102,11,1,0,0,3,1,0,39,28,21990,17639,43,57,22453,16642
103,11,2,1,0,3,1,0,13,6,21992,17640,13,33,22456,16642
104,11,2,1,0,3,1,0,93,59,21994,17641,108,51,22459,16642
105,11,0,5,1,0,0,3,73,57,21994,17646,99,82,22459,16645
106,11,0,1,1,0,0,3,94,61,21994,17647,106,42,22459,16648
107,11,2,0,0,3,1,0,76,55,21996,17647,107,70,22462,16648
108,11,2,1,0,3,1,0,28,20,21998,17648,40,79,22465,16648
109,11,2,2,2,1,2,1,103,67,22000,17650,107,113,22466,16649
110,12,4,0,0,3,1,0,123,48,22004,17650,137,43,22469,16649
111,12,1,1,2,1,2,1,83,66,22005,17651,97,91,22470,16650
112,12,1,3,1,0,0,3,47,54,22006,17654,57,41,22470,16653
113,12,2,1,0,3,1,0,70,64,22008,17655,63,73,22473,16653
114,12,2,0,0,3,1,0,123,59,22010,17655,131,4,22476,16653
115,12,4,2,0,3,1,0,29,20,22014,17657,40,20,22479,16653
116,12,0,0,2,1,2,1,87,74,22014,17657,97,80,22480,16654
117,12,1,2,1,0,0,3,89,57,22015,17659,112,77,22480,16657
118,12,1,1,2,1,2,1,100,50,22016,17660,124,8,22481,16658
119,12,2,0,0,3,1,0,130,58,22018,17660,134,29,22484,16658
120,13,1,1,2,1,2,1,29,21,22019,17661,41,43,22485,16659
121,13,3,1,0,3,1,0,126,49,22022,17662,140,57,22488,16659
122,13,1,0,0,3,1,0,40,28,22023,17662,46,82,22491,16659
123,13,0,0,2,1,2,1,13,6,22023,17662,14,105,22492,16660
124,13,0,0,2,1,2,1,93,59,22023,17662,109,22,22493,16661
125,13,1,1,2,1,2,1,74,58,22024,17663,100,34,22494,16662
126,13,1,1,2,1,2,1,95,62,22025,17664,107,71,22495,16663
127,13,0,3,1,0,0,3,76,58,22025,17667,107,11,22495,16666
128,13,2,1,0,3,1,0,95,61,22027,17668,117,51,22498,16666
129,13,1,2,1,0,0,3,104,69,22028,17670,107,82,22498,16669
130,14,1,3,1,0,0,3,48,57,22029,17673,57,94,22498,16672
131,14,0,3,1,0,0,3,29,23,22029,17676,40,116,22498,16675
132,14,0,4,1,0,0,3,70,68,22029,17680,63,46,22498,16678
133,14,1,1,2,1,2,1,124,60,22030,17681,132,42,22499,16679
134,14,1,1,2,1,2,1,101,51,22031,17682,125,5,22500,16680
135,14,1,1,2,1,2,1,84,67,22032,17683,98,78,22501,16681
136,14,1,1,2,1,2,1,88,75,22033,17684,98,21,22502,16682
137,14,1,0,0,3,1,0,131,58,22034,17684,137,73,22505,16682
138,14,0,1,1,0,0,3,89,58,22034,17685,112,83,22505,16685
139,14,0,1,1,0,0,3,7,4,22034,17686,10,32,22505,16688
140,15,2,0,0,3,1,0,97,61,22036,17686,120,71,22508,16688
141,15,4,0,0,3,1,0,108,69,22040,17686,110,22,22511,16688
142,15,2,0,0,3,1,0,31,21,22042,17686,44,82,22514,16688
143,15,1,0,0,3,1,0,14,6,22043,17686,17,11,22517,16688
144,15,3,0,0,3,1,0,96,59,22046,17686,112,57,22520,16688
145,15,5,1,0,3,1,0,79,59,22051,17687,103,51,22523,16688
146,15,0,1,1,0,0,3,95,63,22051,17688,107,108,22523,16691
147,15,4,0,0,3,1,0,80,58,22055,17688,110,34,22526,16691
148,15,2,0,0,3,1,0,42,28,22057,17688,49,43,22529,16691
149,15,4,0,0,3,1,0,130,49,22061,17688,143,82,22532,16691
150,16,2,1,0,3,1,0,9,5,22063,17689,13,42,22535,16691
151,16,1,0,0,3,1,0,132,58,22064,17689,140,94,22538,16691
152,16,0,3,1,0,0,3,89,61,22064,17692,112,35,22538,16694
153,16,1,1,2,1,2,1,49,58,22065,17693,58,22,22539,16695
154,16,0,1,1,0,0,3,14,7,22065,17694,17,81,22539,16698
155,16,0,2,1,0,0,3,101,53,22065,17696,125,49,22539,16701
156,16,3,1,0,3,1,0,87,68,22068,17697,101,83,22542,16701
157,16,0,2,1,0,0,3,88,77,22068,17699,98,25,22542,16704
158,16,2,0,0,3,1,0,72,68,22070,17699,66,116,22545,16704
159,16,1,1,2,1,2,1,125,61,22071,17700,133,74,22546,16705
160,17,0,1,1,0,0,3,97,62,22071,17701,120,14,22546,16708
161,17,5,0,0,3,1,0,135,49,22076,17701,146,51,22549,16708
162,17,2,0,0,3,1,0,98,59,22078,17701,115,82,22552,16708
163,17,1,0,0,3,1,0,30,23,22079,17701,43,57,22555,16708
164,17,1,1,2,1,2,1,96,64,22080,17702,108,6,22556,16709
165,17,1,0,0,3,1,0,81,58,22081,17702,113,108,22559,16709
166,17,1,3,1,0,0,3,43,31,22082,17705,49,85,22559,16712
167,17,1,1,2,1,2,1,80,60,22083,17706,104,72,22560,16713
168,17,1,0,0,3,1,0,32,21,22084,17706,47,34,22563,16713
169,17,1,0,0,3,1,0,109,69,22085,17706,113,43,22566,16713
170,18,0,1,1,0,0,3,101,54,22085,17707,125,86,22566,16716
171,18,1,3,1,0,0,3,88,71,22086,17710,101,119,22566,16719
172,18,1,2,1,0,0,3,50,60,22087,17712,58,52,22566,16722
173,18,1,1,2,1,2,1,73,69,22088,17713,67,26,22567,16723
174,18,0,2,1,0,0,3,14,9,22088,17715,17,38,22567,16726
175,18,1,2,1,0,0,3,10,7,22089,17717,13,77,22567,16729
176,18,1,0,0,3,1,0,90,61,22090,17717,115,51,22570,16729
177,18,2,1,0,3,1,0,83,59,22092,17718,116,42,22573,16729
178,18,2,1,0,3,1,0,134,59,22094,17719,143,22,22576,16729
179,18,2,2,2,1,2,1,127,63,22096,17721,134,95,22577,16730
180,19,1,2,1,0,0,3,33,23,22097,17723,47,45,22577,16733
181,19,2,0,0,3,1,0,111,69,22099,17723,116,14,22580,16733
182,19,0,0,2,1,2,1,43,31,22099,17723,50,73,22581,16734
183,19,3,1,0,3,1,0,93,62,22102,17724,118,43,22584,16734
184,19,4,1,0,3,1,0,34,24,22106,17725,46,34,22587,16734
185,19,2,1,0,3,1,0,90,78,22108,17726,101,82,22590,16734
186,19,0,0,2,1,2,1,80,60,22108,17726,105,7,22591,16735
187,19,2,2,2,1,2,1,99,64,22110,17728,121,82,22592,16736
188,19,2,2,2,1,2,1,100,61,22112,17730,116,86,22593,16737
189,19,2,2,2,1,2,1,137,51,22114,17732,147,109,22594,16738
190,20,1,1,2,1,2,1,102,55,22115,17733,126,39,22595,16739
191,20,1,2,1,0,0,3,51,62,22116,17735,58,122,22595,16742
192,20,3,2,0,3,1,0,99,66,22119,17737,111,22,22598,16742
193,20,0,0,2,1,2,1,88,71,22119,17737,102,58,22599,16743
194,20,0,0,2,1,2,1,14,9,22119,17737,18,87,22600,16744
195,20,2,0,0,3,1,0,129,63,22121,17737,137,51,22603,16744
196,20,0,1,1,0,0,3,83,60,22121,17738,116,80,22603,16747
197,20,1,0,0,3,1,0,11,7,22122,17738,16,52,22606,16747
198,20,1,2,1,0,0,3,74,71,22123,17740,67,98,22606,16750
199,20,1,2,1,0,0,3,135,61,22124,17742,143,29,22606,16753
200,21,2,0,0,3,1,0,113,69,22126,17742,119,109,22609,16753
201,21,2,0,0,3,1,0,95,62,22128,17742,121,34,22612,16753
202,21,1,0,0,3,1,0,44,31,22129,17742,53,82,22615,16753
203,21,0,0,2,1,2,1,88,71,22129,17742,103,44,22616,16754
204,21,2,0,0,3,1,0,102,61,22131,17742,119,7,22619,16754
205,21,0,2,1,0,0,3,90,80,22131,17744,101,76,22619,16757
206,21,0,2,1,0,0,3,34,26,22131,17746,46,89,22619,16760
207,21,0,2,1,0,0,3,80,62,22131,17748,105,42,22619,16763
208,21,5,0,0,3,1,0,142,51,22136,17748,150,14,22622,16763
209,21,2,1,0,3,1,0,101,65,22138,17749,124,45,22625,16763
210,22,1,1,2,1,2,1,136,62,22139,17750,144,83,22626,16764
211,22,1,1,2,1,2,1,15,10,22140,17751,19,123,22627,16765
212,22,1,1,2,1,2,1,100,67,22141,17752,112,53,22628,16766
213,22,3,1,0,3,1,0,105,56,22144,17753,129,58,22631,16766
214,22,0,0,2,1,2,1,11,7,22144,17753,17,30,22632,16767
215,22,1,1,2,1,2,1,52,63,22145,17754,59,52,22633,16768
216,22,3,0,0,3,1,0,132,63,22148,17754,140,44,22636,16768
217,22,2,0,0,3,1,0,85,60,22150,17754,119,87,22639,16768
218,22,2,0,0,3,1,0,35,23,22152,17754,50,98,22642,16768
219,22,1,3,1,0,0,3,81,65,22153,17757,105,25,22642,16771
220,23,2,0,0,3,1,0,144,51,22155,17757,153,82,22645,16771
221,23,2,2,2,1,2,1,104,63,22157,17759,120,43,22646,16772
222,23,1,1,2,1,2,1,75,72,22158,17760,68,35,22647,16773
223,23,3,2,0,3,1,0,47,33,22161,17762,56,7,22650,16773
224,23,2,4,1,0,0,3,36,30,22163,17766,46,79,22650,16776
225,23,1,0,0,3,1,0,91,80,22164,17766,104,14,22653,16776
226,23,3,0,0,3,1,0,116,69,22167,17766,122,45,22656,16776
227,23,1,0,0,3,1,0,96,62,22168,17766,124,109,22659,16776
228,23,2,0,0,3,1,0,90,71,22170,17766,106,89,22662,16776
229,23,2,2,2,1,2,1,103,67,22172,17768,125,81,22663,16777
230,24,0,0,2,1,2,1,81,65,22172,17768,106,88,22664,16778
231,24,3,0,0,3,1,0,106,67,22175,17768,128,25,22667,16778
232,24,1,1,2,1,2,1,106,57,22176,17769,130,45,22668,16779
233,24,2,1,0,3,1,0,102,68,22178,17770,115,58,22671,16779
234,24,1,2,1,0,0,3,16,12,22179,17772,19,33,22671,16782
235,24,3,1,0,3,1,0,55,64,22182,17773,62,83,22674,16782
236,24,2,0,0,3,1,0,138,62,22184,17773,147,52,22677,16782
237,24,1,2,1,0,0,3,12,9,22185,17775,17,92,22677,16785
238,24,1,1,2,1,2,1,36,24,22186,17776,51,124,22678,16786
239,24,3,2,0,3,1,0,88,62,22189,17778,122,53,22681,16786
240,25,3,0,0,3,1,0,147,51,22192,17778,156,45,22684,16786
241,25,0,2,1,0,0,3,47,35,22192,17780,56,46,22684,16789
242,25,1,0,0,3,1,0,37,30,22193,17780,49,82,22687,16789
243,25,1,0,0,3,1,0,92,80,22194,17780,107,7,22690,16789
244,25,2,2,2,1,2,1,92,73,22196,17782,107,80,22691,16790
245,25,0,0,2,1,2,1,96,62,22196,17782,125,15,22692,16791
246,25,1,3,1,0,0,3,105,66,22197,17785,120,84,22692,16794
247,25,3,1,0,3,1,0,135,64,22200,17786,143,35,22695,16794
248,25,2,2,2,1,2,1,77,74,22202,17788,69,110,22696,16795
249,25,1,1,2,1,2,1,117,70,22203,17789,123,99,22697,16796
250,26,3,2,0,3,1,0,39,26,22206,17791,54,33,22700,16796
251,26,1,0,0,3,1,0,107,67,22207,17791,131,53,22703,16796
252,26,2,0,0,3,1,0,108,57,22209,17791,133,35,22706,16796
253,26,2,1,0,3,1,0,90,63,22211,17792,125,45,22709,16796
254,26,1,0,0,3,1,0,17,12,22212,17792,22,58,22712,16796
255,26,0,2,1,0,0,3,47,37,22212,17794,56,91,22712,16799
256,26,2,2,2,1,2,1,104,70,22214,17796,116,53,22713,16800
257,26,2,4,1,0,0,3,83,69,22216,17800,106,127,22713,16803
258,26,0,3,1,0,0,3,12,12,22216,17803,17,86,22713,16806
259,26,0,0,2,1,2,1,138,62,22216,17803,148,93,22714,16807
260,27,2,0,0,3,1,0,79,74,22218,17803,72,15,22717,16807
261,27,2,0,0,3,1,0,119,70,22220,17803,126,46,22720,16807
262,27,1,1,2,1,2,1,106,67,22221,17804,121,26,22721,16808
263,27,2,0,0,3,1,0,94,80,22223,17804,110,82,22724,16808
264,27,0,2,1,0,0,3,92,75,22223,17806,107,10,22724,16811
265,27,0,2,1,0,0,3,96,64,22223,17808,125,87,22724,16814
266,27,3,1,0,3,1,0,40,31,22226,17809,52,45,22727,16814
267,27,2,3,1,0,0,3,57,67,22228,17812,62,113,22727,16817
268,27,0,0,2,1,2,1,135,64,22228,17812,144,81,22728,16818
269,27,2,0,0,3,1,0,149,51,22230,17812,159,99,22731,16818
270,28,0,1,1,0,0,3,107,68,22230,17813,131,61,22731,16821
271,28,0,3,1,0,0,3,47,40,22230,17816,56,130,22731,16824
272,28,2,2,2,1,2,1,14,14,22232,17818,18,36,22732,16825
273,28,0,1,1,0,0,3,17,13,22232,17819,22,48,22732,16828
274,28,3,2,0,3,1,0,86,71,22235,17821,109,33,22735,16828
275,28,2,1,0,3,1,0,106,71,22237,17822,119,86,22738,16828
276,28,2,1,0,3,1,0,41,27,22239,17823,57,53,22741,16828
277,28,2,0,0,3,1,0,140,62,22241,17823,151,81,22744,16828
278,28,1,0,0,3,1,0,107,67,22242,17823,124,91,22747,16828
279,28,1,2,1,0,0,3,91,65,22243,17825,125,96,22747,16831
280,29,1,1,2,1,2,1,41,32,22244,17826,53,100,22748,16832
281,29,0,0,2,1,2,1,140,62,22244,17826,152,16,22749,16833
282,29,2,0,0,3,1,0,98,64,22246,17826,128,26,22752,16833
283,29,1,2,1,0,0,3,58,69,22247,17828,62,13,22752,16836
284,29,2,0,0,3,1,0,96,80,22249,17828,113,53,22755,16836
285,29,2,3,1,0,0,3,94,78,22251,17831,107,90,22755,16839
286,29,0,1,1,0,0,3,79,75,22251,17832,72,48,22755,16842
287,29,1,1,2,1,2,1,109,58,22252,17833,134,83,22756,16843
288,29,2,3,1,0,0,3,137,67,22254,17836,144,49,22756,16846
289,29,2,0,0,3,1,0,151,51,22256,17836,162,91,22759,16846
290,30,0,1,1,0,0,3,107,68,22256,17837,124,133,22759,16849
291,30,0,1,1,0,0,3,107,69,22256,17838,131,89,22759,16852
292,30,2,3,1,0,0,3,108,74,22258,17841,119,39,22759,16855
293,30,1,1,2,1,2,1,87,72,22259,17842,110,49,22760,16856
294,30,2,1,0,3,1,0,16,15,22261,17843,21,81,22763,16856
295,30,1,1,2,1,2,1,92,66,22262,17844,126,62,22764,16857
296,30,2,0,0,3,1,0,49,40,22264,17844,59,33,22767,16857
297,30,3,1,0,3,1,0,122,71,22267,17845,129,53,22770,16857
298,30,0,1,1,0,0,3,17,14,22267,17846,22,99,22770,16860
299,30,1,1,2,1,2,1,42,28,22268,17847,58,114,22771,16861
300,31,0,1,1,0,0,3,98,65,22268,17848,128,136,22771,16864
301,31,1,1,2,1,2,1,97,81,22269,17849,114,101,22772,16865
302,31,0,0,2,1,2,1,16,15,22269,17849,22,84,22773,16866
303,31,1,1,2,1,2,1,42,33,22270,17850,54,54,22774,16867
304,31,1,0,0,3,1,0,80,75,22271,17850,75,49,22777,16867
305,31,2,2,2,1,2,1,60,71,22273,17852,63,91,22778,16868
306,31,0,0,2,1,2,1,109,58,22273,17852,135,49,22779,16869
307,31,3,0,0,3,1,0,97,78,22276,17852,110,26,22782,16869
308,31,1,0,0,3,1,0,141,62,22277,17852,155,13,22785,16869
309,31,1,2,1,0,0,3,138,69,22278,17854,144,94,22785,16872
310,32,3,1,0,3,1,0,110,70,22281,17855,134,39,22788,16872
311,32,3,0,0,3,1,0,154,51,22284,17855,165,33,22791,16872
312,32,1,1,2,1,2,1,108,69,22285,17856,125,50,22792,16873
313,32,1,2,1,0,0,3,88,74,22286,17858,110,117,22792,16876
314,32,1,2,1,0,0,3,18,16,22287,17860,22,84,22792,16879
315,32,2,2,2,1,2,1,94,68,22289,17862,127,90,22793,16880
316,32,2,2,2,1,2,1,51,42,22291,17864,60,54,22794,16881
317,32,1,1,2,1,2,1,123,72,22292,17865,130,63,22795,16882
318,32,1,2,1,0,0,3,109,76,22293,17867,119,102,22795,16885
319,32,3,1,0,3,1,0,45,29,22296,17868,61,16,22798,16885
320,33,2,3,1,0,0,3,111,61,22298,17871,135,104,22798,16888
321,33,1,0,0,3,1,0,142,62,22299,17871,158,49,22801,16888
322,33,2,1,0,3,1,0,82,76,22301,17872,78,26,22804,16888
323,33,1,1,2,1,2,1,61,72,22302,17873,64,85,22805,16889
324,33,1,2,1,0,0,3,99,67,22303,17875,128,57,22805,16892
325,33,0,1,1,0,0,3,97,79,22303,17876,110,52,22805,16895
326,33,2,0,0,3,1,0,99,81,22305,17876,117,91,22808,16895
327,33,1,0,0,3,1,0,17,15,22306,17876,25,13,22811,16895
328,33,2,2,2,1,2,1,44,35,22308,17878,55,95,22812,16896
329,33,1,0,0,3,1,0,139,69,22309,17878,147,136,22815,16896
330,34,0,0,2,1,2,1,123,72,22309,17878,131,91,22816,16897
331,34,1,0,0,3,1,0,46,29,22310,17878,64,63,22819,16897
332,34,2,1,0,3,1,0,53,43,22312,17879,63,39,22822,16897
333,34,5,1,0,3,1,0,99,69,22317,17880,130,13,22825,16897
334,34,4,4,2,1,2,1,112,73,22321,17884,126,85,22826,16898
335,34,2,6,1,0,0,3,111,82,22323,17890,119,19,22826,16901
336,34,0,1,1,0,0,3,44,36,22323,17891,55,57,22826,16904
337,34,0,0,2,1,2,1,110,70,22323,17891,135,118,22827,16905
338,34,1,0,0,3,1,0,155,51,22324,17891,168,50,22830,16905
339,34,0,0,2,1,2,1,88,74,22324,17891,111,103,22831,16906
340,35,1,1,2,1,2,1,18,16,22325,17892,26,105,22832,16907
341,35,1,4,1,0,0,3,62,76,22326,17896,64,55,22832,16910
342,35,1,1,2,1,2,1,98,80,22327,17897,111,58,22833,16911
343,35,1,0,0,3,1,0,100,67,22328,17897,131,33,22836,16911
344,35,1,2,1,0,0,3,83,78,22329,17899,78,98,22836,16914
345,35,2,1,0,3,1,0,113,62,22331,17900,138,91,22839,16914
346,35,1,0,0,3,1,0,19,16,22332,17900,25,49,22842,16914
347,35,1,1,2,1,2,1,100,82,22333,17901,118,137,22843,16915
348,35,4,1,0,3,1,0,143,70,22337,17902,150,26,22846,16915
349,35,2,1,0,3,1,0,144,63,22339,17903,161,85,22849,16915
350,36,1,1,2,1,2,1,54,44,22340,17904,64,119,22850,16916
351,36,2,0,0,3,1,0,125,72,22342,17904,134,85,22853,16916
352,36,1,0,0,3,1,0,113,73,22343,17904,129,39,22856,16916
353,36,0,1,1,0,0,3,111,83,22343,17905,119,88,22856,16919
354,36,1,0,0,3,1,0,45,36,22344,17905,58,50,22859,16919
355,36,1,1,2,1,2,1,89,75,22345,17906,112,20,22860,16920
356,36,2,0,0,3,1,0,102,82,22347,17906,121,63,22863,16920
357,36,4,2,0,3,1,0,114,72,22351,17908,138,103,22866,16920
358,36,1,1,2,1,2,1,47,30,22352,17909,65,14,22867,16921
359,36,1,2,1,0,0,3,156,53,22353,17911,168,94,22867,16924
360,37,0,2,1,0,0,3,113,64,22353,17913,138,29,22867,16927
361,37,0,1,1,0,0,3,143,71,22353,17914,150,61,22867,16930
362,37,1,1,2,1,2,1,100,70,22354,17915,131,106,22868,16931
363,37,1,2,1,0,0,3,112,85,22355,17917,119,58,22868,16934
364,37,2,0,0,3,1,0,85,78,22357,17917,81,63,22871,16934
365,37,1,3,1,0,0,3,145,66,22358,17920,161,140,22871,16937
366,37,2,1,0,3,1,0,64,77,22360,17921,67,33,22874,16937
367,37,1,3,1,0,0,3,19,19,22361,17924,26,101,22874,16940
368,37,1,2,1,0,0,3,99,82,22362,17926,111,60,22874,16943
369,37,2,0,0,3,1,0,21,16,22364,17926,28,91,22877,16943
370,38,4,0,0,3,1,0,160,53,22368,17926,171,85,22880,16943
371,38,3,1,0,3,1,0,128,73,22371,17927,137,39,22883,16943
372,38,1,1,2,1,2,1,48,31,22372,17928,66,89,22884,16944
373,38,0,3,1,0,0,3,102,85,22372,17931,121,53,22884,16947
374,38,1,0,0,3,1,0,115,72,22373,17931,141,14,22887,16947
375,38,1,4,1,0,0,3,114,77,22374,17935,129,122,22887,16950
376,38,0,1,1,0,0,3,100,68,22374,17936,131,106,22887,16953
377,38,0,0,2,1,2,1,54,44,22374,17936,65,21,22888,16954
378,38,1,3,1,0,0,3,46,39,22375,17939,58,97,22888,16957
379,38,3,1,0,3,1,0,92,76,22378,17940,115,49,22891,16957
0,1,2,2,2,1,2,1,48,41,22380,17942,59,141,22892,16958
1,1,3,3,2,1,2,1,57,47,22383,17945,66,107,22893,16959
2,1,0,3,1,0,0,3,85,81,22383,17948,81,39,22893,16962
3,1,0,2,1,0,0,3,21,18,22383,17950,28,104,22893,16965
4,1,0,0,2,1,2,1,145,66,22383,17950,162,1,22894,16966
5,1,0,1,1,0,0,3,113,65,22383,17951,138,92,22894,16969
6,1,1,0,0,3,1,0,20,19,22384,17951,29,15,22897,16969
7,1,3,2,0,3,1,0,103,70,22387,17953,134,91,22900,16969
8,1,2,0,0,3,1,0,145,71,22389,17953,153,97,22903,16969
9,1,1,2,1,0,0,3,49,33,22390,17955,66,64,22903,16972
10,2,0,1,1,0,0,3,42,51,22390,17956,48,125,22903,16975
11,2,2,0,0,3,1,0,162,53,22392,17956,174,29,22906,16975
12,2,6,2,0,3,1,0,105,84,22398,17958,114,53,22909,16975
13,2,1,1,2,1,2,1,1,1,22399,17959,1,22,22910,16976
14,2,0,1,1,0,0,3,20,27,22399,17960,20,17,22910,16979
15,2,0,0,2,1,2,1,114,77,22399,17960,130,64,22911,16980
16,2,2,1,0,3,1,0,94,77,22401,17961,118,106,22914,16980
17,2,3,1,0,3,1,0,131,74,22404,17962,140,33,22917,16980
18,2,0,2,1,0,0,3,115,74,22404,17964,141,88,22917,16983
19,2,4,1,0,3,1,0,104,71,22408,17965,134,58,22920,16983
20,3,0,0,2,1,2,1,85,81,22408,17965,82,142,22921,16984
21,3,0,1,1,0,0,3,21,19,22408,17966,28,110,22921,16987
22,3,0,2,1,0,0,3,48,43,22408,17968,59,42,22921,16990
23,3,1,0,0,3,1,0,58,47,22409,17968,69,91,22924,16990
24,3,1,3,1,0,0,3,104,73,22410,17971,134,95,22924,16993
25,3,2,0,0,3,1,0,115,65,22412,17971,141,1,22927,16993
26,3,2,0,0,3,1,0,147,66,22414,17971,165,64,22930,16993
27,3,0,1,1,0,0,3,145,72,22414,17972,153,18,22930,16996
28,3,0,0,2,1,2,1,131,74,22414,17972,141,98,22931,16997
29,3,0,1,1,0,0,3,20,20,22414,17973,29,61,22931,17000
30,4,4,0,0,3,1,0,119,74,22418,17973,144,64,22934,17000
31,4,1,1,2,1,2,1,50,34,22419,17974,67,126,22935,17001
32,4,4,0,0,3,1,0,118,77,22423,17974,133,17,22938,17001
33,4,0,1,1,0,0,3,42,52,22423,17975,48,101,22938,17004
34,4,1,0,0,3,1,0,95,77,22424,17975,121,53,22941,17004
35,4,4,2,0,3,1,0,24,29,22428,17977,23,33,22944,17004
36,4,1,0,0,3,1,0,21,20,22429,17977,32,88,22947,17004
37,4,1,1,2,1,2,1,105,72,22430,17978,135,30,22948,17005
38,4,2,1,0,3,1,0,3,2,22432,17979,4,106,22951,17005
39,4,5,0,0,3,1,0,167,53,22437,17979,177,104,22954,17005
40,5,2,1,0,3,1,0,147,73,22439,17980,156,61,22957,17005
41,5,1,1,2,1,2,1,106,85,22440,17981,115,143,22958,17006
42,5,1,0,0,3,1,0,132,74,22441,17981,144,42,22961,17006
43,5,2,0,0,3,1,0,50,43,22443,17981,62,91,22964,17006
44,5,1,0,0,3,1,0,116,65,22444,17981,144,64,22967,17006
45,5,1,0,0,3,1,0,105,73,22445,17981,137,1,22970,17006
46,5,1,1,2,1,2,1,59,48,22446,17982,70,19,22971,17007
47,5,2,0,0,3,1,0,149,66,22448,17982,168,22,22974,17007
48,5,2,1,0,3,1,0,23,20,22450,17983,31,95,22977,17007
49,5,1,3,1,0,0,3,86,84,22451,17986,82,113,22977,17010
50,6,2,1,0,3,1,0,107,73,22453,17987,138,53,22980,17010
51,6,3,0,0,3,1,0,122,74,22456,17987,147,101,22983,17010
52,6,2,1,0,3,1,0,23,21,22458,17988,35,64,22986,17010
53,6,3,1,0,3,1,0,6,3,22461,17989,7,30,22989,17010
54,6,0,1,1,0,0,3,118,78,22461,17990,133,36,22989,17013
55,6,3,3,2,1,2,1,98,80,22464,17993,122,43,22990,17014
56,6,0,0,2,1,2,1,149,66,22464,17993,169,89,22991,17015
57,6,0,1,1,0,0,3,24,30,22464,17994,23,107,22991,17018
58,6,1,0,0,3,1,0,51,34,22465,17994,70,17,22994,17018
59,6,1,1,2,1,2,1,168,54,22466,17995,178,107,22995,17019
60,7,0,5,1,0,0,3,50,48,22466,18000,62,116,22995,17022
61,7,0,3,1,0,0,3,106,88,22466,18003,115,94,22995,17025
62,7,1,0,0,3,1,0,106,73,22467,18003,140,126,22998,17025
63,7,4,0,0,3,1,0,151,73,22471,18003,159,64,23001,17025
64,7,2,1,0,3,1,0,88,85,22473,18004,85,19,23004,17025
65,7,0,0,2,1,2,1,59,48,22473,18004,71,23,23005,17026
66,7,0,1,1,0,0,3,116,66,22473,18005,144,64,23005,17029
67,7,0,1,1,0,0,3,23,21,22473,18006,31,4,23005,17032
68,7,0,2,1,0,0,3,42,54,22473,18008,48,146,23005,17035
69,7,1,1,2,1,2,1,133,75,22474,18009,145,96,23006,17036
70,8,0,1,1,0,0,3,51,35,22474,18010,70,67,23006,17039
71,8,1,1,2,1,2,1,99,81,22475,18011,123,147,23007,17040
72,8,2,1,0,3,1,0,118,67,22477,18012,147,17,23010,17040
73,8,3,0,0,3,1,0,9,3,22480,18012,10,36,23013,17040
74,8,0,2,1,0,0,3,118,80,22480,18014,133,56,23013,17043
75,8,1,0,0,3,1,0,150,66,22481,18014,172,30,23016,17043
76,8,2,1,0,3,1,0,109,74,22483,18015,141,101,23019,17043
77,8,0,0,2,1,2,1,24,30,22483,18015,24,44,23020,17044
78,8,1,1,2,1,2,1,24,22,22484,18016,36,108,23021,17045
79,8,2,1,0,3,1,0,124,75,22486,18017,150,107,23024,17045
80,9,1,0,0,3,1,0,51,48,22487,18017,65,96,23027,17045
81,9,1,2,1,0,0,3,43,56,22488,18019,48,119,23027,17048
82,9,0,2,1,0,0,3,59,50,22488,18021,71,67,23027,17051
83,9,2,0,0,3,1,0,108,88,22490,18021,118,19,23030,17051
84,9,1,1,2,1,2,1,107,74,22491,18022,141,90,23031,17052
85,9,3,0,0,3,1,0,91,85,22494,18022,88,4,23034,17052
86,9,0,1,1,0,0,3,133,76,22494,18023,145,97,23034,17055
87,9,0,1,1,0,0,3,23,22,22494,18024,31,26,23034,17058
88,9,3,0,0,3,1,0,154,73,22497,18024,162,126,23037,17058
89,9,1,1,2,1,2,1,169,55,22498,18025,179,65,23038,17059
90,10,1,3,1,0,0,3,25,33,22499,18028,24,150,23038,17062
91,10,0,1,1,0,0,3,118,81,22499,18029,133,110,23038,17065
92,10,1,1,2,1,2,1,25,23,22500,18030,37,37,23039,17066
93,10,2,0,0,3,1,0,53,35,22502,18030,73,56,23042,17066
94,10,1,2,1,0,0,3,151,68,22503,18032,172,20,23042,17069
95,10,0,1,1,0,0,3,107,75,22503,18033,141,33,23042,17072
96,10,0,0,2,1,2,1,9,3,22503,18033,11,102,23043,17073
97,10,2,0,0,3,1,0,126,75,22505,18033,153,97,23046,17073
98,10,1,1,2,1,2,1,110,75,22506,18034,142,45,23047,17074
99,10,5,1,0,3,1,0,159,74,22511,18035,165,90,23050,17074
100,11,0,2,1,0,0,3,99,83,22511,18037,123,22,23050,17077
101,11,3,0,0,3,1,0,172,55,22514,18037,182,96,23053,17077
102,11,2,1,0,3,1,0,45,57,22516,18038,51,67,23056,17077
103,11,1,0,0,3,1,0,52,48,22517,18038,68,90,23059,17077
104,11,0,2,1,0,0,3,91,87,22517,18040,88,29,23059,17080
105,11,1,3,1,0,0,3,60,53,22518,18043,71,68,23059,17083
106,11,2,0,0,3,1,0,110,88,22520,18043,121,126,23062,17083
107,11,2,7,1,0,0,3,25,29,22522,18050,31,70,23062,17086
108,11,1,0,0,3,1,0,134,76,22523,18050,148,4,23065,17086
109,11,1,0,0,3,1,0,160,74,22524,18050,168,119,23068,17086
110,12,1,1,2,1,2,1,54,36,22525,18051,74,38,23069,17087
111,12,1,2,1,0,0,3,119,83,22526,18053,133,153,23069,17090
112,12,1,1,2,1,2,1,152,69,22527,18054,173,111,23070,17091
113,12,1,3,1,0,0,3,108,78,22528,18057,141,111,23070,17094
114,12,2,0,0,3,1,0,120,67,22530,18057,150,56,23073,17094
115,12,3,2,0,3,1,0,12,5,22533,18059,14,45,23076,17094
116,12,1,0,0,3,1,0,26,29,22534,18059,34,33,23079,17094
117,12,1,1,2,1,2,1,26,24,22535,18060,38,103,23080,17095
118,12,2,1,0,3,1,0,112,76,22537,18061,145,97,23083,17095
119,12,2,1,0,3,1,0,128,76,22539,18062,156,22,23086,17095
120,13,1,0,0,3,1,0,111,88,22540,18062,124,67,23089,17095
121,13,1,2,1,0,0,3,26,35,22541,18064,24,99,23089,17098
122,13,3,0,0,3,1,0,102,83,22544,18064,126,4,23092,17098
123,13,1,0,0,3,1,0,92,87,22545,18064,91,70,23095,17098
124,13,2,0,0,3,1,0,62,53,22547,18064,74,90,23098,17098
125,13,1,2,1,0,0,3,46,59,22548,18066,51,32,23098,17101
126,13,3,1,0,3,1,0,163,75,22551,18067,171,20,23101,17101
127,13,1,1,2,1,2,1,135,77,22552,18068,149,69,23102,17102
128,13,2,0,0,3,1,0,54,48,22554,18068,71,126,23105,17102
129,13,2,0,0,3,1,0,174,55,22556,18068,185,119,23108,17102
130,14,2,3,1,0,0,3,14,8,22558,18071,14,156,23108,17105
131,14,0,0,2,1,2,1,62,53,22558,18071,75,112,23109,17106
132,14,1,0,0,3,1,0,120,83,22559,18071,136,22,23112,17106
133,14,0,1,1,0,0,3,26,30,22559,18072,34,106,23112,17109
134,14,2,2,2,1,2,1,56,38,22561,18074,75,46,23113,17110
135,14,0,0,2,1,2,1,108,78,22561,18074,142,39,23114,17111
136,14,0,0,2,1,2,1,26,24,22561,18074,39,112,23115,17112
137,14,2,0,0,3,1,0,122,67,22563,18074,153,97,23118,17112
138,14,3,1,0,3,1,0,131,77,22566,18075,159,99,23121,17112
139,14,1,0,0,3,1,0,153,69,22567,18075,176,56,23124,17112
140,15,2,0,0,3,1,0,133,77,22569,18075,162,32,23127,17112
141,15,1,0,0,3,1,0,175,55,22570,18075,188,70,23130,17112
142,15,2,0,0,3,1,0,113,88,22572,18075,127,69,23133,17112
143,15,2,0,0,3,1,0,28,35,22574,18075,27,4,23136,17112
144,15,1,1,2,1,2,1,47,60,22575,18076,52,91,23137,17113
145,15,2,3,1,0,0,3,104,86,22577,18079,126,70,23137,17116
146,15,2,1,0,3,1,0,56,49,22579,18080,74,33,23140,17116
147,15,1,0,0,3,1,0,113,76,22580,18080,148,126,23143,17116
148,15,2,0,0,3,1,0,94,87,22582,18080,94,20,23146,17116
149,15,3,0,0,3,1,0,138,77,22585,18080,152,112,23149,17116
150,16,1,1,2,1,2,1,121,84,22586,18081,137,120,23150,17117
151,16,1,2,1,0,0,3,27,26,22587,18083,39,100,23150,17120
152,16,2,0,0,3,1,0,58,38,22589,18083,78,22,23153,17120
153,16,0,0,2,1,2,1,14,8,22589,18083,15,100,23154,17121
154,16,1,2,1,0,0,3,109,80,22590,18085,142,109,23154,17124
155,16,0,2,1,0,0,3,122,69,22590,18087,153,115,23154,17127
156,16,1,2,1,0,0,3,63,55,22591,18089,75,59,23154,17130
157,16,5,1,0,3,1,0,31,31,22596,18090,37,46,23157,17130
158,16,1,1,2,1,2,1,154,70,22597,18091,177,157,23158,17131
159,16,2,1,0,3,1,0,165,76,22599,18092,174,39,23161,17131
160,17,0,2,1,0,0,3,104,88,22599,18094,126,72,23161,17134
161,17,2,1,0,3,1,0,177,56,22601,18095,191,32,23164,17134
162,17,0,4,1,0,0,3,113,92,22601,18099,127,94,23164,17137
163,17,2,3,1,0,0,3,49,63,22603,18102,52,73,23164,17140
164,17,1,0,0,3,1,0,139,77,22604,18102,155,33,23167,17140
165,17,3,2,0,3,1,0,116,78,22607,18104,151,70,23170,17140
166,17,2,3,1,0,0,3,96,90,22609,18107,94,115,23170,17143
167,17,1,1,2,1,2,1,29,36,22610,18108,28,127,23171,17144
168,17,2,3,1,0,0,3,58,52,22612,18111,74,23,23171,17147
169,17,3,1,0,3,1,0,136,78,22615,18112,165,4,23174,17147
170,18,3,0,0,3,1,0,168,76,22618,18112,177,46,23177,17147
171,18,2,1,0,3,1,0,29,27,22620,18113,42,100,23180,17147
172,18,3,3,2,1,2,1,125,72,22623,18116,154,23,23181,17148
173,18,3,1,0,3,1,0,124,85,22626,18117,140,4,23184,17148
174,18,3,2,0,3,1,0,61,54,22629,18119,77,59,23187,17148
175,18,2,0,0,3,1,0,65,55,22631,18119,78,109,23190,17148
176,18,0,0,2,1,2,1,109,80,22631,18119,143,116,23191,17149
177,18,1,0,0,3,1,0,32,31,22632,18119,40,157,23194,17149
178,18,3,0,0,3,1,0,157,70,22635,18119,180,100,23197,17149
179,18,1,0,0,3,1,0,59,38,22636,18119,81,120,23200,17149
180,19,2,0,0,3,1,0,31,36,22638,18119,31,73,23203,17149
181,19,0,0,2,1,2,1,177,56,22638,18119,192,95,23204,17150
182,19,1,1,2,1,2,1,105,89,22639,18120,127,24,23205,17151
183,19,1,3,1,0,0,3,114,95,22640,18123,127,42,23205,17154
184,19,0,1,1,0,0,3,14,9,22640,18124,15,75,23205,17157
185,19,1,2,1,0,0,3,125,87,22641,18126,140,35,23205,17160
186,19,1,1,2,1,2,1,50,64,22642,18127,53,34,23206,17161
187,19,2,1,0,3,1,0,138,79,22644,18128,168,127,23209,17161
188,19,3,0,0,3,1,0,142,77,22647,18128,158,59,23212,17161
189,19,0,5,1,0,0,3,116,83,22647,18133,151,118,23212,17164
190,20,2,1,0,3,1,0,127,73,22649,18134,157,120,23215,17164
191,20,4,2,0,3,1,0,69,57,22653,18136,81,157,23218,17164
192,20,1,2,1,0,0,3,62,56,22654,18138,77,119,23218,17167
193,20,1,0,0,3,1,0,158,70,22655,18138,183,46,23221,17167
194,20,1,1,2,1,2,1,97,91,22656,18139,95,110,23222,17168
195,20,3,1,0,3,1,0,112,81,22659,18140,146,70,23225,17168
196,20,2,0,0,3,1,0,34,31,22661,18140,43,23,23228,17168
197,20,0,0,2,1,2,1,29,27,22661,18140,43,5,23229,17169
198,20,3,0,0,3,1,0,171,76,22664,18140,180,100,23232,17169
199,20,0,0,2,1,2,1,59,38,22664,18140,82,101,23233,17170
200,21,1,2,1,0,0,3,117,85,22665,18142,151,76,23233,17173
201,21,0,2,1,0,0,3,31,38,22665,18144,31,121,23233,17176
202,21,1,0,0,3,1,0,60,38,22666,18144,85,35,23236,17176
203,21,1,1,2,1,2,1,106,90,22667,18145,128,35,23237,17177
204,21,2,3,1,0,0,3,16,12,22669,18148,15,98,23237,17180
205,21,1,0,0,3,1,0,126,87,22670,18148,143,127,23240,17180
206,21,4,1,0,3,1,0,54,65,22674,18149,56,42,23243,17180
207,21,4,2,0,3,1,0,181,58,22678,18151,195,59,23246,17180
208,21,0,0,2,1,2,1,114,95,22678,18151,128,120,23247,17181
209,21,2,1,0,3,1,0,140,80,22680,18152,171,24,23250,17181
210,22,2,1,0,3,1,0,114,82,22682,18153,149,120,23253,17181
211,22,0,1,1,0,0,3,158,71,22682,18154,183,78,23253,17184
212,22,3,2,0,3,1,0,37,33,22685,18156,46,70,23256,17184
213,22,0,0,2,1,2,1,69,57,22685,18156,82,102,23257,17185
214,22,4,0,0,3,1,0,131,73,22689,18156,160,35,23260,17185
215,22,2,0,0,3,1,0,173,76,22691,18156,183,5,23263,17185
216,22,1,0,0,3,1,0,98,91,22692,18156,98,100,23266,17185
217,22,0,0,2,1,2,1,62,56,22692,18156,78,24,23267,17186
218,22,1,4,1,0,0,3,115,99,22693,18160,128,49,23267,17189
219,22,0,1,1,0,0,3,142,78,22693,18161,158,160,23267,17192
220,23,1,0,0,3,1,0,182,58,22694,18161,198,110,23270,17192
221,23,1,0,0,3,1,0,141,80,22695,18161,174,59,23273,17192
222,23,1,1,2,1,2,1,32,39,22696,18162,32,36,23274,17193
223,23,1,0,0,3,1,0,107,90,22697,18162,131,42,23277,17193
224,23,1,1,2,1,2,1,30,28,22698,18163,44,128,23278,17194
225,23,0,0,2,1,2,1,16,12,22698,18163,16,77,23279,17195
226,23,0,0,2,1,2,1,126,87,22698,18163,144,99,23280,17196
227,23,1,0,0,3,1,0,55,65,22699,18163,59,120,23283,17196
228,23,1,1,2,1,2,1,118,86,22700,18164,152,25,23284,17197
229,23,0,0,2,1,2,1,60,38,22700,18164,86,122,23285,17198
230,24,3,3,2,1,2,1,145,81,22703,18167,159,25,23286,17199
231,24,1,1,2,1,2,1,116,100,22704,18168,129,121,23287,17200
232,24,1,3,1,0,0,3,63,59,22705,18171,78,73,23287,17203
233,24,1,2,1,0,0,3,132,75,22706,18173,160,131,23287,17206
234,24,2,0,0,3,1,0,57,65,22708,18173,62,100,23290,17206
235,24,0,1,1,0,0,3,98,92,22708,18174,98,105,23290,17209
236,24,2,0,0,3,1,0,71,57,22710,18174,85,5,23293,17209
237,24,1,0,0,3,1,0,38,33,22711,18174,49,78,23296,17209
238,24,0,0,2,1,2,1,114,82,22711,18174,150,36,23297,17210
239,24,1,1,2,1,2,1,174,77,22712,18175,184,161,23298,17211
240,25,2,2,2,1,2,1,143,82,22714,18177,175,43,23299,17212
241,25,2,2,2,1,2,1,184,60,22716,18179,199,50,23300,17213
242,25,0,0,2,1,2,1,158,71,22716,18179,184,78,23301,17214
243,25,2,1,0,3,1,0,109,91,22718,18180,134,110,23304,17214
244,25,0,2,1,0,0,3,30,30,22718,18182,44,39,23304,17217
245,25,0,2,1,0,0,3,32,41,22718,18184,32,62,23304,17220
246,25,1,0,0,3,1,0,119,86,22719,18184,155,120,23307,17220
247,25,0,2,1,0,0,3,16,14,22719,18186,16,28,23307,17223
248,25,1,1,2,1,2,1,127,88,22720,18187,145,123,23308,17224
249,25,0,0,2,1,2,1,60,38,22720,18187,87,100,23309,17225
250,26,0,1,1,0,0,3,114,83,22720,18188,150,81,23309,17228
251,26,3,1,0,3,1,0,187,61,22723,18189,202,100,23312,17228
252,26,2,1,0,3,1,0,73,58,22725,18190,88,131,23315,17228
253,26,4,1,0,3,1,0,61,66,22729,18191,65,25,23318,17228
254,26,1,1,2,1,2,1,117,101,22730,18192,130,106,23319,17229
255,26,0,2,1,0,0,3,38,35,22730,18194,49,103,23319,17232
256,26,1,0,0,3,1,0,175,77,22731,18194,187,36,23322,17232
257,26,0,0,2,1,2,1,63,59,22731,18194,79,6,23323,17233
258,26,2,2,2,1,2,1,147,83,22733,18196,160,122,23324,17234
259,26,1,0,0,3,1,0,99,92,22734,18196,101,73,23327,17234
260,27,2,3,1,0,0,3,145,85,22736,18199,175,53,23327,17237
261,27,2,1,0,3,1,0,160,72,22738,18200,187,123,23330,17237
262,27,1,1,2,1,2,1,110,92,22739,18201,135,121,23331,17238
263,27,1,2,1,0,0,3,17,16,22740,18203,16,65,23331,17241
264,27,2,0,0,3,1,0,129,88,22742,18203,148,39,23334,17241
265,27,0,1,1,0,0,3,32,42,22742,18204,32,113,23334,17244
266,27,1,1,2,1,2,1,120,87,22743,18205,156,44,23335,17245
267,27,1,0,0,3,1,0,31,30,22744,18205,47,28,23338,17245
268,27,2,1,0,3,1,0,134,76,22746,18206,163,78,23341,17245
269,27,0,0,2,1,2,1,60,38,22746,18206,88,162,23342,17246
270,28,1,6,1,0,0,3,111,98,22747,18212,135,125,23342,17249
271,28,4,1,0,3,1,0,191,62,22751,18213,205,25,23345,17249
272,28,1,2,1,0,0,3,62,68,22752,18215,65,109,23345,17252
273,28,3,1,0,3,1,0,66,60,22755,18216,82,36,23348,17252
274,28,1,3,1,0,0,3,100,95,22756,18219,101,84,23348,17255
275,28,2,1,0,3,1,0,75,59,22758,18220,91,78,23351,17255
276,28,1,0,0,3,1,0,118,101,22759,18220,133,6,23354,17255
277,28,2,0,0,3,1,0,149,83,22761,18220,163,73,23357,17255
278,28,0,1,1,0,0,3,38,36,22761,18221,49,134,23357,17258
279,28,1,5,1,0,0,3,135,81,22762,18226,163,126,23357,17261
280,29,3,0,0,3,1,0,63,38,22765,18226,91,39,23360,17261
281,29,1,2,1,0,0,3,115,85,22766,18228,150,31,23360,17264
282,29,2,3,1,0,0,3,19,19,22768,18231,16,124,23360,17267
283,29,2,1,0,3,1,0,33,31,22770,18232,50,65,23363,17267
284,29,3,1,0,3,1,0,138,82,22773,18233,166,44,23366,17267
285,29,2,1,0,3,1,0,131,89,22775,18234,151,53,23369,17267
286,29,1,0,0,3,1,0,33,42,22776,18234,35,100,23372,17267
287,29,3,0,0,3,1,0,163,72,22779,18234,190,113,23375,17267
288,29,3,2,0,3,1,0,123,89,22782,18236,159,162,23378,17267
289,29,0,0,2,1,2,1,145,85,22782,18236,176,127,23379,17268
290,30,3,1,0,3,1,0,194,63,22785,18237,208,73,23382,17268
291,30,1,2,1,0,0,3,176,79,22786,18239,187,81,23382,17271
292,30,2,1,0,3,1,0,113,99,22788,18240,138,109,23385,17271
293,30,1,0,0,3,1,0,101,95,22789,18240,104,103,23388,17271
294,30,0,0,2,1,2,1,75,59,22789,18240,92,32,23389,17272
295,30,0,0,2,1,2,1,118,101,22789,18240,134,37,23390,17273
296,30,0,0,2,1,2,1,62,68,22789,18240,66,7,23391,17274
297,30,2,0,0,3,1,0,151,83,22791,18240,166,134,23394,17274
298,30,1,3,1,0,0,3,67,63,22792,18243,82,87,23394,17277
299,30,0,4,1,0,0,3,33,46,22792,18247,35,128,23394,17280
300,31,1,1,2,1,2,1,64,39,22793,18248,92,125,23395,17281
301,31,1,3,1,0,0,3,39,39,22794,18251,49,130,23395,17284
302,31,3,1,0,3,1,0,166,73,22797,18252,193,44,23398,17284
303,31,3,1,0,3,1,0,141,83,22800,18253,169,39,23401,17284
304,31,2,2,2,1,2,1,117,87,22802,18255,151,66,23402,17285
305,31,3,2,0,3,1,0,22,21,22805,18257,19,100,23405,17285
306,31,0,3,1,0,0,3,131,92,22805,18260,151,116,23405,17288
307,31,2,1,0,3,1,0,125,90,22807,18261,162,25,23408,17288
308,31,1,2,1,0,0,3,34,33,22808,18263,50,56,23408,17291
309,31,2,3,1,0,0,3,147,88,22810,18266,176,165,23408,17294
310,32,0,3,1,0,0,3,62,71,22810,18269,66,90,23408,17297
311,32,1,0,0,3,1,0,152,83,22811,18269,169,37,23411,17297
312,32,0,1,1,0,0,3,67,64,22811,18270,82,84,23411,17300
313,32,0,1,1,0,0,3,101,96,22811,18271,104,137,23411,17303
314,32,1,0,0,3,1,0,114,99,22812,18271,141,103,23414,17303
315,32,1,0,0,3,1,0,119,101,22813,18271,137,32,23417,17303
316,32,0,0,2,1,2,1,33,46,22813,18271,36,74,23418,17304
317,32,1,0,0,3,1,0,126,90,22814,18271,165,128,23421,17304
318,32,2,0,0,3,1,0,178,79,22816,18271,190,39,23424,17304
319,32,3,1,0,3,1,0,197,64,22819,18272,211,7,23427,17304
320,33,1,0,0,3,1,0,35,33,22820,18272,53,128,23430,17304
321,33,1,3,1,0,0,3,118,90,22821,18275,151,168,23430,17307
322,33,1,2,1,0,0,3,76,61,22822,18277,92,47,23430,17310
323,33,3,1,0,3,1,0,25,22,22825,18278,22,25,23433,17310
324,33,0,1,1,0,0,3,131,93,22825,18279,151,103,23433,17313
325,33,1,1,2,1,2,1,40,40,22826,18280,50,67,23434,17314
326,33,1,1,2,1,2,1,65,40,22827,18281,93,117,23435,17315
327,33,2,0,0,3,1,0,168,73,22829,18281,196,109,23438,17315
328,33,1,0,0,3,1,0,142,83,22830,18281,172,56,23441,17315
329,33,2,2,2,1,2,1,180,81,22832,18283,191,126,23442,17316
330,34,3,5,1,0,0,3,150,93,22835,18288,176,77,23442,17319
331,34,6,1,0,3,1,0,203,65,22841,18289,214,137,23445,17319
332,34,0,2,1,0,0,3,62,73,22841,18291,66,35,23445,17322
333,34,1,1,2,1,2,1,115,100,22842,18292,142,38,23446,17323
334,34,2,1,0,3,1,0,121,102,22844,18293,140,84,23449,17323
335,34,1,2,1,0,0,3,102,98,22845,18295,104,42,23449,17326
336,34,1,1,2,1,2,1,127,91,22846,18296,166,8,23450,17327
337,34,1,0,0,3,1,0,153,83,22847,18296,172,103,23453,17327
338,34,0,3,1,0,0,3,33,49,22847,18299,36,93,23453,17330
339,34,2,4,1,0,0,3,69,68,22849,18303,82,133,23453,17333
340,35,0,2,1,0,0,3,25,24,22849,18305,22,131,23453,17336
341,35,2,0,0,3,1,0,182,81,22851,18305,194,67,23456,17336
342,35,1,1,2,1,2,1,119,91,22852,18306,152,57,23457,17337
343,35,0,0,2,1,2,1,142,83,22852,18306,173,118,23458,17338
344,35,0,0,2,1,2,1,131,93,22852,18306,152,110,23459,17339
345,35,2,0,0,3,1,0,42,40,22854,18306,53,47,23462,17339
346,35,1,0,0,3,1,0,77,61,22855,18306,95,126,23465,17339
347,35,3,1,0,3,1,0,171,74,22858,18307,199,25,23468,17339
348,35,4,1,0,3,1,0,69,41,22862,18308,96,103,23471,17339
349,35,0,2,1,0,0,3,35,35,22862,18310,53,171,23471,17342
350,36,6,0,0,3,1,0,209,65,22868,18310,217,35,23474,17342
351,36,3,0,0,3,1,0,65,73,22871,18310,69,133,23477,17342
352,36,2,3,1,0,0,3,104,101,22873,18313,104,50,23477,17345
353,36,2,1,0,3,1,0,129,92,22875,18314,169,38,23480,17345
354,36,3,2,0,3,1,0,118,102,22878,18316,145,137,23483,17345
355,36,0,1,1,0,0,3,121,103,22878,18317,140,45,23483,17348
356,36,0,4,1,0,0,3,25,28,22878,18321,22,80,23483,17351
357,36,0,1,1,0,0,3,33,50,22878,18322,36,106,23483,17354
358,36,5,0,0,3,1,0,158,83,22883,18322,175,84,23486,17354
359,36,2,1,0,3,1,0,152,94,22885,18323,179,93,23489,17354
360,37,1,1,2,1,2,1,183,82,22886,18324,195,111,23490,17355
361,37,2,1,0,3,1,0,44,41,22888,18325,56,103,23493,17355
362,37,1,0,0,3,1,0,70,68,22889,18325,85,118,23496,17355
363,37,1,1,2,1,2,1,36,36,22890,18326,54,81,23497,17356
364,37,2,0,0,3,1,0,71,41,22892,18326,99,8,23500,17356
365,37,0,4,1,0,0,3,171,78,22892,18330,199,134,23500,17359
366,37,1,1,2,1,2,1,78,62,22893,18331,96,58,23501,17360
367,37,2,1,0,3,1,0,121,92,22895,18332,155,25,23504,17360
368,37,1,2,1,0,0,3,143,85,22896,18334,173,174,23504,17363
369,37,1,2,1,0,0,3,105,103,22897,18336,104,129,23504,17366
370,38,2,1,0,3,1,0,160,84,22899,18337,178,35,23507,17366
371,38,3,2,0,3,1,0,212,67,22902,18339,220,50,23510,17366
372,38,3,0,0,3,1,0,155,94,22905,18339,182,45,23513,17366
373,38,3,2,0,3,1,0,68,75,22908,18341,72,67,23516,17366
374,38,1,0,0,3,1,0,34,50,22909,18341,39,38,23519,17366
375,38,2,3,1,0,0,3,120,105,22911,18344,145,87,23519,17369
376,38,0,1,1,0,0,3,121,104,22911,18345,140,136,23519,17372
377,38,1,4,1,0,0,3,26,32,22912,18349,22,140,23519,17375
378,38,0,1,1,0,0,3,131,94,22912,18350,152,96,23519,17378
379,38,2,1,0,3,1,0,131,93,22914,18351,172,106,23522,17378
0,1,0,1,1,0,0,3,171,79,22914,18352,199,177,23522,17381
1,1,2,1,0,3,1,0,80,63,22916,18353,99,118,23525,17381
2,1,0,1,1,0,0,3,155,95,22916,18354,182,61,23525,17384
3,1,0,2,1,0,0,3,143,87,22916,18356,173,3,23525,17387
4,1,1,0,0,3,1,0,37,36,22917,18356,57,35,23528,17387
5,1,1,2,1,0,0,3,122,94,22918,18358,155,99,23528,17390
6,1,0,0,2,1,2,1,25,24,22918,18358,27,1,23529,17391
7,1,1,2,1,0,0,3,132,95,22919,18360,172,53,23529,17394
8,1,2,1,0,3,1,0,122,106,22921,18361,148,129,23532,17394
9,1,0,0,2,1,2,1,183,82,22921,18361,196,82,23533,17395
10,2,0,0,2,1,2,1,71,41,22921,18361,100,141,23534,17396
11,2,1,1,2,1,2,1,161,85,22922,18362,179,112,23535,17397
12,2,0,0,2,1,2,1,0,0,22922,18362,1,39,23536,17398
13,2,1,0,0,3,1,0,69,75,22923,18362,75,103,23539,17398
14,2,0,1,1,0,0,3,44,42,22923,18363,56,139,23539,17401
15,2,1,0,0,3,1,0,122,104,22924,18363,143,106,23542,17401
16,2,3,3,2,1,2,1,28,27,22927,18366,28,88,23543,17402
17,2,1,0,0,3,1,0,71,68,22928,18366,88,134,23546,17402
18,2,1,1,2,1,2,1,132,95,22929,18367,153,46,23547,17403
19,2,2,0,0,3,1,0,214,67,22931,18367,223,1,23550,17403
20,3,0,1,1,0,0,3,143,88,22931,18368,173,180,23550,17406
21,3,1,2,1,0,0,3,184,84,22932,18370,196,121,23550,17409
22,3,3,0,0,3,1,0,83,63,22935,18370,102,35,23553,17409
23,3,0,2,1,0,0,3,0,2,22935,18372,0,6,23553,17412
24,3,1,0,0,3,1,0,38,36,22936,18372,60,53,23556,17412
25,3,2,1,0,3,1,0,124,95,22938,18373,158,61,23559,17412
26,3,1,1,2,1,2,1,123,107,22939,18374,149,100,23560,17413
27,3,0,0,2,1,2,1,171,79,22939,18374,200,113,23561,17414
28,3,0,1,1,0,0,3,132,96,22939,18375,153,132,23561,17417
29,3,6,0,0,3,1,0,161,95,22945,18375,185,11,23564,17417
30,4,2,0,0,3,1,0,46,42,22947,18375,59,134,23567,17417
31,4,0,4,1,0,0,3,69,79,22947,18379,75,142,23567,17420
32,4,1,1,2,1,2,1,1,1,22948,18380,2,89,23568,17421
33,4,1,0,0,3,1,0,172,79,22949,18380,203,1,23571,17421
34,4,4,1,0,3,1,0,75,69,22953,18381,91,82,23574,17421
35,4,3,1,0,3,1,0,125,105,22956,18382,146,103,23577,17421
36,4,0,0,2,1,2,1,28,27,22956,18382,29,107,23578,17422
37,4,2,1,0,3,1,0,163,86,22958,18383,182,46,23581,17422
38,4,2,0,0,3,1,0,134,95,22960,18383,175,39,23584,17422
39,4,0,3,1,0,0,3,71,44,22960,18386,100,183,23584,17425
40,5,2,2,2,1,2,1,216,69,22962,18388,224,114,23585,17426
41,5,0,0,2,1,2,1,184,84,22962,18388,197,142,23586,17427
42,5,3,1,0,3,1,0,135,97,22965,18389,156,6,23589,17427
43,5,1,2,1,0,0,3,144,90,22966,18391,173,135,23589,17430
44,5,0,1,1,0,0,3,124,96,22966,18392,158,38,23589,17433
45,5,2,2,2,1,2,1,125,109,22968,18394,150,54,23590,17434
46,5,1,3,1,0,0,3,29,30,22969,18397,29,64,23590,17437
47,5,0,1,1,0,0,3,0,3,22969,18398,0,103,23590,17440
48,5,0,2,1,0,0,3,38,38,22969,18400,60,124,23590,17443
49,5,4,1,0,3,1,0,165,96,22973,18401,188,46,23593,17443
50,6,1,1,2,1,2,1,126,106,22974,18402,147,143,23594,17444
51,6,1,1,2,1,2,1,76,70,22975,18403,92,184,23595,17445
52,6,1,0,0,3,1,0,2,1,22976,18403,5,11,23598,17445
53,6,1,3,1,0,0,3,84,66,22977,18406,102,92,23598,17448
54,6,2,1,0,3,1,0,71,80,22979,18407,78,107,23601,17448
55,6,2,1,0,3,1,0,48,43,22981,18408,62,1,23604,17448
56,6,1,1,2,1,2,1,135,96,22982,18409,176,104,23605,17449
57,6,2,3,1,0,0,3,73,47,22984,18412,100,85,23605,17452
58,6,2,0,0,3,1,0,165,86,22986,18412,185,39,23608,17452
59,6,1,1,2,1,2,1,166,97,22987,18413,189,143,23609,17453
60,7,0,0,2,1,2,1,2,1,22987,18413,6,55,23610,17454
61,7,3,0,0,3,1,0,219,69,22990,18413,227,38,23613,17454
62,7,1,1,2,1,2,1,1,4,22991,18414,1,125,23614,17455
63,7,2,0,0,3,1,0,137,97,22993,18414,159,64,23617,17455
64,7,2,0,0,3,1,0,186,84,22995,18414,200,46,23620,17455
65,7,6,1,0,3,1,0,130,97,23001,18415,161,114,23623,17455
66,7,0,1,1,0,0,3,29,31,23001,18416,29,138,23623,17458
67,7,1,1,2,1,2,1,126,110,23002,18417,151,135,23624,17459
68,7,2,3,1,0,0,3,146,93,23004,18420,173,106,23624,17462
69,7,0,1,1,0,0,3,172,80,23004,18421,203,42,23624,17465
70,8,1,0,0,3,1,0,77,70,23005,18421,95,143,23627,17465
71,8,1,4,1,0,0,3,39,42,23006,18425,60,187,23627,17468
72,8,3,0,0,3,1,0,87,66,23009,18425,105,104,23630,17468
73,8,3,1,0,3,1,0,138,97,23012,18426,179,143,23633,17468
74,8,2,0,0,3,1,0,73,80,23014,18426,81,1,23636,17468
75,8,1,1,2,1,2,1,127,107,23015,18427,148,12,23637,17469
76,8,1,2,1,0,0,3,167,99,23016,18429,189,9,23637,17472
77,8,3,3,2,1,2,1,51,46,23019,18432,63,107,23638,17473
78,8,2,1,0,3,1,0,148,94,23021,18433,176,85,23641,17473
79,8,1,4,1,0,0,3,166,90,23022,18437,185,95,23641,17476
80,9,2,0,0,3,1,0,174,80,23024,18437,206,107,23644,17476
81,9,1,0,0,3,1,0,187,84,23025,18437,203,55,23647,17476
82,9,1,0,0,3,1,0,3,1,23026,18437,9,46,23650,17476
83,9,2,2,2,1,2,1,3,6,23028,18439,2,105,23651,17477
84,9,0,1,1,0,0,3,29,32,23028,18440,29,41,23651,17480
85,9,1,1,2,1,2,1,74,48,23029,18441,101,126,23652,17481
86,9,1,0,0,3,1,0,74,80,23030,18441,84,138,23655,17481
87,9,3,2,0,3,1,0,140,99,23033,18443,162,114,23658,17481
88,9,2,1,0,3,1,0,221,70,23035,18444,230,135,23661,17481
89,9,1,2,1,0,0,3,131,99,23036,18446,161,45,23661,17484
90,10,1,1,2,1,2,1,75,49,23037,18447,102,144,23662,17485
91,10,0,2,1,0,0,3,87,68,23037,18449,105,190,23662,17488
92,10,1,1,2,1,2,1,52,47,23038,18450,64,144,23663,17489
93,10,3,0,0,3,1,0,42,42,23041,18450,63,12,23666,17489
94,10,0,1,1,0,0,3,77,71,23041,18451,95,67,23666,17492
95,10,2,0,0,3,1,0,168,90,23043,18451,188,1,23669,17492
96,10,1,2,1,0,0,3,127,112,23044,18453,151,12,23669,17495
97,10,1,1,2,1,2,1,168,100,23045,18454,190,86,23670,17496
98,10,0,0,2,1,2,1,138,97,23045,18454,180,108,23671,17497
99,10,1,4,1,0,0,3,128,111,23046,18458,148,98,23671,17500
100,11,0,2,1,0,0,3,74,82,23046,18460,84,48,23671,17503
101,11,3,0,0,3,1,0,190,84,23049,18460,206,105,23674,17503
102,11,1,1,2,1,2,1,141,100,23050,18461,163,127,23675,17504
103,11,0,0,2,1,2,1,3,1,23050,18461,10,42,23676,17505
104,11,3,1,0,3,1,0,6,7,23053,18462,5,98,23679,17505
105,11,2,0,0,3,1,0,150,94,23055,18462,179,46,23682,17505
106,11,0,1,1,0,0,3,77,72,23055,18463,95,110,23682,17508
107,11,1,0,0,3,1,0,139,97,23056,18463,183,12,23685,17508
108,11,1,2,1,0,0,3,175,82,23057,18465,206,138,23685,17511
109,11,4,1,0,3,1,0,225,71,23061,18466,233,138,23688,17511
110,12,0,1,1,0,0,3,128,112,23061,18467,148,193,23688,17514
111,12,3,0,0,3,1,0,171,90,23064,18467,191,55,23691,17514
112,12,1,0,0,3,1,0,88,68,23065,18467,108,67,23694,17514
113,12,2,0,0,3,1,0,8,7,23067,18467,8,114,23697,17514
114,12,2,2,2,1,2,1,54,49,23069,18469,65,87,23698,17515
115,12,1,1,2,1,2,1,128,113,23070,18470,152,109,23699,17516
116,12,0,1,1,0,0,3,29,33,23070,18471,29,147,23699,17519
117,12,0,0,2,1,2,1,131,99,23070,18471,162,145,23700,17520
118,12,1,0,0,3,1,0,76,49,23071,18471,105,12,23703,17520
119,12,0,1,1,0,0,3,42,43,23071,18472,63,141,23703,17523
120,13,0,2,1,0,0,3,3,3,23071,18474,10,130,23703,17526
121,13,5,0,0,3,1,0,230,71,23076,18474,236,105,23706,17526
122,13,2,1,0,3,1,0,76,83,23078,18475,87,42,23709,17526
123,13,1,1,2,1,2,1,176,83,23079,18476,207,47,23710,17527
124,13,4,1,0,3,1,0,145,101,23083,18477,166,12,23713,17527
125,13,2,1,0,3,1,0,152,95,23085,18478,182,48,23716,17527
126,13,1,2,1,0,0,3,78,74,23086,18480,95,4,23716,17530
127,13,0,1,1,0,0,3,168,101,23086,18481,190,101,23716,17533
128,13,3,1,0,3,1,0,142,98,23089,18482,186,110,23719,17533
129,13,3,0,0,3,1,0,193,84,23092,18482,209,138,23722,17533
130,14,3,0,0,3,1,0,134,99,23095,18482,165,147,23725,17533
131,14,1,2,1,0,0,3,146,103,23096,18484,166,196,23725,17536
132,14,2,0,0,3,1,0,56,49,23098,18484,68,105,23728,17536
133,14,1,0,0,3,1,0,77,49,23099,18484,108,48,23731,17536
134,14,3,1,0,3,1,0,155,96,23102,18485,185,55,23734,17536
135,14,1,1,2,1,2,1,30,34,23103,18486,30,146,23735,17537
136,14,1,2,1,0,0,3,89,70,23104,18488,108,7,23735,17540
137,14,0,0,2,1,2,1,76,83,23104,18488,88,13,23736,17541
138,14,2,2,2,1,2,1,130,114,23106,18490,149,115,23737,17542
139,14,0,2,1,0,0,3,171,92,23106,18492,191,144,23737,17545
140,15,2,4,1,0,0,3,195,88,23108,18496,209,112,23737,17548
141,15,4,1,0,3,1,0,234,72,23112,18497,239,12,23740,17548
142,15,2,0,0,3,1,0,5,3,23114,18497,13,146,23743,17548
143,15,1,1,2,1,2,1,9,8,23115,18498,9,88,23744,17549
144,15,0,0,2,1,2,1,42,43,23115,18498,64,48,23745,17550
145,15,2,2,2,1,2,1,80,76,23117,18500,96,131,23746,17551
146,15,2,0,0,3,1,0,130,113,23119,18500,155,101,23749,17551
147,15,3,0,0,3,1,0,174,92,23122,18500,194,42,23752,17551
148,15,1,4,1,0,0,3,143,102,23123,18504,186,70,23752,17554
149,15,3,3,2,1,2,1,171,104,23126,18507,191,111,23753,17555
150,16,0,0,2,1,2,1,5,3,23126,18507,14,197,23754,17556
151,16,0,0,2,1,2,1,146,103,23126,18507,167,102,23755,17557
152,16,0,0,2,1,2,1,42,43,23126,18507,65,148,23756,17558
153,16,1,0,0,3,1,0,90,70,23127,18507,111,115,23759,17558
154,16,1,2,1,0,0,3,57,51,23128,18509,68,58,23759,17561
155,16,1,1,2,1,2,1,78,50,23129,18510,109,71,23760,17562
156,16,0,2,1,0,0,3,155,98,23129,18512,185,10,23760,17565
157,16,0,3,1,0,0,3,30,37,23129,18515,30,108,23760,17568
158,16,1,0,0,3,1,0,177,83,23130,18515,210,138,23763,17568
159,16,0,1,1,0,0,3,130,115,23130,18516,149,147,23763,17571
160,17,0,3,1,0,0,3,134,102,23130,18519,165,200,23763,17574
161,17,0,2,1,0,0,3,195,90,23130,18521,209,16,23763,17577
162,17,1,2,1,0,0,3,91,72,23131,18523,111,114,23763,17580
163,17,1,2,1,0,0,3,77,85,23132,18525,88,149,23763,17583
164,17,1,1,2,1,2,1,10,9,23133,18526,10,49,23764,17584
165,17,1,1,2,1,2,1,81,77,23134,18527,97,13,23765,17585
166,17,2,3,1,0,0,3,132,116,23136,18530,155,91,23765,17588
167,17,2,2,2,1,2,1,173,106,23138,18532,192,113,23766,17589
168,17,1,0,0,3,1,0,144,102,23139,18532,189,42,23769,17589
169,17,1,1,2,1,2,1,175,93,23140,18533,195,132,23770,17590
170,18,1,1,2,1,2,1,131,116,23141,18534,150,72,23771,17591
171,18,1,1,2,1,2,1,82,78,23142,18535,98,103,23772,17592
172,18,3,0,0,3,1,0,180,83,23145,18535,213,91,23775,17592
173,18,2,1,0,3,1,0,157,99,23147,18536,188,42,23778,17592
174,18,1,1,2,1,2,1,43,44,23148,18537,66,109,23779,17593
175,18,1,1,2,1,2,1,31,38,23149,18538,31,49,23780,17594
176,18,1,0,0,3,1,0,79,50,23150,18538,112,138,23783,17594
177,18,1,1,2,1,2,1,6,4,23151,18539,15,116,23784,17595
178,18,1,1,2,1,2,1,174,107,23152,18540,193,11,23785,17596
179,18,5,1,0,3,1,0,239,73,23157,18541,242,148,23788,17596
180,19,1,0,0,3,1,0,135,102,23158,18541,168,113,23791,17596
181,19,0,3,1,0,0,3,77,88,23158,18544,88,203,23791,17599
182,19,2,0,0,3,1,0,93,72,23160,18544,114,58,23794,17599
183,19,0,2,1,0,0,3,57,53,23160,18546,68,135,23794,17602
184,19,0,0,2,1,2,1,146,103,23160,18546,168,50,23795,17603
185,19,1,1,2,1,2,1,133,117,23161,18547,156,150,23796,17604
186,19,0,0,2,1,2,1,31,38,23161,18547,32,115,23797,17605
187,19,1,0,0,3,1,0,176,93,23162,18547,198,16,23800,17605
188,19,2,1,0,3,1,0,12,10,23164,18548,13,148,23803,17605
189,19,1,1,2,1,2,1,145,103,23165,18549,190,148,23804,17606
190,20,2,0,0,3,1,0,241,73,23167,18549,245,49,23807,17606
191,20,4,1,0,3,1,0,199,91,23171,18550,212,13,23810,17606
192,20,2,0,0,3,1,0,8,4,23173,18550,18,72,23813,17606
193,20,2,2,2,1,2,1,81,52,23175,18552,113,12,23814,17607
194,20,0,1,1,0,0,3,157,100,23175,18553,188,119,23814,17610
195,20,1,3,1,0,0,3,83,81,23176,18556,98,112,23814,17613
196,20,2,2,2,1,2,1,133,118,23178,18558,151,92,23815,17614
197,20,2,1,0,3,1,0,45,45,23180,18559,69,138,23818,17614
198,20,1,1,2,1,2,1,181,84,23181,18560,214,104,23819,17615
199,20,0,0,2,1,2,1,174,107,23181,18560,194,43,23820,17616
200,21,2,1,0,3,1,0,137,103,23183,18561,171,16,23823,17616
201,21,0,1,1,0,0,3,133,118,23183,18562,156,206,23823,17619
202,21,1,0,0,3,1,0,94,72,23184,18562,117,113,23826,17619
203,21,1,0,0,3,1,0,146,103,23185,18562,193,150,23829,17619
204,21,2,2,2,1,2,1,14,12,23187,18564,14,59,23830,17620
205,21,2,2,2,1,2,1,59,55,23189,18566,69,51,23831,17621
206,21,2,4,1,0,0,3,33,42,23191,18570,32,138,23831,17624
207,21,0,2,1,0,0,3,146,105,23191,18572,168,118,23831,17627
208,21,1,3,1,0,0,3,78,91,23192,18575,88,151,23831,17630
209,21,1,0,0,3,1,0,177,93,23193,18575,201,148,23834,17630
210,22,1,0,0,3,1,0,134,118,23194,18575,154,12,23837,17630
211,22,5,1,0,3,1,0,246,74,23199,18576,248,16,23840,17630
212,22,1,0,0,3,1,0,60,55,23200,18576,72,49,23843,17630
213,22,1,3,1,0,0,3,182,87,23201,18579,214,16,23843,17633
214,22,1,2,1,0,0,3,158,102,23202,18581,188,75,23843,17636
215,22,2,2,2,1,2,1,47,47,23204,18583,70,120,23844,17637
216,22,2,1,0,3,1,0,139,104,23206,18584,174,92,23847,17637
217,22,4,0,0,3,1,0,85,52,23210,18584,116,112,23850,17637
218,22,1,1,2,1,2,1,84,82,23211,18585,99,139,23851,17638
219,22,1,1,2,1,2,1,200,92,23212,18586,213,152,23852,17639
220,23,1,1,2,1,2,1,175,108,23213,18587,195,151,23853,17640
221,23,3,0,0,3,1,0,11,4,23216,18587,21,118,23856,17640
222,23,1,0,0,3,1,0,95,72,23217,18587,120,148,23859,17640
223,23,0,4,1,0,0,3,14,16,23217,18591,14,116,23859,17643
224,23,2,0,0,3,1,0,148,105,23219,18591,171,59,23862,17643
225,23,1,2,1,0,0,3,134,120,23220,18593,156,46,23862,17646
226,23,0,1,1,0,0,3,33,43,23220,18594,32,54,23862,17649
227,23,2,0,0,3,1,0,80,91,23222,18594,91,104,23865,17649
228,23,4,0,0,3,1,0,150,103,23226,18594,196,138,23868,17649
229,23,0,2,1,0,0,3,177,95,23226,18596,201,209,23868,17652
230,24,2,0,0,3,1,0,87,52,23228,18596,119,49,23871,17652
231,24,0,1,1,0,0,3,158,103,23228,18597,188,155,23871,17655
232,24,4,0,0,3,1,0,64,55,23232,18597,75,16,23874,17655
233,24,1,0,0,3,1,0,183,87,23233,18597,217,75,23877,17655
234,24,3,0,0,3,1,0,203,92,23236,18597,216,120,23880,17655
235,24,3,1,0,3,1,0,50,48,23239,18598,73,12,23883,17655
236,24,1,0,0,3,1,0,140,104,23240,18598,177,112,23886,17655
237,24,2,1,0,3,1,0,86,83,23242,18599,102,16,23889,17655
238,24,3,1,0,3,1,0,249,75,23245,18600,251,92,23892,17655
239,24,0,1,1,0,0,3,134,119,23245,18601,154,142,23892,17658
240,25,1,0,0,3,1,0,88,52,23246,18601,122,104,23895,17658
241,25,0,3,1,0,0,3,11,7,23246,18604,21,151,23895,17661
242,25,2,0,0,3,1,0,97,72,23248,18604,123,16,23898,17661
243,25,0,2,1,0,0,3,80,93,23248,18606,91,62,23898,17664
244,25,0,0,2,1,2,1,14,16,23248,18606,15,47,23899,17665
245,25,1,1,2,1,2,1,149,106,23249,18607,172,117,23900,17666
246,25,0,0,2,1,2,1,134,120,23249,18607,157,55,23901,17667
247,25,1,1,2,1,2,1,184,88,23250,18608,218,139,23902,17668
248,25,1,4,1,0,0,3,151,107,23251,18612,196,145,23902,17671
249,25,1,2,1,0,0,3,176,110,23252,18614,195,212,23902,17674
250,26,1,0,0,3,1,0,135,119,23253,18614,157,16,23905,17674
251,26,0,0,2,1,2,1,249,75,23253,18614,252,152,23906,17675
252,26,2,3,1,0,0,3,16,19,23255,18617,15,19,23906,17678
253,26,2,4,1,0,0,3,66,59,23257,18621,75,123,23906,17681
254,26,2,0,0,3,1,0,160,103,23259,18621,191,112,23909,17681
255,26,2,1,0,3,1,0,52,49,23261,18622,76,92,23912,17681
256,26,0,1,1,0,0,3,86,84,23261,18623,102,52,23912,17684
257,26,4,1,0,3,1,0,207,93,23265,18624,219,75,23915,17684
258,26,1,1,2,1,2,1,178,96,23266,18625,202,119,23916,17685
259,26,1,1,2,1,2,1,141,105,23267,18626,178,156,23917,17686
260,27,0,0,2,1,2,1,151,107,23267,18626,197,105,23918,17687
261,27,4,1,0,3,1,0,253,76,23271,18627,255,62,23921,17687
262,27,2,3,1,0,0,3,13,10,23273,18630,21,120,23921,17690
263,27,4,3,0,3,1,0,153,109,23277,18633,175,47,23924,17690
264,27,3,1,0,3,1,0,91,53,23280,18634,125,19,23927,17690
265,27,1,1,2,1,2,1,135,121,23281,18635,158,13,23928,17691
266,27,1,1,2,1,2,1,177,111,23282,18636,196,146,23929,17692
267,27,1,0,0,3,1,0,81,93,23283,18636,94,139,23932,17692
268,27,1,0,0,3,1,0,185,88,23284,18636,221,151,23935,17692
269,27,0,0,2,1,2,1,97,72,23284,18636,124,56,23936,17693
270,28,0,2,1,0,0,3,141,107,23284,18638,178,55,23936,17696
271,28,3,0,0,3,1,0,163,103,23287,18638,194,152,23939,17696
272,28,2,2,2,1,2,1,68,61,23289,18640,76,17,23940,17697
273,28,4,1,0,3,1,0,90,85,23293,18641,105,123,23943,17697
274,28,1,2,1,0,0,3,136,123,23294,18643,158,142,23943,17700
275,28,0,1,1,0,0,3,33,44,23294,18644,32,95,23943,17703
276,28,0,0,2,1,2,1,52,49,23294,18644,77,120,23944,17704
277,28,1,2,1,0,0,3,179,98,23295,18646,202,78,23944,17707
278,28,2,1,0,3,1,0,209,94,23297,18647,222,212,23947,17707
279,28,1,1,2,1,2,1,17,20,23298,18648,16,157,23948,17708
280,29,2,2,2,1,2,1,83,95,23300,18650,95,121,23949,17709
281,29,0,0,2,1,2,1,253,76,23300,18650,256,121,23950,17710
282,29,0,0,2,1,2,1,13,10,23300,18650,22,147,23951,17711
283,29,0,0,2,1,2,1,97,72,23300,18650,125,96,23952,17712
284,29,1,1,2,1,2,1,152,108,23301,18651,198,14,23953,17713
285,29,2,0,0,3,1,0,187,88,23303,18651,224,62,23956,17713
286,29,2,1,0,3,1,0,143,108,23305,18652,181,19,23959,17713
287,29,1,1,2,1,2,1,178,112,23306,18653,197,113,23960,17714
288,29,4,1,0,3,1,0,139,120,23310,18654,160,56,23963,17714
289,29,5,1,0,3,1,0,214,95,23315,18655,225,47,23966,17714
290,30,2,2,2,1,2,1,93,55,23317,18657,126,63,23967,17715
291,30,1,1,2,1,2,1,154,110,23318,18658,176,158,23968,17716
292,30,1,2,1,0,0,3,98,74,23319,18660,125,155,23968,17719
293,30,1,0,0,3,1,0,18,20,23320,18660,19,78,23971,17719
294,30,2,0,0,3,1,0,70,61,23322,18660,79,147,23974,17719
295,30,0,2,1,0,0,3,163,105,23322,18662,194,108,23974,17722
296,30,4,0,0,3,1,0,140,123,23326,18662,161,123,23977,17722
297,30,0,9,1,0,0,3,33,53,23326,18671,32,215,23977,17725
298,30,2,0,0,3,1,0,54,49,23328,18671,80,17,23980,17725
299,30,2,2,2,1,2,1,141,122,23330,18673,161,152,23981,17726
300,31,2,5,1,0,0,3,180,117,23332,18678,197,145,23981,17729
301,31,3,0,0,3,1,0,182,98,23335,18678,205,121,23984,17729
302,31,5,1,0,3,1,0,18,11,23340,18679,25,96,23987,17729
303,31,2,1,0,3,1,0,85,96,23342,18680,98,19,23990,17729
304,31,1,0,0,3,1,0,188,88,23343,18680,227,113,23993,17729
305,31,0,1,1,0,0,3,90,86,23343,18681,105,50,23993,17732
306,31,2,0,0,3,1,0,216,95,23345,18681,228,56,23996,17732
307,31,1,1,2,1,2,1,153,109,23346,18682,199,56,23997,17733
308,31,3,0,0,3,1,0,146,108,23349,18682,184,14,24000,17733
309,31,0,2,1,0,0,3,253,78,23349,18684,256,124,24000,17736
310,32,1,2,1,0,0,3,94,57,23350,18686,126,126,24000,17739
311,32,4,1,0,3,1,0,257,79,23354,18687,259,108,24003,17739
312,32,0,2,1,0,0,3,18,22,23354,18689,19,150,24003,17742
313,32,2,2,2,1,2,1,72,63,23356,18691,80,122,24004,17743
314,32,3,1,0,3,1,0,144,123,23359,18692,164,63,24007,17743
315,32,2,0,0,3,1,0,142,123,23361,18692,164,78,24010,17743
316,32,0,1,1,0,0,3,33,54,23361,18693,32,20,24010,17746
317,32,0,3,1,0,0,3,54,52,23361,18696,80,158,24010,17749
318,32,2,1,0,3,1,0,100,75,23363,18697,128,158,24013,17749
319,32,1,3,1,0,0,3,155,113,23364,18700,176,155,24013,17752
320,33,0,2,1,0,0,3,163,107,23364,18702,194,158,24013,17755
321,33,0,2,1,0,0,3,72,65,23364,18704,80,218,24013,17758
322,33,0,0,2,1,2,1,18,11,23364,18704,26,15,24014,17759
323,33,1,2,1,0,0,3,86,98,23365,18706,98,99,24014,17762
324,33,2,1,0,3,1,0,92,87,23367,18707,108,56,24017,17762
325,33,1,0,0,3,1,0,183,98,23368,18707,208,19,24020,17762
326,33,4,0,0,3,1,0,146,123,23372,18707,167,56,24023,17762
327,33,4,1,0,3,1,0,192,89,23376,18708,230,124,24026,17762
328,33,3,0,0,3,1,0,149,108,23379,18708,187,145,24029,17762
329,33,0,0,2,1,2,1,180,117,23379,18708,198,127,24030,17763
330,34,1,1,2,1,2,1,217,96,23380,18709,229,109,24031,17764
331,34,6,0,0,3,1,0,263,79,23386,18709,262,78,24034,17764
332,34,0,1,1,0,0,3,100,76,23386,18710,128,153,24034,17767
333,34,1,3,1,0,0,3,154,112,23387,18713,199,23,24034,17770
334,34,2,4,1,0,0,3,20,26,23389,18717,19,161,24034,17773
335,34,1,1,2,1,2,1,156,114,23390,18718,177,114,24035,17774
336,34,2,1,0,3,1,0,35,55,23392,18719,35,63,24038,17774
337,34,0,2,1,0,0,3,54,54,23392,18721,80,125,24038,17777
338,34,0,3,1,0,0,3,144,126,23392,18724,164,53,24038,17780
339,34,2,1,0,3,1,0,96,58,23394,18725,129,158,24041,17780
340,35,2,0,0,3,1,0,151,108,23396,18725,190,63,24044,17780
341,35,2,3,1,0,0,3,148,126,23398,18728,167,161,24044,17783
342,35,1,1,2,1,2,1,181,118,23399,18729,199,57,24045,17784
343,35,3,2,0,3,1,0,23,28,23402,18731,22,56,24048,17784
344,35,1,1,2,1,2,1,73,66,23403,18732,81,79,24049,17785
345,35,4,1,0,3,1,0,167,108,23407,18733,197,19,24052,17785
346,35,2,0,0,3,1,0,185,98,23409,18733,211,99,24055,17785
347,35,1,1,2,1,2,1,145,127,23410,18734,165,125,24056,17786
348,35,0,0,2,1,2,1,192,89,23410,18734,231,24,24057,17787
349,35,1,1,2,1,2,1,155,113,23411,18735,200,219,24058,17788
350,36,4,0,0,3,1,0,267,79,23415,18735,265,145,24061,17788
351,36,1,0,0,3,1,0,55,54,23416,18735,83,109,24064,17788
352,36,0,0,2,1,2,1,185,98,23416,18735,212,115,24065,17789
353,36,0,0,2,1,2,1,86,98,23416,18735,99,57,24066,17790
354,36,0,1,1,0,0,3,156,115,23416,18736,177,164,24066,17793
355,36,3,2,0,3,1,0,99,60,23419,18738,132,53,24069,17793
356,36,2,3,1,0,0,3,94,90,23421,18741,108,128,24069,17796
357,36,2,4,1,0,0,3,37,59,23423,18745,35,130,24069,17799
358,36,2,1,0,3,1,0,219,97,23425,18746,232,15,24072,17799
359,36,0,1,1,0,0,3,18,12,23425,18747,26,161,24072,17802
360,37,1,0,0,3,1,0,101,76,23426,18747,131,24,24075,17802
361,37,3,0,0,3,1,0,158,113,23429,18747,203,99,24078,17802
362,37,0,4,1,0,0,3,23,32,23429,18751,22,222,24078,17805
363,37,0,0,2,1,2,1,192,89,23429,18751,232,54,24079,17806
364,37,6,1,0,3,1,0,225,98,23435,18752,235,125,24082,17806
365,37,1,0,0,3,1,0,182,118,23436,18752,202,63,24085,17806
366,37,2,0,0,3,1,0,169,108,23438,18752,200,145,24088,17806
367,37,1,2,1,0,0,3,56,56,23439,18754,83,82,24088,17809
368,37,2,0,0,3,1,0,153,108,23441,18754,193,153,24091,17809
369,37,1,0,0,3,1,0,149,126,23442,18754,170,19,24094,17809
370,38,2,3,1,0,0,3,20,15,23444,18757,26,118,24094,17812
371,38,1,0,0,3,1,0,87,98,23445,18757,102,130,24097,17812
372,38,2,3,1,0,0,3,75,69,23447,18760,81,112,24097,17815
373,38,1,0,0,3,1,0,157,115,23448,18760,180,15,24100,17815
374,38,2,0,0,3,1,0,101,60,23450,18760,135,128,24103,17815
375,38,4,0,0,3,1,0,271,79,23454,18760,268,57,24106,17815
376,38,4,1,0,3,1,0,98,91,23458,18761,111,161,24109,17815
377,38,1,2,1,0,0,3,146,129,23459,18763,165,60,24109,17818
378,38,0,1,1,0,0,3,185,99,23459,18764,212,167,24109,17821
379,38,1,1,2,1,2,1,38,60,23460,18765,36,162,24110,17822
0,1,0,1,1,0,0,3,101,77,23460,18766,131,225,24110,17825
1,1,2,2,2,1,2,1,103,62,23462,18768,136,55,24111,17826
2,1,3,2,0,3,1,0,161,115,23465,18770,206,153,24114,17826
3,1,1,0,0,3,1,0,170,108,23466,18770,203,24,24117,17826
4,1,0,1,1,0,0,3,23,27,23466,18771,22,60,24117,17829
5,1,3,2,0,3,1,0,90,100,23469,18773,105,99,24120,17829
6,1,3,2,0,3,1,0,29,34,23472,18775,25,167,24123,17829
7,1,0,3,1,0,0,3,64,74,23472,18778,74,164,24123,17832
8,1,1,0,0,3,1,0,154,108,23473,18778,196,145,24126,17832
9,1,0,0,2,1,2,1,182,118,23473,18778,203,119,24127,17833
10,2,2,0,0,3,1,0,227,98,23475,18778,238,82,24130,17833
11,2,0,1,1,0,0,3,56,57,23475,18779,83,128,24130,17836
12,2,0,3,1,0,0,3,157,118,23475,18782,180,63,24130,17839
13,2,1,0,0,3,1,0,193,89,23476,18782,235,14,24133,17839
14,2,4,1,0,3,1,0,153,127,23480,18783,173,130,24136,17839
15,2,0,1,1,0,0,3,20,16,23480,18784,26,115,24136,17842
16,2,2,0,0,3,1,0,148,129,23482,18784,168,57,24139,17842
17,2,2,1,0,3,1,0,77,70,23484,18785,84,162,24142,17842
18,2,3,1,0,3,1,0,188,100,23487,18786,215,128,24145,17842
19,2,3,0,0,3,1,0,274,79,23490,18786,271,8,24148,17842
20,3,2,0,0,3,1,0,184,118,23492,18786,206,99,24151,17842
21,3,4,2,0,3,1,0,27,29,23496,18788,25,164,24154,17842
22,3,0,2,1,0,0,3,64,76,23496,18790,74,58,24154,17845
23,3,1,1,2,1,2,1,171,109,23497,18791,204,146,24155,17846
24,3,1,1,2,1,2,1,155,109,23498,18792,197,168,24156,17847
25,3,2,0,0,3,1,0,92,100,23500,18792,108,63,24159,17847
26,3,2,0,0,3,1,0,31,34,23502,18792,28,24,24162,17847
27,3,1,0,0,3,1,0,162,115,23503,18792,209,60,24165,17847
28,3,0,0,2,1,2,1,188,100,23503,18792,216,120,24166,17848
29,3,3,1,0,3,1,0,106,63,23506,18793,139,225,24169,17848
30,4,1,1,2,1,2,1,275,80,23507,18794,272,154,24170,17849
31,4,1,3,1,0,0,3,228,101,23508,18797,238,133,24170,17852
32,4,0,2,1,0,0,3,157,120,23508,18799,180,60,24170,17855
33,4,1,4,1,0,0,3,194,93,23509,18803,235,131,24170,17858
34,4,2,1,0,3,1,0,103,78,23511,18804,134,120,24173,17858
35,4,3,1,0,3,1,0,23,17,23514,18805,29,14,24176,17858
36,4,1,1,2,1,2,1,78,71,23515,18806,85,129,24177,17859
37,4,0,3,1,0,0,3,56,60,23515,18809,83,11,24177,17862
38,4,2,0,0,3,1,0,150,129,23517,18809,171,82,24180,17862
39,4,3,2,0,3,1,0,158,111,23520,18811,200,162,24183,17862
40,5,0,6,1,0,0,3,92,106,23520,18817,108,228,24183,17865
41,5,3,0,0,3,1,0,109,63,23523,18817,142,146,24186,17865
42,5,1,1,2,1,2,1,65,77,23524,18818,75,61,24187,17866
43,5,1,0,0,3,1,0,158,120,23525,18818,183,168,24190,17866
44,5,0,1,1,0,0,3,162,116,23525,18819,209,27,24190,17869
45,5,0,0,2,1,2,1,27,29,23525,18819,26,12,24191,17870
46,5,2,1,0,3,1,0,155,128,23527,18820,176,58,24194,17870
47,5,1,1,2,1,2,1,172,110,23528,18821,205,116,24195,17871
48,5,1,0,0,3,1,0,189,100,23529,18821,219,63,24198,17871
49,5,0,0,2,1,2,1,184,118,23529,18821,207,165,24199,17872
50,6,1,2,1,0,0,3,195,95,23530,18823,235,123,24199,17875
51,6,3,0,0,3,1,0,278,80,23533,18823,275,14,24202,17875
52,6,4,0,0,3,1,0,162,111,23537,18823,203,131,24205,17875
53,6,5,1,0,3,1,0,233,102,23542,18824,241,129,24208,17875
54,6,0,0,2,1,2,1,103,78,23542,18824,135,61,24209,17876
55,6,2,1,0,3,1,0,25,18,23544,18825,32,82,24212,17876
56,6,0,0,2,1,2,1,56,60,23544,18825,84,155,24213,17877
57,6,1,0,0,3,1,0,79,71,23545,18825,88,99,24216,17877
58,6,0,3,1,0,0,3,31,37,23545,18828,28,136,24216,17880
59,6,3,2,0,3,1,0,153,131,23548,18830,174,162,24219,17880
60,7,2,0,0,3,1,0,157,128,23550,18830,179,228,24222,17880
61,7,1,0,0,3,1,0,159,120,23551,18830,186,165,24225,17880
62,7,0,0,2,1,2,1,162,116,23551,18830,210,83,24226,17881
63,7,0,1,1,0,0,3,172,111,23551,18831,205,15,24226,17884
64,7,1,0,0,3,1,0,104,78,23552,18831,138,58,24229,17884
65,7,3,0,0,3,1,0,30,29,23555,18831,29,146,24232,17884
66,7,2,1,0,3,1,0,111,64,23557,18832,145,27,24235,17884
67,7,3,1,0,3,1,0,192,101,23560,18833,222,168,24238,17884
68,7,0,1,1,0,0,3,65,78,23560,18834,75,119,24238,17887
69,7,2,1,0,3,1,0,186,119,23562,18835,210,61,24241,17887
70,8,1,0,0,3,1,0,154,131,23563,18835,177,58,24244,17887
71,8,2,0,0,3,1,0,280,80,23565,18835,278,136,24247,17887
72,8,1,0,0,3,1,0,196,95,23566,18835,238,61,24250,17887
73,8,3,3,2,1,2,1,33,32,23569,18838,30,130,24251,17888
74,8,1,0,0,3,1,0,57,60,23570,18838,87,63,24254,17888
75,8,1,0,0,3,1,0,93,106,23571,18838,111,123,24257,17888
76,8,0,7,1,0,0,3,31,44,23571,18845,28,134,24257,17891
77,8,1,1,2,1,2,1,26,19,23572,18846,33,163,24258,17892
78,8,2,1,0,3,1,0,164,112,23574,18847,206,99,24261,17892
79,8,2,0,0,3,1,0,235,102,23576,18847,244,155,24264,17892
80,9,3,1,0,3,1,0,160,129,23579,18848,182,134,24267,17892
81,9,2,0,0,3,1,0,166,112,23581,18848,209,165,24270,17892
82,9,1,2,1,0,0,3,66,80,23582,18850,75,231,24270,17895
83,9,1,2,1,0,0,3,160,122,23583,18852,186,64,24270,17898
84,9,3,2,0,3,1,0,175,113,23586,18854,208,83,24273,17898
85,9,1,2,1,0,0,3,105,80,23587,18856,138,30,24273,17901
86,9,1,0,0,3,1,0,80,71,23588,18856,91,168,24276,17901
87,9,1,1,2,1,2,1,155,132,23589,18857,178,137,24277,17902
88,9,1,1,2,1,2,1,193,102,23590,18858,223,15,24278,17903
89,9,1,0,0,3,1,0,187,119,23591,18858,213,15,24281,17903
90,10,6,2,0,3,1,0,117,66,23597,18860,148,130,24284,17903
91,10,1,3,1,0,0,3,236,105,23598,18863,244,61,24284,17906
92,10,1,1,2,1,2,1,163,117,23599,18864,211,62,24285,17907
93,10,2,1,0,3,1,0,198,96,23601,18865,241,63,24288,17907
94,10,1,0,0,3,1,0,34,32,23602,18865,33,99,24291,17907
95,10,0,0,2,1,2,1,26,19,23602,18865,34,124,24292,17908
96,10,1,2,1,0,0,3,58,62,23603,18867,87,149,24292,17911
97,10,0,2,1,0,0,3,93,108,23603,18869,111,158,24292,17914
98,10,2,4,1,0,0,3,33,48,23605,18873,28,122,24292,17917
99,10,0,0,2,1,2,1,280,80,23605,18873,279,164,24293,17918
100,11,0,1,1,0,0,3,198,97,23605,18874,241,234,24293,17921
101,11,1,2,1,0,0,3,161,131,23606,18876,182,168,24293,17924
102,11,2,0,0,3,1,0,68,80,23608,18876,78,83,24296,17924
103,11,1,1,2,1,2,1,194,103,23609,18877,224,135,24297,17925
104,11,2,2,2,1,2,1,162,124,23611,18879,187,131,24298,17926
105,11,0,0,2,1,2,1,105,80,23611,18879,139,16,24299,17927
106,11,1,0,0,3,1,0,81,71,23612,18879,94,30,24302,17927
107,11,4,1,0,3,1,0,170,113,23616,18880,212,64,24305,17927
108,11,1,0,0,3,1,0,156,132,23617,18880,181,15,24308,17927
109,11,0,0,2,1,2,1,187,119,23617,18880,214,138,24309,17928
110,12,3,1,0,3,1,0,178,114,23620,18881,211,164,24312,17928
111,12,6,0,0,3,1,0,123,66,23626,18881,151,62,24315,17928
112,12,2,1,0,3,1,0,165,118,23628,18882,214,99,24318,17928
113,12,2,1,0,3,1,0,238,106,23630,18883,247,63,24321,17928
114,12,3,3,2,1,2,1,37,35,23633,18886,34,62,24322,17929
115,12,1,0,0,3,1,0,27,19,23634,18886,37,168,24325,17929
116,12,1,1,2,1,2,1,59,63,23635,18887,88,125,24326,17930
117,12,1,0,0,3,1,0,94,108,23636,18887,114,122,24329,17930
118,12,0,0,2,1,2,1,33,48,23636,18887,29,159,24330,17931
119,12,4,0,0,3,1,0,284,80,23640,18887,282,149,24333,17931
120,13,0,3,1,0,0,3,162,127,23640,18890,187,138,24333,17934
121,13,0,1,1,0,0,3,198,98,23640,18891,241,171,24333,17937
122,13,2,0,0,3,1,0,286,80,23642,18891,285,64,24336,17937
123,13,1,0,0,3,1,0,69,80,23643,18891,81,16,24339,17937
124,13,1,1,2,1,2,1,106,81,23644,18892,140,132,24340,17938
125,13,1,2,1,0,0,3,162,133,23645,18894,182,18,24340,17941
126,13,1,1,2,1,2,1,157,133,23646,18895,182,31,24341,17942
127,13,1,1,2,1,2,1,82,72,23647,18896,95,139,24342,17943
128,13,1,0,0,3,1,0,188,119,23648,18896,217,83,24345,17943
129,13,0,1,1,0,0,3,194,104,23648,18897,224,125,24345,17946
130,14,1,0,0,3,1,0,158,133,23649,18897,185,125,24348,17946
131,14,4,0,0,3,1,0,127,66,23653,18897,154,164,24351,17946
132,14,3,2,0,3,1,0,168,120,23656,18899,217,16,24354,17946
133,14,0,0,2,1,2,1,178,114,23656,18899,212,63,24355,17947
134,14,0,0,2,1,2,1,59,63,23656,18899,89,169,24356,17948
135,14,1,1,2,1,2,1,95,109,23657,18900,115,63,24357,17949
136,14,3,3,2,1,2,1,36,51,23660,18903,30,100,24358,17950
137,14,1,2,1,0,0,3,28,21,23661,18905,37,162,24358,17953
138,14,1,1,2,1,2,1,171,114,23662,18906,213,64,24359,17954
139,14,1,2,1,0,0,3,239,108,23663,18908,247,237,24359,17957
140,15,2,1,0,3,1,0,164,128,23665,18909,190,149,24362,17957
141,15,4,2,0,3,1,0,202,100,23669,18911,244,83,24365,17957
142,15,1,1,2,1,2,1,38,36,23670,18912,35,139,24366,17958
143,15,4,0,0,3,1,0,73,80,23674,18912,84,18,24369,17958
144,15,0,0,2,1,2,1,194,104,23674,18912,225,165,24370,17959
145,15,1,1,2,1,2,1,107,82,23675,18913,141,140,24371,17960
146,15,1,0,0,3,1,0,163,133,23676,18913,185,132,24374,17960
147,15,0,6,1,0,0,3,59,69,23676,18919,89,174,24374,17963
148,15,0,1,1,0,0,3,82,73,23676,18920,95,128,24374,17966
149,15,2,0,0,3,1,0,288,80,23678,18920,288,31,24377,17966
150,16,3,3,2,1,2,1,98,112,23681,18923,116,17,24378,17967
151,16,3,0,0,3,1,0,181,114,23684,18923,215,237,24381,17967
152,16,0,1,1,0,0,3,168,121,23684,18924,217,172,24381,17970
153,16,2,2,2,1,2,1,30,23,23686,18926,38,101,24382,17971
154,16,5,0,0,3,1,0,132,66,23691,18926,157,64,24385,17971
155,16,2,0,0,3,1,0,84,73,23693,18926,98,64,24388,17971
156,16,2,0,0,3,1,0,160,133,23695,18926,188,162,24391,17971
157,16,3,0,0,3,1,0,191,119,23698,18926,220,63,24394,17971
158,16,3,0,0,3,1,0,174,114,23701,18926,216,125,24397,17971
159,16,0,3,1,0,0,3,36,54,23701,18929,30,177,24397,17974
160,17,1,2,1,0,0,3,39,38,23702,18931,35,168,24397,17977
161,17,0,4,1,0,0,3,168,125,23702,18935,217,142,24397,17980
162,17,2,0,0,3,1,0,75,80,23704,18935,87,31,24400,17980
163,17,2,1,0,3,1,0,204,101,23706,18936,247,132,24403,17980
164,17,2,0,0,3,1,0,109,82,23708,18936,144,18,24406,17980
165,17,3,2,0,3,1,0,166,135,23711,18938,188,101,24409,17980
166,17,1,0,0,3,1,0,240,108,23712,18938,250,149,24412,17980
167,17,1,0,0,3,1,0,195,104,23713,18938,228,63,24415,17980
168,17,2,2,2,1,2,1,290,82,23715,18940,289,129,24416,17981
169,17,1,0,0,3,1,0,60,69,23716,18940,92,83,24419,17981
170,18,0,2,1,0,0,3,30,25,23716,18942,38,67,24419,17984
171,18,2,1,0,3,1,0,86,74,23718,18943,101,237,24422,17984
172,18,2,1,0,3,1,0,166,129,23720,18944,193,162,24425,17984
173,18,4,0,0,3,1,0,185,114,23724,18944,218,140,24428,17984
174,18,1,1,2,1,2,1,167,136,23725,18945,189,64,24429,17985
175,18,1,2,1,0,0,3,161,135,23726,18947,188,67,24429,17988
176,18,3,0,0,3,1,0,101,112,23729,18947,119,18,24432,17988
177,18,2,1,0,3,1,0,176,115,23731,18948,219,17,24435,17988
178,18,2,0,0,3,1,0,193,119,23733,18948,223,172,24438,17988
179,18,1,3,1,0,0,3,133,69,23734,18951,157,180,24438,17991
180,19,0,0,2,1,2,1,195,104,23734,18951,229,65,24439,17992
181,19,0,0,2,1,2,1,168,125,23734,18951,218,130,24440,17993
182,19,1,1,2,1,2,1,205,102,23735,18952,248,150,24441,17994
183,19,2,0,0,3,1,0,242,108,23737,18952,253,31,24444,17994
184,19,5,0,0,3,1,0,295,82,23742,18952,292,101,24447,17994
185,19,1,2,1,0,0,3,110,84,23743,18954,144,171,24447,17997
186,19,2,0,0,3,1,0,41,38,23745,18954,38,125,24450,17997
187,19,2,1,0,3,1,0,135,70,23747,18955,160,83,24453,17997
188,19,1,0,0,3,1,0,61,69,23748,18955,95,132,24456,17997
189,19,2,2,2,1,2,1,38,56,23750,18957,31,64,24457,17998
190,20,1,1,2,1,2,1,206,103,23751,18958,249,163,24458,17999
191,20,0,1,1,0,0,3,161,136,23751,18959,188,240,24458,18002
192,20,1,0,0,3,1,0,76,80,23752,18959,90,67,24461,18002
193,20,3,1,0,3,1,0,169,130,23755,18960,196,64,24464,18002
194,20,1,1,2,1,2,1,186,115,23756,18961,219,18,24465,18003
195,20,0,1,1,0,0,3,167,137,23756,18962,189,70,24465,18006
196,20,1,1,2,1,2,1,31,26,23757,18963,39,141,24466,18007
197,20,0,0,2,1,2,1,176,115,23757,18963,220,19,24467,18008
198,20,3,2,0,3,1,0,104,114,23760,18965,122,180,24470,18008
199,20,1,4,1,0,0,3,194,123,23761,18969,223,145,24470,18011
200,21,1,1,2,1,2,1,111,85,23762,18970,145,131,24471,18012
201,21,0,2,1,0,0,3,61,71,23762,18972,95,243,24471,18015
202,21,1,0,0,3,1,0,169,125,23763,18972,221,125,24474,18015
203,21,0,0,2,1,2,1,41,38,23763,18972,39,173,24475,18016
204,21,1,1,2,1,2,1,87,75,23764,18973,102,151,24476,18017
205,21,2,0,0,3,1,0,40,56,23766,18973,34,132,24479,18017
206,21,4,0,0,3,1,0,139,70,23770,18973,163,101,24482,18017
207,21,2,1,0,3,1,0,197,105,23772,18974,232,31,24485,18017
208,21,3,1,0,3,1,0,245,109,23775,18975,256,171,24488,18017
209,21,1,0,0,3,1,0,105,114,23776,18975,125,65,24491,18017
210,22,5,1,0,3,1,0,199,124,23781,18976,226,132,24494,18017
211,22,1,2,1,0,0,3,246,111,23782,18978,256,176,24494,18020
212,22,0,2,1,0,0,3,76,82,23782,18980,90,144,24494,18023
213,22,2,3,1,0,0,3,171,133,23784,18983,196,21,24494,18026
214,22,1,1,2,1,2,1,112,86,23785,18984,146,84,24495,18027
215,22,2,1,0,3,1,0,33,27,23787,18985,42,19,24498,18027
216,22,1,1,2,1,2,1,162,137,23788,18986,189,71,24499,18028
217,22,3,1,0,3,1,0,179,116,23791,18987,223,64,24502,18028
218,22,0,3,1,0,0,3,167,140,23791,18990,189,166,24502,18031
219,22,1,1,2,1,2,1,296,83,23792,18991,293,146,24503,18032
220,23,1,0,0,3,1,0,41,56,23793,18991,37,171,24506,18032
221,23,3,0,0,3,1,0,142,70,23796,18991,166,131,24509,18032
222,23,1,1,2,1,2,1,170,126,23797,18992,222,152,24510,18033
223,23,0,1,1,0,0,3,206,104,23797,18993,249,104,24510,18036
224,23,2,1,0,3,1,0,188,116,23799,18994,222,67,24513,18036
225,23,1,3,1,0,0,3,42,41,23800,18997,39,246,24513,18039
226,23,0,1,1,0,0,3,87,76,23800,18998,102,87,24513,18042
227,23,4,0,0,3,1,0,171,140,23804,18998,192,31,24516,18042
228,23,0,2,1,0,0,3,61,73,23804,19000,95,68,24516,18045
229,23,2,0,0,3,1,0,199,105,23806,19000,235,180,24519,18045
230,24,0,4,1,0,0,3,105,118,23806,19004,125,147,24519,18048
231,24,1,2,1,0,0,3,189,118,23807,19006,222,149,24519,18051
232,24,2,1,0,3,1,0,298,84,23809,19007,296,176,24522,18051
233,24,1,1,2,1,2,1,172,134,23810,19008,197,126,24523,18052
234,24,1,0,0,3,1,0,180,116,23811,19008,226,166,24526,18052
235,24,4,0,0,3,1,0,250,111,23815,19008,259,68,24529,18052
236,24,0,0,2,1,2,1,33,27,23815,19008,43,153,24530,18053
237,24,2,1,0,3,1,0,43,57,23817,19009,40,21,24533,18053
238,24,2,0,0,3,1,0,201,124,23819,19009,229,64,24536,18053
239,24,2,2,2,1,2,1,114,88,23821,19011,147,72,24537,18054
240,25,0,3,1,0,0,3,170,129,23821,19014,222,249,24537,18057
241,25,2,1,0,3,1,0,89,77,23823,19015,105,180,24540,18057
242,25,0,3,1,0,0,3,76,85,23823,19018,90,135,24540,18060
243,25,1,2,1,0,0,3,207,106,23824,19020,249,34,24540,18063
244,25,2,0,0,3,1,0,44,41,23826,19020,42,87,24543,18063
245,25,4,1,0,3,1,0,175,141,23830,19021,195,67,24546,18063
246,25,5,0,0,3,1,0,147,70,23835,19021,169,19,24549,18063
247,25,2,2,2,1,2,1,164,139,23837,19023,190,132,24550,18064
248,25,4,0,0,3,1,0,203,105,23841,19023,238,104,24553,18064
249,25,3,2,0,3,1,0,64,75,23844,19025,98,171,24556,18064
250,26,1,1,2,1,2,1,115,89,23845,19026,148,150,24557,18065
251,26,2,0,0,3,1,0,203,124,23847,19026,232,153,24560,18065
252,26,0,1,1,0,0,3,172,135,23847,19027,197,135,24560,18068
253,26,1,0,0,3,1,0,34,27,23848,19027,46,68,24563,18068
254,26,0,1,1,0,0,3,105,119,23848,19028,125,179,24563,18071
255,26,1,1,2,1,2,1,44,58,23849,19029,41,73,24564,18072
256,26,3,0,0,3,1,0,173,129,23852,19029,225,64,24567,18072
257,26,2,1,0,3,1,0,191,119,23854,19030,225,166,24570,18072
258,26,4,2,0,3,1,0,254,113,23858,19032,262,21,24573,18072
259,26,0,0,2,1,2,1,298,84,23858,19032,297,127,24574,18073
260,27,3,1,0,3,1,0,67,76,23861,19033,101,21,24577,18073
261,27,2,1,0,3,1,0,182,117,23863,19034,229,135,24580,18073
262,27,1,2,1,0,0,3,90,79,23864,19036,105,153,24580,18076
263,27,0,0,2,1,2,1,76,85,23864,19036,91,128,24581,18077
264,27,2,3,1,0,0,3,209,109,23866,19039,249,150,24581,18080
265,27,3,0,0,3,1,0,37,27,23869,19039,49,67,24584,18080
266,27,1,0,0,3,1,0,165,139,23870,19039,193,104,24587,18080
267,27,0,1,1,0,0,3,203,106,23870,19040,238,90,24587,18083
268,27,5,0,0,3,1,0,259,113,23875,19040,265,19,24590,18083
269,27,1,5,1,0,0,3,204,129,23876,19045,232,252,24590,18086
270,28,1,1,2,1,2,1,174,130,23877,19046,226,181,24591,18087
271,28,1,0,0,3,1,0,299,84,23878,19046,300,68,24594,18087
272,28,1,1,2,1,2,1,192,120,23879,19047,226,65,24595,18088
273,28,0,0,2,1,2,1,115,89,23879,19047,149,167,24596,18089
274,28,0,1,1,0,0,3,44,42,23879,19048,42,138,24596,18092
275,28,2,3,1,0,0,3,107,122,23881,19051,125,37,24596,18095
276,28,1,1,2,1,2,1,45,59,23882,19052,42,154,24597,18096
277,28,1,4,1,0,0,3,173,139,23883,19056,197,174,24597,18099
278,28,1,1,2,1,2,1,176,142,23884,19057,196,180,24598,18100
279,28,4,0,0,3,1,0,151,70,23888,19057,172,73,24601,18100
280,29,2,2,2,1,2,1,184,119,23890,19059,230,91,24602,18101
281,29,3,0,0,3,1,0,207,129,23893,19059,235,37,24605,18101
282,29,2,1,0,3,1,0,153,71,23895,19060,175,150,24608,18101
283,29,1,2,1,0,0,3,77,87,23896,19062,91,183,24608,18104
284,29,2,3,1,0,0,3,194,123,23898,19065,226,76,24608,18107
285,29,1,1,2,1,2,1,166,140,23899,19066,194,22,24609,18108
286,29,5,0,0,3,1,0,95,79,23904,19066,108,67,24612,18108
287,29,2,2,2,1,2,1,205,108,23906,19068,239,20,24613,18109
288,29,4,0,0,3,1,0,263,113,23910,19068,268,128,24616,18109
289,29,1,2,1,0,0,3,174,141,23911,19070,197,255,24616,18112
290,30,1,0,0,3,1,0,46,59,23912,19070,45,67,24619,18112
291,30,0,0,2,1,2,1,209,109,23912,19070,250,175,24620,18113
292,30,1,1,2,1,2,1,68,77,23913,19071,102,139,24621,18114
293,30,2,3,1,0,0,3,79,90,23915,19074,91,107,24621,18117
294,30,5,1,0,3,1,0,179,131,23920,19075,229,135,24624,18117
295,30,0,0,2,1,2,1,176,142,23920,19075,197,155,24625,18118
296,30,3,0,0,3,1,0,40,27,23923,19075,52,65,24628,18118
297,30,0,3,1,0,0,3,107,125,23923,19078,125,156,24628,18121
298,30,0,1,1,0,0,3,44,43,23923,19079,42,170,24628,18124
299,30,2,1,0,3,1,0,301,85,23925,19080,303,181,24631,18124
300,31,1,0,0,3,1,0,96,79,23926,19080,111,68,24634,18124
301,31,1,1,2,1,2,1,208,130,23927,19081,236,23,24635,18125
302,31,0,1,1,0,0,3,115,90,23927,19082,149,186,24635,18128
303,31,1,1,2,1,2,1,167,141,23928,19083,195,182,24636,18129
304,31,1,0,0,3,1,0,175,141,23929,19083,200,91,24639,18129
305,31,0,1,1,0,0,3,194,124,23929,19084,226,131,24639,18132
306,31,2,1,0,3,1,0,70,78,23931,19085,105,37,24642,18132
307,31,2,1,0,3,1,0,186,120,23933,19086,233,150,24645,18132
308,31,2,3,1,0,0,3,48,62,23935,19089,45,258,24645,18135
309,31,2,0,0,3,1,0,155,71,23937,19089,178,170,24648,18135
310,32,1,2,1,0,0,3,210,111,23938,19091,250,142,24648,18138
311,32,0,1,1,0,0,3,40,28,23938,19092,52,159,24648,18141
312,32,3,0,0,3,1,0,82,90,23941,19092,94,155,24651,18141
313,32,3,0,0,3,1,0,182,131,23944,19092,232,20,24654,18141
314,32,1,4,1,0,0,3,264,117,23945,19096,268,110,24654,18144
315,32,1,2,1,0,0,3,45,45,23946,19098,42,70,24654,18147
316,32,0,2,1,0,0,3,107,127,23946,19100,125,138,24654,18150
317,32,0,0,2,1,2,1,176,142,23946,19100,198,176,24655,18151
318,32,1,1,2,1,2,1,206,109,23947,19101,240,77,24656,18152
319,32,4,0,0,3,1,0,305,85,23951,19101,306,65,24659,18152
320,33,0,2,1,0,0,3,40,30,23951,19103,52,261,24659,18155
321,33,3,1,0,3,1,0,189,121,23954,19104,236,68,24662,18155
322,33,2,0,0,3,1,0,196,124,23956,19104,229,110,24665,18155
323,33,2,0,0,3,1,0,169,141,23958,19104,198,186,24668,18155
324,33,2,1,0,3,1,0,98,80,23960,19105,114,131,24671,18155
325,33,2,2,2,1,2,1,50,64,23962,19107,46,92,24672,18156
326,33,2,1,0,3,1,0,157,72,23964,19108,181,23,24675,18156
327,33,0,1,1,0,0,3,70,79,23964,19109,105,153,24675,18159
328,33,0,0,2,1,2,1,115,90,23964,19109,150,183,24676,18160
329,33,4,0,0,3,1,0,212,130,23968,19109,239,170,24679,18160
330,34,0,0,2,1,2,1,82,90,23968,19109,95,177,24680,18161
331,34,2,0,0,3,1,0,307,85,23970,19109,309,138,24683,18161
332,34,5,1,0,3,1,0,180,142,23975,19110,203,20,24686,18161
333,34,2,0,0,3,1,0,184,131,23977,19110,235,70,24689,18161
334,34,3,0,0,3,1,0,213,111,23980,19110,253,65,24692,18161
335,34,3,2,0,3,1,0,48,47,23983,19112,45,37,24695,18161
336,34,0,2,1,0,0,3,107,129,23983,19114,125,80,24695,18164
337,34,1,1,2,1,2,1,177,143,23984,19115,199,143,24696,18165
338,34,1,1,2,1,2,1,207,110,23985,19116,241,156,24697,18166
339,34,1,2,1,0,0,3,265,119,23986,19118,268,162,24697,18169
340,35,1,2,1,0,0,3,41,32,23987,19120,52,186,24697,18172
341,35,3,1,0,3,1,0,160,73,23990,19121,184,131,24700,18172
342,35,0,3,1,0,0,3,196,127,23990,19124,229,189,24700,18175
343,35,1,0,0,3,1,0,116,90,23991,19124,153,156,24703,18175
344,35,1,0,0,3,1,0,71,79,23992,19124,108,110,24706,18175
345,35,0,2,1,0,0,3,98,82,23992,19126,114,173,24706,18178
346,35,2,1,0,3,1,0,52,65,23994,19127,49,68,24709,18178
347,35,1,5,1,0,0,3,108,134,23995,19132,125,180,24709,18181
348,35,0,0,2,1,2,1,48,47,23995,19132,46,154,24710,18182
349,35,3,1,0,3,1,0,192,122,23998,19133,239,261,24713,18182
350,36,2,2,2,1,2,1,209,112,24000,19135,242,155,24714,18183
351,36,5,0,0,3,1,0,312,85,24005,19135,312,70,24717,18183
352,36,0,3,1,0,0,3,82,93,24005,19138,95,165,24717,18186
353,36,1,1,2,1,2,1,181,143,24006,19139,204,38,24718,18187
354,36,0,2,1,0,0,3,213,113,24006,19141,253,23,24718,18190
355,36,0,1,1,0,0,3,177,144,24006,19142,199,95,24718,18193
356,36,4,0,0,3,1,0,102,82,24010,19142,117,23,24721,18193
357,36,1,0,0,3,1,0,170,141,24011,19142,201,138,24724,18193
358,36,3,2,0,3,1,0,268,121,24014,19144,271,80,24727,18193
359,36,2,1,0,3,1,0,214,131,24016,19145,242,143,24730,18193
360,37,0,5,1,0,0,3,209,117,24016,19150,242,264,24730,18196
361,37,1,1,2,1,2,1,185,132,24017,19151,236,181,24731,18197
362,37,1,3,1,0,0,3,197,130,24018,19154,229,189,24731,18200
363,37,0,2,1,0,0,3,192,124,24018,19156,239,41,24731,18203
364,37,2,0,0,3,1,0,118,90,24020,19156,156,110,24734,18203
365,37,2,0,0,3,1,0,50,47,24022,19156,49,68,24737,18203
366,37,4,0,0,3,1,0,164,73,24026,19156,187,189,24740,18203
367,37,4,1,0,3,1,0,75,80,24030,19157,111,65,24743,18203
368,37,0,1,1,0,0,3,108,135,24030,19158,125,159,24743,18206
369,37,1,1,2,1,2,1,53,66,24031,19159,50,132,24744,18207
370,38,3,1,0,3,1,0,85,94,24034,19160,98,173,24747,18207
371,38,1,1,2,1,2,1,182,144,24035,19161,205,156,24748,18208
372,38,3,0,0,3,1,0,216,113,24038,19161,256,80,24751,18208
373,38,1,0,0,3,1,0,215,131,24039,19161,245,70,24754,18208
374,38,1,1,2,1,2,1,313,86,24040,19162,313,96,24755,18209
375,38,3,3,2,1,2,1,271,124,24043,19165,272,144,24756,18210
376,38,0,0,2,1,2,1,177,144,24043,19165,200,24,24757,18211
377,38,2,0,0,3,1,0,43,32,24045,19165,55,138,24760,18211
378,38,2,3,1,0,0,3,172,144,24047,19168,201,168,24760,18214
379,38,1,0,0,3,1,0,103,82,24048,19168,120,23,24763,18214
0,1,3,2,0,3,1,0,167,75,24051,19170,190,132,24766,18214
1,1,2,0,0,3,1,0,315,86,24053,19170,316,0,24769,18214
2,1,4,0,0,3,1,0,275,124,24057,19170,275,0,24772,18214
3,1,1,0,0,3,1,0,210,117,24058,19170,245,144,24775,18214
4,1,1,0,0,3,1,0,198,130,24059,19170,232,96,24778,18214
5,1,1,3,1,0,0,3,54,69,24060,19173,50,68,24778,18217
6,1,1,1,2,1,2,1,39,61,24061,19174,37,160,24779,18218
7,1,3,0,0,3,1,0,219,113,24064,19174,259,80,24782,18218
8,1,2,2,2,1,2,1,45,34,24066,19176,56,157,24783,18219
9,1,3,0,0,3,1,0,218,131,24069,19176,248,24,24786,18219
10,2,1,2,1,0,0,3,193,126,24070,19178,239,22,24786,18222
11,2,1,2,1,0,0,3,173,146,24071,19180,201,192,24786,18225
12,2,0,1,1,0,0,3,75,81,24071,19181,111,184,24786,18228
13,2,0,2,1,0,0,3,0,2,24071,19183,0,44,24786,18231
14,2,2,0,0,3,1,0,187,132,24073,19183,239,23,24789,18231
15,2,0,1,1,0,0,3,108,136,24073,19184,125,176,24789,18234
16,2,1,0,0,3,1,0,178,144,24074,19184,203,138,24792,18234
17,2,3,0,0,3,1,0,3,0,24077,19184,3,189,24795,18234
18,2,1,4,1,0,0,3,51,51,24078,19188,49,171,24795,18237
19,2,0,3,1,0,0,3,103,85,24078,19191,120,267,24795,18240
20,3,0,1,1,0,0,3,54,70,24078,19192,50,174,24795,18243
21,3,3,3,2,1,2,1,278,127,24081,19195,276,158,24796,18244
22,3,3,0,0,3,1,0,213,117,24084,19195,248,0,24799,18244
23,3,2,2,2,1,2,1,175,148,24086,19197,202,25,24800,18245
24,3,2,0,0,3,1,0,195,126,24088,19197,242,68,24803,18245
25,3,1,1,2,1,2,1,199,131,24089,19198,233,1,24804,18246
26,3,0,1,1,0,0,3,39,62,24089,19199,37,83,24804,18249
27,3,0,2,1,0,0,3,219,115,24089,19201,259,99,24804,18252
28,3,1,1,2,1,2,1,219,132,24090,19202,249,45,24805,18253
29,3,6,2,0,3,1,0,321,88,24096,19204,319,132,24808,18253
30,4,3,0,0,3,1,0,324,88,24099,19204,322,176,24811,18253
31,4,0,0,2,1,2,1,75,81,24099,19204,112,193,24812,18254
32,4,3,0,0,3,1,0,3,2,24102,19204,3,144,24815,18254
33,4,2,1,0,3,1,0,189,133,24104,19205,242,22,24818,18254
34,4,1,0,0,3,1,0,109,136,24105,19205,128,23,24821,18254
35,4,2,1,0,3,1,0,53,52,24107,19206,52,138,24824,18254
36,4,3,2,0,3,1,0,181,146,24110,19208,206,160,24827,18254
37,4,2,0,0,3,1,0,105,85,24112,19208,123,1,24830,18254
38,4,1,1,2,1,2,1,46,35,24113,19209,57,190,24831,18255
39,4,6,1,0,3,1,0,173,76,24119,19210,193,184,24834,18255
40,5,0,0,2,1,2,1,219,115,24119,19210,260,159,24835,18256
41,5,1,5,1,0,0,3,55,75,24120,19215,50,270,24835,18259
42,5,4,0,0,3,1,0,199,126,24124,19215,245,174,24838,18259
43,5,0,1,1,0,0,3,3,1,24124,19216,3,3,24838,18262
44,5,2,1,0,3,1,0,111,137,24126,19217,131,25,24841,18262
45,5,0,1,1,0,0,3,199,132,24126,19218,233,86,24841,18265
46,5,0,0,2,1,2,1,39,62,24126,19218,38,133,24842,18266
47,5,1,1,2,1,2,1,214,118,24127,19219,249,46,24843,18267
48,5,2,1,0,3,1,0,280,128,24129,19220,279,68,24846,18267
49,5,1,3,1,0,0,3,220,135,24130,19223,249,163,24846,18270
50,6,0,1,1,0,0,3,181,147,24130,19224,206,162,24846,18273
51,6,3,0,0,3,1,0,176,76,24133,19224,196,1,24849,18273
52,6,0,1,1,0,0,3,53,53,24133,19225,52,179,24849,18276
53,6,1,0,0,3,1,0,106,85,24134,19225,126,190,24852,18276
54,6,1,0,0,3,1,0,76,81,24135,19225,115,99,24855,18276
55,6,0,1,1,0,0,3,39,63,24135,19226,38,141,24855,18279
56,6,0,2,1,0,0,3,3,4,24135,19228,3,187,24855,18282
57,6,0,1,1,0,0,3,46,36,24135,19229,57,26,24855,18285
58,6,0,1,1,0,0,3,175,149,24135,19230,202,147,24855,18288
59,6,2,0,0,3,1,0,326,88,24137,19230,325,193,24858,18288
60,7,2,2,2,1,2,1,201,128,24139,19232,246,47,24859,18289
61,7,0,4,1,0,0,3,219,119,24139,19236,260,177,24859,18292
62,7,0,0,2,1,2,1,199,132,24139,19236,234,271,24860,18293
63,7,3,1,0,3,1,0,192,134,24142,19237,245,68,24863,18293
64,7,1,0,0,3,1,0,112,137,24143,19237,134,3,24866,18293
65,7,3,3,2,1,2,1,283,131,24146,19240,280,26,24867,18294
66,7,0,1,1,0,0,3,55,76,24146,19241,50,25,24867,18297
67,7,2,2,2,1,2,1,216,120,24148,19243,250,164,24868,18298
68,7,1,2,1,0,0,3,4,3,24149,19245,3,89,24868,18301
69,7,2,0,0,3,1,0,222,135,24151,19245,252,133,24871,18301
70,8,1,1,2,1,2,1,177,77,24152,19246,197,142,24872,18302
71,8,6,2,0,3,1,0,332,90,24158,19248,328,162,24875,18302
72,8,1,1,2,1,2,1,54,54,24159,19249,53,2,24876,18303
73,8,1,1,2,1,2,1,107,86,24160,19250,127,134,24877,18304
74,8,1,0,0,3,1,0,77,81,24161,19250,118,26,24880,18304
75,8,0,1,1,0,0,3,175,150,24161,19251,202,102,24880,18307
76,8,2,1,0,3,1,0,41,64,24163,19252,41,179,24883,18307
77,8,3,3,2,1,2,1,49,39,24166,19255,58,194,24884,18308
78,8,2,4,1,0,0,3,203,132,24168,19259,246,190,24884,18311
79,8,3,0,0,3,1,0,6,4,24171,19259,6,190,24887,18311
80,9,3,2,0,3,1,0,286,133,24174,19261,283,177,24890,18311
81,9,1,2,1,0,0,3,55,56,24175,19263,53,274,24890,18314
82,9,0,2,1,0,0,3,112,139,24175,19265,134,50,24890,18317
83,9,2,0,0,3,1,0,109,86,24177,19265,130,164,24893,18317
84,9,2,2,2,1,2,1,221,121,24179,19267,261,26,24894,18318
85,9,3,1,0,3,1,0,219,121,24182,19268,253,26,24897,18318
86,9,1,0,0,3,1,0,182,147,24183,19268,209,3,24900,18318
87,9,1,1,2,1,2,1,193,135,24184,19269,246,90,24901,18319
88,9,2,0,0,3,1,0,201,132,24186,19269,237,147,24904,18319
89,9,3,3,2,1,2,1,7,6,24189,19272,4,191,24905,18320
90,10,0,1,1,0,0,3,219,122,24189,19273,253,145,24905,18323
91,10,2,0,0,3,1,0,179,77,24191,19273,200,102,24908,18323
92,10,1,0,0,3,1,0,7,4,24192,19273,9,162,24911,18323
93,10,0,1,1,0,0,3,49,40,24192,19274,58,137,24911,18326
94,10,1,2,1,0,0,3,56,78,24193,19276,50,29,24911,18329
95,10,2,1,0,3,1,0,79,82,24195,19277,121,68,24914,18329
96,10,1,0,0,3,1,0,176,150,24196,19277,205,190,24917,18329
97,10,1,2,1,0,0,3,204,134,24197,19279,246,5,24917,18332
98,10,0,5,1,0,0,3,41,69,24197,19284,41,197,24917,18335
99,10,2,2,2,1,2,1,224,137,24199,19286,253,275,24918,18336
100,11,3,0,0,3,1,0,335,90,24202,19286,331,147,24921,18336
101,11,0,2,1,0,0,3,193,137,24202,19288,246,180,24921,18339
102,11,1,0,0,3,1,0,113,139,24203,19288,137,26,24924,18339
103,11,1,0,0,3,1,0,56,56,24204,19288,56,90,24927,18339
104,11,1,1,2,1,2,1,110,87,24205,19289,131,4,24928,18340
105,11,0,1,1,0,0,3,201,133,24205,19290,237,167,24928,18343
106,11,2,2,2,1,2,1,9,8,24207,19292,5,51,24929,18344
107,11,2,0,0,3,1,0,288,133,24209,19292,286,26,24932,18344
108,11,0,0,2,1,2,1,182,147,24209,19292,210,180,24933,18345
109,11,0,1,1,0,0,3,221,122,24209,19293,261,194,24933,18348
110,12,1,0,0,3,1,0,177,150,24210,19293,208,162,24936,18348
111,12,0,5,1,0,0,3,49,45,24210,19298,58,278,24936,18351
112,12,6,0,0,3,1,0,185,77,24216,19298,203,68,24939,18351
113,12,1,1,2,1,2,1,202,134,24217,19299,238,5,24940,18352
114,12,2,1,0,3,1,0,81,83,24219,19300,124,137,24943,18352
115,12,3,0,0,3,1,0,44,69,24222,19300,44,5,24946,18352
116,12,1,0,0,3,1,0,205,134,24223,19300,249,29,24949,18352
117,12,5,0,0,3,1,0,229,137,24228,19300,256,102,24952,18352
118,12,0,3,1,0,0,3,56,81,24228,19303,50,193,24952,18355
119,12,0,5,1,0,0,3,219,127,24228,19308,253,200,24952,18358
120,13,3,1,0,3,1,0,224,123,24231,19309,264,180,24955,18358
121,13,1,1,2,1,2,1,8,5,24232,19310,10,181,24956,18359
122,13,4,1,0,3,1,0,339,91,24236,19311,334,90,24959,18359
123,13,3,1,0,3,1,0,59,57,24239,19312,59,26,24962,18359
124,13,1,1,2,1,2,1,111,88,24240,19313,132,52,24963,18360
125,13,2,1,0,3,1,0,11,9,24242,19314,8,167,24966,18360
126,13,0,0,2,1,2,1,182,147,24242,19314,211,27,24967,18361
127,13,1,1,2,1,2,1,114,140,24243,19315,138,148,24968,18362
128,13,0,0,2,1,2,1,288,133,24243,19315,287,146,24969,18363
129,13,1,1,2,1,2,1,194,138,24244,19316,247,195,24970,18364
130,14,2,2,2,1,2,1,221,129,24246,19318,254,6,24971,18365
131,14,2,1,0,3,1,0,179,151,24248,19319,211,90,24974,18365
132,14,1,0,0,3,1,0,115,140,24249,19319,141,162,24977,18365
133,14,3,1,0,3,1,0,62,58,24252,19320,62,137,24980,18365
134,14,0,2,1,0,0,3,56,83,24252,19322,50,8,24980,18368
135,14,3,0,0,3,1,0,205,134,24255,19322,241,193,24983,18368
136,14,3,0,0,3,1,0,47,69,24258,19322,47,52,24986,18368
137,14,0,5,1,0,0,3,205,139,24258,19327,249,203,24986,18371
138,14,1,0,0,3,1,0,230,137,24259,19327,259,68,24989,18371
139,14,1,2,1,0,0,3,186,79,24260,19329,203,281,24989,18374
140,15,0,0,2,1,2,1,11,9,24260,19329,9,103,24990,18375
141,15,2,1,0,3,1,0,10,6,24262,19330,13,29,24993,18375
142,15,3,0,0,3,1,0,197,138,24265,19330,250,180,24996,18375
143,15,1,2,1,0,0,3,50,47,24266,19332,58,170,24996,18378
144,15,0,0,2,1,2,1,111,88,24266,19332,133,147,24997,18379
145,15,1,2,1,0,0,3,289,135,24267,19334,287,196,24997,18382
146,15,0,3,1,0,0,3,56,86,24267,19337,50,198,24997,18385
147,15,1,0,0,3,1,0,82,83,24268,19337,127,181,25000,18385
148,15,1,2,1,0,0,3,183,149,24269,19339,211,151,25000,18388
149,15,2,0,0,3,1,0,341,91,24271,19339,337,26,25003,18388
150,16,3,2,0,3,1,0,65,60,24274,19341,65,162,25006,18388
151,16,2,1,0,3,1,0,13,10,24276,19342,12,281,25009,18388
152,16,1,0,0,3,1,0,225,123,24277,19342,267,137,25012,18388
153,16,1,0,0,3,1,0,187,79,24278,19342,206,52,25015,18388
154,16,3,1,0,3,1,0,208,140,24281,19343,252,27,25018,18388
155,16,2,0,0,3,1,0,181,151,24283,19343,214,8,25021,18388
156,16,0,1,1,0,0,3,47,70,24283,19344,47,71,25021,18391
157,16,1,1,2,1,2,1,222,130,24284,19345,255,91,25022,18392
158,16,1,2,1,0,0,3,116,142,24285,19347,141,206,25022,18395
159,16,1,1,2,1,2,1,206,135,24286,19348,242,199,25023,18396
160,17,0,3,1,0,0,3,197,141,24286,19351,250,9,25023,18399
161,17,3,1,0,3,1,0,344,92,24289,19352,340,196,25026,18399
162,17,1,1,2,1,2,1,51,48,24290,19353,59,148,25027,18400
163,17,4,0,0,3,1,0,115,88,24294,19353,136,29,25030,18400
164,17,1,1,2,1,2,1,57,87,24295,19354,51,171,25031,18401
165,17,3,2,0,3,1,0,190,81,24298,19356,209,26,25034,18401
166,17,2,0,0,3,1,0,185,149,24300,19356,214,103,25037,18401
167,17,1,2,1,0,0,3,11,8,24301,19358,13,209,25037,18404
168,17,1,2,1,0,0,3,83,85,24302,19360,127,154,25037,18407
169,17,3,0,0,3,1,0,233,137,24305,19360,262,180,25040,18407
170,18,0,4,1,0,0,3,222,134,24305,19364,255,184,25040,18410
171,18,1,4,1,0,0,3,182,155,24306,19368,214,284,25040,18413
172,18,0,0,2,1,2,1,116,142,24306,19368,142,72,25041,18414
173,18,3,0,0,3,1,0,68,60,24309,19368,68,196,25044,18414
174,18,1,3,1,0,0,3,207,138,24310,19371,242,30,25044,18417
175,18,2,1,0,3,1,0,15,11,24312,19372,15,137,25047,18417
176,18,1,0,0,3,1,0,48,70,24313,19372,50,8,25050,18417
177,18,1,0,0,3,1,0,84,85,24314,19372,130,52,25053,18417
178,18,1,0,0,3,1,0,209,140,24315,19372,255,162,25056,18417
179,18,2,0,0,3,1,0,291,135,24317,19372,290,199,25059,18417
180,19,0,1,1,0,0,3,11,9,24317,19373,13,94,25059,18420
181,19,2,1,0,3,1,0,53,49,24319,19374,62,29,25062,18420
182,19,0,2,1,0,0,3,197,143,24319,19376,250,151,25062,18423
183,19,2,1,0,3,1,0,117,89,24321,19377,139,180,25065,18423
184,19,1,1,2,1,2,1,226,124,24322,19378,268,155,25066,18424
185,19,3,1,0,3,1,0,236,138,24325,19379,265,26,25069,18424
186,19,3,0,0,3,1,0,60,87,24328,19379,54,9,25072,18424
187,19,2,1,0,3,1,0,192,82,24330,19380,212,171,25075,18424
188,19,3,1,0,3,1,0,347,93,24333,19381,343,103,25078,18424
189,19,1,2,1,0,0,3,186,151,24334,19383,214,212,25078,18427
190,20,0,2,1,0,0,3,15,13,24334,19385,15,75,25078,18430
191,20,0,3,1,0,0,3,182,158,24334,19388,214,202,25078,18433
192,20,0,1,1,0,0,3,116,143,24334,19389,142,199,25078,18436
193,20,1,1,2,1,2,1,69,61,24335,19390,69,31,25079,18437
194,20,0,0,2,1,2,1,207,138,24335,19390,243,185,25080,18438
195,20,1,0,0,3,1,0,210,140,24336,19390,258,8,25083,18438
196,20,0,1,1,0,0,3,48,71,24336,19391,50,165,25083,18441
197,20,2,0,0,3,1,0,224,134,24338,19391,258,137,25086,18441
198,20,1,1,2,1,2,1,292,136,24339,19392,291,53,25087,18442
199,20,0,1,1,0,0,3,84,86,24339,19393,130,287,25087,18445
200,21,0,2,1,0,0,3,197,145,24339,19395,250,106,25087,18448
201,21,2,0,0,3,1,0,238,138,24341,19395,268,9,25090,18448
202,21,2,2,2,1,2,1,194,84,24343,19397,213,156,25091,18449
203,21,1,1,2,1,2,1,12,10,24344,19398,14,152,25092,18450
204,21,3,1,0,3,1,0,56,50,24347,19399,65,26,25095,18450
205,21,0,2,1,0,0,3,117,91,24347,19401,139,215,25095,18453
206,21,1,2,1,0,0,3,227,126,24348,19403,268,174,25095,18456
207,21,3,0,0,3,1,0,63,87,24351,19403,57,180,25098,18456
208,21,1,1,2,1,2,1,187,152,24352,19404,215,95,25099,18457
209,21,8,0,0,3,1,0,355,93,24360,19404,346,29,25102,18457
210,22,0,2,1,0,0,3,116,145,24360,19406,142,205,25102,18460
211,22,0,1,1,0,0,3,84,87,24360,19407,130,168,25102,18463
212,22,3,1,0,3,1,0,15,11,24363,19408,17,75,25105,18463
213,22,2,1,0,3,1,0,209,139,24365,19409,246,137,25108,18463
214,22,1,0,0,3,1,0,183,158,24366,19409,217,53,25111,18463
215,22,3,2,0,3,1,0,18,15,24369,19411,18,29,25114,18463
216,22,1,0,0,3,1,0,49,71,24370,19411,53,199,25117,18463
217,22,1,0,0,3,1,0,211,140,24371,19411,261,180,25120,18463
218,22,3,1,0,3,1,0,197,85,24374,19412,216,31,25123,18463
219,22,2,1,0,3,1,0,294,137,24376,19413,294,287,25126,18463
220,23,2,1,0,3,1,0,71,62,24378,19414,72,174,25129,18463
221,23,4,0,0,3,1,0,359,93,24382,19414,349,152,25132,18463
222,23,1,0,0,3,1,0,57,50,24383,19414,68,8,25135,18463
223,23,0,3,1,0,0,3,117,94,24383,19417,139,98,25135,18466
224,23,2,1,0,3,1,0,65,88,24385,19418,60,156,25138,18466
225,23,2,1,0,3,1,0,226,135,24387,19419,261,106,25141,18466
226,23,1,0,0,3,1,0,188,152,24388,19419,218,26,25144,18466
227,23,2,1,0,3,1,0,229,127,24390,19420,271,9,25147,18466
228,23,3,1,0,3,1,0,200,146,24393,19421,253,215,25150,18466
229,23,2,2,2,1,2,1,240,140,24395,19423,269,186,25151,18467
230,24,6,3,0,3,1,0,246,143,24401,19426,272,31,25154,18467
231,24,0,3,1,0,0,3,229,130,24401,19429,271,290,25154,18470
232,24,0,2,1,0,0,3,15,13,24401,19431,17,183,25154,18473
233,24,2,1,0,3,1,0,211,140,24403,19432,249,53,25157,18473
234,24,0,1,1,0,0,3,211,141,24403,19433,261,140,25157,18476
235,24,0,2,1,0,0,3,18,17,24403,19435,18,171,25157,18479
236,24,0,1,1,0,0,3,183,159,24403,19436,217,78,25157,18482
237,24,3,2,0,3,1,0,119,147,24406,19438,145,98,25160,18482
238,24,3,2,0,3,1,0,200,87,24409,19440,219,215,25163,18482
239,24,0,0,2,1,2,1,49,71,24409,19440,54,30,25164,18483
240,25,2,2,2,1,2,1,228,137,24411,19442,262,206,25165,18484
241,25,0,1,1,0,0,3,188,153,24411,19443,218,293,25165,18487
242,25,0,4,1,0,0,3,57,54,24411,19447,68,189,25165,18490
243,25,3,2,0,3,1,0,203,148,24414,19449,256,8,25168,18490
244,25,3,2,0,3,1,0,74,64,24417,19451,75,156,25171,18490
245,25,0,0,2,1,2,1,117,94,24417,19451,140,107,25172,18491
246,25,0,1,1,0,0,3,65,89,24417,19452,60,155,25172,18494
247,25,2,1,0,3,1,0,20,18,24419,19453,21,26,25175,18494
248,25,2,2,2,1,2,1,86,89,24421,19455,131,200,25176,18495
249,25,0,2,1,0,0,3,294,139,24421,19457,294,177,25176,18498
250,26,4,0,0,3,1,0,204,87,24425,19457,222,30,25179,18498
251,26,5,2,0,3,1,0,364,95,24430,19459,352,9,25182,18498
252,26,0,0,2,1,2,1,15,13,24430,19459,18,141,25183,18499
253,26,0,1,1,0,0,3,57,55,24430,19460,68,186,25183,18502
254,26,2,2,2,1,2,1,121,149,24432,19462,146,178,25184,18503
255,26,1,1,2,1,2,1,212,141,24433,19463,250,79,25185,18504
256,26,1,0,0,3,1,0,50,71,24434,19463,57,31,25188,18504
257,26,1,1,2,1,2,1,212,142,24435,19464,262,99,25189,18505
258,26,2,2,2,1,2,1,231,132,24437,19466,272,216,25190,18506
259,26,1,0,0,3,1,0,247,143,24438,19466,275,171,25193,18506
260,27,0,0,2,1,2,1,20,18,24438,19466,22,156,25194,18507
261,27,3,3,2,1,2,1,191,156,24441,19469,219,190,25195,18508
262,27,2,0,0,3,1,0,76,64,24443,19469,78,107,25198,18508
263,27,2,2,2,1,2,1,119,96,24445,19471,141,32,25199,18509
264,27,1,2,1,0,0,3,232,134,24446,19473,272,56,25199,18512
265,27,0,1,1,0,0,3,86,90,24446,19474,131,11,25199,18515
266,27,2,0,0,3,1,0,185,159,24448,19474,220,26,25202,18515
267,27,0,0,2,1,2,1,203,148,24448,19474,257,157,25203,18516
268,27,1,1,2,1,2,1,295,140,24449,19475,295,187,25204,18517
269,27,3,0,0,3,1,0,367,95,24452,19475,355,206,25207,18517
270,28,2,1,0,3,1,0,214,143,24454,19476,265,200,25210,18517
271,28,2,1,0,3,1,0,206,88,24456,19477,225,171,25213,18517
272,28,0,2,1,0,0,3,50,73,24456,19479,57,296,25213,18520
273,28,0,2,1,0,0,3,15,15,24456,19481,18,181,25213,18523
274,28,3,0,0,3,1,0,60,55,24459,19481,71,79,25216,18523
275,28,1,1,2,1,2,1,66,90,24460,19482,61,142,25217,18524
276,28,2,2,2,1,2,1,230,139,24462,19484,263,31,25218,18525
277,28,2,0,0,3,1,0,123,149,24464,19484,149,9,25221,18525
278,28,1,1,2,1,2,1,213,142,24465,19485,251,217,25222,18526
279,28,1,1,2,1,2,1,248,144,24466,19486,276,100,25223,18527
280,29,1,3,1,0,0,3,21,21,24467,19489,22,193,25223,18530
281,29,5,0,0,3,1,0,372,95,24472,19489,358,32,25226,18530
282,29,0,0,2,1,2,1,203,148,24472,19489,258,57,25227,18531
283,29,1,1,2,1,2,1,77,65,24473,19490,79,12,25228,18532
284,29,1,1,2,1,2,1,233,135,24474,19491,273,157,25229,18533
285,29,1,0,0,3,1,0,87,90,24475,19491,134,26,25232,18533
286,29,1,1,2,1,2,1,186,160,24476,19492,221,188,25233,18534
287,29,2,5,1,0,0,3,121,101,24478,19497,141,160,25233,18537
288,29,1,0,0,3,1,0,296,140,24479,19497,298,107,25236,18537
289,29,1,2,1,0,0,3,192,158,24480,19499,219,209,25236,18540
290,30,2,1,0,3,1,0,208,89,24482,19500,228,200,25239,18540
291,30,0,2,1,0,0,3,203,150,24482,19502,258,184,25239,18543
292,30,1,1,2,1,2,1,16,16,24483,19503,19,27,25240,18544
293,30,3,0,0,3,1,0,63,55,24486,19503,74,107,25243,18544
294,30,2,2,2,1,2,1,215,144,24488,19505,252,32,25244,18545
295,30,2,2,2,1,2,1,194,160,24490,19507,220,10,25245,18546
296,30,1,2,1,0,0,3,215,145,24491,19509,265,299,25245,18549
297,30,1,1,2,1,2,1,67,91,24492,19510,62,101,25246,18550
298,30,2,0,0,3,1,0,232,139,24494,19510,266,79,25249,18550
299,30,2,3,1,0,0,3,250,147,24496,19513,276,220,25249,18553
300,31,2,1,0,3,1,0,374,96,24498,19514,361,57,25252,18553
301,31,1,3,1,0,0,3,78,68,24499,19517,79,212,25252,18556
302,31,2,1,0,3,1,0,123,102,24501,19518,144,171,25255,18556
303,31,1,3,1,0,0,3,124,152,24502,19521,149,160,25255,18559
304,31,0,1,1,0,0,3,233,136,24502,19522,273,15,25255,18562
305,31,0,3,1,0,0,3,87,93,24502,19525,134,191,25255,18565
306,31,2,2,2,1,2,1,23,23,24504,19527,23,33,25256,18566
307,31,0,2,1,0,0,3,50,75,24504,19529,57,163,25256,18569
308,31,2,0,0,3,1,0,298,140,24506,19529,301,142,25259,18569
309,31,1,1,2,1,2,1,187,161,24507,19530,222,194,25260,18570
310,32,1,1,2,1,2,1,233,140,24508,19531,267,300,25261,18571
311,32,2,1,0,3,1,0,210,90,24510,19532,231,101,25264,18571
312,32,3,0,0,3,1,0,19,16,24513,19532,22,107,25267,18571
313,32,1,1,2,1,2,1,64,56,24514,19533,75,11,25268,18572
314,32,2,1,0,3,1,0,205,151,24516,19534,261,200,25271,18572
315,32,4,0,0,3,1,0,127,102,24520,19534,147,27,25274,18572
316,32,0,1,1,0,0,3,194,161,24520,19535,220,35,25274,18575
317,32,1,1,2,1,2,1,216,146,24521,19536,266,185,25275,18576
318,32,0,5,1,0,0,3,67,96,24521,19541,62,223,25275,18579
319,32,0,0,2,1,2,1,250,147,24521,19541,277,161,25276,18580
320,33,1,1,2,1,2,1,65,57,24522,19542,76,164,25277,18581
321,33,3,0,0,3,1,0,301,140,24525,19542,304,15,25280,18581
322,33,2,2,2,1,2,1,235,138,24527,19544,274,80,25281,18582
323,33,1,1,2,1,2,1,88,94,24528,19545,135,36,25282,18583
324,33,1,2,1,0,0,3,188,163,24529,19547,222,36,25282,18586
325,33,0,1,1,0,0,3,23,24,24529,19548,23,194,25282,18589
326,33,1,3,1,0,0,3,216,147,24530,19551,252,174,25282,18592
327,33,2,3,1,0,0,3,52,78,24532,19554,57,215,25282,18595
328,33,7,1,0,3,1,0,381,97,24539,19555,364,194,25285,18595
329,33,0,0,2,1,2,1,124,152,24539,19555,150,143,25286,18596
330,34,1,1,2,1,2,1,89,95,24540,19556,136,186,25287,18597
331,34,2,5,1,0,0,3,80,73,24542,19561,79,226,25287,18600
332,34,5,1,0,3,1,0,255,148,24547,19562,280,200,25290,18600
333,34,3,1,0,3,1,0,22,17,24550,19563,25,11,25293,18600
334,34,3,1,0,3,1,0,130,103,24553,19564,150,194,25296,18600
335,34,1,1,2,1,2,1,68,97,24554,19565,63,108,25297,18601
336,34,2,0,0,3,1,0,196,161,24556,19565,223,57,25300,18601
337,34,1,0,0,3,1,0,217,146,24557,19565,269,161,25303,18601
338,34,2,1,0,3,1,0,235,141,24559,19566,270,27,25306,18601
339,34,0,1,1,0,0,3,205,152,24559,19567,261,303,25306,18604
340,35,0,1,1,0,0,3,216,148,24559,19568,252,197,25306,18607
341,35,2,0,0,3,1,0,303,140,24561,19568,307,101,25309,18607
342,35,3,1,0,3,1,0,208,153,24564,19569,264,36,25312,18607
343,35,3,1,0,3,1,0,238,139,24567,19570,277,36,25315,18607
344,35,0,0,2,1,2,1,210,90,24567,19570,232,16,25316,18608
345,35,1,1,2,1,2,1,24,25,24568,19571,24,165,25317,18609
346,35,3,1,0,3,1,0,55,79,24571,19572,60,108,25320,18609
347,35,2,1,0,3,1,0,190,164,24573,19573,225,143,25323,18609
348,35,1,1,2,1,2,1,66,58,24574,19574,77,216,25324,18610
349,35,2,2,2,1,2,1,383,99,24576,19576,365,81,25325,18611
350,36,2,2,2,1,2,1,24,19,24578,19578,26,304,25326,18612
351,36,1,3,1,0,0,3,236,144,24579,19581,270,177,25326,18615
352,36,3,0,0,3,1,0,306,140,24582,19581,310,27,25329,18615
353,36,1,2,1,0,0,3,125,154,24583,19583,150,197,25329,18618
354,36,3,1,0,3,1,0,83,74,24586,19584,82,81,25332,18618
355,36,1,2,1,0,0,3,69,99,24587,19586,63,60,25332,18621
356,36,0,2,1,0,0,3,89,97,24587,19588,136,164,25332,18624
357,36,2,1,0,3,1,0,192,165,24589,19589,228,11,25335,18624
358,36,2,3,1,0,0,3,198,164,24591,19592,223,203,25335,18627
359,36,2,1,0,3,1,0,257,149,24593,19593,283,165,25338,18627
360,37,3,3,2,1,2,1,133,106,24596,19596,151,217,25339,18628
361,37,2,0,0,3,1,0,26,19,24598,19596,29,36,25342,18628
362,37,0,2,1,0,0,3,66,60,24598,19598,77,104,25342,18631
363,37,4,2,0,3,1,0,212,155,24602,19600,267,143,25345,18631
364,37,2,1,0,3,1,0,240,140,24604,19601,280,36,25348,18631
365,37,1,0,0,3,1,0,211,90,24605,19601,235,197,25351,18631
366,37,1,1,2,1,2,1,217,149,24606,19602,253,28,25352,18632
367,37,4,1,0,3,1,0,221,147,24610,19603,272,108,25355,18632
368,37,0,2,1,0,0,3,383,101,24610,19605,365,189,25355,18635
369,37,3,2,0,3,1,0,27,27,24613,19607,27,226,25358,18635
370,38,0,0,2,1,2,1,125,154,24613,19607,151,305,25359,18636
371,38,2,1,0,3,1,0,85,75,24615,19608,85,60,25362,18636
372,38,3,2,0,3,1,0,309,142,24618,19610,313,165,25365,18636
373,38,2,1,0,3,1,0,259,150,24620,19611,286,16,25368,18636
374,38,0,4,1,0,0,3,69,103,24620,19615,63,180,25368,18639
375,38,1,0,0,3,1,0,90,97,24621,19615,139,11,25371,18639
376,38,1,1,2,1,2,1,193,166,24622,19616,229,165,25372,18640
377,38,5,0,0,3,1,0,241,144,24627,19616,273,203,25375,18640
378,38,2,1,0,3,1,0,200,165,24629,19617,226,81,25378,18640
379,38,0,3,1,0,0,3,55,82,24629,19620,60,200,25378,18643
0,1,4,0,0,3,1,0,263,150,24633,19620,289,143,25381,18643
1,1,1,3,1,0,0,3,91,100,24634,19623,139,203,25381,18646
2,1,3,4,1,0,0,3,69,64,24637,19627,77,3,25381,18649
3,1,3,1,0,3,1,0,243,141,24640,19628,283,189,25384,18649
4,1,1,2,1,0,0,3,218,151,24641,19630,253,39,25384,18652
5,1,0,1,1,0,0,3,221,148,24641,19631,272,66,25384,18655
6,1,2,1,0,3,1,0,243,145,24643,19632,276,81,25387,18655
7,1,2,0,0,3,1,0,311,142,24645,19632,316,16,25390,18655
8,1,0,2,1,0,0,3,212,157,24645,19634,267,14,25390,18658
9,1,3,0,0,3,1,0,386,101,24648,19634,368,108,25393,18658
10,2,1,0,0,3,1,0,99,91,24649,19634,114,226,25396,18658
11,2,1,3,1,0,0,3,134,109,24650,19637,151,308,25396,18661
12,2,1,2,1,0,0,3,27,21,24651,19639,29,168,25396,18664
13,2,1,1,2,1,2,1,126,155,24652,19640,152,166,25397,18665
14,2,2,0,0,3,1,0,87,75,24654,19640,88,104,25400,18665
15,2,0,0,2,1,2,1,211,90,24654,19640,236,204,25401,18666
16,2,1,0,0,3,1,0,194,166,24655,19640,232,60,25404,18666
17,2,1,1,2,1,2,1,28,28,24656,19641,28,198,25405,18667
18,2,2,1,0,3,1,0,202,166,24658,19642,229,180,25408,18667
19,2,3,1,0,3,1,0,3,1,24661,19643,3,217,25411,18667
20,3,2,0,0,3,1,0,313,142,24663,19643,319,14,25414,18667
21,3,3,1,0,3,1,0,389,102,24666,19644,371,60,25417,18667
22,3,4,1,0,3,1,0,31,22,24670,19645,32,66,25420,18667
23,3,0,0,2,1,2,1,218,151,24670,19645,254,199,25421,18668
24,3,1,1,2,1,2,1,92,101,24671,19646,140,109,25422,18669
25,3,0,4,1,0,0,3,221,152,24671,19650,272,42,25422,18672
26,3,1,0,0,3,1,0,203,166,24672,19650,232,3,25425,18672
27,3,3,0,0,3,1,0,246,141,24675,19650,286,81,25428,18672
28,3,2,1,0,3,1,0,214,158,24677,19651,270,203,25431,18672
29,3,2,2,2,1,2,1,265,152,24679,19653,290,190,25432,18673
30,4,0,1,1,0,0,3,313,143,24679,19654,319,169,25432,18676
31,4,2,4,1,0,0,3,5,5,24681,19658,3,311,25432,18679
32,4,1,0,0,3,1,0,70,64,24682,19658,80,204,25435,18679
33,4,0,2,1,0,0,3,87,77,24682,19660,88,112,25435,18682
34,4,1,2,1,0,0,3,135,111,24683,19662,151,146,25435,18685
35,4,0,1,1,0,0,3,99,92,24683,19663,114,171,25435,18688
36,4,2,3,1,0,0,3,30,31,24685,19666,28,107,25435,18691
37,4,0,0,2,1,2,1,243,145,24685,19666,277,17,25436,18692
38,4,2,0,0,3,1,0,196,166,24687,19666,235,180,25439,18692
39,4,2,3,1,0,0,3,213,93,24689,19669,236,220,25439,18695
40,5,2,1,0,3,1,0,223,153,24691,19670,275,190,25442,18695
41,5,4,0,0,3,1,0,393,102,24695,19670,374,199,25445,18695
42,5,2,2,2,1,2,1,128,157,24697,19672,153,227,25446,18696
43,5,2,3,1,0,0,3,33,25,24699,19675,32,207,25446,18699
44,5,1,3,1,0,0,3,88,80,24700,19678,88,63,25446,18702
45,5,1,1,2,1,2,1,219,152,24701,19679,255,15,25447,18703
46,5,1,1,2,1,2,1,204,167,24702,19680,233,204,25448,18704
47,5,0,0,2,1,2,1,92,101,24702,19680,141,67,25449,18705
48,5,3,3,2,1,2,1,217,161,24705,19683,271,4,25450,18706
49,5,4,0,0,3,1,0,269,152,24709,19683,293,81,25453,18706
50,6,1,1,2,1,2,1,214,94,24710,19684,237,5,25454,18707
51,6,2,1,0,3,1,0,248,142,24712,19685,289,107,25457,18707
52,6,0,0,2,1,2,1,70,64,24712,19685,81,147,25458,18708
53,6,1,0,0,3,1,0,220,152,24713,19685,258,169,25461,18708
54,6,0,0,2,1,2,1,99,92,24713,19685,115,43,25462,18709
55,6,2,1,0,3,1,0,245,146,24715,19686,280,112,25465,18709
56,6,3,1,0,3,1,0,33,32,24718,19687,31,17,25468,18709
57,6,1,3,1,0,0,3,197,169,24719,19690,235,314,25468,18712
58,6,1,3,1,0,0,3,136,114,24720,19693,151,183,25468,18715
59,6,4,2,0,3,1,0,317,145,24724,19695,322,220,25471,18715
60,7,1,2,1,0,0,3,93,103,24725,19697,141,172,25471,18718
61,7,0,1,1,0,0,3,214,95,24725,19698,237,66,25471,18721
62,7,2,3,1,0,0,3,206,170,24727,19701,233,202,25471,18724
63,7,2,1,0,3,1,0,35,26,24729,19702,35,190,25474,18724
64,7,1,0,0,3,1,0,218,161,24730,19702,274,207,25477,18724
65,7,2,2,2,1,2,1,130,159,24732,19704,154,172,25478,18725
66,7,0,3,1,0,0,3,88,83,24732,19707,88,230,25478,18728
67,7,3,2,0,3,1,0,272,154,24735,19709,296,15,25481,18728
68,7,0,0,2,1,2,1,5,5,24735,19709,4,82,25482,18729
69,7,4,1,0,3,1,0,397,103,24739,19710,377,67,25485,18729
70,8,2,0,0,3,1,0,247,146,24741,19710,283,204,25488,18729
71,8,0,3,1,0,0,3,223,156,24741,19713,275,317,25488,18732
72,8,0,1,1,0,0,3,70,65,24741,19714,81,85,25488,18735
73,8,1,0,0,3,1,0,131,159,24742,19714,157,17,25491,18735
74,8,1,1,2,1,2,1,318,146,24743,19715,323,108,25492,18736
75,8,0,0,2,1,2,1,99,92,24743,19715,116,184,25493,18737
76,8,3,0,0,3,1,0,36,32,24746,19715,34,43,25496,18737
77,8,1,1,2,1,2,1,198,170,24747,19716,236,148,25497,18738
78,8,3,0,0,3,1,0,223,152,24750,19716,261,5,25500,18738
79,8,3,0,0,3,1,0,251,142,24753,19716,292,220,25503,18738
80,9,1,1,2,1,2,1,207,171,24754,19717,234,173,25504,18739
81,9,3,1,0,3,1,0,254,143,24757,19718,295,202,25507,18739
82,9,1,0,0,3,1,0,36,26,24758,19718,38,43,25510,18739
83,9,2,2,2,1,2,1,72,67,24760,19720,82,16,25511,18740
84,9,1,1,2,1,2,1,137,115,24761,19721,152,173,25512,18741
85,9,0,0,2,1,2,1,5,5,24761,19721,5,68,25513,18742
86,9,3,0,0,3,1,0,221,161,24764,19721,277,108,25516,18742
87,9,2,0,0,3,1,0,274,154,24766,19721,299,112,25519,18742
88,9,1,2,1,0,0,3,215,97,24767,19723,237,193,25519,18745
89,9,5,0,0,3,1,0,402,103,24772,19723,380,230,25522,18745
90,10,2,0,0,3,1,0,320,146,24774,19723,326,5,25525,18745
91,10,5,0,0,3,1,0,407,103,24779,19723,383,17,25528,18745
92,10,0,0,2,1,2,1,131,159,24779,19723,158,86,25529,18746
93,10,1,2,1,0,0,3,89,85,24780,19725,88,210,25529,18749
94,10,4,0,0,3,1,0,97,103,24784,19725,144,148,25532,18749
95,10,1,1,2,1,2,1,100,93,24785,19726,117,67,25533,18750
96,10,2,1,0,3,1,0,38,33,24787,19727,37,204,25536,18750
97,10,2,0,0,3,1,0,225,152,24789,19727,264,184,25539,18750
98,10,1,1,2,1,2,1,248,147,24790,19728,284,194,25540,18751
99,10,0,1,1,0,0,3,223,157,24790,19729,275,223,25540,18754
100,11,1,1,2,1,2,1,6,6,24791,19730,6,203,25541,18755
101,11,1,2,1,0,0,3,73,69,24792,19732,82,233,25541,18758
102,11,1,2,1,0,0,3,37,28,24793,19734,38,111,25541,18761
103,11,1,1,2,1,2,1,138,116,24794,19735,153,17,25542,18762
104,11,1,0,0,3,1,0,255,143,24795,19735,298,112,25545,18762
105,11,2,2,2,1,2,1,217,99,24797,19737,238,44,25546,18763
106,11,0,3,1,0,0,3,207,174,24797,19740,234,176,25546,18766
107,11,0,2,1,0,0,3,198,172,24797,19742,236,71,25546,18769
108,11,0,1,1,0,0,3,221,162,24797,19743,277,176,25546,18772
109,11,0,2,1,0,0,3,274,156,24797,19745,299,320,25546,18775
110,12,2,1,0,3,1,0,409,104,24799,19746,386,210,25549,18775
111,12,1,1,2,1,2,1,321,147,24800,19747,327,185,25550,18776
112,12,1,2,1,0,0,3,132,161,24801,19749,158,197,25550,18779
113,12,0,4,1,0,0,3,89,89,24801,19753,88,8,25550,18782
114,12,1,0,0,3,1,0,224,157,24802,19753,278,17,25553,18782
115,12,1,0,0,3,1,0,101,93,24803,19753,120,204,25556,18782
116,12,1,1,2,1,2,1,39,34,24804,19754,38,149,25557,18783
117,12,5,0,0,3,1,0,102,103,24809,19754,147,86,25560,18783
118,12,4,3,0,3,1,0,252,150,24813,19757,287,67,25563,18783
119,12,3,0,0,3,1,0,228,152,24816,19757,267,223,25566,18783
120,13,0,0,2,1,2,1,255,143,24816,19757,299,18,25567,18784
121,13,2,4,1,0,0,3,140,120,24818,19761,153,236,25567,18787
122,13,1,0,0,3,1,0,74,69,24819,19761,85,176,25570,18787
123,13,0,1,1,0,0,3,6,7,24819,19762,6,179,25570,18790
124,13,2,0,0,3,1,0,254,150,24821,19762,290,71,25573,18790
125,13,0,1,1,0,0,3,207,175,24821,19763,234,20,25573,18793
126,13,0,0,2,1,2,1,221,162,24821,19763,278,113,25574,18794
127,13,2,0,0,3,1,0,276,156,24823,19763,302,44,25577,18794
128,13,1,1,2,1,2,1,199,173,24824,19764,237,112,25578,18795
129,13,0,4,1,0,0,3,217,103,24824,19768,238,323,25578,18798
130,14,1,0,0,3,1,0,322,147,24825,19768,330,203,25581,18798
131,14,1,0,0,3,1,0,410,104,24826,19768,389,149,25584,18798
132,14,0,1,1,0,0,3,132,162,24826,19769,158,207,25584,18801
133,14,0,0,2,1,2,1,89,89,24826,19769,89,186,25585,18802
134,14,1,1,2,1,2,1,103,104,24827,19770,148,68,25586,18803
135,14,2,1,0,3,1,0,103,94,24829,19771,123,86,25589,18803
136,14,0,1,1,0,0,3,39,35,24829,19772,38,11,25589,18806
137,14,2,2,2,1,2,1,230,154,24831,19774,268,198,25590,18807
138,14,2,0,0,3,1,0,226,157,24833,19774,281,210,25593,18807
139,14,1,3,1,0,0,3,38,31,24834,19777,38,226,25593,18810
140,15,3,0,0,3,1,0,257,150,24837,19777,293,112,25596,18810
141,15,2,2,2,1,2,1,257,145,24839,19779,300,237,25597,18811
142,15,1,1,2,1,2,1,75,70,24840,19780,86,114,25598,18812
143,15,0,0,2,1,2,1,140,120,24840,19780,154,180,25599,18813
144,15,1,2,1,0,0,3,218,105,24841,19782,238,179,25599,18816
145,15,3,0,0,3,1,0,9,7,24844,19782,9,20,25602,18816
146,15,2,2,2,1,2,1,209,177,24846,19784,235,45,25603,18817
147,15,0,0,2,1,2,1,276,156,24846,19784,303,72,25604,18818
148,15,1,4,1,0,0,3,200,177,24847,19788,237,21,25604,18821
149,15,2,2,2,1,2,1,223,164,24849,19790,279,324,25605,18822
150,16,0,2,1,0,0,3,38,33,24849,19792,38,210,25605,18825
151,16,0,0,2,1,2,1,226,157,24849,19792,282,69,25606,18826
152,16,0,1,1,0,0,3,230,155,24849,19793,268,213,25606,18829
153,16,3,2,0,3,1,0,226,166,24852,19795,282,203,25609,18829
154,16,1,2,1,0,0,3,133,164,24853,19797,158,14,25609,18832
155,16,2,1,0,3,1,0,91,90,24855,19798,92,86,25612,18832
156,16,0,2,1,0,0,3,322,149,24855,19800,330,201,25612,18835
157,16,3,2,0,3,1,0,106,106,24858,19802,151,226,25615,18835
158,16,0,1,1,0,0,3,103,95,24858,19803,123,152,25615,18838
159,16,1,1,2,1,2,1,40,36,24859,19804,39,325,25616,18839
160,17,2,0,0,3,1,0,202,177,24861,19804,240,45,25619,18839
161,17,1,2,1,0,0,3,141,122,24862,19806,154,23,25619,18842
162,17,2,2,2,1,2,1,42,38,24864,19808,40,115,25620,18843
163,17,1,1,2,1,2,1,258,146,24865,19809,301,73,25621,18844
164,17,1,2,1,0,0,3,76,72,24866,19811,86,189,25621,18847
165,17,1,1,2,1,2,1,219,106,24867,19812,239,181,25622,18848
166,17,1,0,0,3,1,0,10,7,24868,19812,12,112,25625,18848
167,17,2,2,2,1,2,1,211,179,24870,19814,236,238,25626,18849
168,17,2,1,0,3,1,0,259,151,24872,19815,296,226,25629,18849
169,17,5,1,0,3,1,0,415,105,24877,19816,392,179,25632,18849
170,18,2,1,0,3,1,0,105,96,24879,19817,126,21,25635,18849
171,18,2,3,1,0,0,3,12,10,24881,19820,12,216,25635,18852
172,18,1,1,2,1,2,1,227,158,24882,19821,283,204,25636,18853
173,18,3,0,0,3,1,0,325,149,24885,19821,333,210,25639,18853
174,18,2,1,0,3,1,0,135,165,24887,19822,161,152,25642,18853
175,18,0,0,2,1,2,1,38,33,24887,19822,39,70,25643,18854
176,18,2,0,0,3,1,0,108,106,24889,19822,154,179,25646,18854
177,18,2,1,0,3,1,0,143,123,24891,19823,157,201,25649,18854
178,18,1,0,0,3,1,0,277,156,24892,19823,306,189,25652,18854
179,18,0,4,1,0,0,3,91,94,24892,19827,92,328,25652,18857
180,19,1,1,2,1,2,1,77,73,24893,19828,87,227,25653,18858
181,19,1,2,1,0,0,3,259,148,24894,19830,301,155,25653,18861
182,19,0,2,1,0,0,3,219,108,24894,19832,239,89,25653,18864
183,19,1,1,2,1,2,1,231,156,24895,19833,269,239,25654,18865
184,19,1,0,0,3,1,0,416,105,24896,19833,395,112,25657,18865
185,19,2,2,2,1,2,1,107,98,24898,19835,127,116,25658,18866
186,19,4,0,0,3,1,0,206,177,24902,19835,243,14,25661,18866
187,19,3,0,0,3,1,0,262,151,24905,19835,299,45,25664,18866
188,19,2,0,0,3,1,0,44,38,24907,19835,43,181,25667,18866
189,19,1,1,2,1,2,1,227,167,24908,19836,283,24,25668,18867
190,20,1,3,1,0,0,3,136,168,24909,19839,161,219,25668,18870
191,20,1,1,2,1,2,1,326,150,24910,19840,334,74,25669,18871
192,20,0,3,1,0,0,3,38,36,24910,19843,39,331,25669,18874
193,20,0,1,1,0,0,3,143,124,24910,19844,157,207,25669,18877
194,20,1,0,0,3,1,0,228,158,24911,19844,286,189,25672,18877
195,20,0,1,1,0,0,3,108,107,24911,19845,154,204,25672,18880
196,20,1,1,2,1,2,1,92,95,24912,19846,93,180,25673,18881
197,20,1,2,1,0,0,3,212,181,24913,19848,236,24,25673,18884
198,20,1,1,2,1,2,1,278,157,24914,19849,307,211,25674,18885
199,20,3,1,0,3,1,0,15,11,24917,19850,15,70,25677,18885
200,21,2,1,0,3,1,0,261,149,24919,19851,304,24,25680,18885
201,21,9,0,0,3,1,0,425,105,24928,19851,398,89,25683,18885
202,21,1,5,1,0,0,3,220,113,24929,19856,239,27,25683,18888
203,21,0,1,1,0,0,3,15,12,24929,19857,15,158,25683,18891
204,21,1,1,2,1,2,1,108,99,24930,19858,128,182,25684,18892
205,21,0,0,2,1,2,1,206,177,24930,19858,244,181,25685,18893
206,21,1,0,0,3,1,0,78,73,24931,19858,90,112,25688,18893
207,21,0,1,1,0,0,3,136,169,24931,19859,161,230,25688,18896
208,21,1,0,0,3,1,0,228,167,24932,19859,286,45,25691,18896
209,21,1,2,1,0,0,3,263,153,24933,19861,299,242,25691,18899
210,22,1,2,1,0,0,3,279,159,24934,19863,307,222,25691,18902
211,22,2,0,0,3,1,0,94,95,24936,19863,96,211,25694,18902
212,22,0,1,1,0,0,3,143,125,24936,19864,157,77,25694,18905
213,22,2,0,0,3,1,0,230,158,24938,19864,289,14,25697,18905
214,22,1,0,0,3,1,0,45,38,24939,19864,46,189,25700,18905
215,22,2,0,0,3,1,0,233,156,24941,19864,272,116,25703,18905
216,22,0,1,1,0,0,3,38,37,24941,19865,39,245,25703,18908
217,22,0,0,2,1,2,1,212,181,24941,19865,237,71,25704,18909
218,22,4,1,0,3,1,0,429,106,24945,19866,401,204,25707,18909
219,22,1,1,2,1,2,1,109,108,24946,19867,155,208,25708,18910
220,23,4,0,0,3,1,0,265,149,24950,19867,307,182,25711,18910
221,23,1,0,0,3,1,0,79,73,24951,19867,93,45,25714,18910
222,23,2,1,0,3,1,0,222,114,24953,19868,242,158,25717,18910
223,23,1,0,0,3,1,0,207,177,24954,19868,247,24,25720,18910
224,23,2,1,0,3,1,0,110,100,24956,19869,131,230,25723,18910
225,23,1,1,2,1,2,1,16,13,24957,19870,16,182,25724,18911
226,23,2,1,0,3,1,0,328,151,24959,19871,337,331,25727,18911
227,23,2,1,0,3,1,0,265,154,24961,19872,302,27,25730,18911
228,23,0,1,1,0,0,3,136,170,24961,19873,161,115,25730,18914
229,23,0,0,2,1,2,1,228,167,24961,19873,287,90,25731,18915
230,24,1,2,1,0,0,3,95,97,24962,19875,96,233,25731,18918
231,24,1,0,0,3,1,0,430,106,24963,19875,404,189,25734,18918
232,24,1,0,0,3,1,0,39,37,24964,19875,42,116,25737,18918
233,24,1,2,1,0,0,3,46,40,24965,19877,46,74,25737,18921
234,24,2,2,2,1,2,1,235,158,24967,19879,273,212,25738,18922
235,24,2,4,1,0,0,3,111,112,24969,19883,155,17,25738,18925
236,24,1,1,2,1,2,1,213,182,24970,19884,238,78,25739,18926
237,24,0,2,1,0,0,3,143,127,24970,19886,157,225,25739,18929
238,24,3,0,0,3,1,0,210,177,24973,19886,250,208,25742,18929
239,24,1,0,0,3,1,0,231,158,24974,19886,292,245,25745,18929
240,25,2,0,0,3,1,0,18,13,24976,19886,19,45,25748,18929
241,25,2,1,0,3,1,0,330,152,24978,19887,340,90,25751,18929
242,25,2,0,0,3,1,0,281,159,24980,19887,310,24,25754,18929
243,25,3,0,0,3,1,0,82,73,24983,19887,96,182,25757,18929
244,25,1,0,0,3,1,0,223,114,24984,19887,245,115,25760,18929
245,25,2,1,0,3,1,0,230,168,24986,19888,290,158,25763,18929
246,25,0,0,2,1,2,1,136,170,24986,19888,162,28,25764,18930
247,25,0,0,2,1,2,1,265,149,24986,19888,308,183,25765,18931
248,25,2,0,0,3,1,0,112,100,24988,19888,134,204,25768,18931
249,25,0,1,1,0,0,3,265,155,24988,19889,302,334,25768,18934
250,26,0,1,1,0,0,3,95,98,24988,19890,96,211,25768,18937
251,26,1,1,2,1,2,1,47,41,24989,19891,47,226,25769,18938
252,26,3,0,0,3,1,0,433,106,24992,19891,407,17,25772,18938
253,26,1,0,0,3,1,0,40,37,24993,19891,45,182,25775,18938
254,26,1,0,0,3,1,0,144,127,24994,19891,160,74,25778,18938
255,26,2,4,1,0,0,3,237,162,24996,19895,273,81,25778,18941
256,26,1,0,0,3,1,0,112,112,24997,19895,158,189,25781,18941
257,26,1,1,2,1,2,1,214,183,24998,19896,239,117,25782,18942
258,26,1,1,2,1,2,1,211,178,24999,19897,251,234,25783,18943
259,26,2,0,0,3,1,0,225,114,25001,19897,248,245,25786,18943
260,27,1,2,1,0,0,3,137,172,25002,19899,162,337,25786,18946
261,27,2,2,2,1,2,1,84,75,25004,19901,97,213,25787,18947
262,27,2,2,2,1,2,1,114,102,25006,19903,135,25,25788,18948
263,27,0,0,2,1,2,1,144,127,25006,19903,161,116,25789,18949
264,27,1,0,0,3,1,0,266,149,25007,19903,311,45,25792,18949
265,27,1,0,0,3,1,0,232,158,25008,19903,295,28,25795,18949
266,27,5,1,0,3,1,0,335,153,25013,19904,343,158,25798,18949
267,27,2,0,0,3,1,0,283,159,25015,19904,313,211,25801,18949
268,27,1,2,1,0,0,3,231,170,25016,19906,290,186,25801,18952
269,27,3,1,0,3,1,0,21,14,25019,19907,22,204,25804,18952
270,28,2,2,2,1,2,1,49,43,25021,19909,48,246,25805,18953
271,28,2,1,0,3,1,0,42,38,25023,19910,48,17,25808,18953
272,28,1,1,2,1,2,1,96,99,25024,19911,97,82,25809,18954
273,28,1,1,2,1,2,1,226,115,25025,19912,249,190,25810,18955
274,28,2,2,2,1,2,1,239,164,25027,19914,274,75,25811,18956
275,28,0,1,1,0,0,3,265,156,25027,19915,302,229,25811,18959
276,28,1,0,0,3,1,0,215,183,25028,19915,242,90,25814,18959
277,28,3,1,0,3,1,0,214,179,25031,19916,254,117,25817,18959
278,28,1,0,0,3,1,0,284,159,25032,19916,316,182,25820,18959
279,28,3,2,0,3,1,0,115,114,25035,19918,161,337,25823,18959
280,29,1,1,2,1,2,1,233,159,25036,19919,296,159,25824,18960
281,29,0,1,1,0,0,3,266,150,25036,19920,311,216,25824,18963
282,29,0,0,2,1,2,1,84,75,25036,19920,98,26,25825,18964
283,29,0,5,1,0,0,3,137,177,25036,19925,162,214,25825,18967
284,29,1,0,0,3,1,0,145,127,25037,19925,164,45,25828,18967
285,29,2,2,2,1,2,1,23,16,25039,19927,23,29,25829,18968
286,29,3,2,0,3,1,0,338,155,25042,19929,346,186,25832,18968
287,29,1,0,0,3,1,0,115,102,25043,19929,138,116,25835,18968
288,29,1,1,2,1,2,1,232,171,25044,19930,291,205,25836,18969
289,29,3,1,0,3,1,0,436,107,25047,19931,410,234,25839,18969
290,30,0,1,1,0,0,3,214,180,25047,19932,254,249,25839,18972
291,30,2,2,2,1,2,1,286,161,25049,19934,317,76,25840,18973
292,30,0,0,2,1,2,1,42,38,25049,19934,49,191,25841,18974
293,30,0,1,1,0,0,3,96,100,25049,19935,97,185,25841,18977
294,30,0,1,1,0,0,3,226,116,25049,19936,249,120,25841,18980
295,30,2,3,1,0,0,3,117,117,25051,19939,161,232,25841,18983
296,30,0,1,1,0,0,3,215,184,25051,19940,242,340,25841,18986
297,30,2,1,0,3,1,0,267,157,25053,19941,305,17,25844,18986
298,30,2,0,0,3,1,0,241,164,25055,19941,277,90,25847,18986
299,30,4,0,0,3,1,0,53,43,25059,19941,51,82,25850,18986
300,31,2,0,0,3,1,0,234,171,25061,19941,294,234,25853,18986
301,31,1,3,1,0,0,3,339,158,25062,19944,346,48,25853,18989
302,31,2,2,2,1,2,1,44,40,25064,19946,50,215,25854,18990
303,31,3,3,2,1,2,1,87,78,25067,19949,99,206,25855,18991
304,31,1,1,2,1,2,1,146,128,25068,19950,165,217,25856,18992
305,31,2,0,0,3,1,0,25,16,25070,19950,26,120,25859,18992
306,31,1,1,2,1,2,1,116,103,25071,19951,139,233,25860,18993
307,31,1,0,0,3,1,0,216,184,25072,19951,245,116,25863,18993
308,31,1,0,0,3,1,0,234,159,25073,19951,299,186,25866,18993
309,31,2,2,2,1,2,1,438,109,25075,19953,411,30,25867,18994
310,32,0,0,2,1,2,1,96,100,25075,19953,98,27,25868,18995
311,32,2,1,0,3,1,0,119,118,25077,19954,164,249,25871,18995
312,32,2,1,0,3,1,0,288,162,25079,19955,320,17,25874,18995
313,32,0,1,1,0,0,3,137,178,25079,19956,162,79,25874,18998
314,32,0,0,2,1,2,1,226,116,25079,19956,250,83,25875,18999
315,32,3,3,2,1,2,1,56,46,25082,19959,52,91,25876,19000
316,32,2,1,0,3,1,0,243,165,25084,19960,280,159,25879,19000
317,32,0,0,2,1,2,1,214,180,25084,19960,255,186,25880,19001
318,32,3,0,0,3,1,0,270,157,25087,19960,308,191,25883,19001
319,32,5,1,0,3,1,0,271,151,25092,19961,314,340,25886,19001
320,33,3,2,0,3,1,0,99,102,25095,19963,101,206,25889,19001
321,33,2,1,0,3,1,0,341,159,25097,19964,349,79,25892,19001
322,33,1,3,1,0,0,3,147,131,25098,19967,165,237,25892,19004
323,33,0,1,1,0,0,3,234,160,25098,19968,299,123,25892,19007
324,33,2,1,0,3,1,0,27,17,25100,19969,29,191,25895,19007
325,33,1,3,1,0,0,3,57,49,25101,19972,52,189,25895,19010
326,33,3,2,0,3,1,0,122,120,25104,19974,167,27,25898,19010
327,33,0,0,2,1,2,1,216,184,25104,19974,246,234,25899,19011
328,33,0,2,1,0,0,3,116,105,25104,19976,139,218,25899,19014
329,33,3,1,0,3,1,0,441,110,25107,19977,414,217,25902,19014
330,34,2,3,1,0,0,3,236,174,25109,19980,294,252,25902,19017
331,34,0,0,2,1,2,1,44,40,25109,19980,51,31,25903,19018
332,34,1,1,2,1,2,1,88,79,25110,19981,100,84,25904,19019
333,34,1,0,0,3,1,0,138,178,25111,19981,165,48,25907,19019
334,34,5,0,0,3,1,0,276,151,25116,19981,317,17,25910,19019
335,34,3,0,0,3,1,0,237,160,25119,19981,302,91,25913,19019
336,34,2,0,0,3,1,0,272,157,25121,19981,311,159,25916,19019
337,34,1,2,1,0,0,3,289,164,25122,19983,320,119,25916,19022
338,34,3,2,0,3,1,0,246,167,25125,19985,283,340,25919,19022
339,34,2,2,2,1,2,1,216,182,25127,19987,256,218,25920,19023
340,35,1,1,2,1,2,1,58,50,25128,19988,53,238,25921,19024
341,35,1,1,2,1,2,1,442,111,25129,19989,415,187,25922,19025
342,35,0,1,1,0,0,3,236,175,25129,19990,294,82,25922,19028
343,35,0,0,2,1,2,1,147,131,25129,19990,166,124,25923,19029
344,35,0,3,1,0,0,3,116,108,25129,19993,139,20,25923,19032
345,35,1,1,2,1,2,1,247,168,25130,19994,284,28,25924,19033
346,35,3,0,0,3,1,0,125,120,25133,19994,170,48,25927,19033
347,35,2,2,2,1,2,1,218,186,25135,19996,247,207,25928,19034
348,35,2,3,1,0,0,3,228,119,25137,19999,250,221,25928,19037
349,35,2,2,2,1,2,1,343,161,25139,20001,350,235,25929,19038
350,36,0,1,1,0,0,3,272,158,25139,20002,311,192,25929,19041
351,36,1,2,1,0,0,3,89,81,25140,20004,100,343,25929,19044
352,36,0,0,2,1,2,1,44,40,25140,20004,52,160,25930,19045
353,36,3,2,0,3,1,0,141,180,25143,20006,168,84,25933,19045
354,36,2,1,0,3,1,0,101,103,25145,20007,104,31,25936,19045
355,36,1,1,2,1,2,1,238,161,25146,20008,303,120,25937,19046
356,36,1,0,0,3,1,0,28,17,25147,20008,32,218,25940,19046
357,36,1,1,2,1,2,1,217,183,25148,20009,257,92,25941,19047
358,36,1,0,0,3,1,0,277,151,25149,20009,320,191,25944,19047
359,36,0,3,1,0,0,3,289,167,25149,20012,320,255,25944,19050
360,37,0,1,1,0,0,3,236,176,25149,20013,294,87,25944,19053
361,37,2,2,2,1,2,1,149,133,25151,20015,167,21,25945,19054
362,37,5,0,0,3,1,0,282,151,25156,20015,323,82,25948,19054
363,37,4,0,0,3,1,0,347,161,25160,20015,353,124,25951,19054
364,37,2,0,0,3,1,0,230,119,25162,20015,253,28,25954,19054
365,37,1,1,2,1,2,1,248,169,25163,20016,285,121,25955,19055
366,37,4,0,0,3,1,0,446,111,25167,20016,418,48,25958,19055
367,37,3,0,0,3,1,0,275,158,25170,20016,314,187,25961,19055
368,37,0,2,1,0,0,3,58,52,25170,20018,53,210,25961,19058
369,37,2,5,1,0,0,3,220,191,25172,20023,247,241,25961,19061
370,38,2,1,0,3,1,0,46,41,25174,20024,55,92,25964,19061
371,38,1,1,2,1,2,1,90,82,25175,20025,101,222,25965,19062
372,38,0,1,1,0,0,3,141,181,25175,20026,168,194,25965,19065
373,38,2,1,0,3,1,0,103,104,25177,20027,107,160,25968,19065
374,38,1,0,0,3,1,0,290,167,25178,20027,323,192,25971,19065
375,38,0,1,1,0,0,3,125,121,25178,20028,170,34,25971,19068
376,38,2,0,0,3,1,0,240,161,25180,20028,306,218,25974,19068
377,38,2,3,1,0,0,3,30,20,25182,20031,32,258,25974,19071
378,38,3,1,0,3,1,0,119,109,25185,20032,142,343,25977,19071
379,38,3,1,0,3,1,0,220,184,25188,20033,260,235,25980,19071
0,1,0,3,1,0,0,3,230,122,25188,20036,253,261,25980,19074
1,1,0,2,1,0,0,3,290,169,25188,20038,323,90,25980,19077
2,1,3,1,0,3,1,0,93,83,25191,20039,104,194,25983,19077
3,1,1,1,2,1,2,1,61,61,25192,20040,75,161,25984,19078
4,1,1,2,1,0,0,3,104,106,25193,20042,107,225,25984,19081
5,1,0,1,1,0,0,3,248,170,25193,20043,285,213,25984,19084
6,1,2,1,0,3,1,0,242,162,25195,20044,309,28,25987,19084
7,1,2,1,0,3,1,0,284,152,25197,20045,326,121,25990,19084
8,1,1,1,2,1,2,1,59,53,25198,20046,54,37,25991,19085
9,1,3,0,0,3,1,0,449,111,25201,20046,421,21,25994,19085
10,2,6,0,0,3,1,0,353,161,25207,20046,356,82,25997,19085
11,2,0,0,2,1,2,1,125,121,25207,20046,171,242,25998,19086
12,2,1,0,0,3,1,0,47,41,25208,20046,58,235,26001,19086
13,2,1,1,2,1,2,1,237,177,25209,20047,295,193,26002,19087
14,2,3,0,0,3,1,0,72,103,25212,20047,66,218,26005,19087
15,2,1,2,1,0,0,3,31,22,25213,20049,32,190,26005,19090
16,2,1,0,0,3,1,0,221,191,25214,20049,250,48,26008,19090
17,2,1,1,2,1,2,1,276,159,25215,20050,315,43,26009,19091
18,2,0,0,2,1,2,1,119,109,25215,20050,143,35,26010,19092
19,2,2,1,0,3,1,0,222,185,25217,20051,263,343,26013,19092
20,3,1,2,1,0,0,3,48,43,25218,20053,58,124,26013,19095
21,3,3,0,0,3,1,0,96,83,25221,20053,107,37,26016,19095
22,3,1,0,0,3,1,0,62,61,25222,20053,78,90,26019,19095
23,3,0,2,1,0,0,3,104,108,25222,20055,107,197,26019,19098
24,3,2,2,2,1,2,1,232,124,25224,20057,254,22,26020,19099
25,3,0,2,1,0,0,3,59,55,25224,20059,54,216,26020,19102
26,3,4,0,0,3,1,0,453,111,25228,20059,424,161,26023,19102
27,3,1,0,0,3,1,0,249,170,25229,20059,288,261,26026,19102
28,3,3,0,0,3,1,0,287,152,25232,20059,329,225,26029,19102
29,3,1,2,1,0,0,3,243,164,25233,20061,309,245,26029,19105
30,4,0,2,1,0,0,3,72,105,25233,20063,66,346,26029,19108
31,4,1,1,2,1,2,1,354,162,25234,20064,357,198,26030,19109
32,4,2,0,0,3,1,0,98,83,25236,20064,110,48,26033,19109
33,4,1,0,0,3,1,0,126,121,25237,20064,174,193,26036,19109
34,4,3,0,0,3,1,0,34,22,25240,20064,35,43,26039,19109
35,4,2,0,0,3,1,0,223,191,25242,20064,253,28,26042,19109
36,4,2,0,0,3,1,0,121,109,25244,20064,146,235,26045,19109
37,4,1,2,1,0,0,3,223,187,25245,20066,263,193,26045,19112
38,4,2,2,2,1,2,1,61,57,25247,20068,55,219,26046,19113
39,4,1,0,0,3,1,0,291,169,25248,20068,326,225,26049,19113
40,5,2,1,0,3,1,0,289,153,25250,20069,332,82,26052,19113
41,5,2,2,2,1,2,1,50,45,25252,20071,59,262,26053,19114
42,5,1,0,0,3,1,0,454,111,25253,20071,427,35,26056,19114
43,5,2,0,0,3,1,0,239,177,25255,20071,298,37,26059,19114
44,5,0,0,2,1,2,1,62,61,25255,20071,79,217,26060,19115
45,5,0,0,2,1,2,1,104,108,25255,20071,108,23,26061,19116
46,5,2,1,0,3,1,0,251,171,25257,20072,291,193,26064,19116
47,5,1,0,0,3,1,0,127,121,25258,20072,177,90,26067,19116
48,5,2,2,2,1,2,1,278,161,25260,20074,316,162,26068,19117
49,5,3,4,1,0,0,3,235,128,25263,20078,254,248,26068,19120
50,6,2,1,0,3,1,0,63,58,25265,20079,58,124,26071,19120
51,6,1,1,2,1,2,1,292,170,25266,20080,327,194,26072,19121
52,6,2,2,2,1,2,1,241,179,25268,20082,299,44,26073,19122
53,6,1,2,1,0,0,3,73,107,25269,20084,66,31,26073,19125
54,6,2,1,0,3,1,0,245,165,25271,20085,312,48,26076,19125
55,6,1,0,0,3,1,0,35,22,25272,20085,38,162,26079,19125
56,6,0,0,2,1,2,1,121,109,25272,20085,147,220,26080,19126
57,6,1,1,2,1,2,1,224,188,25273,20086,264,236,26081,19127
58,6,4,1,0,3,1,0,102,84,25277,20087,113,225,26084,19127
59,6,0,1,1,0,0,3,354,163,25277,20088,357,349,26084,19130
60,7,0,0,2,1,2,1,104,108,25277,20088,109,249,26085,19131
61,7,3,1,0,3,1,0,238,129,25280,20089,257,193,26088,19131
62,7,1,3,1,0,0,3,51,48,25281,20092,59,201,26088,19134
63,7,2,2,2,1,2,1,64,63,25283,20094,80,263,26089,19135
64,7,2,0,0,3,1,0,291,153,25285,20094,335,35,26092,19135
65,7,1,0,0,3,1,0,252,171,25286,20094,294,23,26095,19135
66,7,1,0,0,3,1,0,128,121,25287,20094,180,217,26098,19135
67,7,0,1,1,0,0,3,278,162,25287,20095,316,40,26098,19138
68,7,0,2,1,0,0,3,223,193,25287,20097,253,85,26098,19141
69,7,0,2,1,0,0,3,454,113,25287,20099,427,93,26098,19144
70,8,0,1,1,0,0,3,354,164,25287,20100,357,127,26098,19147
71,8,0,1,1,0,0,3,241,180,25287,20101,299,352,26098,19150
72,8,1,1,2,1,2,1,103,85,25288,20102,114,32,26099,19151
73,8,2,2,2,1,2,1,75,109,25290,20104,67,163,26100,19152
74,8,4,1,0,3,1,0,242,130,25294,20105,260,44,26103,19152
75,8,1,1,2,1,2,1,246,166,25295,20106,313,237,26104,19153
76,8,1,2,1,0,0,3,122,111,25296,20108,147,51,26104,19156
77,8,1,0,0,3,1,0,64,58,25297,20108,61,194,26107,19156
78,8,0,1,1,0,0,3,35,23,25297,20109,38,228,26107,19159
79,8,1,1,2,1,2,1,293,171,25298,20110,328,218,26108,19160
80,9,3,1,0,3,1,0,54,49,25301,20111,62,249,26111,19160
81,9,4,0,0,3,1,0,458,113,25305,20111,430,85,26114,19160
82,9,2,0,0,3,1,0,66,63,25307,20111,83,40,26117,19160
83,9,1,0,0,3,1,0,105,108,25308,20111,112,35,26120,19160
84,9,3,1,0,3,1,0,255,172,25311,20112,297,220,26123,19160
85,9,1,0,0,3,1,0,129,121,25312,20112,183,193,26126,19160
86,9,1,3,1,0,0,3,224,196,25313,20115,253,204,26126,19163
87,9,2,2,2,1,2,1,293,155,25315,20117,336,24,26127,19164
88,9,0,1,1,0,0,3,224,189,25315,20118,264,96,26127,19167
89,9,1,0,0,3,1,0,279,162,25316,20118,319,263,26130,19167
90,10,1,4,1,0,0,3,247,170,25317,20122,313,355,26130,19170
91,10,0,0,2,1,2,1,354,164,25317,20122,358,52,26131,19171
92,10,0,1,1,0,0,3,103,86,25317,20123,114,47,26131,19174
93,10,1,0,0,3,1,0,76,109,25318,20123,70,127,26134,19174
94,10,1,1,2,1,2,1,36,24,25319,20124,39,33,26135,19175
95,10,1,0,0,3,1,0,123,111,25320,20124,150,194,26138,19175
96,10,2,1,0,3,1,0,226,197,25322,20125,256,237,26141,19175
97,10,0,1,1,0,0,3,241,181,25322,20126,299,231,26141,19178
98,10,3,2,0,3,1,0,245,132,25325,20128,263,218,26144,19178
99,10,2,0,0,3,1,0,295,171,25327,20128,331,35,26147,19178
100,11,0,1,1,0,0,3,129,122,25327,20129,183,223,26147,19181
101,11,3,0,0,3,1,0,296,155,25330,20129,339,204,26150,19181
102,11,2,0,0,3,1,0,68,63,25332,20129,86,52,26153,19181
103,11,2,0,0,3,1,0,356,164,25334,20129,361,40,26156,19181
104,11,0,0,2,1,2,1,255,172,25334,20129,298,86,26157,19182
105,11,0,0,2,1,2,1,123,111,25334,20129,151,25,26158,19183
106,11,1,0,0,3,1,0,65,58,25335,20129,64,193,26161,19183
107,11,3,2,0,3,1,0,227,191,25338,20131,267,163,26164,19183
108,11,2,2,2,1,2,1,281,164,25340,20133,320,34,26165,19184
109,11,4,0,0,3,1,0,462,113,25344,20133,433,249,26168,19184
110,12,2,1,0,3,1,0,107,109,25346,20134,115,355,26171,19184
111,12,2,1,0,3,1,0,297,172,25348,20135,334,237,26174,19184
112,12,1,0,0,3,1,0,55,49,25349,20135,65,47,26177,19184
113,12,1,0,0,3,1,0,104,86,25350,20135,117,35,26180,19184
114,12,2,2,2,1,2,1,78,111,25352,20137,71,195,26181,19185
115,12,2,3,1,0,0,3,228,200,25354,20140,256,266,26181,19188
116,12,2,0,0,3,1,0,243,181,25356,20140,302,127,26184,19188
117,12,2,0,0,3,1,0,249,170,25358,20140,316,96,26187,19188
118,12,1,0,0,3,1,0,282,164,25359,20140,323,223,26190,19188
119,12,0,1,1,0,0,3,36,25,25359,20141,39,221,26190,19191
120,13,1,1,2,1,2,1,250,171,25360,20142,317,205,26191,19192
121,13,1,2,1,0,0,3,69,65,25361,20144,86,358,26191,19195
122,13,0,0,2,1,2,1,296,155,25361,20144,340,41,26192,19196
123,13,1,0,0,3,1,0,246,132,25362,20144,266,52,26195,19196
124,13,0,0,2,1,2,1,123,111,25362,20144,152,87,26196,19197
125,13,4,1,0,3,1,0,69,59,25366,20145,67,25,26199,19197
126,13,3,1,0,3,1,0,230,192,25369,20146,270,34,26202,19197
127,13,3,0,0,3,1,0,258,172,25372,20146,301,163,26205,19197
128,13,2,3,1,0,0,3,131,125,25374,20149,183,234,26205,19200
129,13,2,1,0,3,1,0,299,173,25376,20150,337,266,26208,19200
130,14,2,0,0,3,1,0,464,113,25378,20150,436,237,26211,19200
131,14,2,1,0,3,1,0,358,165,25380,20151,364,193,26214,19200
132,14,0,4,1,0,0,3,55,53,25380,20155,65,38,26214,19203
133,14,1,0,0,3,1,0,105,86,25381,20155,120,25,26217,19203
134,14,1,1,2,1,2,1,70,66,25382,20156,87,128,26218,19204
135,14,2,1,0,3,1,0,109,110,25384,20157,118,221,26221,19204
136,14,1,1,2,1,2,1,79,112,25385,20158,72,97,26222,19205
137,14,2,1,0,3,1,0,245,182,25387,20159,305,223,26225,19205
138,14,0,0,2,1,2,1,282,164,25387,20159,324,196,26226,19206
139,14,0,2,1,0,0,3,228,202,25387,20161,256,252,26226,19209
140,15,2,1,0,3,1,0,301,174,25389,20162,340,47,26229,19209
141,15,1,2,1,0,0,3,70,61,25390,20164,67,269,26229,19212
142,15,1,0,0,3,1,0,297,155,25391,20164,343,52,26232,19212
143,15,4,2,0,3,1,0,262,174,25395,20166,304,34,26235,19212
144,15,3,1,0,3,1,0,253,172,25398,20167,320,87,26238,19212
145,15,1,1,2,1,2,1,37,26,25399,20168,40,42,26239,19213
146,15,1,1,2,1,2,1,124,112,25400,20169,153,206,26240,19214
147,15,2,1,0,3,1,0,133,126,25402,20170,186,163,26243,19214
148,15,2,1,0,3,1,0,232,193,25404,20171,273,234,26246,19214
149,15,1,4,1,0,0,3,247,136,25405,20175,266,361,26246,19217
150,16,0,2,1,0,0,3,105,88,25405,20177,120,255,26246,19220
151,16,6,0,0,3,1,0,251,182,25411,20177,308,25,26249,19220
152,16,5,0,0,3,1,0,75,66,25416,20177,90,38,26252,19220
153,16,0,1,1,0,0,3,358,166,25416,20178,364,240,26252,19223
154,16,2,2,2,1,2,1,111,112,25418,20180,119,197,26253,19224
155,16,0,1,1,0,0,3,79,113,25418,20181,72,224,26253,19227
156,16,4,1,0,3,1,0,286,165,25422,20182,327,193,26256,19227
157,16,1,2,1,0,0,3,229,204,25423,20184,256,226,26256,19230
158,16,2,0,0,3,1,0,466,113,25425,20184,439,128,26259,19230
159,16,1,1,2,1,2,1,56,54,25426,20185,66,98,26260,19231
160,17,1,0,0,3,1,0,298,155,25427,20185,346,47,26263,19231
161,17,0,4,1,0,0,3,37,30,25427,20189,40,272,26263,19234
162,17,1,3,1,0,0,3,263,177,25428,20192,304,364,26263,19237
163,17,3,0,0,3,1,0,250,136,25431,20192,269,34,26266,19237
164,17,4,1,0,3,1,0,257,173,25435,20193,323,42,26269,19237
165,17,2,1,0,3,1,0,234,194,25437,20194,276,87,26272,19237
166,17,4,2,0,3,1,0,74,63,25441,20196,70,163,26275,19237
167,17,3,1,0,3,1,0,127,113,25444,20197,156,234,26278,19237
168,17,1,0,0,3,1,0,134,126,25445,20197,189,52,26281,19237
169,17,3,1,0,3,1,0,304,175,25448,20198,343,206,26284,19237
170,18,2,1,0,3,1,0,300,156,25450,20199,349,197,26287,19237
171,18,1,1,2,1,2,1,80,114,25451,20200,73,256,26288,19238
172,18,1,1,2,1,2,1,57,55,25452,20201,67,53,26289,19239
173,18,0,0,2,1,2,1,105,88,25452,20201,121,227,26290,19240
174,18,0,0,2,1,2,1,75,66,25452,20201,91,194,26291,19241
175,18,0,1,1,0,0,3,37,31,25452,20202,40,131,26291,19244
176,18,0,1,1,0,0,3,229,205,25452,20203,256,101,26291,19247
177,18,0,1,1,0,0,3,251,183,25452,20204,308,41,26291,19250
178,18,0,1,1,0,0,3,358,167,25452,20205,364,227,26291,19253
179,18,0,4,1,0,0,3,286,169,25452,20209,327,367,26291,19256
180,19,2,2,2,1,2,1,113,114,25454,20211,120,43,26292,19257
181,19,3,1,0,3,1,0,307,176,25457,20212,346,25,26295,19257
182,19,5,1,0,3,1,0,255,137,25462,20213,272,240,26298,19257
183,19,4,0,0,3,1,0,267,177,25466,20213,307,47,26301,19257
184,19,1,2,1,0,0,3,135,128,25467,20215,189,90,26301,19260
185,19,3,0,0,3,1,0,260,173,25470,20215,326,163,26304,19260
186,19,4,1,0,3,1,0,470,114,25474,20216,442,34,26307,19260
187,19,1,1,2,1,2,1,128,114,25475,20217,157,273,26308,19261
188,19,1,0,0,3,1,0,235,194,25476,20217,279,206,26311,19261
189,19,2,1,0,3,1,0,76,64,25478,20218,73,234,26314,19261
190,20,0,1,1,0,0,3,235,195,25478,20219,279,259,26314,19264
191,20,1,2,1,0,0,3,252,185,25479,20221,308,276,26314,19267
192,20,1,2,1,0,0,3,58,57,25480,20223,67,200,26314,19270
193,20,1,1,2,1,2,1,106,89,25481,20224,122,195,26315,19271
194,20,1,0,0,3,1,0,81,114,25482,20224,76,41,26318,19271
195,20,2,0,0,3,1,0,39,31,25484,20224,43,101,26321,19271
196,20,2,5,1,0,0,3,231,210,25486,20229,256,50,26321,19274
197,20,0,2,1,0,0,3,286,171,25486,20231,327,134,26321,19277
198,20,1,0,0,3,1,0,114,114,25487,20231,123,240,26324,19277
199,20,3,3,2,1,2,1,473,117,25490,20234,443,228,26325,19278
200,21,1,1,2,1,2,1,261,174,25491,20235,327,228,26326,19279
201,21,0,0,2,1,2,1,307,176,25491,20235,347,91,26327,19280
202,21,2,1,0,3,1,0,77,67,25493,20236,94,34,26330,19280
203,21,1,3,1,0,0,3,256,140,25494,20239,272,44,26330,19283
204,21,2,1,0,3,1,0,269,178,25496,20240,310,53,26333,19283
205,21,0,1,1,0,0,3,128,115,25496,20241,157,46,26333,19286
206,21,2,1,0,3,1,0,288,172,25498,20242,330,25,26336,19286
207,21,3,0,0,3,1,0,361,167,25501,20242,367,163,26339,19286
208,21,0,1,1,0,0,3,135,129,25501,20243,189,209,26339,19289
209,21,0,2,1,0,0,3,300,158,25501,20245,349,370,26339,19292
210,22,3,2,0,3,1,0,238,197,25504,20247,282,134,26342,19292
211,22,5,0,0,3,1,0,478,117,25509,20247,446,200,26345,19292
212,22,0,0,2,1,2,1,58,57,25509,20247,68,164,26346,19293
213,22,1,4,1,0,0,3,107,93,25510,20251,122,104,26346,19296
214,22,3,0,0,3,1,0,117,114,25513,20251,126,50,26349,19296
215,22,3,1,0,3,1,0,42,32,25516,20252,46,228,26352,19296
216,22,1,2,1,0,0,3,77,66,25517,20254,73,243,26352,19299
217,22,2,1,0,3,1,0,263,175,25519,20255,330,276,26355,19299
218,22,3,1,0,3,1,0,84,115,25522,20256,79,234,26358,19299
219,22,0,0,2,1,2,1,252,185,25522,20256,309,260,26359,19300
220,23,1,0,0,3,1,0,301,158,25523,20256,352,228,26362,19300
221,23,1,0,0,3,1,0,257,140,25524,20256,275,91,26365,19300
222,23,1,2,1,0,0,3,136,131,25525,20258,189,373,26365,19303
223,23,1,1,2,1,2,1,78,68,25526,20259,95,210,26366,19304
224,23,0,0,2,1,2,1,361,167,25526,20259,368,35,26367,19305
225,23,1,1,2,1,2,1,270,179,25527,20260,311,47,26368,19306
226,23,2,0,0,3,1,0,44,32,25529,20260,49,53,26371,19306
227,23,1,1,2,1,2,1,129,116,25530,20261,158,196,26372,19307
228,23,0,1,1,0,0,3,231,211,25530,20262,256,47,26372,19310
229,23,0,2,1,0,0,3,288,174,25530,20264,330,263,26372,19313
230,24,0,2,1,0,0,3,107,95,25530,20266,122,246,26372,19316
231,24,1,0,0,3,1,0,308,176,25531,20266,350,164,26375,19316
232,24,1,2,1,0,0,3,59,59,25532,20268,68,231,26375,19319
233,24,3,3,2,1,2,1,120,117,25535,20271,127,135,26376,19320
234,24,1,2,1,0,0,3,85,117,25536,20273,79,213,26376,19323
235,24,1,3,1,0,0,3,264,178,25537,20276,330,28,26376,19326
236,24,0,0,2,1,2,1,238,197,25537,20276,283,51,26377,19327
237,24,1,0,0,3,1,0,271,179,25538,20276,314,234,26380,19327
238,24,3,0,0,3,1,0,80,66,25541,20276,76,104,26383,19327
239,24,4,2,0,3,1,0,482,119,25545,20278,449,276,26386,19327
240,25,1,0,0,3,1,0,258,140,25546,20278,278,200,26389,19327
241,25,4,4,2,1,2,1,63,63,25550,20282,69,374,26390,19328
242,25,2,2,2,1,2,1,254,187,25552,20284,310,54,26391,19329
243,25,0,0,2,1,2,1,136,131,25552,20284,190,48,26392,19330
244,25,1,0,0,3,1,0,45,32,25553,20284,52,91,26395,19330
245,25,0,2,1,0,0,3,231,213,25553,20286,256,199,26395,19333
246,25,1,1,2,1,2,1,362,168,25554,20287,369,48,26396,19334
247,25,3,2,0,3,1,0,81,70,25557,20289,98,234,26399,19334
248,25,1,0,0,3,1,0,130,116,25558,20289,161,228,26402,19334
249,25,1,2,1,0,0,3,302,160,25559,20291,352,266,26402,19337
250,26,2,2,2,1,2,1,266,180,25561,20293,331,52,26403,19338
251,26,0,2,1,0,0,3,85,119,25561,20295,79,279,26403,19341
252,26,1,3,1,0,0,3,309,179,25562,20298,350,138,26403,19344
253,26,1,0,0,3,1,0,108,95,25563,20298,125,200,26406,19344
254,26,1,1,2,1,2,1,121,118,25564,20299,128,232,26407,19345
255,26,3,0,0,3,1,0,305,160,25567,20299,355,164,26410,19345
256,26,0,0,2,1,2,1,80,66,25567,20299,77,36,26411,19346
257,26,1,1,2,1,2,1,289,175,25568,20300,331,105,26412,19347
258,26,2,1,0,3,1,0,240,198,25570,20301,286,28,26415,19347
259,26,4,3,0,3,1,0,486,122,25574,20304,452,213,26418,19347
260,27,2,3,1,0,0,3,47,35,25576,20307,52,269,26418,19350
261,27,4,0,0,3,1,0,490,122,25580,20307,455,54,26421,19350
262,27,0,1,1,0,0,3,63,64,25580,20308,69,51,26421,19353
263,27,0,1,1,0,0,3,81,71,25580,20309,98,94,26421,19356
264,27,1,1,2,1,2,1,259,141,25581,20310,279,106,26422,19357
265,27,3,0,0,3,1,0,274,179,25584,20310,317,48,26425,19357
266,27,0,2,1,0,0,3,231,215,25584,20312,256,231,26425,19360
267,27,0,1,1,0,0,3,136,132,25584,20313,190,249,26425,19363
268,27,1,1,2,1,2,1,255,188,25585,20314,311,200,26426,19364
269,27,2,0,0,3,1,0,364,168,25587,20314,372,234,26429,19364
270,28,2,2,2,1,2,1,311,181,25589,20316,351,37,26430,19365
271,28,2,0,0,3,1,0,110,95,25591,20316,128,138,26433,19365
272,28,2,1,0,3,1,0,123,119,25593,20317,131,164,26436,19365
273,28,2,1,0,3,1,0,87,120,25595,20318,82,28,26439,19365
274,28,2,1,0,3,1,0,268,181,25597,20319,334,232,26442,19365
275,28,1,0,0,3,1,0,131,116,25598,20319,164,52,26445,19365
276,28,1,1,2,1,2,1,290,176,25599,20320,332,214,26446,19366
277,28,5,0,0,3,1,0,245,198,25604,20320,289,200,26449,19366
278,28,1,0,0,3,1,0,306,160,25605,20320,358,279,26452,19366
279,28,0,0,2,1,2,1,80,66,25605,20320,78,375,26453,19367
0,1,0,0,2,1,2,1,255,188,25605,20320,312,139,26454,19368
1,1,0,1,1,0,0,3,123,120,25605,20321,131,97,26454,19371
2,1,1,1,2,1,2,1,307,161,25606,20322,359,232,26455,19372
3,1,2,2,2,1,2,1,261,143,25608,20324,280,107,26456,19373
4,1,3,1,0,3,1,0,185,145,25611,20325,208,48,26459,19373
5,1,4,0,0,3,1,0,51,35,25615,20325,55,52,26462,19373
6,1,2,1,0,3,1,0,270,182,25617,20326,337,25,26465,19373
7,1,2,1,0,3,1,0,276,180,25619,20327,320,279,26468,19373
8,1,1,0,0,3,1,0,491,122,25620,20327,458,51,26471,19373
9,1,0,2,1,0,0,3,311,183,25620,20329,351,237,26471,19376
10,2,4,1,0,3,1,0,368,169,25624,20330,375,54,26474,19376
11,2,2,1,0,3,1,0,247,199,25626,20331,292,200,26477,19376
12,2,0,2,1,0,0,3,80,68,25626,20333,78,203,26477,19379
13,2,0,1,1,0,0,3,131,117,25626,20334,164,252,26477,19382
14,2,0,2,1,0,0,3,110,97,25626,20336,128,217,26477,19385
15,2,0,1,1,0,0,3,87,121,25626,20337,82,235,26477,19388
16,2,2,1,0,3,1,0,138,133,25628,20338,193,28,26480,19388
17,2,2,0,0,3,1,0,292,176,25630,20338,335,110,26483,19388
18,2,2,3,1,0,0,3,83,74,25632,20341,98,272,26483,19391
19,2,1,0,0,3,1,0,35,50,25633,20341,42,375,26486,19391
20,3,0,0,2,1,2,1,255,188,25633,20341,313,280,26487,19392
21,3,3,1,0,3,1,0,279,181,25636,20342,323,203,26490,19392
22,3,2,0,0,3,1,0,294,176,25638,20342,338,48,26493,19392
23,3,1,0,0,3,1,0,308,161,25639,20342,362,51,26496,19392
24,3,1,0,0,3,1,0,111,97,25640,20342,131,107,26499,19392
25,3,0,2,1,0,0,3,123,122,25640,20344,131,55,26499,19395
26,3,2,3,1,0,0,3,187,148,25642,20347,208,28,26499,19398
27,3,2,4,1,0,0,3,53,39,25644,20351,55,235,26499,19401
28,3,2,1,0,3,1,0,263,144,25646,20352,283,139,26502,19401
29,3,0,1,1,0,0,3,491,123,25646,20353,458,275,26502,19404
30,4,0,0,2,1,2,1,368,169,25646,20353,376,29,26503,19405
31,4,2,1,0,3,1,0,37,51,25648,20354,45,217,26506,19405
32,4,2,1,0,3,1,0,249,200,25650,20355,295,235,26509,19405
33,4,0,3,1,0,0,3,270,185,25650,20358,337,378,26509,19408
34,4,3,2,0,3,1,0,86,76,25653,20360,101,110,26512,19408
35,4,2,1,0,3,1,0,89,122,25655,20361,85,107,26515,19408
36,4,4,1,0,3,1,0,283,182,25659,20362,326,97,26518,19408
37,4,1,0,0,3,1,0,81,68,25660,20362,81,54,26521,19408
38,4,2,2,2,1,2,1,140,135,25662,20364,194,238,26522,19409
39,4,1,1,2,1,2,1,312,184,25663,20365,352,253,26523,19410
40,5,2,0,0,3,1,0,310,161,25665,20365,365,139,26526,19410
41,5,0,3,1,0,0,3,294,179,25665,20368,338,238,26526,19413
42,5,1,1,2,1,2,1,313,185,25666,20369,353,52,26527,19414
43,5,0,0,2,1,2,1,255,188,25666,20369,314,204,26528,19415
44,5,3,2,0,3,1,0,114,99,25669,20371,134,55,26531,19415
45,5,2,2,2,1,2,1,125,124,25671,20373,132,201,26532,19416
46,5,3,2,0,3,1,0,266,146,25674,20375,286,48,26535,19416
47,5,1,1,2,1,2,1,54,40,25675,20376,56,29,26536,19417
48,5,1,1,2,1,2,1,188,149,25676,20377,209,281,26537,19418
49,5,0,2,1,0,0,3,131,119,25676,20379,164,381,26537,19421
50,6,6,1,0,3,1,0,497,124,25682,20380,461,97,26540,19421
51,6,2,0,0,3,1,0,39,51,25684,20380,48,238,26543,19421
52,6,2,1,0,3,1,0,272,186,25686,20381,340,139,26546,19421
53,6,0,1,1,0,0,3,283,183,25686,20382,326,32,26546,19424
54,6,3,0,0,3,1,0,258,188,25689,20382,317,54,26549,19424
55,6,1,0,0,3,1,0,87,76,25690,20382,104,235,26552,19424
56,6,3,1,0,3,1,0,92,123,25693,20383,88,110,26555,19424
57,6,0,3,1,0,0,3,81,71,25693,20386,81,256,26555,19427
58,6,2,2,2,1,2,1,251,202,25695,20388,296,108,26556,19428
59,6,1,1,2,1,2,1,369,170,25696,20389,377,276,26557,19429
60,7,1,1,2,1,2,1,126,125,25697,20390,133,239,26558,19430
61,7,0,4,1,0,0,3,54,44,25697,20394,56,384,26558,19433
62,7,1,3,1,0,0,3,132,122,25698,20397,164,113,26558,19436
63,7,3,1,0,3,1,0,316,186,25701,20398,356,217,26561,19436
64,7,2,3,1,0,0,3,83,74,25703,20401,81,284,26561,19439
65,7,1,1,2,1,2,1,115,100,25704,20402,135,53,26562,19440
66,7,1,1,2,1,2,1,267,147,25705,20403,287,202,26563,19441
67,7,3,1,0,3,1,0,143,136,25708,20404,197,55,26566,19441
68,7,1,3,1,0,0,3,295,182,25709,20407,338,207,26566,19444
69,7,4,0,0,3,1,0,314,161,25713,20407,368,29,26569,19444
70,8,1,2,1,0,0,3,252,204,25714,20409,296,100,26569,19447
71,8,0,1,1,0,0,3,188,150,25714,20410,209,279,26569,19450
72,8,4,0,0,3,1,0,501,124,25718,20410,464,54,26572,19450
73,8,2,0,0,3,1,0,260,188,25720,20410,320,32,26575,19450
74,8,0,3,1,0,0,3,87,79,25720,20413,104,51,26575,19453
75,8,2,0,0,3,1,0,94,123,25722,20413,91,238,26578,19453
76,8,0,4,1,0,0,3,283,187,25722,20417,326,111,26578,19456
77,8,1,1,2,1,2,1,273,187,25723,20418,341,257,26579,19457
78,8,4,1,0,3,1,0,373,171,25727,20419,380,235,26582,19457
79,8,1,1,2,1,2,1,40,52,25728,20420,49,140,26583,19458
80,9,2,1,0,3,1,0,254,205,25730,20421,299,55,26586,19458
81,9,0,3,1,0,0,3,143,139,25730,20424,197,387,26586,19461
82,9,0,1,1,0,0,3,295,183,25730,20425,338,205,26586,19464
83,9,0,3,1,0,0,3,115,103,25730,20428,135,210,26586,19467
84,9,0,0,2,1,2,1,126,125,25730,20428,134,114,26587,19468
85,9,0,1,1,0,0,3,54,45,25730,20429,56,56,26587,19471
86,9,2,1,0,3,1,0,134,123,25732,20430,167,51,26590,19471
87,9,4,0,0,3,1,0,271,147,25736,20430,290,217,26593,19471
88,9,1,1,2,1,2,1,315,162,25737,20431,369,285,26594,19472
89,9,0,1,1,0,0,3,316,187,25737,20432,356,32,26594,19475
90,10,0,1,1,0,0,3,83,75,25737,20433,81,282,26594,19478
91,10,0,2,1,0,0,3,260,190,25737,20435,320,208,26594,19481
92,10,3,0,0,3,1,0,504,124,25740,20435,467,239,26597,19481
93,10,3,2,0,3,1,0,90,81,25743,20437,107,257,26600,19481
94,10,4,4,2,1,2,1,44,56,25747,20441,50,112,26601,19482
95,10,0,2,1,0,0,3,188,152,25747,20443,209,143,26601,19485
96,10,1,1,2,1,2,1,95,124,25748,20444,92,55,26602,19486
97,10,1,5,1,0,0,3,55,50,25749,20449,56,103,26602,19489
98,10,1,2,1,0,0,3,274,189,25750,20451,341,238,26602,19492
99,10,2,1,0,3,1,0,375,172,25752,20452,383,238,26605,19492
100,11,0,1,1,0,0,3,254,206,25752,20453,299,220,26605,19495
101,11,3,2,0,3,1,0,274,149,25755,20455,293,387,26608,19495
102,11,4,1,0,3,1,0,94,82,25759,20456,110,238,26611,19495
103,11,1,1,2,1,2,1,144,140,25760,20457,198,57,26612,19496
104,11,0,1,1,0,0,3,126,126,25760,20458,134,35,26612,19499
105,11,4,3,0,3,1,0,287,190,25764,20461,329,51,26615,19499
106,11,0,1,1,0,0,3,134,124,25764,20462,167,35,26615,19502
107,11,0,1,1,0,0,3,115,104,25764,20463,135,288,26615,19505
108,11,4,0,0,3,1,0,319,162,25768,20463,372,114,26618,19505
109,11,3,2,0,3,1,0,319,189,25771,20465,359,210,26621,19505
110,12,1,1,2,1,2,1,84,76,25772,20466,82,240,26622,19506
111,12,3,1,0,3,1,0,322,190,25775,20467,362,143,26625,19506
112,12,2,2,2,1,2,1,506,126,25777,20469,468,221,26626,19507
113,12,3,0,0,3,1,0,378,172,25780,20469,386,112,26629,19507
114,12,1,3,1,0,0,3,45,59,25781,20472,50,106,26629,19510
115,12,0,1,1,0,0,3,188,153,25781,20473,209,211,26629,19513
116,12,0,2,1,0,0,3,95,126,25781,20475,92,58,26629,19516
117,12,3,0,0,3,1,0,277,149,25784,20475,296,35,26632,19516
118,12,1,3,1,0,0,3,275,192,25785,20478,341,58,26632,19519
119,12,1,1,2,1,2,1,296,184,25786,20479,339,258,26633,19520
120,13,0,2,1,0,0,3,55,52,25786,20481,56,285,26633,19523
121,13,0,2,1,0,0,3,254,208,25786,20483,299,38,26633,19526
122,13,1,3,1,0,0,3,288,193,25787,20486,329,390,26633,19529
123,13,2,1,0,3,1,0,321,163,25789,20487,375,238,26636,19529
124,13,2,0,0,3,1,0,117,104,25791,20487,138,114,26639,19529
125,13,1,0,0,3,1,0,261,190,25792,20487,323,58,26642,19529
126,13,0,0,2,1,2,1,126,126,25792,20487,135,239,26643,19530
127,13,0,4,1,0,0,3,144,144,25792,20491,198,54,26643,19533
128,13,0,0,2,1,2,1,134,124,25792,20491,168,211,26644,19534
129,13,1,3,1,0,0,3,96,129,25793,20494,92,291,26644,19537
130,14,0,0,2,1,2,1,296,184,25793,20494,340,107,26645,19538
131,14,2,1,0,3,1,0,324,191,25795,20495,365,238,26648,19538
132,14,2,3,1,0,0,3,47,62,25797,20498,50,214,26648,19541
133,14,0,1,1,0,0,3,275,193,25797,20499,341,243,26648,19544
134,14,2,1,0,3,1,0,96,83,25799,20500,113,112,26651,19544
135,14,3,0,0,3,1,0,191,153,25802,20500,212,35,26654,19544
136,14,1,1,2,1,2,1,145,145,25803,20501,199,59,26655,19545
137,14,2,2,2,1,2,1,86,78,25805,20503,83,58,26656,19546
138,14,2,1,0,3,1,0,323,164,25807,20504,378,221,26659,19546
139,14,0,1,1,0,0,3,506,127,25807,20505,468,294,26659,19549
140,15,0,2,1,0,0,3,117,106,25807,20507,138,57,26659,19552
141,15,0,2,1,0,0,3,126,128,25807,20509,135,261,26659,19555
142,15,0,2,1,0,0,3,288,195,25807,20511,329,61,26659,19558
143,15,0,2,1,0,0,3,55,54,25807,20513,56,214,26659,19561
144,15,3,2,0,3,1,0,137,126,25810,20515,171,143,26662,19561
145,15,1,2,1,0,0,3,262,192,25811,20517,323,242,26662,19564
146,15,2,2,2,1,2,1,380,174,25813,20519,387,59,26663,19565
147,15,0,3,1,0,0,3,277,152,25813,20522,296,41,26663,19568
148,15,2,0,0,3,1,0,508,127,25815,20522,471,114,26666,19568
149,15,2,1,0,3,1,0,256,209,25817,20523,302,285,26669,19568
150,16,2,0,0,3,1,0,98,129,25819,20523,95,41,26672,19568
151,16,1,1,2,1,2,1,325,192,25820,20524,366,113,26673,19569
152,16,1,4,1,0,0,3,276,197,25821,20528,341,297,26673,19572
153,16,2,2,2,1,2,1,98,85,25823,20530,114,215,26674,19573
154,16,0,1,1,0,0,3,126,129,25823,20531,135,241,26674,19576
155,16,1,1,2,1,2,1,146,146,25824,20532,200,108,26675,19577
156,16,2,2,2,1,2,1,298,186,25826,20534,341,36,26676,19578
157,16,0,2,1,0,0,3,86,80,25826,20536,83,224,26676,19581
158,16,0,3,1,0,0,3,191,156,25826,20539,212,246,26676,19584
159,16,0,0,2,1,2,1,323,164,25826,20539,379,391,26677,19585
160,17,1,3,1,0,0,3,263,195,25827,20542,323,116,26677,19588
161,17,2,1,0,3,1,0,49,63,25829,20543,53,59,26680,19588
162,17,2,2,2,1,2,1,278,199,25831,20545,342,115,26681,19589
163,17,1,3,1,0,0,3,56,57,25832,20548,56,62,26681,19592
164,17,1,0,0,3,1,0,257,209,25833,20548,305,61,26684,19592
165,17,2,1,0,3,1,0,119,107,25835,20549,141,285,26687,19592
166,17,3,0,0,3,1,0,383,174,25838,20549,390,143,26690,19592
167,17,2,2,2,1,2,1,279,154,25840,20551,297,243,26691,19593
168,17,2,3,1,0,0,3,290,198,25842,20554,329,264,26691,19596
169,17,4,0,0,3,1,0,512,127,25846,20554,474,57,26694,19596
170,18,2,0,0,3,1,0,100,85,25848,20554,117,214,26697,19596
171,18,2,5,1,0,0,3,193,161,25850,20559,212,244,26697,19599
172,18,0,0,2,1,2,1,98,129,25850,20559,96,225,26698,19600
173,18,0,0,2,1,2,1,146,146,25850,20559,201,247,26699,19601
174,18,5,0,0,3,1,0,91,80,25855,20559,86,36,26702,19601
175,18,1,2,1,0,0,3,324,166,25856,20561,379,111,26702,19604
176,18,3,2,0,3,1,0,386,176,25859,20563,393,41,26705,19604
177,18,3,1,0,3,1,0,328,193,25862,20564,369,215,26708,19604
178,18,0,0,2,1,2,1,137,126,25862,20564,172,63,26709,19605
179,18,1,1,2,1,2,1,299,187,25863,20565,342,392,26710,19606
180,19,2,1,0,3,1,0,265,196,25865,20566,326,115,26713,19606
181,19,0,0,2,1,2,1,126,129,25865,20566,136,286,26714,19607
182,19,0,1,1,0,0,3,49,64,25865,20567,53,60,26714,19610
183,19,1,1,2,1,2,1,99,130,25866,20568,97,215,26715,19611
184,19,3,0,0,3,1,0,282,154,25869,20568,300,111,26718,19611
185,19,1,1,2,1,2,1,291,199,25870,20569,330,144,26719,19612
186,19,0,1,1,0,0,3,56,58,25870,20570,56,267,26719,19615
187,19,3,0,0,3,1,0,515,127,25873,20570,477,59,26722,19615
188,19,3,1,0,3,1,0,140,127,25876,20571,175,243,26725,19615
189,19,2,2,2,1,2,1,259,211,25878,20573,306,298,26726,19616
190,20,2,3,1,0,0,3,293,202,25880,20576,330,247,26726,19619
191,20,1,2,1,0,0,3,329,195,25881,20578,369,39,26726,19622
192,20,0,1,1,0,0,3,119,108,25881,20579,141,395,26726,19625
193,20,1,2,1,0,0,3,101,87,25882,20581,117,250,26726,19628
194,20,1,1,2,1,2,1,147,147,25883,20582,202,42,26727,19629
195,20,0,3,1,0,0,3,278,202,25883,20585,342,228,26727,19632
196,20,1,0,0,3,1,0,92,80,25884,20585,89,243,26730,19632
197,20,2,1,0,3,1,0,326,167,25886,20586,382,116,26733,19632
198,20,0,1,1,0,0,3,386,177,25886,20587,393,64,26733,19635
199,20,3,2,0,3,1,0,196,163,25889,20589,215,63,26736,19635
200,21,4,0,0,3,1,0,519,127,25893,20589,480,215,26739,19635
201,21,0,1,1,0,0,3,49,65,25893,20590,53,218,26739,19638
202,21,3,1,0,3,1,0,285,155,25896,20591,303,286,26742,19638
203,21,2,1,0,3,1,0,267,197,25898,20592,329,111,26745,19638
204,21,1,1,2,1,2,1,127,130,25899,20593,137,61,26746,19639
205,21,2,0,0,3,1,0,101,130,25901,20593,100,144,26749,19639
206,21,1,0,0,3,1,0,141,127,25902,20593,178,59,26752,19639
207,21,0,1,1,0,0,3,259,212,25902,20594,306,270,26752,19642
208,21,0,5,1,0,0,3,299,192,25902,20599,342,301,26752,19645
209,21,1,0,0,3,1,0,57,58,25903,20599,59,115,26755,19645
210,22,2,1,0,3,1,0,388,178,25905,20600,396,228,26758,19645
211,22,1,2,1,0,0,3,294,204,25906,20602,330,45,26758,19648
212,22,0,1,1,0,0,3,278,203,25906,20603,342,246,26758,19651
213,22,3,1,0,3,1,0,122,109,25909,20604,144,39,26761,19651
214,22,2,4,1,0,0,3,103,91,25911,20608,117,67,26761,19654
215,22,3,2,0,3,1,0,199,165,25914,20610,218,395,26764,19654
216,22,0,1,1,0,0,3,92,81,25914,20611,89,119,26764,19657
217,22,1,0,0,3,1,0,327,167,25915,20611,385,63,26767,19657
218,22,1,2,1,0,0,3,148,149,25916,20613,202,250,26767,19660
219,22,1,0,0,3,1,0,330,195,25917,20613,372,250,26770,19660
220,23,0,3,1,0,0,3,267,200,25917,20616,329,273,26770,19663
221,23,1,1,2,1,2,1,102,131,25918,20617,101,216,26771,19664
222,23,0,0,2,1,2,1,141,127,25918,20617,179,112,26772,19665
223,23,1,1,2,1,2,1,260,213,25919,20618,307,116,26773,19666
224,23,2,2,2,1,2,1,94,83,25921,20620,90,60,26774,19667
225,23,0,1,1,0,0,3,127,131,25921,20621,137,304,26774,19670
226,23,2,2,2,1,2,1,51,67,25923,20623,54,287,26775,19671
227,23,2,1,0,3,1,0,287,156,25925,20624,306,218,26778,19671
228,23,3,0,0,3,1,0,522,127,25928,20624,483,39,26781,19671
229,23,1,1,2,1,2,1,300,193,25929,20625,343,145,26782,19672
230,24,1,0,0,3,1,0,200,165,25930,20625,221,119,26785,19672
231,24,3,0,0,3,1,0,391,178,25933,20625,399,61,26788,19672
232,24,0,0,2,1,2,1,51,67,25933,20625,55,251,26789,19673
233,24,2,1,0,3,1,0,105,92,25935,20626,120,228,26792,19673
234,24,4,2,0,3,1,0,298,206,25939,20628,333,63,26795,19673
235,24,3,0,0,3,1,0,281,203,25942,20628,345,112,26798,19673
236,24,3,4,1,0,0,3,60,62,25945,20632,59,253,26798,19676
237,24,1,0,0,3,1,0,301,193,25946,20632,346,67,26801,19676
238,24,0,2,1,0,0,3,148,151,25946,20634,202,276,26801,19679
239,24,0,2,1,0,0,3,330,197,25946,20636,372,398,26801,19682
240,25,2,1,0,3,1,0,524,128,25948,20637,486,218,26804,19682
241,25,1,1,2,1,2,1,142,128,25949,20638,180,46,26805,19683
242,25,1,2,1,0,0,3,392,180,25950,20640,399,219,26805,19686
243,25,2,2,2,1,2,1,289,158,25952,20642,307,117,26806,19687
244,25,1,3,1,0,0,3,123,112,25953,20645,144,148,26806,19690
245,25,0,2,1,0,0,3,127,133,25953,20647,137,42,26806,19693
246,25,1,2,1,0,0,3,103,133,25954,20649,101,64,26806,19696
247,25,0,2,1,0,0,3,260,215,25954,20651,307,249,26806,19699
248,25,0,0,2,1,2,1,327,167,25954,20651,386,61,26807,19700
249,25,0,0,2,1,2,1,267,200,25954,20651,330,288,26808,19701
250,26,2,3,1,0,0,3,107,95,25956,20654,120,307,26808,19704
251,26,1,1,2,1,2,1,302,194,25957,20655,347,120,26809,19705
252,26,1,1,2,1,2,1,149,152,25958,20656,203,289,26810,19706
253,26,2,1,0,3,1,0,300,207,25960,20657,336,251,26813,19706
254,26,2,1,0,3,1,0,53,68,25962,20658,58,63,26816,19706
255,26,1,2,1,0,0,3,282,205,25963,20660,345,70,26816,19709
256,26,2,0,0,3,1,0,62,62,25965,20660,62,228,26819,19709
257,26,0,0,2,1,2,1,94,83,25965,20660,91,113,26820,19710
258,26,1,4,1,0,0,3,201,169,25966,20664,221,279,26820,19713
259,26,0,2,1,0,0,3,524,130,25966,20666,486,256,26820,19716
260,27,1,2,1,0,0,3,261,217,25967,20668,307,221,26820,19719
261,27,1,2,1,0,0,3,268,202,25968,20670,330,73,26820,19722
262,27,0,4,1,0,0,3,127,137,25968,20674,137,401,26820,19725
263,27,2,0,0,3,1,0,291,158,25970,20674,310,61,26823,19725
264,27,2,2,2,1,2,1,125,114,25972,20676,145,47,26824,19726
265,27,2,1,0,3,1,0,203,170,25974,20677,224,249,26827,19726
266,27,1,1,2,1,2,1,63,63,25975,20678,63,149,26828,19727
267,27,0,0,2,1,2,1,142,128,25975,20678,181,220,26829,19728
268,27,1,1,2,1,2,1,328,168,25976,20679,387,65,26830,19729
269,27,1,1,2,1,2,1,331,198,25977,20680,373,308,26831,19730
270,28,3,1,0,3,1,0,110,96,25980,20681,123,63,26834,19730
271,28,1,0,0,3,1,0,393,180,25981,20681,402,251,26837,19730
272,28,0,1,1,0,0,3,103,134,25981,20682,101,116,26837,19733
273,28,2,1,0,3,1,0,284,206,25983,20683,348,42,26840,19733
274,28,2,3,1,0,0,3,304,197,25985,20686,347,50,26840,19736
275,28,0,1,1,0,0,3,268,203,25985,20687,330,404,26840,19739
276,28,2,0,0,3,1,0,330,168,25987,20687,390,289,26843,19739
277,28,1,1,2,1,2,1,301,208,25988,20688,337,118,26844,19740
278,28,1,2,1,0,0,3,150,154,25989,20690,203,123,26844,19743
279,28,1,0,0,3,1,0,95,83,25990,20690,94,256,26847,19743
280,29,1,1,2,1,2,1,143,129,25991,20691,182,309,26848,19744
281,29,0,1,1,0,0,3,125,115,25991,20692,145,252,26848,19747
282,29,3,1,0,3,1,0,334,199,25994,20693,376,61,26851,19747
283,29,1,1,2,1,2,1,64,64,25995,20694,64,221,26852,19748
284,29,1,3,1,0,0,3,128,140,25996,20697,137,231,26852,19751
285,29,2,2,2,1,2,1,55,70,25998,20699,59,74,26853,19752
286,29,1,1,2,1,2,1,204,171,25999,20700,225,222,26854,19753
287,29,1,0,0,3,1,0,262,217,26000,20700,310,65,26857,19753
288,29,0,0,2,1,2,1,291,158,26000,20700,311,280,26858,19754
289,29,1,2,1,0,0,3,525,132,26001,20702,486,152,26858,19757
290,30,0,4,1,0,0,3,304,201,26001,20706,347,259,26858,19760
291,30,1,3,1,0,0,3,104,137,26002,20709,101,254,26858,19763
292,30,3,0,0,3,1,0,287,206,26005,20709,351,289,26861,19763
293,30,1,2,1,0,0,3,96,85,26006,20711,94,53,26861,19766
294,30,0,0,2,1,2,1,110,96,26006,20711,124,117,26862,19767
295,30,0,1,1,0,0,3,128,141,26006,20712,137,126,26862,19770
296,30,3,1,0,3,1,0,304,209,26009,20713,340,231,26865,19770
297,30,1,1,2,1,2,1,151,155,26010,20714,204,119,26866,19771
298,30,1,2,1,0,0,3,331,170,26011,20716,390,45,26866,19774
299,30,2,4,1,0,0,3,395,184,26013,20720,402,407,26866,19777
300,31,4,0,0,3,1,0,295,158,26017,20720,314,74,26869,19777
301,31,0,1,1,0,0,3,525,133,26017,20721,486,283,26869,19780
302,31,1,1,2,1,2,1,56,71,26018,20722,60,310,26870,19781
303,31,1,1,2,1,2,1,126,116,26019,20723,146,222,26871,19782
304,31,2,3,1,0,0,3,270,206,26021,20726,330,68,26871,19785
305,31,1,0,0,3,1,0,205,171,26022,20726,228,61,26874,19785
306,31,1,2,1,0,0,3,152,157,26023,20728,204,225,26874,19788
307,31,2,2,2,1,2,1,145,131,26025,20730,183,255,26875,19789
308,31,0,2,1,0,0,3,64,66,26025,20732,64,255,26875,19792
309,31,2,0,0,3,1,0,336,199,26027,20732,379,63,26878,19792
310,32,0,2,1,0,0,3,104,139,26027,20734,101,286,26878,19795
311,32,1,4,1,0,0,3,97,89,26028,20738,94,410,26878,19798
312,32,3,3,2,1,2,1,307,212,26031,20741,341,290,26879,19799
313,32,1,0,0,3,1,0,263,217,26032,20741,313,152,26882,19799
314,32,1,1,2,1,2,1,111,97,26033,20742,125,46,26883,19800
315,32,4,1,0,3,1,0,60,72,26037,20743,63,119,26886,19800
316,32,0,0,2,1,2,1,287,206,26037,20743,352,127,26887,19801
317,32,4,1,0,3,1,0,308,202,26041,20744,350,231,26890,19801
318,32,3,0,0,3,1,0,298,158,26044,20744,317,63,26893,19801
319,32,3,0,0,3,1,0,398,184,26047,20744,405,117,26896,19801
0,1,1,0,0,3,1,0,65,77,26048,20744,70,46,26899,19801
1,1,1,1,2,1,2,1,1,1,26049,20745,1,1,26900,19802
2,1,0,0,2,1,2,1,0,0,26049,20745,1,1,26901,19803
3,1,0,0,2,1,2,1,128,141,26049,20745,138,118,26902,19804
4,1,1,0,0,3,1,0,1,0,26050,20745,3,0,26905,19804
5,1,0,2,1,0,0,3,104,141,26050,20747,101,70,26905,19807
6,1,1,1,2,1,2,1,146,132,26051,20748,184,1,26906,19808
7,1,4,3,0,3,1,0,4,3,26055,20751,3,0,26909,19808
8,1,1,0,0,3,1,0,1,0,26056,20751,3,28,26912,19808
9,1,0,2,1,0,0,3,152,159,26056,20753,204,3,26912,19811
10,2,0,0,2,1,2,1,126,116,26056,20753,147,1,26913,19812
11,2,2,2,2,1,2,1,2,2,26058,20755,1,64,26914,19813
12,2,4,0,0,3,1,0,109,103,26062,20755,107,0,26917,19813
13,2,1,0,0,3,1,0,1,0,26063,20755,3,0,26920,19813
14,2,1,0,0,3,1,0,1,0,26064,20755,3,74,26923,19813
15,2,2,0,0,3,1,0,2,0,26066,20755,3,39,26926,19813
16,2,2,2,2,1,2,1,2,2,26068,20757,1,128,26927,19814
17,2,1,1,2,1,2,1,65,67,26069,20758,65,1,26928,19815
18,2,0,2,1,0,0,3,55,84,26069,20760,60,155,26928,19818
19,2,1,0,0,3,1,0,1,0,26070,20760,3,0,26931,19818
20,3,0,1,1,0,0,3,104,142,26070,20761,101,31,26931,19821
21,3,0,0,2,1,2,1,65,77,26070,20761,71,4,26932,19822
22,3,2,1,0,3,1,0,3,2,26072,20762,4,46,26935,19822
23,3,2,1,0,3,1,0,2,1,26074,20763,4,0,26938,19822
24,3,1,1,2,1,2,1,129,142,26075,20764,139,1,26939,19823
25,3,0,2,1,0,0,3,1,2,26075,20766,3,121,26939,19826
26,3,0,1,1,0,0,3,152,160,26075,20767,204,73,26939,19829
27,3,0,0,2,1,2,1,146,132,26075,20767,185,2,26940,19830
28,3,3,2,0,3,1,0,7,5,26078,20769,6,1,26943,19830
29,3,2,1,0,3,1,0,3,1,26080,20770,6,1,26946,19830
30,4,1,2,1,0,0,3,3,4,26081,20772,1,124,26946,19833
31,4,1,2,1,0,0,3,110,105,26082,20774,107,3,26946,19836
32,4,1,1,2,1,2,1,2,1,26083,20775,4,65,26947,19837
33,4,2,1,0,3,1,0,4,1,26085,20776,6,128,26950,19837
34,4,0,2,1,0,0,3,2,4,26085,20778,1,4,26950,19840
35,4,1,0,0,3,1,0,105,142,26086,20778,104,0,26953,19840
36,4,1,0,0,3,1,0,66,67,26087,20778,68,0,26956,19840
37,4,1,1,2,1,2,1,2,1,26088,20779,4,2,26957,19841
38,4,3,0,0,3,1,0,58,84,26091,20779,63,39,26960,19841
39,4,0,0,2,1,2,1,1,0,26091,20779,4,156,26961,19842
40,5,0,0,2,1,2,1,65,77,26091,20779,72,75,26962,19843
41,5,0,3,1,0,0,3,126,119,26091,20782,147,4,26962,19846
42,5,2,0,0,3,1,0,5,2,26093,20782,7,2,26965,19846
43,5,2,1,0,3,1,0,5,5,26095,20783,4,0,26968,19846
44,5,1,0,0,3,1,0,130,142,26096,20783,142,46,26971,19846
45,5,2,0,0,3,1,0,154,160,26098,20783,207,0,26974,19846
46,5,0,1,1,0,0,3,146,133,26098,20784,185,34,26974,19849
47,5,2,0,0,3,1,0,9,5,26100,20784,9,1,26977,19849
48,5,0,1,1,0,0,3,2,2,26100,20785,4,76,26977,19852
49,5,0,1,1,0,0,3,1,3,26100,20786,3,7,26977,19855
50,6,0,1,1,0,0,3,2,2,26100,20787,4,3,26977,19858
51,6,1,1,2,1,2,1,2,1,26101,20788,5,5,26978,19859
52,6,2,1,0,3,1,0,6,2,26103,20789,9,65,26981,19859
53,6,1,1,2,1,2,1,3,5,26104,20790,2,3,26982,19860
54,6,1,1,2,1,2,1,106,143,26105,20791,105,157,26983,19861
55,6,2,0,0,3,1,0,68,67,26107,20791,71,124,26986,19861
56,6,4,0,0,3,1,0,6,1,26111,20791,7,1,26989,19861
57,6,1,2,1,0,0,3,59,86,26112,20793,63,6,26989,19864
58,6,4,1,0,3,1,0,7,2,26116,20794,9,128,26992,19864
59,6,1,1,2,1,2,1,111,106,26117,20795,108,40,26993,19865
60,7,3,0,0,3,1,0,68,77,26120,20795,75,0,26996,19865
61,7,0,0,2,1,2,1,5,2,26120,20795,8,2,26997,19866
62,7,1,0,0,3,1,0,3,2,26121,20795,7,75,27000,19866
63,7,2,0,0,3,1,0,7,5,26123,20795,7,46,27003,19866
64,7,5,1,0,3,1,0,135,143,26128,20796,145,76,27006,19866
65,7,0,2,1,0,0,3,1,5,26128,20798,3,37,27006,19869
66,7,2,1,0,3,1,0,8,2,26130,20799,10,7,27009,19869
67,7,0,0,2,1,2,1,9,5,26130,20799,10,1,27010,19870
68,7,1,1,2,1,2,1,127,120,26131,20800,148,3,27011,19871
69,7,2,1,0,3,1,0,148,134,26133,20801,188,157,27014,19871
70,8,2,2,2,1,2,1,4,4,26135,20803,5,2,27015,19872
71,8,0,0,2,1,2,1,2,1,26135,20803,6,41,27016,19873
72,8,1,0,0,3,1,0,7,2,26136,20803,12,124,27019,19873
73,8,2,2,2,1,2,1,5,7,26138,20805,3,66,27020,19874
74,8,0,0,2,1,2,1,106,143,26138,20805,106,129,27021,19875
75,8,2,1,0,3,1,0,156,161,26140,20806,210,3,27024,19875
76,8,2,0,0,3,1,0,70,67,26142,20806,74,4,27027,19875
77,8,3,1,0,3,1,0,62,87,26145,20807,66,5,27030,19875
78,8,0,0,2,1,2,1,7,2,26145,20807,10,7,27031,19876
79,8,0,0,2,1,2,1,111,106,26145,20807,109,4,27032,19877
80,9,2,3,1,0,0,3,70,80,26147,20810,75,160,27032,19880
81,9,2,0,0,3,1,0,129,120,26149,20810,151,2,27035,19880
82,9,1,1,2,1,2,1,6,3,26150,20811,9,2,27036,19881
83,9,2,0,0,3,1,0,5,2,26152,20811,10,129,27039,19881
84,9,3,3,2,1,2,1,10,8,26155,20814,8,77,27040,19882
85,9,0,1,1,0,0,3,135,144,26155,20815,145,40,27040,19885
86,9,1,2,1,0,0,3,2,7,26156,20817,3,3,27040,19888
87,9,1,2,1,0,0,3,71,69,26157,20819,74,10,27040,19891
88,9,5,1,0,3,1,0,13,3,26162,20820,13,3,27043,19891
89,9,2,2,2,1,2,1,11,7,26164,20822,11,76,27044,19892
90,10,0,0,2,1,2,1,111,106,26164,20822,110,125,27045,19893
91,10,0,0,2,1,2,1,4,4,26164,20822,6,47,27046,19894
92,10,3,0,0,3,1,0,5,1,26167,20822,9,3,27049,19894
93,10,1,1,2,1,2,1,8,3,26168,20823,13,5,27050,19895
94,10,2,0,0,3,1,0,7,7,26170,20823,6,2,27053,19895
95,10,3,1,0,3,1,0,109,144,26173,20824,109,66,27056,19895
96,10,1,1,2,1,2,1,149,135,26174,20825,189,42,27057,19896
97,10,1,1,2,1,2,1,63,88,26175,20826,67,5,27058,19897
98,10,0,1,1,0,0,3,7,3,26175,20827,10,8,27058,19900
99,10,0,0,2,1,2,1,156,161,26175,20827,211,8,27059,19901
100,11,0,0,2,1,2,1,6,3,26175,20827,10,161,27060,19902
101,11,1,3,1,0,0,3,130,123,26176,20830,151,13,27060,19905
102,11,1,2,1,0,0,3,6,4,26177,20832,10,45,27060,19908
103,11,2,0,0,3,1,0,12,8,26179,20832,11,2,27063,19908
104,11,4,1,0,3,1,0,139,145,26183,20833,148,3,27066,19908
105,11,1,0,0,3,1,0,3,7,26184,20833,6,76,27069,19908
106,11,0,2,1,0,0,3,4,6,26184,20835,6,5,27069,19911
107,11,1,3,1,0,0,3,72,72,26185,20838,74,80,27069,19914
108,11,1,1,2,1,2,1,14,4,26186,20839,14,41,27070,19915
109,11,2,1,0,3,1,0,13,8,26188,20840,14,129,27073,19915
110,12,2,0,0,3,1,0,72,80,26190,20840,78,8,27076,19915
111,12,2,0,0,3,1,0,7,1,26192,20840,12,66,27079,19915
112,12,1,0,0,3,1,0,8,7,26193,20840,9,3,27082,19915
113,12,1,1,2,1,2,1,110,145,26194,20841,110,126,27083,19916
114,12,1,1,2,1,2,1,157,162,26195,20842,212,9,27084,19917
115,12,4,1,0,3,1,0,153,136,26199,20843,192,3,27087,19917
116,12,1,1,2,1,2,1,64,89,26200,20844,68,3,27088,19918
117,12,0,0,2,1,2,1,7,3,26200,20844,11,6,27089,19919
118,12,2,2,2,1,2,1,113,108,26202,20846,111,6,27090,19920
119,12,0,0,2,1,2,1,8,3,26202,20846,14,48,27091,19921
120,13,3,0,0,3,1,0,133,123,26205,20846,154,41,27094,19921
121,13,1,0,0,3,1,0,7,3,26206,20846,13,129,27097,19921
122,13,1,1,2,1,2,1,13,9,26207,20847,12,77,27098,19922
123,13,0,0,2,1,2,1,139,145,26207,20847,149,162,27099,19923
124,13,1,1,2,1,2,1,4,8,26208,20848,7,46,27100,19924
125,13,1,1,2,1,2,1,5,7,26209,20849,7,81,27101,19925
126,13,1,1,2,1,2,1,9,4,26210,20850,15,14,27102,19926
127,13,0,0,2,1,2,1,72,72,26210,20850,75,3,27103,19927
128,13,4,0,0,3,1,0,18,4,26214,20850,17,3,27106,19927
129,13,2,0,0,3,1,0,15,8,26216,20850,17,9,27109,19927
130,14,1,0,0,3,1,0,73,80,26217,20850,81,66,27112,19927
131,14,4,3,0,3,1,0,10,7,26221,20853,13,3,27115,19927
132,14,1,1,2,1,2,1,114,109,26222,20854,112,6,27116,19928
133,14,3,0,0,3,1,0,10,1,26225,20854,15,6,27119,19928
134,14,0,1,1,0,0,3,110,146,26225,20855,110,17,27119,19931
135,14,2,1,0,3,1,0,159,163,26227,20856,215,48,27122,19931
136,14,2,0,0,3,1,0,155,136,26229,20856,195,126,27125,19931
137,14,0,1,1,0,0,3,64,90,26229,20857,68,6,27125,19934
138,14,1,1,2,1,2,1,8,4,26230,20858,12,4,27126,19935
139,14,2,0,0,3,1,0,17,8,26232,20858,20,6,27129,19935
140,15,1,1,2,1,2,1,134,124,26233,20859,155,163,27130,19936
141,15,0,1,1,0,0,3,13,10,26233,20860,12,12,27130,19939
142,15,3,2,0,3,1,0,142,147,26236,20862,152,129,27133,19939
143,15,2,2,2,1,2,1,6,10,26238,20864,8,9,27134,19940
144,15,3,0,0,3,1,0,8,7,26241,20864,10,3,27137,19940
145,15,1,0,0,3,1,0,10,4,26242,20864,18,3,27140,19940
146,15,1,0,0,3,1,0,73,72,26243,20864,78,41,27143,19940
147,15,1,3,1,0,0,3,9,10,26244,20867,9,84,27143,19943
148,15,4,1,0,3,1,0,22,5,26248,20868,20,46,27146,19943
149,15,0,2,1,0,0,3,7,5,26248,20870,13,80,27146,19946
150,16,2,0,0,3,1,0,75,80,26250,20870,84,6,27149,19946
151,16,0,3,1,0,0,3,10,10,26250,20873,13,69,27149,19949
152,16,2,0,0,3,1,0,116,109,26252,20873,115,3,27152,19949
153,16,0,0,2,1,2,1,10,1,26252,20873,16,7,27153,19950
154,16,0,0,2,1,2,1,110,146,26252,20873,111,7,27154,19951
155,16,2,0,0,3,1,0,161,163,26254,20873,218,4,27157,19951
156,16,1,1,2,1,2,1,156,137,26255,20874,196,49,27158,19952
157,16,0,0,2,1,2,1,64,90,26255,20874,69,7,27159,19953
158,16,0,0,2,1,2,1,8,4,26255,20874,13,127,27160,19954
159,16,0,1,1,0,0,3,17,9,26255,20875,20,20,27160,19957
160,17,2,1,0,3,1,0,136,125,26257,20876,158,12,27163,19957
161,17,2,0,0,3,1,0,9,5,26259,20876,16,3,27166,19957
162,17,3,2,0,3,1,0,145,149,26262,20878,155,9,27169,19957
163,17,2,1,0,3,1,0,10,8,26264,20879,13,163,27172,19957
164,17,2,1,0,3,1,0,12,5,26266,20880,21,80,27175,19957
165,17,2,1,0,3,1,0,75,73,26268,20881,81,3,27178,19957
166,17,0,0,2,1,2,1,22,5,26268,20881,21,130,27179,19958
167,17,1,0,0,3,1,0,10,10,26269,20881,12,41,27182,19958
168,17,2,0,0,3,1,0,15,10,26271,20881,15,46,27185,19958
169,17,3,0,0,3,1,0,119,109,26274,20881,118,3,27188,19958
170,18,1,0,0,3,1,0,76,80,26275,20881,87,127,27191,19958
171,18,1,1,2,1,2,1,11,11,26276,20882,14,7,27192,19959
172,18,3,1,0,3,1,0,9,11,26279,20883,11,69,27195,19959
173,18,1,3,1,0,0,3,157,140,26280,20886,196,7,27195,19962
174,18,0,2,1,0,0,3,17,11,26280,20888,20,52,27195,19965
175,18,1,1,2,1,2,1,65,91,26281,20889,70,85,27196,19966
176,18,1,1,2,1,2,1,9,5,26282,20890,14,8,27197,19967
177,18,0,0,2,1,2,1,161,163,26282,20890,219,8,27198,19968
178,18,2,1,0,3,1,0,12,2,26284,20891,19,20,27201,19968
179,18,0,0,2,1,2,1,110,146,26284,20891,112,8,27202,19969
180,19,0,1,1,0,0,3,12,6,26284,20892,21,166,27202,19972
181,19,2,2,2,1,2,1,138,127,26286,20894,159,10,27203,19973
182,19,0,1,1,0,0,3,9,6,26286,20895,16,72,27203,19976
183,19,2,2,2,1,2,1,17,12,26288,20897,16,4,27204,19977
184,19,1,2,1,0,0,3,120,111,26289,20899,118,133,27204,19980
185,19,2,2,2,1,2,1,12,10,26291,20901,14,47,27205,19981
186,19,0,0,2,1,2,1,12,2,26291,20901,20,42,27206,19982
187,19,0,1,1,0,0,3,10,11,26291,20902,12,6,27206,19985
188,19,2,0,0,3,1,0,77,73,26293,20902,84,80,27209,19985
189,19,2,0,0,3,1,0,24,5,26295,20902,24,12,27212,19985
190,20,2,1,0,3,1,0,78,81,26297,20903,90,8,27215,19985
191,20,2,1,0,3,1,0,11,7,26299,20904,19,127,27218,19985
192,20,1,1,2,1,2,1,12,12,26300,20905,15,53,27219,19986
193,20,0,1,1,0,0,3,145,150,26300,20906,155,10,27219,19989
194,20,1,1,2,1,2,1,10,12,26301,20907,12,9,27220,19990
195,20,4,0,0,3,1,0,114,146,26305,20907,115,3,27223,19990
196,20,3,0,0,3,1,0,160,140,26308,20907,199,20,27226,19990
197,20,2,3,1,0,0,3,19,14,26310,20910,20,11,27226,19993
198,20,2,2,2,1,2,1,11,7,26312,20912,15,86,27227,19994
199,20,0,1,1,0,0,3,161,164,26312,20913,219,45,27227,19997
200,21,2,2,2,1,2,1,140,129,26314,20915,160,5,27228,19998
201,21,3,1,0,3,1,0,20,13,26317,20916,19,10,27231,19998
202,21,3,0,0,3,1,0,123,111,26320,20916,121,166,27234,19998
203,21,2,0,0,3,1,0,14,10,26322,20916,17,133,27237,19998
204,21,1,0,0,3,1,0,13,2,26323,20916,23,6,27240,19998
205,21,0,1,1,0,0,3,77,74,26323,20917,84,10,27240,20001
206,21,0,0,2,1,2,1,24,5,26323,20917,25,73,27241,20002
207,21,2,1,0,3,1,0,67,92,26325,20918,73,80,27244,20002
208,21,3,0,0,3,1,0,13,11,26328,20918,15,47,27247,20002
209,21,1,0,0,3,1,0,13,6,26329,20918,24,12,27250,20002
210,22,3,0,0,3,1,0,81,81,26332,20918,93,45,27253,20002
211,22,1,0,0,3,1,0,141,129,26333,20918,163,10,27256,20002
212,22,1,0,0,3,1,0,12,7,26334,20918,22,9,27259,20002
213,22,1,2,1,0,0,3,13,14,26335,20920,15,23,27259,20005
214,22,0,1,1,0,0,3,145,151,26335,20921,155,14,27259,20008
215,22,1,0,0,3,1,0,11,12,26336,20921,15,53,27262,20008
216,22,1,1,2,1,2,1,162,165,26337,20922,220,4,27263,20009
217,22,2,1,0,3,1,0,162,141,26339,20923,202,8,27266,20009
218,22,1,2,1,0,0,3,12,9,26340,20925,15,83,27266,20012
219,22,1,0,0,3,1,0,20,14,26341,20925,23,86,27269,20012
220,23,1,0,0,3,1,0,124,111,26342,20925,124,12,27272,20012
221,23,0,1,1,0,0,3,14,11,26342,20926,17,13,27272,20015
222,23,2,2,2,1,2,1,15,4,26344,20928,24,11,27273,20016
223,23,1,0,0,3,1,0,14,6,26345,20928,27,10,27276,20016
224,23,1,0,0,3,1,0,14,11,26346,20928,18,5,27279,20016
225,23,0,2,1,0,0,3,77,76,26346,20930,84,76,27279,20019
226,23,0,1,1,0,0,3,24,6,26346,20931,25,130,27279,20022
227,23,3,2,0,3,1,0,70,94,26349,20933,76,133,27282,20022
228,23,1,0,0,3,1,0,13,9,26350,20933,18,166,27285,20022
229,23,2,2,2,1,2,1,116,148,26352,20935,116,48,27286,20023
230,24,1,0,0,3,1,0,82,81,26353,20935,96,86,27289,20023
231,24,2,0,0,3,1,0,143,129,26355,20935,166,53,27292,20023
232,24,1,0,0,3,1,0,14,14,26356,20935,18,4,27295,20023
233,24,1,1,2,1,2,1,21,14,26357,20936,20,10,27296,20024
234,24,0,0,2,1,2,1,145,151,26357,20936,156,9,27297,20025
235,24,0,2,1,0,0,3,11,14,26357,20938,15,17,27297,20028
236,24,0,0,2,1,2,1,162,165,26357,20938,221,84,27298,20029
237,24,3,1,0,3,1,0,165,142,26360,20939,205,6,27301,20029
238,24,1,0,0,3,1,0,21,14,26361,20939,26,45,27304,20029
239,24,1,0,0,3,1,0,13,7,26362,20939,25,23,27307,20029
240,25,0,2,1,0,0,3,124,113,26362,20941,124,79,27307,20032
241,25,1,1,2,1,2,1,15,12,26363,20942,18,131,27308,20033
242,25,4,0,0,3,1,0,19,4,26367,20942,27,13,27311,20033
243,25,1,1,2,1,2,1,15,12,26368,20943,19,11,27312,20034
244,25,0,0,2,1,2,1,116,148,26368,20943,117,13,27313,20035
245,25,1,1,2,1,2,1,163,166,26369,20944,222,134,27314,20036
246,25,1,2,1,0,0,3,78,78,26370,20946,84,13,27314,20039
247,25,2,0,0,3,1,0,72,94,26372,20946,79,5,27317,20039
248,25,0,1,1,0,0,3,13,10,26372,20947,18,51,27317,20042
249,25,4,3,0,3,1,0,18,9,26376,20950,30,11,27320,20042
250,26,1,1,2,1,2,1,83,82,26377,20951,97,5,27321,20043
251,26,1,0,0,3,1,0,15,14,26378,20951,21,45,27324,20043
252,26,2,0,0,3,1,0,23,14,26380,20951,23,17,27327,20043
253,26,2,0,0,3,1,0,13,14,26382,20951,18,166,27330,20043
254,26,2,2,2,1,2,1,167,144,26384,20953,206,85,27331,20044
255,26,1,0,0,3,1,0,25,6,26385,20953,28,53,27334,20044
256,26,2,0,0,3,1,0,23,14,26387,20953,29,6,27337,20044
257,26,0,0,2,1,2,1,143,129,26387,20953,167,10,27338,20045
258,26,3,2,0,3,1,0,148,153,26390,20955,159,23,27341,20045
259,26,1,2,1,0,0,3,14,9,26391,20957,25,89,27341,20048
260,27,1,1,2,1,2,1,125,114,26392,20958,125,14,27342,20049
261,27,5,3,0,3,1,0,20,15,26397,20961,21,11,27345,20049
262,27,1,1,2,1,2,1,20,5,26398,20962,28,132,27346,20050
263,27,2,0,0,3,1,0,20,9,26400,20962,33,13,27349,20050
264,27,1,0,0,3,1,0,117,148,26401,20962,120,11,27352,20050
265,27,2,0,0,3,1,0,165,166,26403,20962,225,51,27355,20050
266,27,1,1,2,1,2,1,168,145,26404,20963,207,14,27356,20051
267,27,2,0,0,3,1,0,74,94,26406,20963,82,79,27359,20051
268,27,1,1,2,1,2,1,14,11,26407,20964,19,6,27360,20052
269,27,1,1,2,1,2,1,16,13,26408,20965,20,54,27361,20053
270,28,3,0,0,3,1,0,86,82,26411,20965,100,134,27364,20053
271,28,3,0,0,3,1,0,146,129,26414,20965,170,89,27367,20053
272,28,2,0,0,3,1,0,16,9,26416,20965,28,45,27370,20053
273,28,0,2,1,0,0,3,15,16,26416,20967,21,9,27370,20056
274,28,0,0,2,1,2,1,23,14,26416,20967,24,24,27371,20057
275,28,2,1,0,3,1,0,150,154,26418,20968,162,85,27374,20057
276,28,1,2,1,0,0,3,14,16,26419,20970,18,8,27374,20060
277,28,2,0,0,3,1,0,80,78,26421,20970,87,17,27377,20060
278,28,1,1,2,1,2,1,26,7,26422,20971,29,11,27378,20061
279,28,2,1,0,3,1,0,25,15,26424,20972,32,166,27381,20061
280,29,1,1,2,1,2,1,87,83,26425,20973,101,15,27382,20062
281,29,1,0,0,3,1,0,126,114,26426,20973,128,54,27385,20062
282,29,1,1,2,1,2,1,21,6,26427,20974,29,15,27386,20063
283,29,1,2,1,0,0,3,21,11,26428,20976,33,20,27386,20066
284,29,0,0,2,1,2,1,16,13,26428,20976,21,133,27387,20067
285,29,0,1,1,0,0,3,117,149,26428,20977,120,9,27387,20070
286,29,4,1,0,3,1,0,172,146,26432,20978,210,11,27390,20070
287,29,0,2,1,0,0,3,74,96,26432,20980,82,14,27390,20073
288,29,2,4,1,0,0,3,16,15,26434,20984,19,82,27390,20076
289,29,1,2,1,0,0,3,166,168,26435,20986,225,16,27390,20079
290,30,0,0,2,1,2,1,146,129,26435,20986,171,86,27391,20080
291,30,0,1,1,0,0,3,16,10,26435,20987,28,12,27391,20083
292,30,0,0,2,1,2,1,15,16,26435,20987,22,167,27392,20084
293,30,2,2,2,1,2,1,25,16,26437,20989,25,46,27393,20085
294,30,2,0,0,3,1,0,152,154,26439,20989,165,8,27396,20085
295,30,1,1,2,1,2,1,15,17,26440,20990,19,135,27397,20086
296,30,0,0,2,1,2,1,20,15,26440,20990,22,25,27398,20087
297,30,1,1,2,1,2,1,81,79,26441,20991,88,12,27399,20088
298,30,1,4,1,0,0,3,27,11,26442,20995,29,92,27399,20091
299,30,2,2,2,1,2,1,27,17,26444,20997,33,52,27400,20092
300,31,1,0,0,3,1,0,88,83,26445,20997,104,9,27403,20092
301,31,3,0,0,3,1,0,18,16,26448,20997,25,11,27406,20092
302,31,3,2,0,3,1,0,129,116,26451,20999,131,20,27409,20092
303,31,1,0,0,3,1,0,22,6,26452,20999,32,54,27412,20092
304,31,3,3,2,1,2,1,120,152,26455,21002,121,16,27413,20093
305,31,1,1,2,1,2,1,167,169,26456,21003,226,83,27414,20094
306,31,4,1,0,3,1,0,176,147,26460,21004,213,16,27417,20094
307,31,1,2,1,0,0,3,75,98,26461,21006,82,136,27417,20097
308,31,0,3,1,0,0,3,16,18,26461,21009,19,17,27417,20100
309,31,1,0,0,3,1,0,17,13,26462,21009,24,12,27420,20100
310,32,3,2,0,3,1,0,19,12,26465,21011,31,11,27423,20100
311,32,1,0,0,3,1,0,26,16,26466,21011,28,12,27426,20100
312,32,1,1,2,1,2,1,16,18,26467,21012,20,16,27427,20101
313,32,2,0,0,3,1,0,22,15,26469,21012,25,46,27430,20101
314,32,0,0,2,1,2,1,21,11,26469,21012,34,93,27431,20102
315,32,0,0,2,1,2,1,17,13,26469,21012,25,87,27432,20103
316,32,2,2,2,1,2,1,83,81,26471,21014,89,168,27433,20104
317,32,2,0,0,3,1,0,29,11,26473,21014,32,8,27436,20104
318,32,0,1,1,0,0,3,146,130,26473,21015,171,138,27436,20107
319,32,1,1,2,1,2,1,153,155,26474,21016,166,53,27437,20108
320,33,0,0,2,1,2,1,88,83,26474,21016,105,18,27438,20109
321,33,3,1,0,3,1,0,21,17,26477,21017,28,16,27441,20109
322,33,2,1,0,3,1,0,24,7,26479,21018,35,12,27444,20109
323,33,3,1,0,3,1,0,123,153,26482,21019,124,16,27447,20109
324,33,2,0,0,3,1,0,169,169,26484,21019,229,136,27450,20109
325,33,1,2,1,0,0,3,177,149,26485,21021,213,86,27450,20112
326,33,2,2,2,1,2,1,29,19,26487,21023,34,10,27451,20113
327,33,1,3,1,0,0,3,76,101,26488,21026,82,57,27451,20116
328,33,2,2,2,1,2,1,18,20,26490,21028,20,21,27452,20117
329,33,3,0,0,3,1,0,132,116,26493,21028,134,25,27455,20117
330,34,3,0,0,3,1,0,149,130,26496,21028,174,12,27458,20117
331,34,2,1,0,3,1,0,28,17,26498,21029,31,168,27461,20117
332,34,3,1,0,3,1,0,156,156,26501,21030,169,16,27464,20117
333,34,1,1,2,1,2,1,17,19,26502,21031,21,94,27465,20118
334,34,0,1,1,0,0,3,22,16,26502,21032,25,11,27465,20121
335,34,1,2,1,0,0,3,22,13,26503,21034,34,49,27465,20124
336,34,3,0,0,3,1,0,20,13,26506,21034,28,11,27468,20124
337,34,2,2,2,1,2,1,85,83,26508,21036,90,139,27469,20125
338,34,3,1,0,3,1,0,32,12,26511,21037,35,87,27472,20125
339,34,0,1,1,0,0,3,19,13,26511,21038,31,56,27472,20128
340,35,2,2,2,1,2,1,26,9,26513,21040,36,95,27473,20129
341,35,1,0,0,3,1,0,89,83,26514,21040,108,16,27476,20129
342,35,1,2,1,0,0,3,22,19,26515,21042,28,139,27476,20132
343,35,2,2,2,1,2,1,19,21,26517,21044,22,17,27477,20133
344,35,2,0,0,3,1,0,125,153,26519,21044,127,12,27480,20133
345,35,2,1,0,3,1,0,171,170,26521,21045,232,21,27483,20133
346,35,1,0,0,3,1,0,178,149,26522,21045,216,18,27486,20133
347,35,0,1,1,0,0,3,29,20,26522,21046,34,89,27486,20136
348,35,0,1,1,0,0,3,76,102,26522,21047,82,28,27486,20139
349,35,3,1,0,3,1,0,21,21,26525,21048,23,57,27489,20139
350,36,3,1,0,3,1,0,152,131,26528,21049,177,56,27492,20139
351,36,3,2,0,3,1,0,22,15,26531,21051,34,16,27495,20139
352,36,1,1,2,1,2,1,29,18,26532,21052,32,140,27496,20140
353,36,3,0,0,3,1,0,135,116,26535,21052,137,49,27499,20140
354,36,2,3,1,0,0,3,24,19,26537,21055,25,90,27499,20143
355,36,3,4,1,0,0,3,25,17,26540,21059,34,15,27499,20146
356,36,2,3,1,0,0,3,87,86,26542,21062,90,14,27499,20149
357,36,3,1,0,3,1,0,35,13,26545,21063,38,168,27502,20149
358,36,4,0,0,3,1,0,24,13,26549,21063,31,11,27505,20149
359,36,2,1,0,3,1,0,158,157,26551,21064,172,10,27508,20149
360,37,2,0,0,3,1,0,91,83,26553,21064,111,21,27511,20149
361,37,1,0,0,3,1,0,23,19,26554,21064,31,18,27514,20149
362,37,1,1,2,1,2,1,159,158,26555,21065,173,18,27515,20150
363,37,2,2,2,1,2,1,21,23,26557,21067,23,17,27516,20151
364,37,3,0,0,3,1,0,128,153,26560,21067,130,57,27519,20151
365,37,2,1,0,3,1,0,173,171,26562,21068,235,12,27522,20151
366,37,1,2,1,0,0,3,179,151,26563,21070,216,98,27522,20154
367,37,1,1,2,1,2,1,30,21,26564,21071,35,140,27523,20155
368,37,3,2,0,3,1,0,79,104,26567,21073,85,11,27526,20155
369,37,4,3,0,3,1,0,25,24,26571,21076,26,28,27529,20155
370,38,1,0,0,3,1,0,153,131,26572,21076,180,89,27532,20155
371,38,1,0,0,3,1,0,30,18,26573,21076,35,18,27535,20155
372,38,4,3,0,3,1,0,139,119,26577,21079,140,90,27538,20155
373,38,5,3,0,3,1,0,29,22,26582,21082,28,16,27541,20155
374,38,1,2,1,0,0,3,27,11,26583,21084,36,143,27541,20158
375,38,5,0,0,3,1,0,30,17,26588,21084,37,10,27544,20158
376,38,3,2,0,3,1,0,27,15,26591,21086,34,168,27547,20158
377,38,1,2,1,0,0,3,88,88,26592,21088,90,59,27547,20161
378,38,1,0,0,3,1,0,36,13,26593,21088,41,14,27550,20161
379,38,0,1,1,0,0,3,79,105,26593,21089,85,18,27550,20164
0,1,1,1,2,1,2,1,64,65,26594,21090,70,50,27551,20165
1,1,1,2,1,0,0,3,154,133,26595,21092,180,15,27551,20168
2,1,3,1,0,3,1,0,121,91,26598,21093,159,21,27554,20168
3,1,1,1,2,1,2,1,150,134,26599,21094,168,17,27555,20169
4,1,1,2,1,0,0,3,28,13,26600,21096,36,20,27555,20172
5,1,2,0,0,3,1,0,38,13,26602,21096,44,168,27558,20172
6,1,1,0,0,3,1,0,31,21,26603,21096,38,90,27561,20172
7,1,1,0,0,3,1,0,15,31,26604,21096,15,28,27564,20172
8,1,0,2,1,0,0,3,60,74,26604,21098,63,146,27564,20175
9,1,0,0,2,1,2,1,298,158,26604,21098,318,19,27565,20176
10,2,3,3,2,1,2,1,25,18,26607,21101,35,141,27566,20177
11,2,0,1,1,0,0,3,30,19,26607,21102,35,95,27566,20180
12,2,2,1,0,3,1,0,31,23,26609,21103,31,53,27569,20180
13,2,1,1,2,1,2,1,31,18,26610,21104,38,12,27570,20181
14,2,0,1,1,0,0,3,27,16,26610,21105,34,17,27570,20184
15,2,0,2,1,0,0,3,173,173,26610,21107,235,73,27570,20187
16,2,1,0,0,3,1,0,180,151,26611,21107,219,37,27573,20187
17,2,0,1,1,0,0,3,23,20,26611,21108,31,21,27573,20190
18,2,1,1,2,1,2,1,80,106,26612,21109,86,260,27574,20191
19,2,0,0,2,1,2,1,128,153,26612,21109,131,9,27575,20192
20,3,0,1,1,0,0,3,64,66,26612,21110,70,18,27575,20195
21,3,3,1,0,3,1,0,157,134,26615,21111,183,21,27578,20195
22,3,0,0,2,1,2,1,15,31,26615,21111,16,169,27579,20196
23,3,1,0,0,3,1,0,122,91,26616,21111,162,28,27582,20196
24,3,2,2,2,1,2,1,30,15,26618,21113,37,20,27583,20197
25,3,1,2,1,0,0,3,39,15,26619,21115,44,23,27583,20200
26,3,1,2,1,0,0,3,32,23,26620,21117,38,20,27583,20203
27,3,0,1,1,0,0,3,150,135,26620,21118,168,93,27583,20206
28,3,2,1,0,3,1,0,62,75,26622,21119,66,50,27586,20206
29,3,1,2,1,0,0,3,299,160,26623,21121,318,149,27586,20209
30,4,0,0,2,1,2,1,25,18,26623,21121,36,18,27587,20210
31,4,2,0,0,3,1,0,32,19,26625,21121,38,53,27590,20210
32,4,1,2,1,0,0,3,32,25,26626,21123,31,15,27590,20213
33,4,2,1,0,3,1,0,130,154,26628,21124,134,20,27593,20213
34,4,1,1,2,1,2,1,300,161,26629,21125,319,38,27594,20214
35,4,3,2,0,3,1,0,183,153,26632,21127,222,9,27597,20214
36,4,2,1,0,3,1,0,82,107,26634,21128,89,141,27600,20214
37,4,2,0,0,3,1,0,33,18,26636,21128,41,73,27603,20214
38,4,3,1,0,3,1,0,30,17,26639,21129,37,21,27606,20214
39,4,4,0,0,3,1,0,177,173,26643,21129,238,95,27609,20214
40,5,0,0,2,1,2,1,157,134,26643,21129,184,150,27610,20215
41,5,1,0,0,3,1,0,16,31,26644,21129,19,18,27613,20215
42,5,1,1,2,1,2,1,123,92,26645,21130,163,24,27614,20216
43,5,1,0,0,3,1,0,24,20,26646,21130,34,28,27617,20216
44,5,1,0,0,3,1,0,151,135,26647,21130,171,21,27620,20216
45,5,0,0,2,1,2,1,30,15,26647,21130,38,51,27621,20217
46,5,1,1,2,1,2,1,40,16,26648,21131,45,94,27622,20218
47,5,0,0,2,1,2,1,64,66,26648,21131,71,21,27623,20219
48,5,2,1,0,3,1,0,34,24,26650,21132,41,169,27626,20219
49,5,2,2,2,1,2,1,64,77,26652,21134,67,261,27627,20220
50,6,1,1,2,1,2,1,26,19,26653,21135,37,10,27628,20221
51,6,1,1,2,1,2,1,33,26,26654,21136,32,22,27629,20222
52,6,2,1,0,3,1,0,35,19,26656,21137,44,18,27632,20222
53,6,2,2,2,1,2,1,132,156,26658,21139,135,16,27633,20223
54,6,1,3,1,0,0,3,301,164,26659,21142,319,144,27633,20226
55,6,2,1,0,3,1,0,185,154,26661,21143,225,95,27636,20226
56,6,1,0,0,3,1,0,83,107,26662,21143,92,73,27639,20226
57,6,1,1,2,1,2,1,178,174,26663,21144,239,29,27640,20227
58,6,2,1,0,3,1,0,34,20,26665,21145,41,20,27643,20227
59,6,1,2,1,0,0,3,65,68,26666,21147,71,56,27643,20230
60,7,0,0,2,1,2,1,157,134,26666,21147,185,39,27644,20231
61,7,0,2,1,0,0,3,16,33,26666,21149,19,27,27644,20234
62,7,2,2,2,1,2,1,26,22,26668,21151,35,170,27645,20235
63,7,0,0,2,1,2,1,151,135,26668,21151,172,52,27646,20236
64,7,3,2,0,3,1,0,33,17,26671,21153,41,150,27649,20236
65,7,3,0,0,3,1,0,43,16,26674,21153,48,18,27652,20236
66,7,1,2,1,0,0,3,35,26,26675,21155,41,24,27652,20239
67,7,2,0,0,3,1,0,66,77,26677,21155,70,21,27655,20239
68,7,1,1,2,1,2,1,124,93,26678,21156,164,262,27656,20240
69,7,0,1,1,0,0,3,30,18,26678,21157,37,97,27656,20243
70,8,1,0,0,3,1,0,302,164,26679,21157,322,10,27659,20243
71,8,1,0,0,3,1,0,66,68,26680,21157,74,16,27662,20243
72,8,2,0,0,3,1,0,28,19,26682,21157,40,95,27665,20243
73,8,0,1,1,0,0,3,34,21,26682,21158,41,21,27665,20246
74,8,3,1,0,3,1,0,36,27,26685,21159,35,20,27668,20246
75,8,0,0,2,1,2,1,66,77,26685,21159,71,145,27669,20247
76,8,1,3,1,0,0,3,133,159,26686,21162,135,173,27669,20250
77,8,1,0,0,3,1,0,186,154,26687,21162,228,73,27672,20250
78,8,1,1,2,1,2,1,84,108,26688,21163,93,23,27673,20251
79,8,1,1,2,1,2,1,36,20,26689,21164,45,30,27674,20252
80,9,3,1,0,3,1,0,127,94,26692,21165,167,145,27677,20252
81,9,1,0,0,3,1,0,152,135,26693,21165,175,18,27680,20252
82,9,1,0,0,3,1,0,34,17,26694,21165,44,262,27683,20252
83,9,1,2,1,0,0,3,134,161,26695,21167,135,27,27683,20255
84,9,1,1,2,1,2,1,36,27,26696,21168,42,40,27684,20256
85,9,2,1,0,3,1,0,28,23,26698,21169,38,21,27687,20256
86,9,3,0,0,3,1,0,19,33,26701,21169,22,56,27690,20256
87,9,1,0,0,3,1,0,179,174,26702,21169,242,27,27693,20256
88,9,1,1,2,1,2,1,31,19,26703,21170,38,53,27694,20257
89,9,1,0,0,3,1,0,44,16,26704,21170,51,150,27697,20257
90,10,0,0,2,1,2,1,66,68,26704,21170,75,96,27698,20258
91,10,2,0,0,3,1,0,159,134,26706,21170,188,10,27701,20258
92,10,1,0,0,3,1,0,35,21,26707,21170,44,97,27704,20258
93,10,1,2,1,0,0,3,37,29,26708,21172,35,33,27704,20261
94,10,0,0,2,1,2,1,66,77,26708,21172,72,17,27705,20262
95,10,2,2,2,1,2,1,304,166,26710,21174,323,24,27706,20263
96,10,2,0,0,3,1,0,188,154,26712,21174,231,20,27709,20263
97,10,2,1,0,3,1,0,86,109,26714,21175,96,21,27712,20263
98,10,1,1,2,1,2,1,37,21,26715,21176,46,174,27713,20264
99,10,1,3,1,0,0,3,29,22,26716,21179,40,76,27713,20267
100,11,1,1,2,1,2,1,20,34,26717,21180,23,41,27714,20268
101,11,1,0,0,3,1,0,29,23,26718,21180,41,53,27717,20268
102,11,0,1,1,0,0,3,34,18,26718,21181,44,148,27717,20271
103,11,0,2,1,0,0,3,31,21,26718,21183,38,30,27717,20274
104,11,0,2,1,0,0,3,134,163,26718,21185,135,21,27717,20277
105,11,1,4,1,0,0,3,45,20,26719,21189,51,24,27717,20280
106,11,1,1,2,1,2,1,37,28,26720,21190,43,151,27718,20281
107,11,3,1,0,3,1,0,182,175,26723,21191,245,27,27721,20281
108,11,2,2,2,1,2,1,129,96,26725,21193,168,57,27722,20282
109,11,4,0,0,3,1,0,156,135,26729,21193,178,262,27725,20282
110,12,1,1,2,1,2,1,67,69,26730,21194,76,77,27726,20283
111,12,2,1,0,3,1,0,36,19,26732,21195,47,10,27729,20283
112,12,3,0,0,3,1,0,40,21,26735,21195,49,20,27732,20283
113,12,0,2,1,0,0,3,66,79,26735,21197,72,99,27732,20286
114,12,0,0,2,1,2,1,304,166,26735,21197,324,22,27733,20287
115,12,1,1,2,1,2,1,189,155,26736,21198,232,34,27734,20288
116,12,1,0,0,3,1,0,87,109,26737,21198,99,97,27737,20288
117,12,1,3,1,0,0,3,160,137,26738,21201,188,27,27737,20291
118,12,2,2,2,1,2,1,39,31,26740,21203,36,31,27738,20292
119,12,2,1,0,3,1,0,31,23,26742,21204,43,174,27741,20292
120,13,3,0,0,3,1,0,132,96,26745,21204,171,10,27744,20292
121,13,2,1,0,3,1,0,31,24,26747,21205,44,262,27747,20292
122,13,1,1,2,1,2,1,36,22,26748,21206,45,54,27748,20293
123,13,1,0,0,3,1,0,157,135,26749,21206,181,148,27751,20293
124,13,1,1,2,1,2,1,40,32,26750,21207,37,22,27752,20294
125,13,1,0,0,3,1,0,135,163,26751,21207,138,151,27755,20294
126,13,0,0,2,1,2,1,37,28,26751,21207,44,18,27756,20295
127,13,1,0,0,3,1,0,32,21,26752,21207,41,24,27759,20295
128,13,3,1,0,3,1,0,48,21,26755,21208,54,41,27762,20295
129,13,1,0,0,3,1,0,183,175,26756,21208,248,57,27765,20295
130,14,0,1,1,0,0,3,31,24,26756,21209,43,100,27765,20298
131,14,2,2,2,1,2,1,306,168,26758,21211,325,35,27766,20299
132,14,2,1,0,3,1,0,191,156,26760,21212,235,27,27769,20299
133,14,4,0,0,3,1,0,71,69,26764,21212,79,20,27772,20299
134,14,1,0,0,3,1,0,161,137,26765,21212,191,22,27775,20299
135,14,1,0,0,3,1,0,37,19,26766,21212,50,77,27778,20299
136,14,0,2,1,0,0,3,40,23,26766,21214,49,34,27778,20302
137,14,2,0,0,3,1,0,89,109,26768,21214,102,174,27781,20302
138,14,4,2,0,3,1,0,70,81,26772,21216,75,27,27784,20302
139,14,1,2,1,0,0,3,21,36,26773,21218,23,102,27784,20305
140,15,1,1,2,1,2,1,158,136,26774,21219,182,78,27785,20306
141,15,0,0,2,1,2,1,40,32,26774,21219,38,25,27786,20307
142,15,3,0,0,3,1,0,43,23,26777,21219,52,54,27789,20307
143,15,1,0,0,3,1,0,136,163,26778,21219,141,41,27792,20307
144,15,3,0,0,3,1,0,186,175,26781,21219,251,262,27795,20307
145,15,2,1,0,3,1,0,50,22,26783,21220,57,18,27798,20307
146,15,4,1,0,3,1,0,41,29,26787,21221,47,10,27801,20307
147,15,0,1,1,0,0,3,31,25,26787,21222,44,151,27801,20310
148,15,0,1,1,0,0,3,32,22,26787,21223,41,60,27801,20313
149,15,1,0,0,3,1,0,37,22,26788,21223,48,151,27804,20313
150,16,0,0,2,1,2,1,71,69,26788,21223,80,36,27805,20314
151,16,0,1,1,0,0,3,161,138,26788,21224,191,37,27805,20317
152,16,0,0,2,1,2,1,21,36,26788,21224,24,21,27806,20318
153,16,2,2,2,1,2,1,134,98,26790,21226,172,28,27807,20319
154,16,3,0,0,3,1,0,73,81,26793,21226,78,22,27810,20319
155,16,0,2,1,0,0,3,306,170,26793,21228,325,103,27810,20322
156,16,1,1,2,1,2,1,90,110,26794,21229,103,28,27811,20323
157,16,1,2,1,0,0,3,38,21,26795,21231,50,105,27811,20326
158,16,1,1,2,1,2,1,32,25,26796,21232,44,23,27812,20327
159,16,3,1,0,3,1,0,194,157,26799,21233,238,174,27815,20327
160,17,0,2,1,0,0,3,31,27,26799,21235,44,81,27815,20330
161,17,2,1,0,3,1,0,42,33,26801,21236,41,41,27818,20330
162,17,2,2,2,1,2,1,34,24,26803,21238,42,152,27819,20331
163,17,2,3,1,0,0,3,188,178,26805,21241,251,21,27819,20334
164,17,0,0,2,1,2,1,50,22,26805,21241,58,11,27820,20335
165,17,5,1,0,3,1,0,46,30,26810,21242,50,105,27823,20335
166,17,1,0,0,3,1,0,91,110,26811,21242,106,151,27826,20335
167,17,2,0,0,3,1,0,138,163,26813,21242,144,60,27829,20335
168,17,2,2,2,1,2,1,45,25,26815,21244,53,263,27830,20336
169,17,1,2,1,0,0,3,38,24,26816,21246,48,28,27830,20339
170,18,1,3,1,0,0,3,159,139,26817,21249,182,31,27830,20342
171,18,0,2,1,0,0,3,71,71,26817,21251,80,177,27830,20345
172,18,2,0,0,3,1,0,163,138,26819,21251,194,103,27833,20345
173,18,1,5,1,0,0,3,22,41,26820,21256,24,31,27833,20348
174,18,4,1,0,3,1,0,138,99,26824,21257,175,22,27836,20348
175,18,2,0,0,3,1,0,34,25,26826,21257,47,54,27839,20348
176,18,2,1,0,3,1,0,40,22,26828,21258,53,36,27842,20348
177,18,2,3,1,0,0,3,75,84,26830,21261,78,24,27842,20351
178,18,2,1,0,3,1,0,196,158,26832,21262,241,23,27845,20351
179,18,0,0,2,1,2,1,306,170,26832,21262,326,38,27846,20352
180,19,2,1,0,3,1,0,190,179,26834,21263,254,152,27849,20352
181,19,0,0,2,1,2,1,45,25,26834,21263,54,61,27850,20353
182,19,0,0,2,1,2,1,34,25,26834,21263,48,152,27851,20354
183,19,3,1,0,3,1,0,34,28,26837,21264,47,21,27854,20354
184,19,0,1,1,0,0,3,42,34,26837,21265,41,266,27854,20357
185,19,1,0,0,3,1,0,35,24,26838,21265,45,105,27857,20357
186,19,0,1,1,0,0,3,138,164,26838,21266,144,84,27857,20360
187,19,1,0,0,3,1,0,47,30,26839,21266,53,31,27860,20360
188,19,0,1,1,0,0,3,91,111,26839,21267,106,14,27860,20363
189,19,2,1,0,3,1,0,40,25,26841,21268,51,41,27863,20363
190,20,2,0,0,3,1,0,161,139,26843,21268,185,177,27866,20363
191,20,3,1,0,3,1,0,50,31,26846,21269,56,28,27869,20363
192,20,2,1,0,3,1,0,77,85,26848,21270,81,38,27872,20363
193,20,2,1,0,3,1,0,42,23,26850,21271,56,31,27875,20363
194,20,1,0,0,3,1,0,139,99,26851,21271,178,23,27878,20363
195,20,1,1,2,1,2,1,35,29,26852,21272,48,104,27879,20364
196,20,1,2,1,0,0,3,72,73,26853,21274,80,269,27879,20367
197,20,2,2,2,1,2,1,24,43,26855,21276,25,153,27880,20368
198,20,2,3,1,0,0,3,165,141,26857,21279,194,57,27880,20371
199,20,0,2,1,0,0,3,50,24,26857,21281,58,39,27880,20374
200,21,0,2,1,0,0,3,138,166,26857,21283,144,34,27880,20377
201,21,0,1,1,0,0,3,34,26,26857,21284,48,44,27880,20380
202,21,3,0,0,3,1,0,199,158,26860,21284,244,152,27883,20380
203,21,1,1,2,1,2,1,46,26,26861,21285,55,15,27884,20381
204,21,0,1,1,0,0,3,35,25,26861,21286,45,27,27884,20384
205,21,2,1,0,3,1,0,44,35,26863,21287,44,105,27887,20384
206,21,3,0,0,3,1,0,94,111,26866,21287,109,21,27890,20384
207,21,1,0,0,3,1,0,191,179,26867,21287,257,22,27893,20384
208,21,2,1,0,3,1,0,42,26,26869,21288,54,84,27896,20384
209,21,2,2,2,1,2,1,308,172,26871,21290,327,62,27897,20385
210,22,2,1,0,3,1,0,26,44,26873,21291,28,28,27900,20385
211,22,2,1,0,3,1,0,37,30,26875,21292,51,38,27903,20385
212,22,1,1,2,1,2,1,51,25,26876,21293,59,32,27904,20386
213,22,2,3,1,0,0,3,163,142,26878,21296,185,156,27904,20389
214,22,5,1,0,3,1,0,144,100,26883,21297,181,57,27907,20389
215,22,1,1,2,1,2,1,78,86,26884,21298,82,45,27908,20390
216,22,0,0,2,1,2,1,50,31,26884,21298,57,24,27909,20391
217,22,0,0,2,1,2,1,42,23,26884,21298,57,105,27910,20392
218,22,1,2,1,0,0,3,166,143,26885,21300,194,272,27910,20395
219,22,0,0,2,1,2,1,35,25,26885,21300,46,178,27911,20396
220,23,3,0,0,3,1,0,194,179,26888,21300,260,27,27914,20396
221,23,1,0,0,3,1,0,45,35,26889,21300,47,22,27917,20396
222,23,0,1,1,0,0,3,308,173,26889,21301,327,87,27917,20399
223,23,0,0,2,1,2,1,42,26,26889,21301,55,16,27918,20400
224,23,1,1,2,1,2,1,95,112,26890,21302,110,106,27919,20401
225,23,0,2,1,0,0,3,34,28,26890,21304,48,65,27919,20404
226,23,2,0,0,3,1,0,74,73,26892,21304,83,152,27922,20404
227,23,1,1,2,1,2,1,200,159,26893,21305,245,22,27923,20405
228,23,0,0,2,1,2,1,46,26,26893,21305,56,35,27924,20406
229,23,0,1,1,0,0,3,138,167,26893,21306,144,42,27924,20409
230,24,3,1,0,3,1,0,45,24,26896,21307,60,45,27927,20409
231,24,1,1,2,1,2,1,164,143,26897,21308,186,29,27928,20410
232,24,2,1,0,3,1,0,52,32,26899,21309,60,38,27931,20410
233,24,0,2,1,0,0,3,37,32,26899,21311,51,35,27931,20413
234,24,1,1,2,1,2,1,167,144,26900,21312,195,66,27932,20414
235,24,2,1,0,3,1,0,28,45,26902,21313,31,272,27935,20414
236,24,1,0,0,3,1,0,145,100,26903,21313,184,156,27938,20414
237,24,1,2,1,0,0,3,52,27,26904,21315,59,60,27938,20417
238,24,3,1,0,3,1,0,38,26,26907,21316,49,24,27941,20417
239,24,0,0,2,1,2,1,194,179,26907,21316,261,106,27942,20418
240,25,0,0,2,1,2,1,78,86,26907,21316,83,17,27943,20419
241,25,1,1,2,1,2,1,168,145,26908,21317,196,88,27944,20420
242,25,0,1,1,0,0,3,34,29,26908,21318,48,30,27944,20423
243,25,3,1,0,3,1,0,49,27,26911,21319,59,106,27947,20423
244,25,2,1,0,3,1,0,310,174,26913,21320,330,22,27950,20423
245,25,2,1,0,3,1,0,97,113,26915,21321,113,42,27953,20423
246,25,1,0,0,3,1,0,46,35,26916,21321,50,106,27956,20423
247,25,1,1,2,1,2,1,75,74,26917,21322,84,23,27957,20424
248,25,0,0,2,1,2,1,42,26,26917,21322,56,179,27958,20425
249,25,1,2,1,0,0,3,201,161,26918,21324,245,38,27958,20428
250,26,1,1,2,1,2,1,165,144,26919,21325,187,46,27959,20429
251,26,2,2,2,1,2,1,30,47,26921,21327,32,153,27960,20430
252,26,2,0,0,3,1,0,147,100,26923,21327,187,29,27963,20430
253,26,2,2,2,1,2,1,140,169,26925,21329,145,39,27964,20431
254,26,1,0,0,3,1,0,39,26,26926,21329,52,35,27967,20431
255,26,2,2,2,1,2,1,47,26,26928,21331,61,67,27968,20432
256,26,1,1,2,1,2,1,38,33,26929,21332,52,157,27969,20433
257,26,0,2,1,0,0,3,52,34,26929,21334,60,63,27969,20436
258,26,2,2,2,1,2,1,54,29,26931,21336,60,273,27970,20437
259,26,1,0,0,3,1,0,195,179,26932,21336,264,24,27973,20437
260,27,0,3,1,0,0,3,75,77,26932,21339,84,20,27973,20440
261,27,0,1,1,0,0,3,97,114,26932,21340,113,33,27973,20443
262,27,1,0,0,3,1,0,311,174,26933,21340,333,106,27976,20443
263,27,0,0,2,1,2,1,168,145,26933,21340,197,23,27977,20444
264,27,1,1,2,1,2,1,43,27,26934,21341,57,43,27978,20445
265,27,1,1,2,1,2,1,50,28,26935,21342,60,107,27979,20446
266,27,2,1,0,3,1,0,48,36,26937,21343,53,179,27982,20446
267,27,1,1,2,1,2,1,35,30,26938,21344,49,39,27983,20447
268,27,2,3,1,0,0,3,203,164,26940,21347,245,26,27983,20450
269,27,1,3,1,0,0,3,79,89,26941,21350,83,91,27983,20453
270,28,2,1,0,3,1,0,149,101,26943,21351,190,46,27986,20453
271,28,2,2,2,1,2,1,56,31,26945,21353,61,154,27987,20454
272,28,2,2,2,1,2,1,45,29,26947,21355,58,36,27988,20455
273,28,1,0,0,3,1,0,31,47,26948,21355,35,23,27991,20455
274,28,1,0,0,3,1,0,39,33,26949,21355,55,24,27994,20455
275,28,3,0,0,3,1,0,168,144,26952,21355,190,67,27997,20455
276,28,0,0,2,1,2,1,52,34,26952,21355,61,274,27998,20456
277,28,2,2,2,1,2,1,142,171,26954,21357,146,64,27999,20457
278,28,3,3,2,1,2,1,198,182,26957,21360,265,30,28000,20458
279,28,0,1,1,0,0,3,39,27,26957,21361,52,160,28000,20461
280,29,0,0,2,1,2,1,31,47,26957,21361,36,92,28001,20462
281,29,2,1,0,3,1,0,313,175,26959,21362,336,33,28004,20462
282,29,1,0,0,3,1,0,169,145,26960,21362,200,106,28007,20462
283,29,0,0,2,1,2,1,50,28,26960,21362,61,37,28008,20463
284,29,2,0,0,3,1,0,37,30,26962,21362,52,43,28011,20463
285,29,3,0,0,3,1,0,206,164,26965,21362,248,107,28014,20463
286,29,0,3,1,0,0,3,75,80,26965,21365,84,42,28014,20466
287,29,1,2,1,0,0,3,48,28,26966,21367,61,29,28014,20469
288,29,3,2,0,3,1,0,100,116,26969,21369,116,39,28017,20469
289,29,1,0,0,3,1,0,80,89,26970,21369,86,179,28020,20469
290,30,4,1,0,3,1,0,43,34,26974,21370,58,46,28023,20469
291,30,1,0,0,3,1,0,53,34,26975,21370,64,154,28026,20469
292,30,1,1,2,1,2,1,169,145,26976,21371,191,21,28027,20470
293,30,1,0,0,3,1,0,143,171,26977,21371,149,30,28030,20470
294,30,3,2,0,3,1,0,152,103,26980,21373,193,23,28033,20470
295,30,2,1,0,3,1,0,47,30,26982,21374,61,24,28036,20470
296,30,0,1,1,0,0,3,39,28,26982,21375,52,277,28036,20473
297,30,1,1,2,1,2,1,49,37,26983,21376,54,161,28037,20474
298,30,1,1,2,1,2,1,57,32,26984,21377,62,68,28038,20475
299,30,1,1,2,1,2,1,199,183,26985,21378,266,65,28039,20476
300,31,2,0,0,3,1,0,171,145,26987,21378,203,33,28042,20476
301,31,3,1,0,3,1,0,155,104,26990,21379,196,106,28045,20476
302,31,1,1,2,1,2,1,38,31,26991,21380,53,38,28046,20477
303,31,1,0,0,3,1,0,101,116,26992,21380,119,24,28049,20477
304,31,1,3,1,0,0,3,81,92,26993,21383,86,46,28049,20480
305,31,1,1,2,1,2,1,76,81,26994,21384,85,108,28050,20481
306,31,5,1,0,3,1,0,53,29,26999,21385,64,42,28053,20481
307,31,2,2,2,1,2,1,33,49,27001,21387,37,30,28054,20482
308,31,2,1,0,3,1,0,315,176,27003,21388,339,179,28057,20482
309,31,2,2,2,1,2,1,208,166,27005,21390,249,40,28058,20483
310,32,3,2,0,3,1,0,42,30,27008,21392,55,46,28061,20483
311,32,1,2,1,0,0,3,48,32,27009,21394,61,157,28061,20486
312,32,1,2,1,0,0,3,44,36,27010,21396,58,24,28061,20489
313,32,0,0,2,1,2,1,50,28,27010,21396,62,31,28062,20490
314,32,1,0,0,3,1,0,170,145,27011,21396,194,23,28065,20490
315,32,0,3,1,0,0,3,53,37,27011,21399,64,71,28065,20493
316,32,0,2,1,0,0,3,143,173,27011,21401,149,280,28065,20496
317,32,0,0,2,1,2,1,49,37,27011,21401,55,66,28066,20497
318,32,2,0,0,3,1,0,59,32,27013,21401,65,92,28069,20497
319,32,2,0,0,3,1,0,201,183,27015,21401,269,161,28072,20497
320,33,1,1,2,1,2,1,39,32,27016,21402,54,41,28073,20498
321,33,1,2,1,0,0,3,77,83,27017,21404,85,41,28073,20501
322,33,1,0,0,3,1,0,316,176,27018,21404,342,24,28076,20501
323,33,1,1,2,1,2,1,172,146,27019,21405,204,47,28077,20502
324,33,0,2,1,0,0,3,81,94,27019,21407,86,111,28077,20505
325,33,2,0,0,3,1,0,55,29,27021,21407,67,179,28080,20505
326,33,0,0,2,1,2,1,33,49,27021,21407,38,43,28081,20506
327,33,0,0,2,1,2,1,170,145,27021,21407,195,31,28082,20507
328,33,1,0,0,3,1,0,209,166,27022,21407,252,66,28085,20507
329,33,2,1,0,3,1,0,157,105,27024,21408,199,33,28088,20507
330,34,5,0,0,3,1,0,206,183,27029,21408,272,46,28091,20507
331,34,1,1,2,1,2,1,144,174,27030,21409,150,158,28092,20508
332,34,0,0,2,1,2,1,49,37,27030,21409,56,25,28093,20509
333,34,2,1,0,3,1,0,103,117,27032,21410,122,31,28096,20509
334,34,0,1,1,0,0,3,59,33,27032,21411,65,109,28096,20512
335,34,1,3,1,0,0,3,43,33,27033,21414,55,26,28096,20515
336,34,1,0,0,3,1,0,45,36,27034,21414,61,71,28099,20515
337,34,1,1,2,1,2,1,51,29,27035,21415,63,162,28100,20516
338,34,1,0,0,3,1,0,49,32,27036,21415,64,280,28103,20516
339,34,2,1,0,3,1,0,55,38,27038,21416,67,92,28106,20516
340,35,2,0,0,3,1,0,83,94,27040,21416,89,24,28109,20516
341,35,1,1,2,1,2,1,56,30,27041,21417,68,34,28110,20517
342,35,1,1,2,1,2,1,78,84,27042,21418,86,42,28111,20518
343,35,3,2,0,3,1,0,319,178,27045,21420,345,41,28114,20518
344,35,1,1,2,1,2,1,171,146,27046,21421,196,48,28115,20519
345,35,3,0,0,3,1,0,160,105,27049,21421,202,111,28118,20519
346,35,2,0,0,3,1,0,174,146,27051,21421,207,179,28121,20519
347,35,3,0,0,3,1,0,62,33,27054,21421,68,31,28124,20519
348,35,0,0,2,1,2,1,33,49,27054,21421,39,67,28125,20520
349,35,3,2,0,3,1,0,212,168,27057,21423,255,31,28128,20520
350,36,2,0,0,3,1,0,53,29,27059,21423,66,46,28131,20520
351,36,0,1,1,0,0,3,49,38,27059,21424,56,161,28131,20523
352,36,3,0,0,3,1,0,209,183,27062,21424,275,25,28134,20523
353,36,3,0,0,3,1,0,46,33,27065,21424,58,92,28137,20523
354,36,2,5,1,0,0,3,146,179,27067,21429,150,112,28137,20526
355,36,3,0,0,3,1,0,42,32,27070,21429,57,26,28140,20526
356,36,1,1,2,1,2,1,50,33,27071,21430,65,44,28141,20527
357,36,1,3,1,0,0,3,46,39,27072,21433,61,34,28141,20530
358,36,2,0,0,3,1,0,105,117,27074,21433,125,71,28144,20530
359,36,2,0,0,3,1,0,214,168,27076,21433,258,280,28147,20530
360,37,2,1,0,3,1,0,176,147,27078,21434,210,31,28150,20530
361,37,2,0,0,3,1,0,64,33,27080,21434,71,34,28153,20530
362,37,3,1,0,3,1,0,174,147,27083,21435,199,42,28156,20530
363,37,1,0,0,3,1,0,84,94,27084,21435,92,41,28159,20530
364,37,0,2,1,0,0,3,56,32,27084,21437,68,27,28159,20533
365,37,2,1,0,3,1,0,57,39,27086,21438,70,48,28162,20533
366,37,1,0,0,3,1,0,34,49,27087,21438,42,111,28165,20533
367,37,2,1,0,3,1,0,162,106,27089,21439,205,179,28168,20533
368,37,0,2,1,0,0,3,78,86,27089,21441,86,165,28168,20536
369,37,0,2,1,0,0,3,319,180,27089,21443,345,70,28168,20539
370,38,2,0,0,3,1,0,107,117,27091,21443,128,46,28171,20539
371,38,3,0,0,3,1,0,56,29,27094,21443,69,161,28174,20539
372,38,1,1,2,1,2,1,47,34,27095,21444,59,26,28175,20540
373,38,1,0,0,3,1,0,50,38,27096,21444,59,92,28178,20540
374,38,0,2,1,0,0,3,46,41,27096,21446,61,115,28178,20543
375,38,2,0,0,3,1,0,52,33,27098,21446,68,26,28181,20543
376,38,1,1,2,1,2,1,215,169,27099,21447,259,72,28182,20544
377,38,1,2,1,0,0,3,43,34,27100,21449,57,283,28182,20547
378,38,1,2,1,0,0,3,210,185,27101,21451,275,47,28182,20550
379,38,1,1,2,1,2,1,147,180,27102,21452,151,35,28183,20551
0,1,1,0,0,3,1,0,177,147,27103,21452,213,47,28186,20551
1,1,2,0,0,3,1,0,58,46,27105,21452,55,57,28189,20551
2,1,1,1,2,1,2,1,47,42,27106,21453,62,27,28190,20552
3,1,1,0,0,3,1,0,160,158,27107,21453,176,115,28193,20552
4,1,0,0,2,1,2,1,23,32,27107,21453,23,125,28194,20553
5,1,1,2,1,0,0,3,57,31,27108,21455,69,29,28194,20556
6,1,1,1,2,1,2,1,211,186,27109,21456,276,42,28195,20557
7,1,1,1,2,1,2,1,1,1,27110,21457,1,43,28196,20558
8,1,2,2,2,1,2,1,86,96,27112,21459,93,49,28197,20559
9,1,4,0,0,3,1,0,323,180,27116,21459,348,35,28200,20559
10,2,0,0,2,1,2,1,34,49,27116,21459,43,73,28201,20560
11,2,1,2,1,0,0,3,53,35,27117,21461,68,164,28201,20563
12,2,3,3,2,1,2,1,177,150,27120,21464,200,28,28202,20564
13,2,2,0,0,3,1,0,52,38,27122,21464,62,15,28205,20564
14,2,0,0,2,1,2,1,56,32,27122,21464,69,284,28206,20565
15,2,1,2,1,0,0,3,48,36,27123,21466,59,92,28206,20568
16,2,1,1,2,1,2,1,65,34,27124,21467,72,35,28207,20569
17,2,2,2,2,1,2,1,59,41,27126,21469,71,1,28208,20570
18,2,3,1,0,3,1,0,144,182,27129,21470,171,31,28211,20570
19,2,0,0,2,1,2,1,88,88,27129,21470,91,180,28212,20571
20,3,1,2,1,0,0,3,178,149,27130,21472,213,118,28212,20574
21,3,1,0,0,3,1,0,48,42,27131,21472,65,49,28215,20574
22,3,1,0,0,3,1,0,161,158,27132,21472,179,35,28218,20574
23,3,1,1,2,1,2,1,24,33,27133,21473,24,30,28219,20575
24,3,3,2,0,3,1,0,326,182,27136,21475,351,42,28222,20575
25,3,3,1,0,3,1,0,214,187,27139,21476,279,27,28225,20575
26,3,1,0,0,3,1,0,2,1,27140,21476,4,125,28228,20575
27,3,2,1,0,3,1,0,55,36,27142,21477,71,57,28231,20575
28,3,1,0,0,3,1,0,59,46,27143,21477,58,47,28234,20575
29,3,1,0,0,3,1,0,87,96,27144,21477,96,28,28237,20575
30,4,2,1,0,3,1,0,59,32,27146,21478,72,15,28240,20575
31,4,1,1,2,1,2,1,88,97,27147,21479,97,93,28241,20576
32,4,2,0,0,3,1,0,36,49,27149,21479,46,164,28244,20576
33,4,4,0,0,3,1,0,148,182,27153,21479,174,43,28247,20576
34,4,0,0,2,1,2,1,52,38,27153,21479,63,36,28248,20577
35,4,1,0,0,3,1,0,57,32,27154,21479,72,1,28251,20577
36,4,2,3,1,0,0,3,67,37,27156,21482,72,60,28251,20580
37,4,0,2,1,0,0,3,59,43,27156,21484,71,183,28251,20583
38,4,1,2,1,0,0,3,178,152,27157,21486,200,287,28251,20586
39,4,3,1,0,3,1,0,51,37,27160,21487,62,31,28254,20586
40,5,0,1,1,0,0,3,178,150,27160,21488,213,45,28254,20589
41,5,2,1,0,3,1,0,61,47,27162,21489,61,27,28257,20589
42,5,3,0,0,3,1,0,51,42,27165,21489,68,35,28260,20589
43,5,1,1,2,1,2,1,25,34,27166,21490,25,74,28261,20590
44,5,3,0,0,3,1,0,329,182,27169,21490,354,30,28264,20590
45,5,0,0,2,1,2,1,2,1,27169,21490,5,119,28265,20591
46,5,0,2,1,0,0,3,55,38,27169,21492,71,50,28265,20594
47,5,0,2,1,0,0,3,88,90,27169,21494,91,128,28265,20597
48,5,2,2,2,1,2,1,163,160,27171,21496,180,29,28266,20598
49,5,2,0,0,3,1,0,216,187,27173,21496,282,49,28269,20598
50,6,2,1,0,3,1,0,165,161,27175,21497,183,15,28272,20598
51,6,2,1,0,3,1,0,61,33,27177,21498,75,287,28275,20598
52,6,2,1,0,3,1,0,38,50,27179,21499,49,183,28278,20598
53,6,2,1,0,3,1,0,180,153,27181,21500,203,36,28281,20598
54,6,1,0,0,3,1,0,53,38,27182,21500,66,1,28284,20598
55,6,0,1,1,0,0,3,57,33,27182,21501,72,63,28284,20601
56,6,3,1,0,3,1,0,54,38,27185,21502,65,43,28287,20601
57,6,2,2,2,1,2,1,69,39,27187,21504,73,129,28288,20602
58,6,1,0,0,3,1,0,60,43,27188,21504,74,31,28291,20602
59,6,1,3,1,0,0,3,89,100,27189,21507,97,167,28291,20605
60,7,0,0,2,1,2,1,61,47,27189,21507,62,46,28292,20606
61,7,1,1,2,1,2,1,52,43,27190,21508,69,75,28293,20607
62,7,1,1,2,1,2,1,330,183,27191,21509,355,94,28294,20608
63,7,0,0,2,1,2,1,2,1,27191,21509,6,31,28295,20609
64,7,0,2,1,0,0,3,148,184,27191,21511,174,52,28295,20612
65,7,1,1,2,1,2,1,56,39,27192,21512,72,36,28296,20613
66,7,1,3,1,0,0,3,70,42,27193,21515,73,30,28296,20616
67,7,3,1,0,3,1,0,181,151,27196,21516,216,29,28299,20616
68,7,0,1,1,0,0,3,88,91,27196,21517,91,18,28299,20619
69,7,1,1,2,1,2,1,217,188,27197,21518,283,120,28300,20620
70,8,0,1,1,0,0,3,25,35,27197,21519,25,170,28300,20623
71,8,1,1,2,1,2,1,62,34,27198,21520,76,184,28301,20624
72,8,0,4,1,0,0,3,89,104,27198,21524,97,290,28301,20627
73,8,1,1,2,1,2,1,39,51,27199,21525,50,37,28302,20628
74,8,2,0,0,3,1,0,55,38,27201,21525,69,63,28305,20628
75,8,1,2,1,0,0,3,58,35,27202,21527,72,132,28305,20631
76,8,2,2,2,1,2,1,56,40,27204,21529,66,2,28306,20632
77,8,1,1,2,1,2,1,61,44,27205,21530,75,51,28307,20633
78,8,4,3,0,3,1,0,184,156,27209,21533,206,31,28310,20633
79,8,1,1,2,1,2,1,166,162,27210,21534,184,44,28311,20634
80,9,4,0,0,3,1,0,185,151,27214,21534,219,52,28314,20634
81,9,1,1,2,1,2,1,53,44,27215,21535,70,30,28315,20635
82,9,4,2,0,3,1,0,6,3,27219,21537,9,94,28318,20635
83,9,0,0,2,1,2,1,56,39,27219,21537,73,31,28319,20636
84,9,2,1,0,3,1,0,90,92,27221,21538,94,120,28322,20636
85,9,0,2,1,0,0,3,70,44,27221,21540,73,49,28322,20639
86,9,4,0,0,3,1,0,221,188,27225,21540,286,75,28325,20639
87,9,0,1,1,0,0,3,148,185,27225,21541,174,39,28325,20642
88,9,2,2,2,1,2,1,332,185,27227,21543,356,19,28326,20643
89,9,2,1,0,3,1,0,63,48,27229,21544,65,31,28329,20643
90,10,3,1,0,3,1,0,28,36,27232,21545,28,184,28332,20643
91,10,2,1,0,3,1,0,64,35,27234,21546,79,31,28335,20643
92,10,1,0,0,3,1,0,90,104,27235,21546,100,2,28338,20643
93,10,0,2,1,0,0,3,39,53,27235,21548,50,47,28338,20646
94,10,1,1,2,1,2,1,185,157,27236,21549,207,32,28339,20647
95,10,0,4,1,0,0,3,55,42,27236,21553,69,135,28339,20650
96,10,1,0,0,3,1,0,57,40,27237,21553,69,51,28342,20650
97,10,1,0,0,3,1,0,62,44,27238,21553,78,63,28345,20650
98,10,0,0,2,1,2,1,166,162,27238,21553,185,171,28346,20651
99,10,0,0,2,1,2,1,332,185,27238,21553,357,38,28347,20652
100,11,1,2,1,0,0,3,186,153,27239,21555,219,293,28347,20655
101,11,3,1,0,3,1,0,56,45,27242,21556,73,19,28350,20655
102,11,0,0,2,1,2,1,6,3,27242,21556,10,31,28351,20656
103,11,1,2,1,0,0,3,149,187,27243,21558,174,123,28351,20659
104,11,2,1,0,3,1,0,58,40,27245,21559,76,49,28354,20659
105,11,2,2,2,1,2,1,60,37,27247,21561,73,40,28355,20660
106,11,2,1,0,3,1,0,92,93,27249,21562,97,52,28358,20660
107,11,4,2,0,3,1,0,74,46,27253,21564,76,31,28361,20660
108,11,1,2,1,0,0,3,64,50,27254,21566,65,78,28361,20663
109,11,2,0,0,3,1,0,223,188,27256,21566,289,94,28364,20663
110,12,1,0,0,3,1,0,187,153,27257,21566,222,38,28367,20663
111,12,0,1,1,0,0,3,166,163,27257,21567,185,34,28367,20666
112,12,1,1,2,1,2,1,65,36,27258,21568,80,64,28368,20667
113,12,0,2,1,0,0,3,39,55,27258,21570,50,138,28368,20670
114,12,2,0,0,3,1,0,187,157,27260,21570,210,51,28371,20670
115,12,4,1,0,3,1,0,59,43,27264,21571,72,40,28374,20670
116,12,2,0,0,3,1,0,59,40,27266,21571,72,32,28377,20670
117,12,0,2,1,0,0,3,332,187,27266,21573,357,187,28377,20673
118,12,2,2,2,1,2,1,92,106,27268,21575,101,48,28378,20674
119,12,2,2,2,1,2,1,30,38,27270,21577,29,3,28379,20675
120,13,2,2,2,1,2,1,58,47,27272,21579,74,95,28380,20676
121,13,1,1,2,1,2,1,7,4,27273,21580,11,294,28381,20677
122,13,1,2,1,0,0,3,59,42,27274,21582,76,126,28381,20680
123,13,2,1,0,3,1,0,62,38,27276,21583,76,49,28384,20680
124,13,4,1,0,3,1,0,96,94,27280,21584,100,31,28387,20680
125,13,0,1,1,0,0,3,74,47,27280,21585,76,81,28387,20683
126,13,2,0,0,3,1,0,64,44,27282,21585,81,52,28390,20683
127,13,1,1,2,1,2,1,65,51,27283,21586,66,20,28391,20684
128,13,1,0,0,3,1,0,224,188,27284,21586,292,171,28394,20684
129,13,2,0,0,3,1,0,151,187,27286,21586,177,31,28397,20684
130,14,0,0,2,1,2,1,187,153,27286,21586,223,4,28398,20685
131,14,2,1,0,3,1,0,168,164,27288,21587,188,64,28401,20685
132,14,1,1,2,1,2,1,31,39,27289,21588,30,52,28402,20686
133,14,1,3,1,0,0,3,66,39,27290,21591,80,51,28402,20689
134,14,1,1,2,1,2,1,225,189,27291,21592,293,39,28403,20690
135,14,0,3,1,0,0,3,39,58,27291,21595,50,35,28403,20693
136,14,0,0,2,1,2,1,187,157,27291,21595,211,41,28404,20694
137,14,1,0,0,3,1,0,60,43,27292,21595,75,52,28407,20694
138,14,2,0,0,3,1,0,334,187,27294,21595,360,34,28410,20694
139,14,0,0,2,1,2,1,92,106,27294,21595,102,139,28411,20695
140,15,2,2,2,1,2,1,9,6,27296,21597,12,40,28412,20696
141,15,1,0,0,3,1,0,152,187,27297,21597,180,171,28415,20696
142,15,0,1,1,0,0,3,60,44,27297,21598,75,34,28415,20699
143,15,3,0,0,3,1,0,65,38,27300,21598,79,95,28418,20699
144,15,0,2,1,0,0,3,59,42,27300,21600,72,129,28418,20702
145,15,1,2,1,0,0,3,97,96,27301,21602,100,84,28418,20705
146,15,1,2,1,0,0,3,75,49,27302,21604,76,34,28418,20708
147,15,2,1,0,3,1,0,66,45,27304,21605,84,20,28421,20708
148,15,0,2,1,0,0,3,65,53,27304,21607,66,190,28421,20711
149,15,0,1,1,0,0,3,59,43,27304,21608,76,297,28421,20714
150,16,0,0,2,1,2,1,187,153,27304,21608,224,65,28422,20715
151,16,1,1,2,1,2,1,59,48,27305,21609,75,35,28423,20716
152,16,3,0,0,3,1,0,69,39,27308,21609,83,41,28426,20716
153,16,1,0,0,3,1,0,93,106,27309,21609,105,35,28429,20716
154,16,3,1,0,3,1,0,337,188,27312,21610,363,52,28432,20716
155,16,0,0,2,1,2,1,225,189,27312,21610,294,5,28433,20717
156,16,0,0,2,1,2,1,39,58,27312,21610,51,53,28434,20718
157,16,1,0,0,3,1,0,169,164,27313,21610,191,139,28437,20718
158,16,0,1,1,0,0,3,31,40,27313,21611,30,54,28437,20721
159,16,1,0,0,3,1,0,188,157,27314,21611,214,49,28440,20721
160,17,0,1,1,0,0,3,59,44,27314,21612,76,193,28440,20724
161,17,4,2,0,3,1,0,69,55,27318,21614,69,5,28443,20724
162,17,3,0,0,3,1,0,155,187,27321,21614,183,297,28446,20724
163,17,0,0,2,1,2,1,188,157,27321,21614,215,35,28447,20725
164,17,3,0,0,3,1,0,63,44,27324,21614,78,34,28450,20725
165,17,1,4,1,0,0,3,66,42,27325,21618,79,174,28450,20728
166,17,1,0,0,3,1,0,60,42,27326,21618,75,20,28453,20728
167,17,2,0,0,3,1,0,99,96,27328,21618,103,40,28456,20728
168,17,0,0,2,1,2,1,66,45,27328,21618,85,85,28457,20729
169,17,0,1,1,0,0,3,75,50,27328,21619,76,98,28457,20732
170,18,2,1,0,3,1,0,189,154,27330,21620,227,35,28460,20732
171,18,0,0,2,1,2,1,59,48,27330,21620,76,55,28461,20733
172,18,3,1,0,3,1,0,34,41,27333,21621,33,35,28464,20733
173,18,1,0,0,3,1,0,70,39,27334,21621,86,53,28467,20733
174,18,1,1,2,1,2,1,338,189,27335,21622,364,66,28468,20734
175,18,2,2,2,1,2,1,41,60,27337,21624,52,42,28469,20735
176,18,3,1,0,3,1,0,172,165,27340,21625,194,49,28472,20735
177,18,2,1,0,3,1,0,227,190,27342,21626,297,139,28475,20735
178,18,1,1,2,1,2,1,94,107,27343,21627,106,130,28476,20736
179,18,1,3,1,0,0,3,10,9,27344,21630,12,55,28476,20739
180,19,1,1,2,1,2,1,42,61,27345,21631,53,99,28477,20740
181,19,1,0,0,3,1,0,156,187,27346,21631,186,40,28480,20740
182,19,1,2,1,0,0,3,60,46,27347,21633,76,38,28480,20743
183,19,0,0,2,1,2,1,188,157,27347,21633,216,21,28481,20744
184,19,2,2,2,1,2,1,65,46,27349,21635,79,86,28482,20745
185,19,1,2,1,0,0,3,67,44,27350,21637,79,37,28482,20748
186,19,3,1,0,3,1,0,102,97,27353,21638,106,5,28485,20748
187,19,1,2,1,0,0,3,67,47,27354,21640,85,177,28485,20751
188,19,2,3,1,0,0,3,62,45,27356,21643,75,300,28485,20754
189,19,0,0,2,1,2,1,75,50,27356,21643,77,194,28486,20755
190,20,1,2,1,0,0,3,190,156,27357,21645,227,58,28486,20758
191,20,1,1,2,1,2,1,60,49,27358,21646,77,56,28487,20759
192,20,3,0,0,3,1,0,175,165,27361,21646,197,53,28490,20759
193,20,3,2,0,3,1,0,37,43,27364,21648,36,49,28493,20759
194,20,0,1,1,0,0,3,70,40,27364,21649,86,133,28493,20762
195,20,0,0,2,1,2,1,94,107,27364,21649,107,36,28494,20763
196,20,1,2,1,0,0,3,228,192,27365,21651,297,69,28494,20766
197,20,3,1,0,3,1,0,13,10,27368,21652,15,42,28497,20766
198,20,1,2,1,0,0,3,70,57,27369,21654,69,142,28497,20769
199,20,1,1,2,1,2,1,339,190,27370,21655,365,36,28498,20770
200,21,2,2,2,1,2,1,72,42,27372,21657,87,87,28499,20771
201,21,1,0,0,3,1,0,43,61,27373,21657,56,21,28502,20771
202,21,0,1,1,0,0,3,156,188,27373,21658,186,8,28502,20774
203,21,0,2,1,0,0,3,65,48,27373,21660,79,303,28502,20777
204,21,2,0,0,3,1,0,64,45,27375,21660,78,40,28505,20777
205,21,3,0,0,3,1,0,105,97,27378,21660,109,58,28508,20777
206,21,3,1,0,3,1,0,70,48,27381,21661,88,99,28511,20777
207,21,0,0,2,1,2,1,67,44,27381,21661,80,195,28512,20778
208,21,2,1,0,3,1,0,190,158,27383,21662,219,177,28515,20778
209,21,1,0,0,3,1,0,76,50,27384,21662,80,38,28518,20778
210,22,2,0,0,3,1,0,192,156,27386,21662,230,36,28521,20778
211,22,1,1,2,1,2,1,71,58,27387,21663,70,54,28522,20779
212,22,0,1,1,0,0,3,37,44,27387,21664,36,40,28522,20782
213,22,3,1,0,3,1,0,231,193,27390,21665,300,42,28525,20782
214,22,0,0,2,1,2,1,13,10,27390,21665,16,37,28526,20783
215,22,0,0,2,1,2,1,60,46,27390,21665,77,143,28527,20784
216,22,2,1,0,3,1,0,107,98,27392,21666,112,56,28530,20784
217,22,2,0,0,3,1,0,62,49,27394,21666,80,49,28533,20784
218,22,2,2,2,1,2,1,341,192,27396,21668,366,134,28534,20785
219,22,2,1,0,3,1,0,177,166,27398,21669,200,87,28537,20785
220,23,3,0,0,3,1,0,75,42,27401,21669,90,99,28540,20785
221,23,2,0,0,3,1,0,96,107,27403,21669,110,21,28543,20785
222,23,1,0,0,3,1,0,157,188,27404,21669,189,69,28546,20785
223,23,4,3,0,3,1,0,194,161,27408,21672,222,8,28549,20785
224,23,0,0,2,1,2,1,65,48,27408,21672,80,178,28550,20786
225,23,4,5,1,0,0,3,71,49,27412,21677,80,41,28550,20789
226,23,1,1,2,1,2,1,77,51,27413,21678,81,59,28551,20790
227,23,3,1,0,3,1,0,73,49,27416,21679,91,40,28554,20790
228,23,0,3,1,0,0,3,64,48,27416,21682,78,198,28554,20793
229,23,0,2,1,0,0,3,43,63,27416,21684,56,306,28554,20796
230,24,3,2,0,3,1,0,74,60,27419,21686,73,42,28557,20796
231,24,3,1,0,3,1,0,65,50,27422,21687,83,134,28560,20796
232,24,0,2,1,0,0,3,37,46,27422,21689,36,102,28560,20799
233,24,2,1,0,3,1,0,343,193,27424,21690,369,40,28563,20799
234,24,0,0,2,1,2,1,13,10,27424,21690,17,50,28564,20800
235,24,2,0,0,3,1,0,159,188,27426,21690,192,56,28567,20800
236,24,1,1,2,1,2,1,61,47,27427,21691,78,55,28568,20801
237,24,3,0,0,3,1,0,110,98,27430,21691,115,37,28571,20801
238,24,1,1,2,1,2,1,232,194,27431,21692,301,37,28572,20802
239,24,3,2,0,3,1,0,195,158,27434,21694,233,87,28575,20802
240,25,2,3,1,0,0,3,39,49,27436,21697,36,72,28575,20805
241,25,2,1,0,3,1,0,77,43,27438,21698,93,178,28578,20805
242,25,4,3,0,3,1,0,100,110,27442,21701,113,40,28581,20805
243,25,0,1,1,0,0,3,43,64,27442,21702,56,11,28581,20808
244,25,0,3,1,0,0,3,65,51,27442,21705,80,44,28581,20811
245,25,3,0,0,3,1,0,74,49,27445,21705,83,56,28584,20811
246,25,1,1,2,1,2,1,65,49,27446,21706,79,144,28585,20812
247,25,2,1,0,3,1,0,75,50,27448,21707,94,59,28588,20812
248,25,2,1,0,3,1,0,196,162,27450,21708,225,198,28591,20812
249,25,0,2,1,0,0,3,177,168,27450,21710,200,309,28591,20815
250,26,1,0,0,3,1,0,196,158,27451,21710,236,21,28594,20815
251,26,2,1,0,3,1,0,76,61,27453,21711,76,134,28597,20815
252,26,2,0,0,3,1,0,67,50,27455,21711,86,37,28600,20815
253,26,2,3,1,0,0,3,15,13,27457,21714,17,58,28600,20818
254,26,2,1,0,3,1,0,161,189,27459,21715,195,37,28603,20818
255,26,0,0,2,1,2,1,61,47,27459,21715,79,103,28604,20819
256,26,1,0,0,3,1,0,111,98,27460,21715,118,50,28607,20819
257,26,1,1,2,1,2,1,78,52,27461,21716,82,43,28608,20820
258,26,2,0,0,3,1,0,234,194,27463,21716,304,40,28611,20820
259,26,2,1,0,3,1,0,345,194,27465,21717,372,87,28614,20820
260,27,1,1,2,1,2,1,178,169,27466,21718,201,12,28615,20821
261,27,0,1,1,0,0,3,39,50,27466,21719,36,312,28615,20824
262,27,1,0,0,3,1,0,78,43,27467,21719,96,40,28618,20824
263,27,2,1,0,3,1,0,45,65,27469,21720,59,44,28621,20824
264,27,1,0,0,3,1,0,66,51,27470,21720,83,56,28624,20824
265,27,1,1,2,1,2,1,75,50,27471,21721,84,60,28625,20825
266,27,0,2,1,0,0,3,65,51,27471,21723,79,181,28625,20828
267,27,1,1,2,1,2,1,76,51,27472,21724,95,145,28626,20829
268,27,3,0,0,3,1,0,199,162,27475,21724,228,72,28629,20829
269,27,1,2,1,0,0,3,101,112,27476,21726,113,201,28629,20832
270,28,3,3,2,1,2,1,199,161,27479,21729,237,104,28630,20833
271,28,4,1,0,3,1,0,80,62,27483,21730,79,40,28633,20833
272,28,1,1,2,1,2,1,68,51,27484,21731,87,313,28634,20834
273,28,0,0,2,1,2,1,15,13,27484,21731,18,88,28635,20835
274,28,2,4,1,0,0,3,63,51,27486,21735,79,40,28635,20838
275,28,2,1,0,3,1,0,77,51,27488,21736,87,134,28638,20838
276,28,1,1,2,1,2,1,112,99,27489,21737,119,44,28639,20839
277,28,2,1,0,3,1,0,80,53,27491,21738,85,58,28642,20839
278,28,2,1,0,3,1,0,236,195,27493,21739,307,21,28645,20839
279,28,1,0,0,3,1,0,162,189,27494,21739,198,50,28648,20839
280,29,2,1,0,3,1,0,80,44,27496,21740,99,12,28651,20839
281,29,2,2,2,1,2,1,347,196,27498,21742,373,182,28652,20840
282,29,2,2,2,1,2,1,47,67,27500,21744,60,57,28653,20841
283,29,1,0,0,3,1,0,200,162,27501,21744,231,145,28656,20841
284,29,0,0,2,1,2,1,66,51,27501,21744,84,61,28657,20842
285,29,0,3,1,0,0,3,65,54,27501,21747,79,75,28657,20845
286,29,1,1,2,1,2,1,77,52,27502,21748,96,38,28658,20846
287,29,1,0,0,3,1,0,102,112,27503,21748,116,44,28661,20846
288,29,3,1,0,3,1,0,181,170,27506,21749,204,201,28664,20846
289,29,1,1,2,1,2,1,40,51,27507,21750,37,41,28665,20847
290,30,0,0,2,1,2,1,80,62,27507,21750,80,105,28666,20848
291,30,2,3,1,0,0,3,70,54,27509,21753,87,185,28666,20851
292,30,2,1,0,3,1,0,17,14,27511,21754,21,21,28669,20851
293,30,1,1,2,1,2,1,163,190,27512,21755,199,41,28670,20852
294,30,1,0,0,3,1,0,64,51,27513,21755,82,88,28673,20852
295,30,2,1,0,3,1,0,79,52,27515,21756,90,58,28676,20852
296,30,1,2,1,0,0,3,81,55,27516,21758,85,137,28676,20855
297,30,1,0,0,3,1,0,78,52,27517,21758,99,50,28679,20855
298,30,1,1,2,1,2,1,237,196,27518,21759,308,314,28680,20856
299,30,0,1,1,0,0,3,112,100,27518,21760,119,43,28680,20859
300,31,2,0,0,3,1,0,201,161,27520,21760,240,201,28683,20859
301,31,1,1,2,1,2,1,182,171,27521,21761,205,42,28684,20860
302,31,0,0,2,1,2,1,40,51,27521,21761,38,45,28685,20861
303,31,2,2,2,1,2,1,104,114,27523,21763,117,58,28686,20862
304,31,1,1,2,1,2,1,348,197,27524,21764,374,13,28687,20863
305,31,1,1,2,1,2,1,48,68,27525,21765,61,76,28688,20864
306,31,2,2,2,1,2,1,68,53,27527,21767,85,39,28689,20865
307,31,1,0,0,3,1,0,66,54,27528,21767,82,44,28692,20865
308,31,0,0,2,1,2,1,200,162,27528,21767,232,62,28693,20866
309,31,1,1,2,1,2,1,81,45,27529,21768,100,146,28694,20867
310,32,0,0,2,1,2,1,17,14,27529,21768,22,186,28695,20868
311,32,0,0,2,1,2,1,163,190,27529,21768,200,89,28696,20869
312,32,1,1,2,1,2,1,65,52,27530,21769,83,44,28697,20870
313,32,1,3,1,0,0,3,80,55,27531,21772,90,44,28697,20873
314,32,1,2,1,0,0,3,67,56,27532,21774,82,53,28697,20876
315,32,1,1,2,1,2,1,113,101,27533,21775,120,106,28698,20877
316,32,4,1,0,3,1,0,85,56,27537,21776,88,21,28701,20877
317,32,2,0,0,3,1,0,80,52,27539,21776,102,137,28704,20877
318,32,0,2,1,0,0,3,80,64,27539,21778,80,317,28704,20880
319,32,0,4,1,0,0,3,70,58,27539,21782,87,204,28704,20883
320,33,1,1,2,1,2,1,202,162,27540,21783,241,147,28705,20884
321,33,1,0,0,3,1,0,71,58,27541,21783,90,13,28708,20884
322,33,1,0,0,3,1,0,183,171,27542,21783,208,39,28711,20884
323,33,0,1,1,0,0,3,40,52,27542,21784,38,47,28711,20887
324,33,1,1,2,1,2,1,82,46,27543,21785,101,59,28712,20888
325,33,1,0,0,3,1,0,49,68,27544,21785,64,53,28715,20888
326,33,6,1,0,3,1,0,206,163,27550,21786,235,58,28718,20888
327,33,1,2,1,0,0,3,105,116,27551,21788,117,79,28718,20891
328,33,1,1,2,1,2,1,238,197,27552,21789,309,46,28719,20892
329,33,4,0,0,3,1,0,352,197,27556,21789,377,62,28722,20892
330,34,0,0,2,1,2,1,80,64,27556,21789,81,43,28723,20893
331,34,0,1,1,0,0,3,17,15,27556,21790,22,207,28723,20896
332,34,0,2,1,0,0,3,65,54,27556,21792,83,24,28723,20899
333,34,2,0,0,3,1,0,70,53,27558,21792,88,137,28726,20899
334,34,1,1,2,1,2,1,81,56,27559,21793,91,90,28727,20900
335,34,0,0,2,1,2,1,67,56,27559,21793,83,45,28728,20901
336,34,3,0,0,3,1,0,116,101,27562,21793,123,186,28731,20901
337,34,1,2,1,0,0,3,81,54,27563,21795,102,47,28731,20904
338,34,2,2,2,1,2,1,165,192,27565,21797,201,107,28732,20905
339,34,1,1,2,1,2,1,86,57,27566,21798,89,318,28733,20906
340,35,1,0,0,3,1,0,203,162,27567,21798,244,39,28736,20906
341,35,2,1,0,3,1,0,73,59,27569,21799,93,79,28739,20906
342,35,4,2,0,3,1,0,187,173,27573,21801,211,59,28742,20906
343,35,1,3,1,0,0,3,41,55,27574,21804,38,61,28742,20909
344,35,2,0,0,3,1,0,84,46,27576,21804,104,53,28745,20909
345,35,0,0,2,1,2,1,105,116,27576,21804,118,48,28746,20910
346,35,0,1,1,0,0,3,17,16,27576,21805,22,49,28746,20913
347,35,0,2,1,0,0,3,49,70,27576,21807,64,140,28746,20916
348,35,0,1,1,0,0,3,352,198,27576,21808,377,150,28746,20919
349,35,0,1,1,0,0,3,238,198,27576,21809,309,65,28746,20922
350,36,2,2,2,1,2,1,82,66,27578,21811,82,187,28747,20923
351,36,1,0,0,3,1,0,66,54,27579,21811,86,43,28750,20923
352,36,7,0,0,3,1,0,213,163,27586,21811,238,90,28753,20923
353,36,2,3,1,0,0,3,72,56,27588,21814,88,110,28753,20926
354,36,1,2,1,0,0,3,82,58,27589,21816,91,27,28753,20929
355,36,0,4,1,0,0,3,67,60,27589,21820,83,50,28753,20932
356,36,0,2,1,0,0,3,86,59,27589,21822,89,16,28753,20935
357,36,0,0,2,1,2,1,81,54,27589,21822,103,46,28754,20936
358,36,0,1,1,0,0,3,116,102,27589,21823,123,321,28754,20939
359,36,0,1,1,0,0,3,165,193,27589,21824,201,210,28754,20942
360,37,0,1,1,0,0,3,203,163,27589,21825,244,51,28754,20945
361,37,1,1,2,1,2,1,83,67,27590,21826,83,66,28755,20946
362,37,2,2,2,1,2,1,75,61,27592,21828,94,151,28756,20947
363,37,2,3,1,0,0,3,189,176,27594,21831,211,49,28756,20950
364,37,0,1,1,0,0,3,41,56,27594,21832,38,143,28756,20953
365,37,1,2,1,0,0,3,85,48,27595,21834,104,42,28756,20956
366,37,1,1,2,1,2,1,106,117,27596,21835,119,54,28757,20957
367,37,2,1,0,3,1,0,354,199,27598,21836,380,61,28760,20957
368,37,1,0,0,3,1,0,239,198,27599,21836,312,59,28763,20957
369,37,2,0,0,3,1,0,19,16,27601,21836,25,79,28766,20957
370,38,1,1,2,1,2,1,50,71,27602,21837,65,51,28767,20958
371,38,2,1,0,3,1,0,167,194,27604,21838,204,27,28770,20958
372,38,1,1,2,1,2,1,67,55,27605,21839,87,17,28771,20959
373,38,2,0,0,3,1,0,215,163,27607,21839,241,110,28774,20959
374,38,2,2,2,1,2,1,74,58,27609,21841,89,211,28775,20960
375,38,3,2,0,3,1,0,85,60,27612,21843,94,43,28778,20960
376,38,2,1,0,3,1,0,69,61,27614,21844,86,90,28781,20960
377,38,4,2,0,3,1,0,120,104,27618,21846,126,49,28784,20960
378,38,2,2,2,1,2,1,88,61,27620,21848,90,188,28785,20961
379,38,1,2,1,0,0,3,82,56,27621,21850,103,324,28785,20964
0,1,2,0,0,3,1,0,52,71,27623,21850,68,51,28788,20964
1,1,3,1,0,3,1,0,170,195,27626,21851,207,110,28791,20964
2,1,3,3,2,1,2,1,78,64,27629,21854,95,62,28792,20965
3,1,2,1,0,3,1,0,69,56,27631,21855,90,51,28795,20965
4,1,2,4,1,0,0,3,76,62,27633,21859,89,191,28795,20968
5,1,1,0,0,3,1,0,148,180,27634,21859,154,42,28798,20968
6,1,2,3,1,0,0,3,122,107,27636,21862,126,3,28798,20971
7,1,1,1,2,1,2,1,20,17,27637,21863,26,71,28799,20972
8,1,0,0,2,1,2,1,85,94,27637,21863,99,50,28800,20973
9,1,1,0,0,3,1,0,107,117,27638,21863,122,0,28803,20973
10,2,1,1,2,1,2,1,84,68,27639,21864,84,80,28804,20974
11,2,3,2,0,3,1,0,3,2,27642,21866,3,111,28807,20974
12,2,1,2,1,0,0,3,86,62,27643,21868,94,154,28807,20977
13,2,0,1,1,0,0,3,85,49,27643,21869,104,69,28807,20980
14,2,1,1,2,1,2,1,83,57,27644,21870,104,18,28808,20981
15,2,1,0,0,3,1,0,204,163,27645,21870,247,43,28811,20981
16,2,1,2,1,0,0,3,1,2,27646,21872,0,71,28811,20984
17,2,1,1,2,1,2,1,190,177,27647,21873,212,91,28812,20985
18,2,1,0,0,3,1,0,108,117,27648,21873,131,49,28815,20985
19,2,3,1,0,3,1,0,114,98,27651,21874,128,54,28818,20985
20,3,3,0,0,3,1,0,173,195,27654,21874,210,3,28821,20985
21,3,0,4,1,0,0,3,78,68,27654,21878,95,54,28821,20988
22,3,2,1,0,3,1,0,71,57,27656,21879,93,42,28824,20988
23,3,1,3,1,0,0,3,191,180,27657,21882,212,194,28824,20991
24,3,1,1,2,1,2,1,77,63,27658,21883,90,1,28825,20992
25,3,1,0,0,3,1,0,149,180,27659,21883,157,49,28828,20992
26,3,3,2,0,3,1,0,125,109,27662,21885,129,71,28831,20992
27,3,1,1,2,1,2,1,21,18,27663,21886,27,52,28832,20993
28,3,4,1,0,3,1,0,111,118,27667,21887,125,50,28835,20993
29,3,0,1,1,0,0,3,85,95,27667,21888,99,65,28835,20996
30,4,1,0,0,3,1,0,53,71,27668,21888,71,69,28838,20996
31,4,2,0,0,3,1,0,86,68,27670,21888,87,43,28841,20996
32,4,1,1,2,1,2,1,2,3,27671,21889,1,195,28842,20997
33,4,2,2,2,1,2,1,5,4,27673,21891,4,55,28843,20998
34,4,1,1,2,1,2,1,86,50,27674,21892,105,72,28844,20999
35,4,1,1,2,1,2,1,150,181,27675,21893,158,19,28845,21000
36,4,3,1,0,3,1,0,86,58,27678,21894,107,80,28848,21000
37,4,2,1,0,3,1,0,110,118,27680,21895,134,154,28851,21000
38,4,0,0,2,1,2,1,114,98,27680,21895,129,111,28852,21001
39,4,0,2,1,0,0,3,86,64,27680,21897,94,94,28852,21004
40,5,2,1,0,3,1,0,206,164,27682,21898,250,65,28855,21004
41,5,2,0,0,3,1,0,80,68,27684,21898,98,1,28858,21004
42,5,0,0,2,1,2,1,71,57,27684,21898,94,4,28859,21005
43,5,1,0,0,3,1,0,192,180,27685,21898,215,42,28862,21005
44,5,1,1,2,1,2,1,78,64,27686,21899,91,51,28863,21006
45,5,1,0,0,3,1,0,112,118,27687,21899,128,71,28866,21006
46,5,2,3,1,0,0,3,87,98,27689,21902,99,57,28866,21009
47,5,0,0,2,1,2,1,125,109,27689,21902,130,53,28867,21010
48,5,1,0,0,3,1,0,22,18,27690,21902,30,49,28870,21010
49,5,0,2,1,0,0,3,173,197,27690,21904,210,114,28870,21013
50,6,3,2,0,3,1,0,56,73,27693,21906,74,154,28873,21013
51,6,0,0,2,1,2,1,2,3,27693,21906,2,112,28874,21014
52,6,1,1,2,1,2,1,6,5,27694,21907,5,73,28875,21015
53,6,4,1,0,3,1,0,90,65,27698,21908,97,195,28878,21015
54,6,2,2,2,1,2,1,152,183,27700,21910,159,81,28879,21016
55,6,0,0,2,1,2,1,22,18,27700,21910,31,70,28880,21017
56,6,2,2,2,1,2,1,88,60,27702,21912,108,56,28881,21018
57,6,3,0,0,3,1,0,113,118,27705,21912,137,43,28884,21018
58,6,6,2,0,3,1,0,92,52,27711,21914,108,94,28887,21018
59,6,0,0,2,1,2,1,86,68,27711,21914,88,66,28888,21019
60,7,2,0,0,3,1,0,116,98,27713,21914,132,1,28891,21019
61,7,3,1,0,3,1,0,176,198,27716,21915,213,19,28894,21019
62,7,2,2,2,1,2,1,82,70,27718,21917,99,54,28895,21020
63,7,0,0,2,1,2,1,71,57,27718,21917,95,115,28896,21021
64,7,2,0,0,3,1,0,194,180,27720,21917,218,57,28899,21021
65,7,3,0,0,3,1,0,81,64,27723,21917,94,42,28902,21021
66,7,1,1,2,1,2,1,113,119,27724,21918,129,5,28903,21022
67,7,2,1,0,3,1,0,89,99,27726,21919,102,71,28906,21022
68,7,1,2,1,0,0,3,126,111,27727,21921,130,52,28906,21025
69,7,2,0,0,3,1,0,208,164,27729,21921,253,51,28909,21025
70,8,3,1,0,3,1,0,91,61,27732,21922,111,94,28912,21025
71,8,1,1,2,1,2,1,57,74,27733,21923,75,44,28913,21026
72,8,1,0,0,3,1,0,87,68,27734,21923,91,1,28916,21026
73,8,2,2,2,1,2,1,73,59,27736,21925,96,155,28917,21027
74,8,1,3,1,0,0,3,7,8,27737,21928,5,115,28917,21030
75,8,2,1,0,3,1,0,92,66,27739,21929,100,66,28920,21030
76,8,1,0,0,3,1,0,93,52,27740,21929,111,56,28923,21030
77,8,3,0,0,3,1,0,155,183,27743,21929,162,73,28926,21030
78,8,2,1,0,3,1,0,24,19,27745,21930,34,81,28929,21030
79,8,3,3,2,1,2,1,116,121,27748,21933,138,196,28930,21031
80,9,1,1,2,1,2,1,209,165,27749,21934,254,58,28931,21032
81,9,1,2,1,0,0,3,117,100,27750,21936,132,8,28931,21035
82,9,1,1,2,1,2,1,3,4,27751,21937,3,43,28932,21036
83,9,1,0,0,3,1,0,177,198,27752,21937,216,54,28935,21036
84,9,3,0,0,3,1,0,85,70,27755,21937,102,19,28938,21036
85,9,1,0,0,3,1,0,195,180,27756,21937,221,51,28941,21036
86,9,0,2,1,0,0,3,81,66,27756,21939,94,74,28941,21039
87,9,0,0,2,1,2,1,89,99,27756,21939,103,53,28942,21040
88,9,1,1,2,1,2,1,127,112,27757,21940,131,71,28943,21041
89,9,3,2,0,3,1,0,116,121,27760,21942,132,115,28946,21041
90,10,2,0,0,3,1,0,89,68,27762,21942,94,43,28949,21041
91,10,2,0,0,3,1,0,75,59,27764,21942,99,56,28952,21041
92,10,0,0,2,1,2,1,93,52,27764,21942,112,116,28953,21042
93,10,1,0,0,3,1,0,156,183,27765,21942,165,44,28956,21042
94,10,2,1,0,3,1,0,129,113,27767,21943,134,155,28959,21042
95,10,2,2,2,1,2,1,26,21,27769,21945,35,74,28960,21043
96,10,1,1,2,1,2,1,92,62,27770,21946,112,67,28961,21044
97,10,6,1,0,3,1,0,122,122,27776,21947,141,1,28964,21044
98,10,0,0,2,1,2,1,7,8,27776,21947,6,197,28965,21045
99,10,1,1,2,1,2,1,58,75,27777,21948,76,95,28966,21046
100,11,2,0,0,3,1,0,211,165,27779,21948,257,19,28969,21046
101,11,1,1,2,1,2,1,90,69,27780,21949,95,9,28970,21047
102,11,1,2,1,0,0,3,4,6,27781,21951,3,61,28970,21050
103,11,0,2,1,0,0,3,85,72,27781,21953,102,158,28970,21053
104,11,2,1,0,3,1,0,197,181,27783,21954,224,74,28973,21053
105,11,1,0,0,3,1,0,82,66,27784,21954,97,53,28976,21053
106,11,2,2,2,1,2,1,94,68,27786,21956,101,55,28977,21054
107,11,3,2,0,3,1,0,92,101,27789,21958,106,71,28980,21054
108,11,1,0,0,3,1,0,117,121,27790,21958,135,81,28983,21054
109,11,0,3,1,0,0,3,117,103,27790,21961,132,118,28983,21057
110,12,0,0,2,1,2,1,58,75,27790,21961,77,117,28984,21058
111,12,3,0,0,3,1,0,10,8,27793,21961,9,1,28987,21058
112,12,0,1,1,0,0,3,93,53,27793,21962,112,70,28987,21061
113,12,1,0,0,3,1,0,157,183,27794,21962,168,197,28990,21061
114,12,3,1,0,3,1,0,132,114,27797,21963,137,44,28993,21061
115,12,3,1,0,3,1,0,29,22,27800,21964,38,56,28996,21061
116,12,2,0,0,3,1,0,94,62,27802,21964,115,43,28999,21061
117,12,2,0,0,3,1,0,124,122,27804,21964,144,51,29002,21061
118,12,1,2,1,0,0,3,178,200,27805,21966,216,77,29002,21064
119,12,0,0,2,1,2,1,75,59,27805,21966,100,96,29003,21065
120,13,1,0,0,3,1,0,212,165,27806,21966,260,53,29006,21065
121,13,4,0,0,3,1,0,94,69,27810,21966,98,61,29009,21065
122,13,0,0,2,1,2,1,4,6,27810,21966,4,56,29010,21066
123,13,3,0,0,3,1,0,88,72,27813,21966,105,71,29013,21066
124,13,2,2,2,1,2,1,199,183,27815,21968,225,20,29014,21067
125,13,1,2,1,0,0,3,83,68,27816,21970,97,121,29014,21070
126,13,5,1,0,3,1,0,99,69,27821,21971,104,9,29017,21070
127,13,1,0,0,3,1,0,93,101,27822,21971,109,81,29020,21070
128,13,2,1,0,3,1,0,119,122,27824,21972,138,158,29023,21070
129,13,1,1,2,1,2,1,118,104,27825,21973,133,75,29024,21071
130,14,4,0,0,3,1,0,182,200,27829,21973,219,56,29027,21071
131,14,1,1,2,1,2,1,76,60,27830,21974,101,52,29028,21072
132,14,2,1,0,3,1,0,12,9,27832,21975,12,61,29031,21072
133,14,1,2,1,0,0,3,94,55,27833,21977,112,200,29031,21075
134,14,2,0,0,3,1,0,95,101,27835,21977,112,44,29034,21075
135,14,0,1,1,0,0,3,132,115,27835,21978,137,4,29034,21078
136,14,0,1,1,0,0,3,124,123,27835,21979,144,46,29034,21081
137,14,2,0,0,3,1,0,159,183,27837,21979,171,117,29037,21081
138,14,1,0,0,3,1,0,59,75,27838,21979,80,70,29040,21081
139,14,2,2,2,1,2,1,31,24,27840,21981,39,97,29041,21082
140,15,0,2,1,0,0,3,212,167,27840,21983,260,74,29041,21085
141,15,0,1,1,0,0,3,118,105,27840,21984,133,23,29041,21088
142,15,0,2,1,0,0,3,4,8,27840,21986,4,124,29041,21091
143,15,0,3,1,0,0,3,12,12,27840,21989,12,78,29041,21094
144,15,1,0,0,3,1,0,200,183,27841,21989,228,77,29044,21094
145,15,4,2,0,3,1,0,87,70,27845,21991,100,81,29047,21094
146,15,1,1,2,1,2,1,100,70,27846,21992,105,54,29048,21095
147,15,2,2,2,1,2,1,96,64,27848,21994,116,57,29049,21096
148,15,2,0,0,3,1,0,121,122,27850,21994,141,44,29052,21096
149,15,3,2,0,3,1,0,97,71,27853,21996,101,158,29055,21096
150,16,0,0,2,1,2,1,59,75,27853,21996,81,5,29056,21097
151,16,1,1,2,1,2,1,183,201,27854,21997,220,201,29057,21098
152,16,2,0,0,3,1,0,90,72,27856,21997,108,56,29060,21098
153,16,1,0,0,3,1,0,77,60,27857,21997,104,70,29063,21098
154,16,3,1,0,3,1,0,97,56,27860,21998,115,9,29066,21098
155,16,1,1,2,1,2,1,133,116,27861,21999,138,118,29067,21099
156,16,0,1,1,0,0,3,31,25,27861,22000,39,49,29067,21102
157,16,1,2,1,0,0,3,125,125,27862,22002,144,64,29067,21105
158,16,1,0,0,3,1,0,96,101,27863,22002,115,97,29070,21105
159,16,3,0,0,3,1,0,162,183,27866,22002,174,52,29073,21105
160,17,2,0,0,3,1,0,99,71,27868,22002,104,23,29076,21105
161,17,1,1,2,1,2,1,119,106,27869,22003,134,82,29077,21106
162,17,1,5,1,0,0,3,5,13,27870,22008,4,161,29077,21109
163,17,1,1,2,1,2,1,13,13,27871,22009,13,55,29078,21110
164,17,0,0,2,1,2,1,87,70,27871,22009,101,78,29079,21111
165,17,2,2,2,1,2,1,102,72,27873,22011,106,45,29080,21112
166,17,4,2,0,3,1,0,100,66,27877,22013,119,124,29083,21112
167,17,0,1,1,0,0,3,125,126,27877,22014,144,60,29083,21115
168,17,1,2,1,0,0,3,213,169,27878,22016,260,100,29083,21118
169,17,1,0,0,3,1,0,201,183,27879,22016,231,74,29086,21118
170,18,1,2,1,0,0,3,122,124,27880,22018,141,59,29086,21121
171,18,0,0,2,1,2,1,183,201,27880,22018,221,71,29087,21122
172,18,3,1,0,3,1,0,93,73,27883,22019,111,118,29090,21122
173,18,2,0,0,3,1,0,79,60,27885,22019,107,5,29093,21122
174,18,2,0,0,3,1,0,99,56,27887,22019,118,52,29096,21122
175,18,2,1,0,3,1,0,98,102,27889,22020,118,49,29099,21122
176,18,0,2,1,0,0,3,133,118,27889,22022,138,204,29099,21125
177,18,2,1,0,3,1,0,33,26,27891,22023,42,9,29102,21125
178,18,1,0,0,3,1,0,60,75,27892,22023,84,64,29105,21125
179,18,1,0,0,3,1,0,163,183,27893,22023,177,78,29108,21125
180,19,1,1,2,1,2,1,100,72,27894,22024,105,56,29109,21126
181,19,0,3,1,0,0,3,5,16,27894,22027,4,26,29109,21129
182,19,4,1,0,3,1,0,205,184,27898,22028,234,59,29112,21129
183,19,1,3,1,0,0,3,103,75,27899,22031,106,85,29112,21132
184,19,2,2,2,1,2,1,101,58,27901,22033,119,125,29113,21133
185,19,2,1,0,3,1,0,102,67,27903,22034,122,161,29116,21133
186,19,2,2,2,1,2,1,127,128,27905,22036,145,75,29117,21134
187,19,1,1,2,1,2,1,214,170,27906,22037,261,79,29118,21135
188,19,3,2,0,3,1,0,16,15,27909,22039,16,45,29121,21135
189,19,0,1,1,0,0,3,119,107,27909,22040,134,103,29121,21138
190,20,2,1,0,3,1,0,185,202,27911,22041,224,49,29124,21138
191,20,0,1,1,0,0,3,93,74,27911,22042,111,207,29124,21141
192,20,0,1,1,0,0,3,79,61,27911,22043,107,63,29124,21144
193,20,3,1,0,3,1,0,90,71,27914,22044,104,71,29127,21144
194,20,0,1,1,0,0,3,98,103,27914,22045,118,8,29127,21147
195,20,2,2,2,1,2,1,135,120,27916,22047,139,53,29128,21148
196,20,3,2,0,3,1,0,36,28,27919,22049,45,64,29131,21148
197,20,3,0,0,3,1,0,63,75,27922,22049,87,78,29134,21148
198,20,2,2,2,1,2,1,124,126,27924,22051,142,119,29135,21149
199,20,1,1,2,1,2,1,164,184,27925,22052,178,10,29136,21150
200,21,1,0,0,3,1,0,64,75,27926,22052,90,125,29139,21150
201,21,0,0,2,1,2,1,119,107,27926,22052,135,80,29140,21151
202,21,2,2,2,1,2,1,7,18,27928,22054,5,60,29141,21152
203,21,1,2,1,0,0,3,17,17,27929,22056,16,164,29141,21155
204,21,0,0,2,1,2,1,103,75,27929,22056,107,76,29142,21156
205,21,1,2,1,0,0,3,102,60,27930,22058,119,29,29142,21159
206,21,2,1,0,3,1,0,129,129,27932,22059,148,85,29145,21159
207,21,5,2,0,3,1,0,107,69,27937,22061,125,45,29148,21159
208,21,0,0,2,1,2,1,214,170,27937,22061,262,120,29149,21160
209,21,1,2,1,0,0,3,101,74,27938,22063,105,106,29149,21163
210,22,1,0,0,3,1,0,215,170,27939,22063,265,8,29152,21163
211,22,1,1,2,1,2,1,186,203,27940,22064,225,79,29153,21164
212,22,2,0,0,3,1,0,95,74,27942,22064,114,53,29156,21164
213,22,1,1,2,1,2,1,80,62,27943,22065,108,57,29157,21165
214,22,3,0,0,3,1,0,208,184,27946,22065,237,71,29160,21165
215,22,3,2,0,3,1,0,93,73,27949,22067,107,10,29163,21165
216,22,3,0,0,3,1,0,138,120,27952,22067,142,64,29166,21165
217,22,2,0,0,3,1,0,38,28,27954,22067,48,125,29169,21165
218,22,0,0,2,1,2,1,124,126,27954,22067,143,50,29170,21166
219,22,3,2,0,3,1,0,101,105,27957,22069,121,63,29173,21166
220,23,0,0,2,1,2,1,64,75,27957,22069,91,30,29174,21167
221,23,1,0,0,3,1,0,102,74,27958,22069,108,60,29177,21167
222,23,1,4,1,0,0,3,8,22,27959,22073,5,48,29177,21170
223,23,2,0,0,3,1,0,19,17,27961,22073,19,76,29180,21170
224,23,0,0,2,1,2,1,103,75,27961,22073,108,121,29181,21171
225,23,0,1,1,0,0,3,102,61,27961,22074,119,88,29181,21174
226,23,2,1,0,3,1,0,166,185,27963,22075,181,164,29184,21174
227,23,1,0,0,3,1,0,130,129,27964,22075,151,106,29187,21174
228,23,1,3,1,0,0,3,108,72,27965,22078,125,83,29187,21177
229,23,1,0,0,3,1,0,120,107,27966,22078,138,207,29190,21177
230,24,1,0,0,3,1,0,187,203,27967,22078,228,57,29193,21177
231,24,2,1,0,3,1,0,97,75,27969,22079,117,79,29196,21177
232,24,0,1,1,0,0,3,80,63,27969,22080,108,33,29196,21180
233,24,3,0,0,3,1,0,211,184,27972,22080,240,8,29199,21180
234,24,1,0,0,3,1,0,94,73,27973,22080,110,64,29202,21180
235,24,2,2,2,1,2,1,103,107,27975,22082,122,11,29203,21181
236,24,0,0,2,1,2,1,138,120,27975,22082,143,126,29204,21182
237,24,1,1,2,1,2,1,216,171,27976,22083,266,51,29205,21183
238,24,1,0,0,3,1,0,121,107,27977,22083,141,53,29208,21183
239,24,1,1,2,1,2,1,125,127,27978,22084,144,64,29209,21184
240,25,1,1,2,1,2,1,65,76,27979,22085,92,89,29210,21185
241,25,1,2,1,0,0,3,103,76,27980,22087,108,210,29210,21188
242,25,3,4,1,0,0,3,106,79,27983,22091,108,63,29210,21191
243,25,0,0,2,1,2,1,102,61,27983,22091,120,49,29211,21192
244,25,0,0,2,1,2,1,38,28,27983,22091,49,165,29212,21193
245,25,1,0,0,3,1,0,109,72,27984,22091,128,121,29215,21193
246,25,2,0,0,3,1,0,132,129,27986,22091,154,83,29218,21193
247,25,1,0,0,3,1,0,167,185,27987,22091,184,76,29221,21193
248,25,0,1,1,0,0,3,8,23,27987,22092,5,74,29221,21196
249,25,2,3,1,0,0,3,21,20,27989,22095,19,109,29221,21199
250,26,1,1,2,1,2,1,217,172,27990,22096,267,80,29222,21200
251,26,2,1,0,3,1,0,123,108,27992,22097,144,51,29225,21200
252,26,0,0,2,1,2,1,8,23,27992,22097,6,54,29226,21201
253,26,2,1,0,3,1,0,189,204,27994,22098,231,76,29229,21201
254,26,2,0,0,3,1,0,99,75,27996,22098,120,57,29232,21201
255,26,2,2,2,1,2,1,213,186,27998,22100,241,12,29233,21202
256,26,0,1,1,0,0,3,94,74,27998,22101,110,67,29233,21205
257,26,4,1,0,3,1,0,142,121,28002,22102,146,33,29236,21205
258,26,0,1,1,0,0,3,103,108,28002,22103,122,129,29236,21208
259,26,2,2,2,1,2,1,127,129,28004,22105,145,65,29237,21209
260,27,1,2,1,0,0,3,66,78,28005,22107,92,86,29237,21212
261,27,2,2,2,1,2,1,105,78,28007,22109,109,122,29238,21213
262,27,1,0,0,3,1,0,81,63,28008,22109,111,89,29241,21213
263,27,0,0,2,1,2,1,21,20,28008,22109,20,75,29242,21214
264,27,2,0,0,3,1,0,108,79,28010,22109,111,8,29245,21214
265,27,1,1,2,1,2,1,103,62,28011,22110,121,166,29246,21215
266,27,4,0,0,3,1,0,42,28,28015,22110,52,49,29249,21215
267,27,4,1,0,3,1,0,136,130,28019,22111,157,63,29252,21215
268,27,0,1,1,0,0,3,167,186,28019,22112,184,112,29252,21218
269,27,2,0,0,3,1,0,111,72,28021,22112,131,210,29255,21218
270,28,2,0,0,3,1,0,125,108,28023,22112,147,65,29258,21218
271,28,1,0,0,3,1,0,9,23,28024,22112,9,80,29261,21218
272,28,0,1,1,0,0,3,99,76,28024,22113,120,132,29261,21221
273,28,1,2,1,0,0,3,214,188,28025,22115,241,70,29261,21224
274,28,1,1,2,1,2,1,95,75,28026,22116,111,77,29262,21225
275,28,3,0,0,3,1,0,111,79,28029,22116,114,54,29265,21225
276,28,1,1,2,1,2,1,104,109,28030,22117,123,34,29266,21226
277,28,2,2,2,1,2,1,219,174,28032,22119,268,13,29267,21227
278,28,3,0,0,3,1,0,130,129,28035,22119,148,57,29270,21227
279,28,1,1,2,1,2,1,190,205,28036,22120,232,90,29271,21228
280,29,2,2,2,1,2,1,68,80,28038,22122,93,64,29272,21229
281,29,1,1,2,1,2,1,191,206,28039,22123,233,50,29273,21230
282,29,1,0,0,3,1,0,82,63,28040,22123,114,86,29276,21230
283,29,0,2,1,0,0,3,21,22,28040,22125,20,57,29276,21233
284,29,1,1,2,1,2,1,104,63,28041,22126,122,52,29277,21234
285,29,2,1,0,3,1,0,44,29,28043,22127,55,210,29280,21234
286,29,1,0,0,3,1,0,112,72,28044,22127,134,8,29283,21234
287,29,2,0,0,3,1,0,138,130,28046,22127,160,122,29286,21234
288,29,3,3,2,1,2,1,145,124,28049,22130,147,113,29287,21235
289,29,1,0,0,3,1,0,168,186,28050,22130,187,75,29290,21235
290,30,0,0,2,1,2,1,105,78,28050,22130,110,81,29291,21236
291,30,1,1,2,1,2,1,126,109,28051,22131,148,71,29292,21237
292,30,3,1,0,3,1,0,12,24,28054,22132,12,13,29295,21237
293,30,2,0,0,3,1,0,101,76,28056,22132,123,90,29298,21237
294,30,1,1,2,1,2,1,215,189,28057,22133,242,58,29299,21238
295,30,2,1,0,3,1,0,97,76,28059,22134,114,34,29302,21238
296,30,1,0,0,3,1,0,112,79,28060,22134,117,65,29305,21238
297,30,1,1,2,1,2,1,105,110,28061,22135,124,167,29306,21239
298,30,2,2,2,1,2,1,221,176,28063,22137,269,133,29307,21240
299,30,1,1,2,1,2,1,131,130,28064,22138,149,78,29308,21241
300,31,3,0,0,3,1,0,71,80,28067,22138,96,210,29311,21241
301,31,1,1,2,1,2,1,83,64,28068,22139,115,51,29312,21242
302,31,4,0,0,3,1,0,25,22,28072,22139,23,52,29315,21242
303,31,1,0,0,3,1,0,105,63,28073,22139,125,8,29318,21242
304,31,0,1,1,0,0,3,145,125,28073,22140,147,89,29318,21245
305,31,2,0,0,3,1,0,46,29,28075,22140,58,122,29321,21245
306,31,2,2,2,1,2,1,114,74,28077,22142,135,58,29322,21246
307,31,0,2,1,0,0,3,138,132,28077,22144,160,78,29322,21249
308,31,1,0,0,3,1,0,192,206,28078,22144,236,113,29325,21249
309,31,2,1,0,3,1,0,170,187,28080,22145,190,64,29328,21249
310,32,1,0,0,3,1,0,222,176,28081,22145,272,71,29331,21249
311,32,0,2,1,0,0,3,105,80,28081,22147,110,81,29331,21252
312,32,2,0,0,3,1,0,128,109,28083,22147,151,58,29334,21252
313,32,0,0,2,1,2,1,12,24,28083,22147,13,91,29335,21253
314,32,0,3,1,0,0,3,101,79,28083,22150,123,92,29335,21256
315,32,2,3,1,0,0,3,99,79,28085,22153,114,170,29335,21259
316,32,2,1,0,3,1,0,114,80,28087,22154,120,81,29338,21259
317,32,1,2,1,0,0,3,115,76,28088,22156,135,16,29338,21262
318,32,2,0,0,3,1,0,133,130,28090,22156,152,34,29341,21262
319,32,2,2,2,1,2,1,217,191,28092,22158,243,134,29342,21263
320,33,1,1,2,1,2,1,72,81,28093,22159,97,53,29343,21264
321,33,1,1,2,1,2,1,84,65,28094,22160,116,211,29344,21265
322,33,2,2,2,1,2,1,107,65,28096,22162,126,66,29345,21266
323,33,1,0,0,3,1,0,171,187,28097,22162,193,8,29348,21266
324,33,2,1,0,3,1,0,107,111,28099,22163,127,122,29351,21266
325,33,1,0,0,3,1,0,146,125,28100,22163,150,64,29354,21266
326,33,1,2,1,0,0,3,47,31,28101,22165,58,81,29354,21269
327,33,0,3,1,0,0,3,138,135,28101,22168,160,19,29354,21272
328,33,1,0,0,3,1,0,193,206,28102,22168,239,58,29357,21272
329,33,1,1,2,1,2,1,102,80,28103,22169,124,114,29358,21273
330,34,2,0,0,3,1,0,130,109,28105,22169,154,81,29361,21273
331,34,2,2,2,1,2,1,14,26,28107,22171,14,59,29362,21274
332,34,2,0,0,3,1,0,27,22,28109,22171,26,71,29365,21274
333,34,5,1,0,3,1,0,222,192,28114,22172,246,91,29368,21274
334,34,0,0,2,1,2,1,99,79,28114,22172,115,52,29369,21275
335,34,2,4,1,0,0,3,116,84,28116,22176,120,37,29369,21278
336,34,1,1,2,1,2,1,134,131,28117,22177,153,93,29370,21279
337,34,1,2,1,0,0,3,116,78,28118,22179,135,84,29370,21282
338,34,0,3,1,0,0,3,105,83,28118,22182,110,137,29370,21285
339,34,1,2,1,0,0,3,223,178,28119,22184,272,173,29370,21288
340,35,2,1,0,3,1,0,74,82,28121,22185,100,19,29373,21288
341,35,6,1,0,3,1,0,199,207,28127,22186,242,8,29376,21288
342,35,1,1,2,1,2,1,103,81,28128,22187,125,54,29377,21289
343,35,0,1,1,0,0,3,84,66,28128,22188,116,125,29377,21292
344,35,2,1,0,3,1,0,109,66,28130,22189,129,84,29380,21292
345,35,1,1,2,1,2,1,172,188,28131,22190,194,67,29381,21293
346,35,3,1,0,3,1,0,110,112,28134,22191,130,64,29384,21293
347,35,1,1,2,1,2,1,147,126,28135,22192,151,82,29385,21294
348,35,1,0,0,3,1,0,48,31,28136,22192,61,58,29388,21294
349,35,0,0,2,1,2,1,134,131,28136,22192,154,212,29389,21295
350,36,0,1,1,0,0,3,130,110,28136,22193,154,176,29389,21298
351,36,2,3,1,0,0,3,225,181,28138,22196,272,94,29389,21301
352,36,2,1,0,3,1,0,107,84,28140,22197,113,71,29392,21301
353,36,1,1,2,1,2,1,15,27,28141,22198,15,82,29393,21302
354,36,1,1,2,1,2,1,28,23,28142,22199,27,38,29394,21303
355,36,2,1,0,3,1,0,224,193,28144,22200,249,52,29397,21303
356,36,1,6,1,0,0,3,100,85,28145,22206,115,117,29397,21306
357,36,1,0,0,3,1,0,117,84,28146,22206,123,93,29400,21306
358,36,2,2,2,1,2,1,118,80,28148,22208,136,60,29401,21307
359,36,0,1,1,0,0,3,138,136,28148,22209,160,140,29401,21310
360,37,0,2,1,0,0,3,74,84,28148,22211,100,61,29401,21313
361,37,1,3,1,0,0,3,200,210,28149,22214,242,70,29401,21316
362,37,0,2,1,0,0,3,103,83,28149,22216,125,22,29401,21319
363,37,0,3,1,0,0,3,84,69,28149,22219,116,87,29401,21322
364,37,2,4,1,0,0,3,102,89,28151,22223,115,128,29401,21325
365,37,0,1,1,0,0,3,134,132,28151,22224,154,85,29401,21328
366,37,3,0,0,3,1,0,175,188,28154,22224,197,71,29404,21328
367,37,3,1,0,3,1,0,113,113,28157,22225,133,212,29407,21328
368,37,2,1,0,3,1,0,149,127,28159,22226,154,54,29410,21328
369,37,1,1,2,1,2,1,49,32,28160,22227,62,9,29411,21329
370,38,1,0,0,3,1,0,226,181,28161,22227,275,64,29414,21329
371,38,0,0,2,1,2,1,107,84,28161,22227,114,94,29415,21330
372,38,3,0,0,3,1,0,133,110,28164,22227,157,52,29418,21330
373,38,0,2,1,0,0,3,15,29,28164,22229,15,120,29418,21333
374,38,1,1,2,1,2,1,29,24,28165,22230,28,95,29419,21334
375,38,2,2,2,1,2,1,226,195,28167,22232,250,177,29420,21335
376,38,0,0,2,1,2,1,117,84,28167,22232,124,141,29421,21336
377,38,2,1,0,3,1,0,111,67,28169,22233,132,60,29424,21336
378,38,3,0,0,3,1,0,121,80,28172,22233,139,82,29427,21336
379,38,4,1,0,3,1,0,142,137,28176,22234,163,38,29430,21336
0,1,0,0,2,1,2,1,74,84,28176,22234,101,60,29431,21337
1,1,2,0,0,3,1,0,109,84,28178,22234,117,71,29434,21337
2,1,2,0,0,3,1,0,43,56,28180,22234,41,49,29437,21337
3,1,3,2,0,3,1,0,152,129,28183,22236,157,212,29440,21337
4,1,4,2,0,3,1,0,125,82,28187,22238,142,22,29443,21337
5,1,1,1,2,1,2,1,114,114,28188,22239,134,129,29444,21338
6,1,1,1,2,1,2,1,118,85,28189,22240,125,39,29445,21339
7,1,0,1,1,0,0,3,103,84,28189,22241,125,90,29445,21342
8,1,0,1,1,0,0,3,102,86,28189,22242,121,3,29445,21345
9,1,2,1,0,3,1,0,135,111,28191,22243,160,82,29448,21345
10,2,2,0,0,3,1,0,228,181,28193,22243,278,60,29451,21345
11,2,1,1,2,1,2,1,85,70,28194,22244,117,62,29452,21346
12,2,1,1,2,1,2,1,112,68,28195,22245,133,28,29453,21347
13,2,0,0,2,1,2,1,49,32,28195,22245,63,86,29454,21348
14,2,0,1,1,0,0,3,0,1,28195,22246,0,97,29454,21351
15,2,1,0,0,3,1,0,143,137,28196,22246,166,70,29457,21351
16,2,1,0,0,3,1,0,227,195,28197,22246,253,54,29460,21351
17,2,3,0,0,3,1,0,32,24,28200,22246,31,52,29463,21351
18,2,2,2,2,1,2,1,114,87,28202,22248,120,96,29464,21352
19,2,0,2,1,0,0,3,91,85,28202,22250,111,63,29464,21355
20,3,1,0,0,3,1,0,126,82,28203,22250,145,49,29467,21355
21,3,1,1,2,1,2,1,115,115,28204,22251,135,61,29468,21356
22,3,2,2,2,1,2,1,154,131,28206,22253,158,130,29469,21357
23,3,0,1,1,0,0,3,109,85,28206,22254,117,6,29469,21360
24,3,1,0,0,3,1,0,50,32,28207,22254,66,71,29472,21360
25,3,1,1,2,1,2,1,119,86,28208,22255,126,23,29473,21361
26,3,3,2,0,3,1,0,106,86,28211,22257,128,82,29476,21361
27,3,0,0,2,1,2,1,135,111,28211,22257,161,213,29477,21362
28,3,0,2,1,0,0,3,43,58,28211,22259,41,63,29477,21365
29,3,0,2,1,0,0,3,102,88,28211,22261,121,93,29477,21368
30,4,2,2,2,1,2,1,76,86,28213,22263,102,64,29478,21369
31,4,0,0,2,1,2,1,115,115,28213,22263,136,97,29479,21370
32,4,3,4,1,0,0,3,88,74,28216,22267,117,31,29479,21373
33,4,1,0,0,3,1,0,92,85,28217,22267,114,70,29482,21373
34,4,1,1,2,1,2,1,33,25,28218,22268,32,40,29483,21374
35,4,0,4,1,0,0,3,114,91,28218,22272,120,74,29483,21377
36,4,1,0,0,3,1,0,1,1,28219,22272,3,86,29486,21377
37,4,0,0,2,1,2,1,143,137,28219,22272,167,55,29487,21378
38,4,1,1,2,1,2,1,229,182,28220,22273,279,53,29488,21379
39,4,1,0,0,3,1,0,228,195,28221,22273,256,62,29491,21379
40,5,0,1,1,0,0,3,102,89,28221,22274,121,133,29491,21382
41,5,2,2,2,1,2,1,156,133,28223,22276,159,62,29492,21383
42,5,1,1,2,1,2,1,113,69,28224,22277,134,24,29493,21384
43,5,0,4,1,0,0,3,43,62,28224,22281,41,96,29493,21387
44,5,1,2,1,0,0,3,110,87,28225,22283,117,52,29493,21390
45,5,0,0,2,1,2,1,50,32,28225,22283,67,83,29494,21391
46,5,0,0,2,1,2,1,119,86,28225,22283,127,64,29495,21392
47,5,0,0,2,1,2,1,106,86,28225,22283,129,7,29496,21393
48,5,1,2,1,0,0,3,127,84,28226,22285,145,216,29496,21396
49,5,2,0,0,3,1,0,137,111,28228,22285,164,97,29499,21396
50,6,1,1,2,1,2,1,115,92,28229,22286,121,25,29500,21397
51,6,1,0,0,3,1,0,89,74,28230,22286,120,74,29503,21397
52,6,2,0,0,3,1,0,231,182,28232,22286,282,31,29506,21397
53,6,0,0,2,1,2,1,156,133,28232,22286,160,87,29507,21398
54,6,1,0,0,3,1,0,229,195,28233,22286,259,40,29510,21398
55,6,1,0,0,3,1,0,77,86,28234,22286,105,70,29513,21398
56,6,1,1,2,1,2,1,2,2,28235,22287,4,56,29514,21399
57,6,1,1,2,1,2,1,93,86,28236,22288,115,54,29515,21400
58,6,1,1,2,1,2,1,116,116,28237,22289,137,65,29516,21401
59,6,1,2,1,0,0,3,144,139,28238,22291,167,65,29516,21404
60,7,2,0,0,3,1,0,45,62,28240,22291,44,133,29519,21404
61,7,1,0,0,3,1,0,138,111,28241,22291,167,62,29522,21404
62,7,2,0,0,3,1,0,104,89,28243,22291,124,97,29525,21404
63,7,2,2,2,1,2,1,35,27,28245,22293,33,84,29526,21405
64,7,1,1,2,1,2,1,111,88,28246,22294,118,65,29527,21406
65,7,4,3,0,3,1,0,131,87,28250,22297,148,7,29530,21406
66,7,3,0,0,3,1,0,53,32,28253,22297,70,52,29533,21406
67,7,3,2,0,3,1,0,122,88,28256,22299,130,216,29536,21406
68,7,2,5,1,0,0,3,108,91,28258,22304,129,100,29536,21409
69,7,3,2,0,3,1,0,116,71,28261,22306,137,96,29539,21409
70,8,2,1,0,3,1,0,117,93,28263,22307,124,84,29542,21409
71,8,4,1,0,3,1,0,148,140,28267,22308,170,40,29545,21409
72,8,0,1,1,0,0,3,2,3,28267,22309,4,34,29545,21412
73,8,2,1,0,3,1,0,118,117,28269,22310,140,70,29548,21412
74,8,0,1,1,0,0,3,93,87,28269,22311,115,77,29548,21415
75,8,0,0,2,1,2,1,104,89,28269,22311,125,88,29549,21416
76,8,2,1,0,3,1,0,231,196,28271,22312,262,25,29552,21416
77,8,0,0,2,1,2,1,231,182,28271,22312,283,66,29553,21417
78,8,2,3,1,0,0,3,79,89,28273,22315,105,59,29553,21420
79,8,1,0,0,3,1,0,157,133,28274,22315,163,54,29556,21420
80,9,2,1,0,3,1,0,113,89,28276,22316,121,62,29559,21420
81,9,2,0,0,3,1,0,119,93,28278,22316,127,7,29562,21420
82,9,2,1,0,3,1,0,55,33,28280,22317,73,216,29565,21420
83,9,1,0,0,3,1,0,117,71,28281,22317,140,133,29568,21420
84,9,2,0,0,3,1,0,47,62,28283,22317,47,97,29571,21420
85,9,0,1,1,0,0,3,131,88,28283,22318,148,68,29571,21423
86,9,3,2,0,3,1,0,38,29,28286,22320,36,65,29574,21423
87,9,1,1,2,1,2,1,123,89,28287,22321,131,101,29575,21424
88,9,1,1,2,1,2,1,109,92,28288,22322,130,89,29576,21425
89,9,1,0,0,3,1,0,90,74,28289,22322,123,96,29579,21425
90,10,1,0,0,3,1,0,119,117,28290,22322,143,34,29582,21425
91,10,3,0,0,3,1,0,234,182,28293,22322,286,25,29585,21425
92,10,0,0,2,1,2,1,104,89,28293,22322,126,67,29586,21426
93,10,1,0,0,3,1,0,232,196,28294,22322,265,84,29589,21426
94,10,0,0,2,1,2,1,93,87,28294,22322,116,41,29590,21427
95,10,2,2,2,1,2,1,4,5,28296,22324,5,78,29591,21428
96,10,0,0,2,1,2,1,157,133,28296,22324,164,60,29592,21429
97,10,0,1,1,0,0,3,79,90,28296,22325,105,57,29592,21432
98,10,0,0,2,1,2,1,148,140,28296,22325,171,53,29593,21433
99,10,2,0,0,3,1,0,140,111,28298,22325,170,70,29596,21433
100,11,2,2,2,1,2,1,115,91,28300,22327,122,102,29597,21434
101,11,1,2,1,0,0,3,132,90,28301,22329,148,100,29597,21437
102,11,1,0,0,3,1,0,118,71,28302,22329,143,216,29600,21437
103,11,3,1,0,3,1,0,50,63,28305,22330,50,62,29603,21437
104,11,1,1,2,1,2,1,91,75,28306,22331,124,66,29604,21438
105,11,1,1,2,1,2,1,56,34,28307,22332,74,8,29605,21439
106,11,2,2,2,1,2,1,125,91,28309,22334,132,90,29606,21440
107,11,1,4,1,0,0,3,110,96,28310,22338,130,71,29606,21443
108,11,1,1,2,1,2,1,39,30,28311,22339,37,97,29607,21444
109,11,0,3,1,0,0,3,119,96,28311,22342,127,136,29607,21447
110,12,2,1,0,3,1,0,95,88,28313,22343,119,53,29610,21447
111,12,0,1,1,0,0,3,157,134,28313,22344,164,70,29610,21450
112,12,3,0,0,3,1,0,143,111,28316,22344,173,34,29613,21450
113,12,1,1,2,1,2,1,5,6,28317,22345,6,26,29614,21451
114,12,1,0,0,3,1,0,80,90,28318,22345,108,41,29617,21451
115,12,3,0,0,3,1,0,237,182,28321,22345,289,84,29620,21451
116,12,1,1,2,1,2,1,105,90,28322,22346,127,61,29621,21452
117,12,2,1,0,3,1,0,112,97,28324,22347,133,70,29624,21452
118,12,1,0,0,3,1,0,149,140,28325,22347,174,136,29627,21452
119,12,2,1,0,3,1,0,121,118,28327,22348,146,78,29630,21452
120,13,1,2,1,0,0,3,40,32,28328,22350,37,74,29630,21455
121,13,0,3,1,0,0,3,115,94,28328,22353,122,93,29630,21458
122,13,3,0,0,3,1,0,235,196,28331,22353,268,66,29633,21458
123,13,3,0,0,3,1,0,94,75,28334,22353,127,100,29636,21458
124,13,1,0,0,3,1,0,150,140,28335,22353,177,8,29639,21458
125,13,2,0,0,3,1,0,120,71,28337,22353,146,62,29642,21458
126,13,2,1,0,3,1,0,127,92,28339,22354,135,70,29645,21458
127,13,1,0,0,3,1,0,51,63,28340,22354,53,57,29648,21458
128,13,1,4,1,0,0,3,57,38,28341,22358,74,105,29648,21461
129,13,1,0,0,3,1,0,120,96,28342,22358,130,216,29651,21461
130,14,2,3,1,0,0,3,134,93,28344,22361,148,73,29651,21464
131,14,2,1,0,3,1,0,7,7,28346,22362,9,84,29654,21464
132,14,1,0,0,3,1,0,238,182,28347,22362,292,136,29657,21464
133,14,2,1,0,3,1,0,107,91,28349,22363,130,34,29660,21464
134,14,3,2,0,3,1,0,160,136,28352,22365,167,41,29663,21464
135,14,1,2,1,0,0,3,81,92,28353,22367,108,56,29663,21467
136,14,2,1,0,3,1,0,97,89,28355,22368,122,97,29666,21467
137,14,1,1,2,1,2,1,113,98,28356,22369,134,62,29667,21468
138,14,1,0,0,3,1,0,144,111,28357,22369,176,78,29670,21468
139,14,3,1,0,3,1,0,124,119,28360,22370,149,26,29673,21468
140,15,2,1,0,3,1,0,237,197,28362,22371,271,8,29676,21468
141,15,3,1,0,3,1,0,97,76,28365,22372,130,62,29679,21468
142,15,1,1,2,1,2,1,98,90,28366,22373,123,217,29680,21469
143,15,0,1,1,0,0,3,120,97,28366,22374,130,96,29680,21472
144,15,1,1,2,1,2,1,58,39,28367,22375,75,71,29681,21473
145,15,2,0,0,3,1,0,42,32,28369,22375,40,100,29684,21473
146,15,1,0,0,3,1,0,52,63,28370,22375,56,62,29687,21473
147,15,3,1,0,3,1,0,118,95,28373,22376,125,57,29690,21473
148,15,1,1,2,1,2,1,121,72,28374,22377,147,75,29691,21474
149,15,1,0,0,3,1,0,151,140,28375,22377,180,105,29694,21474
150,16,2,2,2,1,2,1,146,113,28377,22379,177,27,29695,21475
151,16,2,1,0,3,1,0,136,94,28379,22380,151,34,29698,21475
152,16,1,1,2,1,2,1,8,8,28380,22381,10,67,29699,21476
153,16,0,2,1,0,0,3,81,94,28380,22383,108,139,29699,21479
154,16,1,0,0,3,1,0,108,91,28381,22383,133,84,29702,21479
155,16,3,3,2,1,2,1,163,139,28384,22386,168,79,29703,21480
156,16,1,1,2,1,2,1,128,93,28385,22387,136,74,29704,21481
157,16,0,1,1,0,0,3,113,99,28385,22388,134,44,29704,21484
158,16,0,3,1,0,0,3,238,185,28385,22391,292,100,29704,21487
159,16,0,1,1,0,0,3,124,120,28385,22392,149,59,29704,21490
160,17,2,3,1,0,0,3,10,11,28387,22395,10,220,29704,21493
161,17,2,2,2,1,2,1,99,78,28389,22397,131,72,29705,21494
162,17,0,1,1,0,0,3,58,40,28389,22398,75,78,29705,21497
163,17,1,1,2,1,2,1,53,64,28390,22399,57,75,29706,21498
164,17,2,0,0,3,1,0,44,32,28392,22399,43,62,29709,21498
165,17,2,0,0,3,1,0,100,90,28394,22399,126,105,29712,21498
166,17,0,1,1,0,0,3,121,73,28394,22400,147,65,29712,21501
167,17,1,0,0,3,1,0,121,97,28395,22400,133,57,29715,21501
168,17,1,0,0,3,1,0,238,197,28396,22400,274,96,29718,21501
169,17,2,0,0,3,1,0,153,140,28398,22400,183,100,29721,21501
170,18,1,1,2,1,2,1,109,92,28399,22401,134,221,29722,21502
171,18,1,1,2,1,2,1,119,96,28400,22402,126,45,29723,21503
172,18,1,2,1,0,0,3,125,122,28401,22404,149,87,29723,21506
173,18,3,2,0,3,1,0,139,96,28404,22406,154,79,29726,21506
174,18,0,1,1,0,0,3,163,140,28404,22407,168,11,29726,21509
175,18,3,1,0,3,1,0,131,94,28407,22408,139,59,29729,21509
176,18,1,1,2,1,2,1,114,100,28408,22409,135,140,29730,21510
177,18,2,1,0,3,1,0,148,114,28410,22410,180,67,29733,21510
178,18,0,4,1,0,0,3,81,98,28410,22414,108,103,29733,21513
179,18,2,0,0,3,1,0,55,64,28412,22414,60,27,29736,21513
180,19,1,1,2,1,2,1,59,41,28413,22415,76,35,29737,21514
181,19,0,1,1,0,0,3,100,91,28413,22416,126,103,29737,21517
182,19,2,2,2,1,2,1,46,34,28415,22418,44,76,29738,21518
183,19,1,1,2,1,2,1,11,12,28416,22419,11,63,29739,21519
184,19,3,1,0,3,1,0,241,186,28419,22420,295,105,29742,21519
185,19,0,3,1,0,0,3,238,200,28419,22423,274,75,29742,21522
186,19,0,0,2,1,2,1,99,78,28419,22423,132,66,29743,21523
187,19,1,1,2,1,2,1,122,74,28420,22424,148,58,29744,21524
188,19,1,0,0,3,1,0,154,140,28421,22424,186,96,29747,21524
189,19,1,2,1,0,0,3,122,99,28422,22426,133,81,29747,21527
190,20,0,2,1,0,0,3,139,98,28422,22428,154,106,29747,21530
191,20,2,0,0,3,1,0,165,140,28424,22428,171,59,29750,21530
192,20,1,0,0,3,1,0,56,64,28425,22428,63,79,29753,21530
193,20,1,1,2,1,2,1,120,97,28426,22429,127,88,29754,21531
194,20,0,0,2,1,2,1,148,114,28426,22429,181,46,29755,21532
195,20,1,3,1,0,0,3,82,101,28427,22432,108,224,29755,21535
196,20,1,0,0,3,1,0,132,94,28428,22432,142,140,29758,21535
197,20,2,2,2,1,2,1,116,102,28430,22434,136,28,29759,21536
198,20,1,1,2,1,2,1,110,93,28431,22435,135,68,29760,21537
199,20,2,2,2,1,2,1,127,124,28433,22437,150,12,29761,21538
200,21,1,1,2,1,2,1,123,75,28434,22438,149,47,29762,21539
201,21,1,0,0,3,1,0,83,101,28435,22438,111,105,29765,21539
202,21,0,3,1,0,0,3,100,94,28435,22441,126,38,29765,21542
203,21,0,0,2,1,2,1,11,12,28435,22441,12,77,29766,21543
204,21,4,5,1,0,0,3,242,205,28439,22446,274,106,29766,21546
205,21,1,0,0,3,1,0,47,34,28440,22446,47,66,29769,21546
206,21,2,0,0,3,1,0,156,140,28442,22446,189,81,29772,21546
207,21,1,2,1,0,0,3,123,101,28443,22448,133,78,29772,21549
208,21,3,3,2,1,2,1,102,81,28446,22451,133,59,29773,21550
209,21,1,2,1,0,0,3,242,188,28447,22453,295,99,29773,21553
210,22,1,0,0,3,1,0,111,93,28448,22453,138,63,29776,21553
211,22,1,1,2,1,2,1,166,141,28449,22454,172,106,29777,21554
212,22,1,1,2,1,2,1,57,65,28450,22455,64,89,29778,21555
213,22,0,2,1,0,0,3,139,100,28450,22457,154,71,29778,21558
214,22,1,3,1,0,0,3,60,44,28451,22460,76,31,29778,21561
215,22,1,1,2,1,2,1,149,115,28452,22461,182,13,29779,21562
216,22,2,1,0,3,1,0,134,95,28454,22462,145,106,29782,21562
217,22,0,1,1,0,0,3,116,103,28454,22463,136,227,29782,21565
218,22,3,0,0,3,1,0,123,97,28457,22463,130,140,29785,21565
219,22,3,1,0,3,1,0,126,76,28460,22464,152,59,29788,21565
220,23,0,1,1,0,0,3,83,102,28460,22465,111,109,29788,21568
221,23,1,2,1,0,0,3,124,103,28461,22467,133,80,29788,21571
222,23,1,1,2,1,2,1,157,141,28462,22468,190,39,29789,21572
223,23,0,0,2,1,2,1,47,34,28462,22468,48,80,29790,21573
224,23,2,0,0,3,1,0,244,188,28464,22468,298,78,29793,21573
225,23,1,1,2,1,2,1,103,82,28465,22469,134,48,29794,21574
226,23,0,0,2,1,2,1,100,94,28465,22469,127,67,29795,21575
227,23,1,0,0,3,1,0,12,12,28466,22469,15,59,29798,21575
228,23,1,0,0,3,1,0,243,205,28467,22469,277,81,29801,21575
229,23,2,1,0,3,1,0,129,125,28469,22470,153,99,29804,21575
230,24,0,0,2,1,2,1,47,34,28469,22470,49,60,29805,21576
231,24,0,1,1,0,0,3,123,98,28469,22471,130,109,29805,21579
232,24,2,2,2,1,2,1,141,102,28471,22473,155,64,29806,21580
233,24,1,1,2,1,2,1,61,45,28472,22474,77,141,29807,21581
234,24,3,1,0,3,1,0,129,77,28475,22475,155,89,29810,21581
235,24,1,0,0,3,1,0,58,65,28476,22475,67,227,29813,21581
236,24,1,1,2,1,2,1,135,96,28477,22476,146,14,29814,21582
237,24,0,0,2,1,2,1,116,103,28477,22476,137,72,29815,21583
238,24,0,2,1,0,0,3,111,95,28477,22478,138,109,29815,21586
239,24,3,1,0,3,1,0,152,116,28480,22479,185,109,29818,21586
240,25,1,3,1,0,0,3,125,106,28481,22482,133,51,29818,21589
241,25,2,1,0,3,1,0,14,13,28483,22483,18,78,29821,21589
242,25,1,0,0,3,1,0,104,82,28484,22483,137,31,29824,21589
243,25,1,1,2,1,2,1,244,206,28485,22484,278,40,29825,21590
244,25,1,0,0,3,1,0,84,102,28486,22484,114,99,29828,21590
245,25,1,1,2,1,2,1,101,95,28487,22485,128,81,29829,21591
246,25,2,0,0,3,1,0,246,188,28489,22485,301,67,29832,21591
247,25,6,0,0,3,1,0,135,125,28495,22485,156,59,29835,21591
248,25,2,2,2,1,2,1,159,143,28497,22487,191,81,29836,21592
249,25,2,1,0,3,1,0,168,142,28499,22488,175,81,29839,21592
250,26,1,0,0,3,1,0,62,45,28500,22488,80,109,29842,21592
251,26,2,1,0,3,1,0,131,78,28502,22489,158,72,29845,21592
252,26,3,2,0,3,1,0,61,67,28505,22491,70,14,29848,21592
253,26,0,0,2,1,2,1,104,82,28505,22491,138,61,29849,21593
254,26,1,1,2,1,2,1,142,103,28506,22492,156,110,29850,21594
255,26,0,2,1,0,0,3,47,36,28506,22494,49,144,29850,21597
256,26,1,0,0,3,1,0,136,96,28507,22494,149,64,29853,21597
257,26,2,1,0,3,1,0,118,104,28509,22495,140,109,29856,21597
258,26,1,1,2,1,2,1,153,117,28510,22496,186,82,29857,21598
259,26,0,1,1,0,0,3,123,99,28510,22497,130,230,29857,21601
260,27,2,1,0,3,1,0,113,96,28512,22498,141,78,29860,21601
261,27,2,0,0,3,1,0,170,142,28514,22498,178,40,29863,21601
262,27,0,1,1,0,0,3,101,96,28514,22499,128,34,29863,21604
263,27,2,0,0,3,1,0,161,143,28516,22499,194,89,29866,21604
264,27,0,1,1,0,0,3,14,14,28516,22500,18,64,29866,21607
265,27,0,0,2,1,2,1,246,188,28516,22500,302,52,29867,21608
266,27,1,1,2,1,2,1,136,126,28517,22501,157,68,29868,21609
267,27,1,1,2,1,2,1,245,207,28518,22502,279,82,29869,21610
268,27,2,4,1,0,0,3,86,106,28520,22506,114,84,29869,21613
269,27,3,0,0,3,1,0,156,117,28523,22506,189,59,29872,21613
270,28,1,0,0,3,1,0,63,45,28524,22506,83,72,29875,21613
271,28,3,1,0,3,1,0,134,79,28527,22507,161,14,29878,21613
272,28,1,0,0,3,1,0,62,67,28528,22507,73,110,29881,21613
273,28,2,5,1,0,0,3,106,87,28530,22512,138,147,29881,21616
274,28,1,1,2,1,2,1,143,104,28531,22513,157,100,29882,21617
275,28,0,1,1,0,0,3,47,37,28531,22514,49,233,29882,21620
276,28,0,1,1,0,0,3,136,97,28531,22515,149,112,29882,21623
277,28,1,2,1,0,0,3,119,106,28532,22517,140,67,29882,21626
278,28,1,0,0,3,1,0,124,99,28533,22517,133,82,29885,21626
279,28,1,1,2,1,2,1,126,107,28534,22518,134,110,29886,21627
280,29,1,0,0,3,1,0,247,188,28535,22518,305,82,29889,21627
281,29,3,2,0,3,1,0,173,144,28538,22520,181,78,29892,21627
282,29,1,1,2,1,2,1,246,208,28539,22521,280,65,29893,21628
283,29,0,0,2,1,2,1,86,106,28539,22521,115,41,29894,21629
284,29,1,2,1,0,0,3,102,98,28540,22523,128,92,29894,21632
285,29,2,0,0,3,1,0,163,143,28542,22523,197,34,29897,21632
286,29,0,0,2,1,2,1,14,14,28542,22523,19,53,29898,21633
287,29,3,0,0,3,1,0,116,96,28545,22523,144,59,29901,21633
288,29,0,0,2,1,2,1,156,117,28545,22523,190,69,29902,21634
289,29,2,1,0,3,1,0,138,127,28547,22524,160,84,29905,21634
290,30,0,1,1,0,0,3,134,80,28547,22525,161,113,29905,21637
291,30,1,0,0,3,1,0,48,37,28548,22525,52,14,29908,21637
292,30,3,1,0,3,1,0,127,100,28551,22526,136,112,29911,21637
293,30,1,1,2,1,2,1,127,108,28552,22527,135,73,29912,21638
294,30,1,1,2,1,2,1,64,46,28553,22528,84,68,29913,21639
295,30,2,0,0,3,1,0,108,87,28555,22528,141,233,29916,21639
296,30,2,2,2,1,2,1,138,99,28557,22530,150,83,29917,21640
297,30,1,0,0,3,1,0,144,104,28558,22530,160,59,29920,21640
298,30,0,1,1,0,0,3,246,209,28558,22531,280,113,29920,21643
299,30,1,1,2,1,2,1,63,68,28559,22532,74,101,29921,21644
300,31,1,0,0,3,1,0,103,98,28560,22532,131,147,29924,21644
301,31,0,1,1,0,0,3,14,15,28560,22533,19,116,29924,21647
302,31,1,2,1,0,0,3,139,129,28561,22535,160,56,29924,21650
303,31,2,1,0,3,1,0,118,97,28563,22536,147,34,29927,21650
304,31,0,1,1,0,0,3,173,145,28563,22537,181,95,29927,21653
305,31,0,1,1,0,0,3,86,107,28563,22538,115,85,29927,21656
306,31,1,1,2,1,2,1,145,105,28564,22539,161,70,29928,21657
307,31,0,2,1,0,0,3,119,108,28564,22541,140,44,29928,21660
308,31,0,1,1,0,0,3,156,118,28564,22542,190,87,29928,21663
309,31,0,0,2,1,2,1,247,188,28564,22542,306,66,29929,21664
310,32,1,0,0,3,1,0,109,87,28565,22542,144,14,29932,21664
311,32,2,0,0,3,1,0,165,143,28567,22542,200,73,29935,21664
312,32,3,0,0,3,1,0,66,68,28570,22542,77,83,29938,21664
313,32,1,1,2,1,2,1,49,38,28571,22543,53,114,29939,21665
314,32,2,3,1,0,0,3,129,103,28573,22546,136,81,29939,21668
315,32,3,0,0,3,1,0,130,108,28576,22546,138,68,29942,21668
316,32,3,2,0,3,1,0,67,48,28579,22548,87,112,29945,21668
317,32,1,0,0,3,1,0,139,99,28580,22548,153,59,29948,21668
318,32,1,1,2,1,2,1,247,210,28581,22549,281,234,29949,21669
319,32,1,1,2,1,2,1,135,81,28582,22550,162,102,29950,21670
320,33,0,1,1,0,0,3,118,98,28582,22551,147,88,29950,21673
321,33,0,1,1,0,0,3,173,146,28582,22552,181,37,29950,21676
322,33,1,0,0,3,1,0,157,118,28583,22552,193,66,29953,21676
323,33,1,0,0,3,1,0,248,188,28584,22552,309,73,29956,21676
324,33,1,0,0,3,1,0,146,105,28585,22552,164,56,29959,21676
325,33,2,0,0,3,1,0,141,129,28587,22552,163,116,29962,21676
326,33,0,0,2,1,2,1,86,107,28587,22552,116,96,29963,21677
327,33,0,2,1,0,0,3,139,101,28587,22554,153,47,29963,21680
328,33,2,1,0,3,1,0,121,109,28589,22555,143,87,29966,21680
329,33,0,1,1,0,0,3,14,16,28589,22556,19,150,29966,21683
330,34,0,0,2,1,2,1,109,87,28589,22556,145,84,29967,21684
331,34,2,3,1,0,0,3,105,101,28591,22559,131,17,29967,21687
332,34,1,1,2,1,2,1,131,109,28592,22560,139,115,29968,21688
333,34,1,1,2,1,2,1,67,69,28593,22561,78,82,29969,21689
334,34,2,1,0,3,1,0,51,39,28595,22562,56,102,29972,21689
335,34,2,1,0,3,1,0,167,144,28597,22563,203,234,29975,21689
336,34,2,0,0,3,1,0,137,81,28599,22563,165,112,29978,21689
337,34,1,0,0,3,1,0,248,210,28600,22563,284,68,29981,21689
338,34,1,1,2,1,2,1,130,104,28601,22564,137,71,29982,21690
339,34,3,0,0,3,1,0,70,48,28604,22564,90,59,29985,21690
340,35,2,0,0,3,1,0,88,107,28606,22564,119,37,29988,21690
341,35,2,3,1,0,0,3,120,101,28608,22567,147,59,29988,21693
342,35,2,0,0,3,1,0,143,129,28610,22567,166,73,29991,21693
343,35,0,0,2,1,2,1,130,104,28610,22567,138,48,29992,21694
344,35,2,1,0,3,1,0,250,189,28612,22568,312,17,29995,21694
345,35,0,1,1,0,0,3,146,106,28612,22569,164,99,29995,21697
346,35,1,1,2,1,2,1,140,102,28613,22570,154,89,29996,21698
347,35,3,0,0,3,1,0,124,109,28616,22570,146,66,29999,21698
348,35,1,2,1,0,0,3,174,148,28617,22572,181,119,29999,21701
349,35,0,0,2,1,2,1,157,118,28617,22572,194,151,30000,21702
350,36,4,0,0,3,1,0,171,144,28621,22572,206,68,30003,21702
351,36,1,1,2,1,2,1,71,49,28622,22573,91,88,30004,21703
352,36,0,1,1,0,0,3,109,88,28622,22574,145,118,30004,21706
353,36,2,1,0,3,1,0,107,102,28624,22575,134,102,30007,21706
354,36,1,1,2,1,2,1,15,17,28625,22576,20,113,30008,21707
355,36,0,1,1,0,0,3,137,82,28625,22577,165,85,30008,21710
356,36,2,2,2,1,2,1,133,111,28627,22579,140,72,30009,21711
357,36,0,1,1,0,0,3,248,211,28627,22580,284,62,30009,21714
358,36,1,1,2,1,2,1,52,40,28628,22581,57,49,30010,21715
359,36,0,0,2,1,2,1,250,189,28628,22581,313,85,30011,21716
360,37,0,0,2,1,2,1,146,106,28628,22581,165,152,30012,21717
361,37,1,1,2,1,2,1,175,149,28629,22582,182,74,30013,21718
362,37,3,2,0,3,1,0,70,71,28632,22584,81,59,30016,21718
363,37,2,2,2,1,2,1,132,106,28634,22586,139,38,30017,21719
364,37,1,1,2,1,2,1,121,102,28635,22587,148,67,30018,21720
365,37,0,0,2,1,2,1,143,129,28635,22587,167,235,30019,21721
366,37,2,1,0,3,1,0,159,119,28637,22588,197,119,30022,21721
367,37,4,1,0,3,1,0,92,108,28641,22589,122,17,30025,21721
368,37,3,1,0,3,1,0,143,103,28644,22590,157,99,30028,21721
369,37,0,0,2,1,2,1,124,109,28644,22590,147,90,30029,21722
370,38,2,1,0,3,1,0,139,83,28646,22591,168,88,30032,21722
371,38,1,4,1,0,0,3,53,44,28647,22595,57,88,30032,21725
372,38,3,0,0,3,1,0,253,189,28650,22595,316,113,30035,21725
373,38,3,1,0,3,1,0,251,212,28653,22596,287,118,30038,21725
374,38,1,0,0,3,1,0,110,88,28654,22596,148,102,30041,21725
375,38,2,1,0,3,1,0,109,103,28656,22597,137,68,30044,21725
376,38,2,1,0,3,1,0,135,112,28658,22598,143,49,30047,21725
377,38,1,0,0,3,1,0,16,17,28659,22598,23,85,30050,21725
378,38,0,3,1,0,0,3,71,52,28659,22601,91,75,30050,21728
379,38,4,1,0,3,1,0,175,145,28663,22602,209,62,30053,21728
0,1,0,0,2,1,2,1,109,103,28663,22602,138,153,30054,21729
1,1,0,0,2,1,2,1,132,106,28663,22602,140,103,30055,21730
2,1,1,3,1,0,0,3,1,3,28664,22605,0,93,30055,21733
3,1,0,0,2,1,2,1,110,88,28664,22605,149,86,30056,21734
4,1,0,0,2,1,2,1,175,149,28664,22605,183,99,30057,21735
5,1,0,1,1,0,0,3,71,53,28664,22606,91,70,30057,21738
6,1,1,1,2,1,2,1,1,1,28665,22607,1,76,30058,21739
7,1,0,1,1,0,0,3,0,1,28665,22608,0,41,30058,21742
8,1,0,0,2,1,2,1,175,188,28665,22608,198,121,30059,21743
9,1,0,0,2,1,2,1,143,129,28665,22608,168,89,30060,21744
10,2,2,0,0,3,1,0,161,119,28667,22608,200,113,30063,21744
11,2,2,1,0,3,1,0,55,45,28669,22609,60,0,30066,21744
12,2,3,0,0,3,1,0,254,212,28672,22609,290,59,30069,21744
13,2,2,2,2,1,2,1,141,121,28674,22611,141,100,30070,21745
14,2,0,1,1,0,0,3,143,104,28674,22612,157,121,30070,21748
15,2,1,0,0,3,1,0,140,83,28675,22612,171,74,30073,21748
16,2,0,1,1,0,0,3,121,103,28675,22613,148,144,30073,21751
17,2,0,0,2,1,2,1,146,106,28675,22613,166,1,30074,21752
18,2,0,0,2,1,2,1,135,112,28675,22613,144,89,30075,21753
19,2,1,1,2,1,2,1,135,133,28676,22614,155,1,30076,21754
20,3,1,1,2,1,2,1,110,104,28677,22615,139,100,30077,21755
21,3,2,3,1,0,0,3,134,109,28679,22618,140,79,30077,21758
22,3,2,1,0,3,1,0,3,4,28681,22619,3,153,30080,21758
23,3,1,0,0,3,1,0,111,88,28682,22619,152,113,30083,21758
24,3,1,1,2,1,2,1,136,134,28683,22620,156,42,30084,21759
25,3,1,1,2,1,2,1,72,54,28684,22621,92,87,30085,21760
26,3,3,0,0,3,1,0,4,1,28687,22621,4,93,30088,21760
27,3,1,1,2,1,2,1,1,2,28688,22622,1,90,30089,21761
28,3,3,0,0,3,1,0,146,129,28691,22622,171,103,30092,21761
29,3,2,0,0,3,1,0,177,188,28693,22622,201,70,30095,21761
30,4,1,0,0,3,1,0,162,119,28694,22622,203,74,30098,21761
31,4,1,2,1,0,0,3,56,47,28695,22624,60,147,30098,21764
32,4,2,0,0,3,1,0,256,212,28697,22624,293,121,30101,21764
33,4,0,0,2,1,2,1,141,121,28697,22624,142,60,30102,21765
34,4,2,1,0,3,1,0,145,105,28699,22625,160,1,30105,21765
35,4,0,1,1,0,0,3,140,84,28699,22626,171,103,30105,21768
36,4,1,1,2,1,2,1,122,104,28700,22627,149,2,30106,21769
37,4,3,1,0,3,1,0,149,107,28703,22628,169,89,30109,21769
38,4,1,1,2,1,2,1,136,113,28704,22629,145,1,30110,21770
39,4,2,2,2,1,2,1,177,151,28706,22631,184,122,30111,21771
40,5,1,2,1,0,0,3,111,106,28707,22633,139,93,30111,21774
41,5,1,0,0,3,1,0,135,109,28708,22633,143,113,30114,21774
42,5,2,1,0,3,1,0,5,5,28710,22634,6,87,30117,21774
43,5,1,2,1,0,0,3,112,90,28711,22636,152,125,30117,21777
44,5,4,1,0,3,1,0,260,213,28715,22637,296,42,30120,21777
45,5,0,1,1,0,0,3,72,55,28715,22638,92,82,30120,21780
46,5,1,1,2,1,2,1,5,2,28716,22639,5,104,30121,21781
47,5,1,5,1,0,0,3,2,7,28717,22644,1,73,30121,21784
48,5,2,1,0,3,1,0,179,189,28719,22645,204,100,30124,21784
49,5,0,4,1,0,0,3,136,138,28719,22649,156,96,30124,21787
50,6,1,1,2,1,2,1,113,91,28720,22650,153,3,30125,21788
51,6,4,0,0,3,1,0,145,121,28724,22650,145,89,30128,21788
52,6,0,1,1,0,0,3,145,106,28724,22651,160,150,30128,21791
53,6,0,2,1,0,0,3,140,86,28724,22653,171,4,30128,21794
54,6,1,1,2,1,2,1,147,130,28725,22654,172,61,30129,21795
55,6,0,0,2,1,2,1,177,151,28725,22654,185,75,30130,21796
56,6,0,3,1,0,0,3,122,107,28725,22657,149,45,30130,21799
57,6,0,1,1,0,0,3,149,108,28725,22658,169,4,30130,21802
58,6,1,3,1,0,0,3,137,116,28726,22661,145,156,30130,21805
59,6,2,1,0,3,1,0,164,120,28728,22662,206,121,30133,21805
60,7,0,0,2,1,2,1,111,106,28728,22662,140,83,30134,21806
61,7,1,0,0,3,1,0,136,109,28729,22662,146,103,30137,21806
62,7,3,1,0,3,1,0,8,6,28732,22663,9,104,30140,21806
63,7,0,1,1,0,0,3,56,48,28732,22664,60,76,30140,21809
64,7,2,1,0,3,1,0,262,214,28734,22665,299,96,30143,21809
65,7,1,1,2,1,2,1,137,139,28735,22666,157,94,30144,21810
66,7,0,0,2,1,2,1,179,189,28735,22666,205,126,30145,21811
67,7,1,0,0,3,1,0,73,55,28736,22666,95,113,30148,21811
68,7,0,0,2,1,2,1,2,7,28736,22666,2,88,30149,21812
69,7,0,0,2,1,2,1,5,2,28736,22666,6,101,30150,21813
70,8,0,1,1,0,0,3,137,117,28736,22667,145,124,30150,21816
71,8,1,1,2,1,2,1,165,121,28737,22668,207,62,30151,21817
72,8,2,1,0,3,1,0,115,92,28739,22669,156,75,30154,21817
73,8,0,1,1,0,0,3,145,122,28739,22670,145,7,30154,21820
74,8,1,3,1,0,0,3,146,109,28740,22673,160,7,30154,21823
75,8,1,1,2,1,2,1,141,87,28741,22674,172,151,30155,21824
76,8,0,1,1,0,0,3,147,131,28741,22675,172,92,30155,21827
77,8,1,1,2,1,2,1,178,152,28742,22676,186,4,30156,21828
78,8,0,1,1,0,0,3,122,108,28742,22677,149,159,30156,21831
79,8,1,2,1,0,0,3,150,110,28743,22679,169,48,30156,21834
80,9,1,0,0,3,1,0,112,106,28744,22679,143,92,30159,21834
81,9,0,2,1,0,0,3,8,8,28744,22681,9,104,30159,21837
82,9,2,1,0,3,1,0,58,49,28746,22682,63,96,30162,21837
83,9,1,0,0,3,1,0,138,139,28747,22682,160,88,30165,21837
84,9,1,2,1,0,0,3,180,191,28748,22684,205,116,30165,21840
85,9,1,1,2,1,2,1,74,56,28749,22685,96,104,30166,21841
86,9,1,0,0,3,1,0,3,7,28750,22685,5,104,30169,21841
87,9,0,0,2,1,2,1,137,117,28750,22685,146,95,30170,21842
88,9,2,0,0,3,1,0,264,214,28752,22685,302,83,30173,21842
89,9,1,1,2,1,2,1,6,3,28753,22686,7,127,30174,21843
90,10,2,0,0,3,1,0,138,109,28755,22686,149,4,30177,21843
91,10,3,2,0,3,1,0,118,94,28758,22688,159,7,30180,21843
92,10,2,1,0,3,1,0,147,123,28760,22689,148,124,30183,21843
93,10,3,2,0,3,1,0,149,111,28763,22691,163,48,30186,21843
94,10,0,0,2,1,2,1,141,87,28763,22691,173,63,30187,21844
95,10,3,0,0,3,1,0,150,131,28766,22691,175,75,30190,21844
96,10,1,1,2,1,2,1,179,153,28767,22692,187,8,30191,21845
97,10,1,0,0,3,1,0,123,108,28768,22692,152,76,30194,21845
98,10,1,1,2,1,2,1,166,122,28769,22693,208,152,30195,21846
99,10,1,0,0,3,1,0,151,110,28770,22693,172,159,30198,21846
100,11,4,2,0,3,1,0,12,10,28774,22695,12,116,30201,21846
101,11,0,2,1,0,0,3,58,51,28774,22697,63,107,30201,21849
102,11,2,2,2,1,2,1,182,193,28776,22699,206,105,30202,21850
103,11,2,3,1,0,0,3,76,59,28778,22702,96,95,30202,21853
104,11,0,0,2,1,2,1,6,3,28778,22702,8,76,30203,21854
105,11,0,1,1,0,0,3,3,8,28778,22703,5,130,30203,21857
106,11,0,0,2,1,2,1,123,108,28778,22703,153,96,30204,21858
107,11,0,1,1,0,0,3,137,118,28778,22704,146,99,30204,21861
108,11,1,3,1,0,0,3,265,217,28779,22707,302,107,30204,21864
109,11,1,1,2,1,2,1,139,140,28780,22708,161,84,30205,21865
110,12,0,1,1,0,0,3,112,107,28780,22709,143,155,30205,21868
111,12,0,1,1,0,0,3,138,110,28780,22710,149,11,30205,21871
112,12,1,2,1,0,0,3,167,124,28781,22712,208,79,30205,21874
113,12,1,2,1,0,0,3,148,125,28782,22714,148,51,30205,21877
114,12,1,1,2,1,2,1,150,112,28783,22715,164,97,30206,21878
115,12,2,1,0,3,1,0,143,88,28785,22716,176,88,30209,21878
116,12,3,1,0,3,1,0,153,132,28788,22717,178,7,30212,21878
117,12,1,1,2,1,2,1,7,4,28789,22718,9,64,30213,21879
118,12,1,1,2,1,2,1,180,154,28790,22719,188,160,30214,21880
119,12,2,2,2,1,2,1,120,96,28792,22721,160,125,30215,21881
120,13,1,2,1,0,0,3,59,53,28793,22723,63,119,30215,21884
121,13,2,1,0,3,1,0,184,194,28795,22724,209,4,30218,21884
122,13,3,1,0,3,1,0,79,60,28798,22725,99,76,30221,21884
123,13,2,1,0,3,1,0,5,9,28800,22726,8,105,30224,21884
124,13,1,0,0,3,1,0,124,108,28801,22726,156,107,30227,21884
125,13,0,1,1,0,0,3,151,111,28801,22727,172,102,30227,21887
126,13,0,0,2,1,2,1,137,118,28801,22727,147,85,30228,21888
127,13,1,1,2,1,2,1,13,11,28802,22728,13,96,30229,21889
128,13,3,1,0,3,1,0,268,218,28805,22729,305,107,30232,21889
129,13,1,0,0,3,1,0,140,140,28806,22729,164,130,30235,21889
130,14,2,0,0,3,1,0,114,107,28808,22729,146,7,30238,21889
131,14,1,2,1,0,0,3,139,112,28809,22731,149,128,30238,21892
132,14,3,0,0,3,1,0,170,124,28812,22731,211,97,30241,21892
133,14,1,0,0,3,1,0,121,96,28813,22731,163,51,30244,21892
134,14,4,0,0,3,1,0,152,125,28817,22731,151,79,30247,21892
135,14,0,1,1,0,0,3,150,113,28817,22732,164,105,30247,21895
136,14,0,2,1,0,0,3,180,156,28817,22734,188,91,30247,21898
137,14,1,1,2,1,2,1,80,61,28818,22735,100,156,30248,21899
138,14,0,1,1,0,0,3,7,5,28818,22736,9,14,30248,21902
139,14,3,1,0,3,1,0,156,133,28821,22737,181,160,30251,21902
140,15,0,3,1,0,0,3,59,56,28821,22740,63,133,30251,21905
141,15,4,1,0,3,1,0,272,219,28825,22741,308,105,30254,21905
142,15,2,1,0,3,1,0,153,112,28827,22742,175,107,30257,21905
143,15,0,1,1,0,0,3,184,195,28827,22743,209,99,30257,21908
144,15,0,0,2,1,2,1,143,88,28827,22743,177,108,30258,21909
145,15,4,1,0,3,1,0,17,12,28831,22744,16,4,30261,21909
146,15,1,1,2,1,2,1,141,141,28832,22745,165,65,30262,21910
147,15,1,1,2,1,2,1,6,10,28833,22746,9,77,30263,21911
148,15,0,0,2,1,2,1,124,108,28833,22746,157,86,30264,21912
149,15,2,2,2,1,2,1,139,120,28835,22748,148,120,30265,21913
150,16,1,1,2,1,2,1,115,108,28836,22749,147,129,30266,21914
151,16,3,1,0,3,1,0,142,113,28839,22750,152,51,30269,21914
152,16,1,0,0,3,1,0,171,124,28840,22750,214,91,30272,21914
153,16,2,0,0,3,1,0,123,96,28842,22750,166,79,30275,21914
154,16,0,0,2,1,2,1,152,125,28842,22750,152,87,30276,21915
155,16,5,0,0,3,1,0,189,195,28847,22750,212,7,30279,21915
156,16,2,1,0,3,1,0,182,157,28849,22751,191,97,30282,21915
157,16,0,0,2,1,2,1,80,61,28849,22751,101,15,30283,21916
158,16,0,3,1,0,0,3,7,8,28849,22754,9,163,30283,21919
159,16,3,1,0,3,1,0,159,134,28852,22755,184,105,30286,21919
160,17,1,0,0,3,1,0,142,141,28853,22755,168,120,30289,21919
161,17,2,1,0,3,1,0,19,13,28855,22756,19,65,30292,21919
162,17,0,0,2,1,2,1,59,56,28855,22756,64,5,30293,21920
163,17,0,0,2,1,2,1,272,219,28855,22756,309,100,30294,21921
164,17,2,0,0,3,1,0,152,113,28857,22756,167,108,30297,21921
165,17,3,2,0,3,1,0,146,90,28860,22758,180,107,30300,21921
166,17,3,1,0,3,1,0,9,11,28863,22759,12,156,30303,21921
167,17,2,2,2,1,2,1,126,110,28865,22761,158,134,30304,21922
168,17,1,1,2,1,2,1,154,113,28866,22762,176,106,30305,21923
169,17,1,1,2,1,2,1,140,121,28867,22763,149,78,30306,21924
170,18,3,0,0,3,1,0,118,108,28870,22763,150,51,30309,21924
171,18,2,1,0,3,1,0,144,114,28872,22764,155,91,30312,21924
172,18,0,1,1,0,0,3,19,14,28872,22765,19,18,30312,21927
173,18,4,1,0,3,1,0,127,97,28876,22766,169,87,30315,21927
174,18,0,2,1,0,0,3,152,127,28876,22768,152,111,30315,21930
175,18,2,2,2,1,2,1,184,159,28878,22770,192,106,30316,21931
176,18,0,0,2,1,2,1,80,61,28878,22770,102,98,30317,21932
177,18,0,1,1,0,0,3,7,9,28878,22771,9,132,30317,21935
178,18,1,2,1,0,0,3,190,197,28879,22773,212,166,30317,21938
179,18,1,0,0,3,1,0,160,134,28880,22773,187,79,30320,21938
180,19,0,1,1,0,0,3,152,128,28880,22774,152,137,30320,21941
181,19,1,2,1,0,0,3,172,126,28881,22776,214,109,30320,21944
182,19,2,3,1,0,0,3,61,59,28883,22779,64,68,30320,21947
183,19,0,0,2,1,2,1,272,219,28883,22779,310,19,30321,21948
184,19,3,2,0,3,1,0,155,115,28886,22781,170,120,30324,21948
185,19,1,0,0,3,1,0,147,90,28887,22781,183,100,30327,21948
186,19,3,0,0,3,1,0,129,110,28890,22781,161,78,30330,21948
187,19,1,1,2,1,2,1,141,122,28891,22782,150,6,30331,21949
188,19,2,0,0,3,1,0,144,141,28893,22782,171,7,30334,21949
189,19,2,0,0,3,1,0,156,113,28895,22782,179,156,30337,21949
190,20,1,1,2,1,2,1,119,109,28896,22783,151,107,30338,21950
191,20,1,1,2,1,2,1,145,115,28897,22784,156,80,30339,21951
192,20,5,1,0,3,1,0,24,15,28902,22785,22,51,30342,21951
193,20,4,1,0,3,1,0,131,98,28906,22786,172,107,30345,21951
194,20,1,0,0,3,1,0,161,134,28907,22786,190,87,30348,21951
195,20,2,0,0,3,1,0,186,159,28909,22786,195,111,30351,21951
196,20,2,2,2,1,2,1,82,63,28911,22788,103,167,30352,21952
197,20,1,3,1,0,0,3,8,12,28912,22791,9,101,30352,21955
198,20,1,2,1,0,0,3,10,13,28913,22793,12,135,30352,21958
199,20,1,0,0,3,1,0,191,197,28914,22793,215,91,30355,21958
200,21,1,1,2,1,2,1,62,60,28915,22794,65,136,30356,21959
201,21,3,0,0,3,1,0,275,219,28918,22794,313,7,30359,21959
202,21,0,2,1,0,0,3,152,130,28918,22796,152,81,30359,21962
203,21,4,1,0,3,1,0,159,116,28922,22797,173,100,30362,21962
204,21,2,1,0,3,1,0,149,91,28924,22798,186,6,30365,21962
205,21,6,2,0,3,1,0,192,161,28930,22800,198,109,30368,21962
206,21,2,3,1,0,0,3,131,113,28932,22803,161,71,30368,21965
207,21,0,0,2,1,2,1,156,113,28932,22803,180,20,30369,21966
208,21,1,1,2,1,2,1,173,127,28933,22804,215,138,30370,21967
209,21,2,1,0,3,1,0,143,123,28935,22805,153,156,30373,21967
210,22,2,1,0,3,1,0,147,116,28937,22806,159,101,30376,21967
211,22,0,0,2,1,2,1,24,15,28937,22806,23,81,30377,21968
212,22,2,1,0,3,1,0,193,198,28939,22807,218,51,30380,21968
213,22,3,4,1,0,0,3,164,138,28942,22811,190,123,30380,21971
214,22,0,0,2,1,2,1,8,12,28942,22811,10,92,30381,21972
215,22,1,1,2,1,2,1,145,142,28943,22812,172,168,30382,21973
216,22,0,3,1,0,0,3,82,66,28943,22815,103,110,30382,21976
217,22,2,0,0,3,1,0,12,13,28945,22815,15,87,30385,21976
218,22,2,1,0,3,1,0,121,110,28947,22816,154,111,30388,21976
219,22,2,1,0,3,1,0,133,99,28949,22817,175,107,30391,21976
220,23,1,0,0,3,1,0,174,127,28950,22817,218,6,30394,21976
221,23,0,1,1,0,0,3,62,61,28950,22818,65,171,30394,21979
222,23,0,1,1,0,0,3,152,131,28950,22819,152,159,30394,21982
223,23,0,0,2,1,2,1,159,116,28950,22819,174,72,30395,21983
224,23,3,1,0,3,1,0,167,139,28953,22820,193,109,30398,21983
225,23,2,1,0,3,1,0,194,162,28955,22821,201,100,30401,21983
226,23,1,1,2,1,2,1,132,114,28956,22822,162,8,30402,21984
227,23,1,1,2,1,2,1,157,114,28957,22823,181,82,30403,21985
228,23,0,0,2,1,2,1,143,123,28957,22823,154,21,30404,21986
229,23,2,0,0,3,1,0,151,91,28959,22823,189,136,30407,21986
230,24,0,0,2,1,2,1,8,12,28959,22823,11,110,30408,21987
231,24,2,0,0,3,1,0,123,110,28961,22823,157,123,30411,21987
232,24,3,1,0,3,1,0,150,117,28964,22824,162,110,30414,21987
233,24,0,2,1,0,0,3,24,17,28964,22826,23,104,30414,21990
234,24,1,1,2,1,2,1,63,62,28965,22827,66,93,30415,21991
235,24,1,0,0,3,1,0,276,219,28966,22827,316,81,30418,21991
236,24,2,0,0,3,1,0,147,142,28968,22827,175,111,30421,21991
237,24,1,0,0,3,1,0,194,198,28969,22827,221,87,30424,21991
238,24,0,0,2,1,2,1,82,66,28969,22827,104,139,30425,21992
239,24,2,1,0,3,1,0,14,14,28971,22828,18,107,30428,21992
240,25,2,1,0,3,1,0,176,128,28973,22829,221,8,30431,21992
241,25,1,2,1,0,0,3,134,101,28974,22831,175,103,30431,21995
242,25,1,0,0,3,1,0,153,131,28975,22831,155,6,30434,21995
243,25,0,0,2,1,2,1,159,116,28975,22831,175,83,30435,21996
244,25,2,2,2,1,2,1,169,141,28977,22833,194,160,30436,21997
245,25,1,0,0,3,1,0,195,162,28978,22833,204,72,30439,21997
246,25,1,2,1,0,0,3,133,116,28979,22835,162,24,30439,22000
247,25,0,1,1,0,0,3,157,115,28979,22836,181,139,30439,22003
248,25,2,2,2,1,2,1,145,125,28981,22838,155,52,30440,22004
249,25,0,2,1,0,0,3,151,93,28981,22840,189,174,30440,22007
250,26,3,1,0,3,1,0,126,111,28984,22841,160,110,30443,22007
251,26,2,2,2,1,2,1,152,119,28986,22843,163,140,30444,22008
252,26,0,0,2,1,2,1,24,17,28986,22843,24,88,30445,22009
253,26,2,2,2,1,2,1,65,64,28988,22845,67,105,30446,22010
254,26,2,2,2,1,2,1,278,221,28990,22847,317,94,30447,22011
255,26,1,2,1,0,0,3,83,68,28991,22849,104,114,30447,22014
256,26,0,0,2,1,2,1,8,12,28991,22849,12,124,30448,22015
257,26,2,2,2,1,2,1,16,16,28993,22851,19,111,30449,22016
258,26,0,1,1,0,0,3,194,199,28993,22852,221,110,30449,22019
259,26,0,1,1,0,0,3,147,143,28993,22853,175,84,30449,22022
260,27,0,0,2,1,2,1,152,119,28993,22853,164,84,30450,22023
261,27,0,1,1,0,0,3,176,129,28993,22854,221,27,30450,22026
262,27,2,1,0,3,1,0,136,102,28995,22855,178,72,30453,22026
263,27,1,1,2,1,2,1,154,132,28996,22856,156,9,30454,22027
264,27,2,2,2,1,2,1,161,118,28998,22858,176,175,30455,22028
265,27,3,2,0,3,1,0,172,143,29001,22860,197,6,30458,22028
266,27,0,0,2,1,2,1,133,116,29001,22860,163,140,30459,22029
267,27,1,0,0,3,1,0,158,115,29002,22860,184,84,30462,22029
268,27,1,0,0,3,1,0,152,93,29003,22860,192,52,30465,22029
269,27,2,1,0,3,1,0,197,163,29005,22861,207,160,30468,22029
270,28,2,1,0,3,1,0,128,112,29007,22862,163,140,30471,22029
271,28,1,2,1,0,0,3,25,19,29008,22864,24,113,30471,22032
272,28,0,0,2,1,2,1,65,64,29008,22864,68,89,30472,22033
273,28,3,0,0,3,1,0,281,221,29011,22864,320,105,30475,22033
274,28,2,2,2,1,2,1,196,201,29013,22866,222,115,30476,22034
275,28,0,0,2,1,2,1,83,68,29013,22866,105,111,30477,22035
276,28,2,2,2,1,2,1,10,14,29015,22868,13,104,30478,22036
277,28,2,2,2,1,2,1,147,127,29017,22870,156,95,30479,22037
278,28,1,0,0,3,1,0,17,16,29018,22870,22,124,30482,22037
279,28,1,0,0,3,1,0,148,143,29019,22870,178,111,30485,22037
280,29,0,0,2,1,2,1,128,112,29019,22870,164,7,30486,22038
281,29,1,1,2,1,2,1,153,120,29020,22871,165,73,30487,22039
282,29,2,1,0,3,1,0,178,130,29022,22872,224,52,30490,22039
283,29,1,2,1,0,0,3,155,134,29023,22874,156,178,30490,22042
284,29,1,1,2,1,2,1,162,119,29024,22875,177,141,30491,22043
285,29,3,2,0,3,1,0,155,95,29027,22877,195,84,30494,22043
286,29,1,1,2,1,2,1,198,164,29028,22878,208,10,30495,22044
287,29,2,0,0,3,1,0,174,143,29030,22878,200,27,30498,22044
288,29,1,0,0,3,1,0,159,115,29031,22878,187,95,30501,22044
289,29,2,1,0,3,1,0,138,103,29033,22879,181,160,30504,22044
290,30,2,0,0,3,1,0,27,19,29035,22879,27,140,30507,22044
291,30,0,0,2,1,2,1,65,64,29035,22879,69,112,30508,22045
292,30,1,1,2,1,2,1,149,144,29036,22880,179,114,30509,22046
293,30,3,2,0,3,1,0,199,203,29039,22882,225,84,30512,22046
294,30,2,1,0,3,1,0,85,69,29041,22883,108,7,30515,22046
295,30,1,0,0,3,1,0,134,116,29042,22883,166,111,30518,22046
296,30,1,1,2,1,2,1,160,116,29043,22884,188,90,30519,22047
297,30,0,1,1,0,0,3,147,128,29043,22885,156,118,30519,22050
298,30,0,1,1,0,0,3,281,222,29043,22886,320,127,30519,22053
299,30,0,2,1,0,0,3,17,18,29043,22888,22,107,30519,22056
300,31,2,0,0,3,1,0,130,112,29045,22888,167,73,30522,22056
301,31,1,2,1,0,0,3,154,122,29046,22890,165,13,30522,22059
302,31,0,0,2,1,2,1,178,130,29046,22890,225,179,30523,22060
303,31,0,0,2,1,2,1,155,134,29046,22890,157,96,30524,22061
304,31,0,3,1,0,0,3,162,122,29046,22893,177,87,30524,22064
305,31,2,0,0,3,1,0,157,95,29048,22893,198,105,30527,22064
306,31,1,3,1,0,0,3,199,167,29049,22896,208,55,30527,22067
307,31,1,2,1,0,0,3,11,16,29050,22898,13,163,30527,22070
308,31,1,0,0,3,1,0,175,143,29051,22898,203,141,30530,22070
309,31,0,2,1,0,0,3,138,105,29051,22900,181,30,30530,22073
310,32,3,0,0,3,1,0,30,19,29054,22900,30,84,30533,22073
311,32,0,3,1,0,0,3,65,67,29054,22903,69,117,30533,22076
312,32,2,0,0,3,1,0,159,95,29056,22903,201,90,30536,22076
313,32,3,0,0,3,1,0,152,144,29059,22903,182,107,30539,22076
314,32,2,0,0,3,1,0,201,203,29061,22903,228,73,30542,22076
315,32,0,0,2,1,2,1,134,116,29061,22903,167,128,30543,22077
316,32,2,1,0,3,1,0,162,117,29063,22904,191,118,30546,22077
317,32,1,0,0,3,1,0,148,128,29064,22904,159,112,30549,22077
318,32,0,0,2,1,2,1,281,222,29064,22904,321,141,30550,22078
319,32,2,4,1,0,0,3,19,22,29066,22908,22,10,30550,22081
320,33,1,2,1,0,0,3,131,114,29067,22910,167,33,30550,22084
321,33,4,0,0,3,1,0,158,122,29071,22910,168,163,30553,22084
322,33,0,0,2,1,2,1,178,130,29071,22910,226,112,30554,22085
323,33,0,0,2,1,2,1,155,134,29071,22910,158,106,30555,22086
324,33,1,2,1,0,0,3,163,124,29072,22912,177,99,30555,22089
325,33,2,0,0,3,1,0,201,167,29074,22912,211,87,30558,22089
326,33,0,1,1,0,0,3,85,70,29074,22913,108,144,30558,22092
327,33,2,0,0,3,1,0,13,16,29076,22913,16,13,30561,22092
328,33,2,3,1,0,0,3,140,108,29078,22916,181,182,30561,22095
329,33,1,0,0,3,1,0,176,143,29079,22916,206,55,30564,22095
330,34,0,3,1,0,0,3,30,22,29079,22919,30,166,30564,22098
331,34,1,0,0,3,1,0,66,67,29080,22919,72,107,30567,22098
332,34,2,1,0,3,1,0,165,125,29082,22920,180,112,30570,22098
333,34,2,0,0,3,1,0,154,144,29084,22920,185,84,30573,22098
334,34,0,2,1,0,0,3,19,24,29084,22922,22,76,30573,22101
335,34,2,1,0,3,1,0,136,117,29086,22923,170,118,30576,22101
336,34,1,2,1,0,0,3,163,119,29087,22925,191,131,30576,22104
337,34,1,2,1,0,0,3,149,130,29088,22927,159,120,30576,22107
338,34,1,3,1,0,0,3,160,98,29089,22930,201,144,30576,22110
339,34,3,0,0,3,1,0,284,222,29092,22930,324,10,30579,22110
340,35,1,1,2,1,2,1,132,115,29093,22931,168,88,30580,22111
341,35,0,0,2,1,2,1,178,130,29093,22931,227,91,30581,22112
342,35,0,1,1,0,0,3,140,109,29093,22932,181,109,30581,22115
343,35,1,1,2,1,2,1,156,135,29094,22933,159,113,30582,22116
344,35,2,0,0,3,1,0,203,203,29096,22933,231,33,30585,22116
345,35,4,2,0,3,1,0,205,169,29100,22935,214,144,30588,22116
346,35,0,0,2,1,2,1,85,70,29100,22935,109,14,30589,22117
347,35,2,2,2,1,2,1,15,18,29102,22937,17,56,30590,22118
348,35,2,0,0,3,1,0,160,122,29104,22937,171,182,30593,22118
349,35,1,0,0,3,1,0,177,143,29105,22937,209,99,30596,22118
350,36,0,2,1,0,0,3,178,132,29105,22939,227,115,30596,22121
351,36,2,2,2,1,2,1,68,69,29107,22941,73,85,30597,22122
352,36,1,1,2,1,2,1,166,126,29108,22942,181,121,30598,22123
353,36,3,1,0,3,1,0,163,99,29111,22943,204,131,30601,22123
354,36,0,1,1,0,0,3,154,145,29111,22944,185,13,30601,22126
355,36,1,0,0,3,1,0,20,24,29112,22944,25,14,30604,22126
356,36,2,3,1,0,0,3,138,120,29114,22947,170,110,30604,22129
357,36,1,2,1,0,0,3,164,121,29115,22949,191,79,30604,22132
358,36,0,4,1,0,0,3,284,226,29115,22953,324,169,30604,22135
359,36,1,0,0,3,1,0,150,130,29116,22953,162,144,30607,22135
360,37,0,2,1,0,0,3,132,117,29116,22955,168,102,30607,22138
361,37,1,3,1,0,0,3,161,125,29117,22958,171,116,30607,22141
362,37,2,1,0,3,1,0,32,23,29119,22959,33,144,30610,22141
363,37,2,0,0,3,1,0,142,109,29121,22959,184,118,30613,22141
364,37,2,1,0,3,1,0,205,204,29123,22960,234,109,30616,22141
365,37,1,0,0,3,1,0,178,143,29124,22960,212,115,30619,22141
366,37,1,1,2,1,2,1,206,170,29125,22961,215,92,30620,22142
367,37,4,2,0,3,1,0,89,72,29129,22963,112,56,30623,22142
368,37,1,4,1,0,0,3,16,22,29130,22967,17,91,30623,22145
369,37,3,2,0,3,1,0,23,26,29133,22969,28,182,30626,22145
370,38,0,0,2,1,2,1,178,132,29133,22969,228,111,30627,22146
371,38,2,4,1,0,0,3,70,73,29135,22973,73,36,30627,22149
372,38,2,0,0,3,1,0,286,226,29137,22973,327,85,30630,22149
373,38,4,1,0,3,1,0,160,136,29141,22974,162,131,30633,22149
374,38,3,1,0,3,1,0,169,127,29144,22975,184,13,30636,22149
375,38,5,0,0,3,1,0,168,99,29149,22975,207,14,30639,22149
376,38,1,0,0,3,1,0,155,145,29150,22975,188,169,30642,22149
377,38,2,0,0,3,1,0,140,120,29152,22975,173,121,30645,22149
378,38,2,5,1,0,0,3,166,126,29154,22980,191,147,30645,22152
379,38,3,3,2,1,2,1,153,133,29157,22983,163,80,30646,22153
0,1,0,0,2,1,2,1,32,23,29157,22983,34,69,30647,22154
1,1,0,0,2,1,2,1,70,71,29157,22983,82,119,30648,22155
2,1,0,0,2,1,2,1,206,170,29157,22983,216,93,30649,22156
3,1,0,0,2,1,2,1,89,72,29157,22983,113,145,30650,22157
4,1,0,1,1,0,0,3,16,18,29157,22984,23,119,30650,22160
5,1,0,0,2,1,2,1,166,126,29157,22984,192,86,30651,22161
6,1,1,3,1,0,0,3,176,148,29158,22987,209,105,30651,22164
7,1,2,0,0,3,1,0,155,133,29160,22987,166,121,30654,22164
8,1,0,0,2,1,2,1,23,26,29160,22987,29,112,30655,22165
9,1,1,1,2,1,2,1,79,87,29161,22988,87,166,30656,22166
10,2,2,1,0,3,1,0,134,118,29163,22989,171,119,30659,22166
11,2,1,2,1,0,0,3,162,127,29164,22991,171,52,30659,22169
12,2,2,1,0,3,1,0,180,133,29166,22992,231,17,30662,22169
13,2,0,0,2,1,2,1,142,109,29166,22992,185,37,30663,22170
14,2,1,1,2,1,2,1,170,128,29167,22993,185,81,30664,22171
15,2,1,0,0,3,1,0,169,99,29168,22993,210,131,30667,22171
16,2,2,2,2,1,2,1,157,147,29170,22995,189,110,30668,22172
17,2,1,0,0,3,1,0,216,169,29171,22995,262,14,30671,22172
18,2,0,0,2,1,2,1,140,120,29171,22995,174,92,30672,22173
19,2,1,0,0,3,1,0,98,89,29172,22995,97,46,30675,22173
20,3,2,0,0,3,1,0,81,87,29174,22995,90,81,30678,22173
21,3,2,4,1,0,0,3,34,27,29176,22999,34,115,30678,22176
22,3,1,2,1,0,0,3,143,111,29177,23001,185,108,30678,22179
23,3,1,1,2,1,2,1,71,72,29178,23002,83,120,30679,22180
24,3,2,0,0,3,1,0,18,18,29180,23002,26,86,30682,22180
25,3,0,3,1,0,0,3,23,29,29180,23005,29,122,30682,22183
26,3,1,3,1,0,0,3,167,129,29181,23008,192,72,30682,22186
27,3,1,0,0,3,1,0,177,148,29182,23008,212,93,30685,22186
28,3,0,0,2,1,2,1,155,133,29182,23008,167,167,30686,22187
29,3,0,2,1,0,0,3,206,172,29182,23010,216,148,30686,22190
30,4,3,1,0,3,1,0,137,119,29185,23011,174,14,30689,22190
31,4,0,1,1,0,0,3,162,128,29185,23012,171,124,30689,22193
32,4,3,2,0,3,1,0,183,135,29188,23014,234,92,30692,22193
33,4,0,1,1,0,0,3,170,129,29188,23015,185,55,30692,22196
34,4,1,3,1,0,0,3,170,102,29189,23018,210,122,30692,22199
35,4,1,4,1,0,0,3,90,76,29190,23022,113,113,30692,22202
36,4,0,0,2,1,2,1,140,120,29190,23022,175,18,30693,22203
37,4,1,1,2,1,2,1,99,90,29191,23023,98,132,30694,22204
38,4,0,1,1,0,0,3,157,148,29191,23024,189,49,30694,22207
39,4,2,1,0,3,1,0,218,170,29193,23025,265,37,30697,22207
40,5,2,2,2,1,2,1,36,29,29195,23027,35,82,30698,22208
41,5,2,1,0,3,1,0,145,112,29197,23028,188,86,30701,22208
42,5,1,1,2,1,2,1,72,73,29198,23029,84,73,30702,22209
43,5,2,3,1,0,0,3,208,175,29200,23032,216,52,30702,22212
44,5,0,0,2,1,2,1,18,18,29200,23032,27,116,30703,22213
45,5,1,1,2,1,2,1,168,130,29201,23033,193,168,30704,22214
46,5,1,1,2,1,2,1,178,149,29202,23034,213,149,30705,22215
47,5,2,0,0,3,1,0,157,133,29204,23034,170,93,30708,22215
48,5,0,0,2,1,2,1,23,29,29204,23034,30,121,30709,22216
49,5,2,2,2,1,2,1,142,122,29206,23036,176,123,30710,22217
50,6,1,2,1,0,0,3,138,121,29207,23038,174,40,30710,22220
51,6,3,1,0,3,1,0,84,88,29210,23039,93,113,30713,22220
52,6,0,0,2,1,2,1,162,128,29210,23039,172,109,30714,22221
53,6,0,2,1,0,0,3,183,137,29210,23041,234,127,30714,22224
54,6,3,1,0,3,1,0,173,130,29213,23042,188,18,30717,22224
55,6,1,1,2,1,2,1,158,149,29214,23043,190,15,30718,22225
56,6,1,3,1,0,0,3,91,79,29215,23046,113,135,30718,22228
57,6,2,0,0,3,1,0,220,170,29217,23046,268,55,30721,22228
58,6,2,2,2,1,2,1,172,104,29219,23048,211,93,30722,22229
59,6,2,0,0,3,1,0,101,90,29221,23048,101,122,30725,22229
60,7,2,1,0,3,1,0,38,30,29223,23049,38,121,30728,22229
61,7,1,1,2,1,2,1,146,113,29224,23050,189,150,30729,22230
62,7,3,1,0,3,1,0,21,19,29227,23051,30,73,30732,22230
63,7,1,0,0,3,1,0,24,29,29228,23051,33,93,30735,22230
64,7,1,1,2,1,2,1,143,123,29229,23052,177,169,30736,22231
65,7,1,3,1,0,0,3,169,133,29230,23055,193,138,30736,22234
66,7,1,1,2,1,2,1,179,150,29231,23056,214,83,30737,22235
67,7,1,1,2,1,2,1,158,134,29232,23057,171,87,30738,22236
68,7,1,0,0,3,1,0,184,137,29233,23057,237,116,30741,22236
69,7,1,1,2,1,2,1,73,74,29234,23058,85,53,30742,22237
70,8,0,0,2,1,2,1,101,90,29234,23058,102,41,30743,22238
71,8,2,0,0,3,1,0,140,121,29236,23058,177,116,30746,22238
72,8,0,0,2,1,2,1,84,88,29236,23058,94,94,30747,22239
73,8,1,1,2,1,2,1,174,131,29237,23059,189,110,30748,22240
74,8,1,1,2,1,2,1,173,105,29238,23060,212,124,30749,22241
75,8,4,2,0,3,1,0,162,151,29242,23062,193,18,30752,22241
76,8,2,2,2,1,2,1,210,177,29244,23064,217,123,30753,22242
77,8,0,0,2,1,2,1,91,79,29244,23064,114,56,30754,22243
78,8,2,1,0,3,1,0,222,171,29246,23065,271,127,30757,22243
79,8,0,2,1,0,0,3,169,135,29246,23067,193,18,30757,22246
80,9,0,1,1,0,0,3,162,129,29246,23068,172,124,30757,22249
81,9,0,0,2,1,2,1,38,30,29246,23068,39,94,30758,22250
82,9,0,0,2,1,2,1,146,113,29246,23068,190,74,30759,22251
83,9,0,2,1,0,0,3,73,76,29246,23070,85,141,30759,22254
84,9,1,2,1,0,0,3,22,21,29247,23072,30,56,30759,22257
85,9,0,1,1,0,0,3,24,30,29247,23073,33,86,30759,22260
86,9,3,1,0,3,1,0,182,151,29250,23074,217,113,30762,22260
87,9,1,0,0,3,1,0,144,123,29251,23074,180,87,30765,22260
88,9,1,2,1,0,0,3,159,136,29252,23076,171,153,30765,22263
89,9,2,1,0,3,1,0,186,138,29254,23077,240,169,30768,22263
90,10,1,1,2,1,2,1,141,122,29255,23078,178,125,30769,22264
91,10,0,1,1,0,0,3,84,89,29255,23079,94,126,30769,22267
92,10,1,1,2,1,2,1,175,132,29256,23080,190,128,30770,22268
93,10,2,0,0,3,1,0,164,151,29258,23080,196,41,30773,22268
94,10,0,0,2,1,2,1,210,177,29258,23080,218,19,30774,22269
95,10,1,0,0,3,1,0,92,79,29259,23080,117,18,30777,22269
96,10,3,0,0,3,1,0,225,171,29262,23080,274,116,30780,22269
97,10,0,3,1,0,0,3,169,138,29262,23083,193,59,30780,22272
98,10,2,4,1,0,0,3,103,94,29264,23087,102,97,30780,22275
99,10,2,1,0,3,1,0,175,106,29266,23088,215,110,30783,22275
100,11,1,0,0,3,1,0,142,122,29267,23088,181,169,30786,22275
101,11,2,0,0,3,1,0,164,129,29269,23088,175,94,30789,22275
102,11,2,4,1,0,0,3,40,34,29271,23092,39,59,30789,22278
103,11,1,3,1,0,0,3,147,116,29272,23095,190,127,30789,22281
104,11,0,0,2,1,2,1,22,21,29272,23095,31,114,30790,22282
105,11,3,3,2,1,2,1,27,33,29275,23098,34,142,30791,22283
106,11,1,0,0,3,1,0,183,151,29276,23098,220,59,30794,22283
107,11,3,1,0,3,1,0,162,137,29279,23099,174,86,30797,22283
108,11,2,1,0,3,1,0,188,139,29281,23100,243,74,30800,22283
109,11,1,0,0,3,1,0,145,123,29282,23100,183,153,30803,22283
110,12,2,0,0,3,1,0,75,76,29284,23100,88,18,30806,22283
111,12,0,1,1,0,0,3,175,133,29284,23101,190,128,30806,22286
112,12,2,0,0,3,1,0,177,106,29286,23101,218,87,30809,22286
113,12,0,0,2,1,2,1,210,177,29286,23101,219,111,30810,22287
114,12,2,1,0,3,1,0,94,80,29288,23102,120,128,30813,22287
115,12,2,1,0,3,1,0,105,95,29290,23103,105,116,30816,22287
116,12,4,1,0,3,1,0,173,139,29294,23104,196,97,30819,22287
117,12,1,0,0,3,1,0,184,151,29295,23104,223,19,30822,22287
118,12,1,1,2,1,2,1,165,152,29296,23105,197,170,30823,22288
119,12,0,0,2,1,2,1,84,89,29296,23105,95,42,30824,22289
120,13,1,3,1,0,0,3,143,125,29297,23108,181,97,30824,22292
121,13,1,0,0,3,1,0,41,34,29298,23108,42,59,30827,22292
122,13,1,1,2,1,2,1,23,22,29299,23109,32,127,30828,22293
123,13,3,1,0,3,1,0,30,34,29302,23110,37,114,30831,22293
124,13,1,0,0,3,1,0,226,171,29303,23110,277,127,30834,22293
125,13,2,3,1,0,0,3,164,140,29305,23113,174,145,30834,22296
126,13,0,4,1,0,0,3,164,133,29305,23117,175,89,30834,22299
127,13,1,0,0,3,1,0,148,116,29306,23117,193,59,30837,22299
128,13,1,2,1,0,0,3,146,125,29307,23119,183,77,30837,22302
129,13,1,2,1,0,0,3,189,141,29308,23121,243,156,30837,22305
130,14,0,0,2,1,2,1,84,89,29308,23121,96,117,30838,22306
131,14,0,0,2,1,2,1,41,34,29308,23121,43,19,30839,22307
132,14,2,1,0,3,1,0,77,77,29310,23122,91,42,30842,22307
133,14,0,2,1,0,0,3,175,135,29310,23124,190,130,30842,22310
134,14,1,1,2,1,2,1,211,178,29311,23125,220,129,30843,22311
135,14,2,0,0,3,1,0,96,80,29313,23125,123,111,30846,22311
136,14,0,1,1,0,0,3,173,140,29313,23126,196,131,30846,22314
137,14,2,0,0,3,1,0,186,151,29315,23126,226,97,30849,22314
138,14,1,2,1,0,0,3,106,97,29316,23128,105,173,30849,22317
139,14,1,1,2,1,2,1,166,153,29317,23129,198,88,30850,22318
140,15,2,0,0,3,1,0,145,125,29319,23129,184,77,30853,22318
141,15,1,1,2,1,2,1,165,134,29320,23130,176,157,30854,22319
142,15,3,1,0,3,1,0,151,117,29323,23131,196,59,30857,22319
143,15,2,1,0,3,1,0,25,23,29325,23132,35,145,30860,22319
144,15,1,2,1,0,0,3,31,36,29326,23134,37,130,30860,22322
145,15,0,2,1,0,0,3,226,173,29326,23136,277,100,30860,22325
146,15,2,1,0,3,1,0,148,126,29328,23137,186,114,30863,22325
147,15,3,3,2,1,2,1,167,143,29331,23140,175,20,30864,22326
148,15,0,0,2,1,2,1,177,106,29331,23140,219,60,30865,22327
149,15,2,3,1,0,0,3,191,144,29333,23143,243,92,30865,22330
150,16,4,1,0,3,1,0,45,35,29337,23144,46,42,30868,22330
151,16,0,1,1,0,0,3,77,78,29337,23145,91,114,30868,22333
152,16,1,0,0,3,1,0,167,153,29338,23145,201,130,30871,22333
153,16,3,0,0,3,1,0,214,178,29341,23145,223,173,30874,22333
154,16,1,1,2,1,2,1,97,81,29342,23146,124,89,30875,22334
155,16,0,2,1,0,0,3,25,25,29342,23148,35,100,30875,22337
156,16,1,0,0,3,1,0,107,97,29343,23148,108,100,30878,22337
157,16,1,0,0,3,1,0,187,151,29344,23148,229,129,30881,22337
158,16,2,1,0,3,1,0,175,141,29346,23149,199,117,30884,22337
159,16,3,0,0,3,1,0,87,89,29349,23149,99,131,30887,22337
160,17,1,0,0,3,1,0,227,173,29350,23149,280,92,30890,22337
161,17,1,1,2,1,2,1,146,126,29351,23150,185,61,30891,22338
162,17,2,0,0,3,1,0,167,134,29353,23150,179,145,30894,22338
163,17,2,1,0,3,1,0,193,145,29355,23151,246,130,30897,22338
164,17,0,0,2,1,2,1,151,117,29355,23151,197,115,30898,22339
165,17,0,1,1,0,0,3,175,136,29355,23152,190,160,30898,22342
166,17,0,1,1,0,0,3,177,107,29355,23153,219,80,30898,22345
167,17,1,0,0,3,1,0,32,36,29356,23153,40,19,30901,22345
168,17,1,1,2,1,2,1,149,127,29357,23154,187,21,30902,22346
169,17,0,0,2,1,2,1,167,143,29357,23154,176,60,30903,22347
170,18,0,1,1,0,0,3,87,90,29357,23155,99,117,30903,22350
171,18,1,1,2,1,2,1,46,36,29358,23156,47,130,30904,22351
172,18,4,1,0,3,1,0,81,79,29362,23157,94,89,30907,22351
173,18,1,2,1,0,0,3,215,180,29363,23159,223,134,30907,22354
174,18,1,1,2,1,2,1,98,82,29364,23160,125,131,30908,22355
175,18,2,2,2,1,2,1,34,38,29366,23162,41,101,30909,22356
176,18,1,1,2,1,2,1,176,142,29367,23163,200,101,30910,22357
177,18,1,1,2,1,2,1,188,152,29368,23164,230,118,30911,22358
178,18,3,1,0,3,1,0,110,98,29371,23165,111,160,30914,22358
179,18,2,2,2,1,2,1,27,27,29373,23167,36,174,30915,22359
180,19,1,2,1,0,0,3,147,128,29374,23169,185,148,30915,22362
181,19,1,1,2,1,2,1,168,135,29375,23170,180,102,30916,22363
182,19,0,0,2,1,2,1,193,145,29375,23170,247,22,30917,22364
183,19,3,0,0,3,1,0,154,117,29378,23170,200,19,30920,22364
184,19,2,2,2,1,2,1,177,138,29380,23172,191,62,30921,22365
185,19,0,2,1,0,0,3,177,109,29380,23174,219,118,30921,22368
186,19,2,0,0,3,1,0,151,127,29382,23174,190,42,30924,22368
187,19,3,0,0,3,1,0,113,98,29385,23174,114,92,30927,22368
188,19,2,1,0,3,1,0,169,154,29387,23175,204,60,30930,22368
189,19,2,0,0,3,1,0,229,173,29389,23175,283,130,30933,22368
190,20,1,0,0,3,1,0,47,36,29390,23175,50,174,30936,22368
191,20,2,0,0,3,1,0,83,79,29392,23175,97,118,30939,22368
192,20,0,0,2,1,2,1,215,180,29392,23175,224,132,30940,22369
193,20,2,2,2,1,2,1,100,84,29394,23177,126,102,30941,22370
194,20,0,1,1,0,0,3,27,28,29394,23178,36,137,30941,22373
195,20,1,3,1,0,0,3,35,41,29395,23181,41,133,30941,22376
196,20,2,3,1,0,0,3,178,145,29397,23184,200,163,30941,22379
197,20,1,2,1,0,0,3,189,154,29398,23186,230,92,30941,22382
198,20,4,3,0,3,1,0,91,93,29402,23189,102,80,30944,22382
199,20,2,1,0,3,1,0,169,144,29404,23190,179,117,30947,22382
200,21,1,0,0,3,1,0,148,128,29405,23190,188,19,30950,22382
201,21,0,2,1,0,0,3,168,137,29405,23192,180,25,30950,22385
202,21,1,0,0,3,1,0,178,138,29406,23192,194,130,30953,22385
203,21,1,2,1,0,0,3,178,111,29407,23194,219,63,30953,22388
204,21,2,1,0,3,1,0,102,85,29409,23195,129,62,30956,22388
205,21,0,0,2,1,2,1,229,173,29409,23195,284,103,30957,22389
206,21,3,3,2,1,2,1,154,130,29412,23198,191,134,30958,22390
207,21,1,3,1,0,0,3,170,157,29413,23201,204,151,30958,22393
208,21,0,1,1,0,0,3,193,146,29413,23202,247,45,30958,22396
209,21,4,2,0,3,1,0,117,100,29417,23204,117,118,30961,22396
210,22,3,2,0,3,1,0,50,38,29420,23206,53,92,30964,22396
211,22,0,1,1,0,0,3,154,118,29420,23207,200,121,30964,22399
212,22,1,1,2,1,2,1,84,80,29421,23208,98,103,30965,22400
213,22,2,2,2,1,2,1,217,182,29423,23210,225,81,30966,22401
214,22,1,0,0,3,1,0,28,28,29424,23210,39,117,30969,22401
215,22,0,0,2,1,2,1,178,145,29424,23210,201,93,30970,22402
216,22,2,1,0,3,1,0,191,155,29426,23211,233,132,30973,22402
217,22,0,1,1,0,0,3,169,145,29426,23212,179,140,30973,22405
218,22,2,1,0,3,1,0,93,94,29428,23213,105,163,30976,22405
219,22,0,1,1,0,0,3,35,42,29428,23214,41,177,30976,22408
220,23,2,1,0,3,1,0,150,129,29430,23215,191,134,30979,22408
221,23,1,2,1,0,0,3,94,96,29431,23217,105,154,30979,22411
222,23,0,0,2,1,2,1,178,138,29431,23217,195,104,30980,22412
223,23,1,1,2,1,2,1,179,112,29432,23218,220,46,30981,22413
224,23,0,0,2,1,2,1,170,157,29432,23218,205,131,30982,22414
225,23,3,2,0,3,1,0,105,87,29435,23220,132,25,30985,22414
226,23,1,1,2,1,2,1,230,174,29436,23221,285,119,30986,22415
227,23,2,0,0,3,1,0,119,100,29438,23221,120,63,30989,22415
228,23,0,2,1,0,0,3,168,139,29438,23223,180,22,30989,22418
229,23,2,0,0,3,1,0,195,146,29440,23223,250,117,30992,22418
230,24,2,0,0,3,1,0,37,42,29442,23223,44,92,30995,22418
231,24,0,0,2,1,2,1,169,145,29442,23223,180,133,30996,22419
232,24,0,0,2,1,2,1,50,38,29442,23223,54,164,30997,22420
233,24,1,1,2,1,2,1,155,119,29443,23224,201,141,30998,22421
234,24,1,1,2,1,2,1,85,81,29444,23225,99,178,30999,22422
235,24,3,0,0,3,1,0,220,182,29447,23225,228,93,31002,22422
236,24,2,1,0,3,1,0,30,29,29449,23226,42,103,31005,22422
237,24,0,1,1,0,0,3,154,131,29449,23227,191,124,31005,22425
238,24,0,3,1,0,0,3,178,148,29449,23230,201,65,31005,22428
239,24,4,0,0,3,1,0,195,155,29453,23230,236,81,31008,22428
240,25,3,2,0,3,1,0,153,131,29456,23232,194,104,31011,22428
241,25,4,0,0,3,1,0,98,96,29460,23232,108,63,31014,22428
242,25,3,1,0,3,1,0,171,140,29463,23233,183,141,31017,22428
243,25,1,1,2,1,2,1,179,139,29464,23234,196,47,31018,22429
244,25,3,0,0,3,1,0,182,112,29467,23234,223,25,31021,22429
245,25,1,1,2,1,2,1,221,183,29468,23235,229,120,31022,22430
246,25,3,2,0,3,1,0,108,89,29471,23237,135,131,31025,22430
247,25,0,1,1,0,0,3,230,175,29471,23238,285,120,31025,22433
248,25,3,2,0,3,1,0,122,102,29474,23240,123,22,31028,22433
249,25,3,1,0,3,1,0,173,158,29477,23241,208,134,31031,22433
250,26,1,0,0,3,1,0,172,140,29478,23241,186,92,31034,22433
251,26,3,2,0,3,1,0,53,40,29481,23243,57,120,31037,22433
252,26,0,1,1,0,0,3,155,120,29481,23244,201,181,31037,22436
253,26,1,0,0,3,1,0,86,81,29482,23244,102,93,31040,22436
254,26,1,1,2,1,2,1,38,43,29483,23245,45,82,31041,22437
255,26,1,1,2,1,2,1,155,132,29484,23246,192,104,31042,22438
256,26,0,0,2,1,2,1,195,155,29484,23246,237,155,31043,22439
257,26,1,1,2,1,2,1,170,146,29485,23247,181,66,31044,22440
258,26,2,0,0,3,1,0,197,146,29487,23247,253,133,31047,22440
259,26,2,1,0,3,1,0,32,30,29489,23248,45,164,31050,22440
260,27,0,0,2,1,2,1,153,131,29489,23248,195,121,31051,22441
261,27,0,2,1,0,0,3,98,98,29489,23250,108,25,31051,22444
262,27,2,4,1,0,0,3,181,143,29491,23254,196,28,31051,22447
263,27,1,0,0,3,1,0,183,112,29492,23254,226,124,31054,22447
264,27,1,1,2,1,2,1,222,184,29493,23255,230,64,31055,22448
265,27,2,3,1,0,0,3,110,92,29495,23258,135,50,31055,22451
266,27,0,2,1,0,0,3,122,104,29495,23260,123,137,31055,22454
267,27,0,0,2,1,2,1,178,148,29495,23260,202,132,31056,22455
268,27,2,0,0,3,1,0,175,158,29497,23260,211,104,31059,22455
269,27,1,1,2,1,2,1,231,176,29498,23261,286,142,31060,22456
270,28,1,2,1,0,0,3,173,142,29499,23263,186,184,31060,22459
271,28,0,1,1,0,0,3,53,41,29499,23264,57,158,31060,22462
272,28,1,2,1,0,0,3,198,148,29500,23266,253,95,31060,22465
273,28,1,1,2,1,2,1,156,121,29501,23267,202,105,31061,22466
274,28,2,2,2,1,2,1,88,83,29503,23269,103,121,31062,22467
275,28,2,3,1,0,0,3,40,46,29505,23272,45,167,31062,22470
276,28,0,1,1,0,0,3,155,133,29505,23273,192,136,31062,22473
277,28,1,1,2,1,2,1,33,31,29506,23274,46,94,31063,22474
278,28,4,0,0,3,1,0,199,155,29510,23274,240,66,31066,22474
279,28,2,1,0,3,1,0,172,147,29512,23275,184,82,31069,22474
280,29,2,1,0,3,1,0,100,99,29514,23276,111,28,31072,22474
281,29,3,1,0,3,1,0,91,84,29517,23277,106,132,31075,22474
282,29,0,0,2,1,2,1,181,143,29517,23277,197,125,31076,22475
283,29,0,1,1,0,0,3,183,113,29517,23278,226,140,31076,22478
284,29,2,0,0,3,1,0,224,184,29519,23278,233,50,31079,22478
285,29,2,1,0,3,1,0,112,93,29521,23279,138,104,31082,22478
286,29,3,0,0,3,1,0,234,176,29524,23279,289,95,31085,22478
287,29,3,1,0,3,1,0,181,149,29527,23280,205,25,31088,22478
288,29,4,1,0,3,1,0,126,105,29531,23281,126,142,31091,22478
289,29,2,1,0,3,1,0,177,159,29533,23282,214,121,31094,22478
290,30,0,0,2,1,2,1,153,131,29533,23282,196,137,31095,22479
291,30,2,4,1,0,0,3,55,45,29535,23286,57,135,31095,22482
292,30,3,0,0,3,1,0,201,148,29538,23286,256,105,31098,22482
293,30,0,1,1,0,0,3,156,122,29538,23287,202,97,31098,22485
294,30,1,1,2,1,2,1,34,32,29539,23288,47,65,31099,22486
295,30,0,1,1,0,0,3,40,47,29539,23289,45,69,31099,22489
296,30,2,1,0,3,1,0,157,134,29541,23290,195,158,31102,22489
297,30,0,4,1,0,0,3,172,151,29541,23294,184,124,31102,22492
298,30,0,2,1,0,0,3,234,178,29541,23296,289,170,31102,22495
299,30,0,2,1,0,0,3,173,144,29541,23298,186,85,31102,22498
300,31,0,1,1,0,0,3,100,100,29541,23299,111,143,31102,22501
301,31,2,3,1,0,0,3,93,87,29543,23302,106,31,31102,22504
302,31,1,1,2,1,2,1,182,144,29544,23303,198,96,31103,22505
303,31,1,1,2,1,2,1,184,114,29545,23304,227,185,31104,22506
304,31,1,0,0,3,1,0,225,184,29546,23304,236,104,31107,22506
305,31,1,0,0,3,1,0,113,93,29547,23304,141,125,31110,22506
306,31,3,1,0,3,1,0,184,150,29550,23305,208,50,31113,22506
307,31,4,2,0,3,1,0,203,157,29554,23307,243,25,31116,22506
308,31,0,2,1,0,0,3,177,161,29554,23309,214,145,31116,22509
309,31,2,0,0,3,1,0,128,105,29556,23309,129,121,31119,22509
310,32,1,0,0,3,1,0,174,144,29557,23309,189,69,31122,22509
311,32,1,1,2,1,2,1,202,149,29558,23310,257,125,31123,22510
312,32,2,3,1,0,0,3,158,125,29560,23313,202,161,31123,22513
313,32,2,0,0,3,1,0,186,114,29562,23313,230,105,31126,22513
314,32,1,0,0,3,1,0,35,32,29563,23313,50,31,31129,22513
315,32,2,2,2,1,2,1,159,136,29565,23315,196,98,31130,22514
316,32,2,0,0,3,1,0,174,151,29567,23315,187,135,31133,22514
317,32,0,3,1,0,0,3,40,50,29567,23318,45,68,31133,22517
318,32,1,1,2,1,2,1,235,179,29568,23319,290,86,31134,22518
319,32,3,6,1,0,0,3,156,137,29571,23325,196,173,31134,22521
320,33,2,0,0,3,1,0,102,100,29573,23325,114,137,31137,22521
321,33,0,2,1,0,0,3,55,47,29573,23327,57,107,31137,22524
322,33,4,4,2,1,2,1,97,91,29577,23331,107,144,31138,22525
323,33,5,2,0,3,1,0,187,146,29582,23333,201,185,31141,22525
324,33,2,0,0,3,1,0,227,184,29584,23333,239,25,31144,22525
325,33,0,3,1,0,0,3,113,96,29584,23336,141,148,31144,22528
326,33,3,1,0,3,1,0,187,151,29587,23337,211,121,31147,22528
327,33,3,2,0,3,1,0,206,159,29590,23339,246,50,31150,22528
328,33,0,1,1,0,0,3,177,162,29590,23340,214,128,31150,22531
329,33,4,2,0,3,1,0,132,107,29594,23342,132,96,31153,22531
330,34,3,1,0,3,1,0,159,138,29597,23343,199,98,31156,22531
331,34,1,1,2,1,2,1,175,145,29598,23344,190,126,31157,22532
332,34,1,1,2,1,2,1,159,126,29599,23345,203,136,31158,22533
333,34,1,2,1,0,0,3,188,148,29600,23347,201,89,31158,22536
334,34,4,1,0,3,1,0,44,51,29604,23348,48,31,31161,22536
335,34,1,1,2,1,2,1,236,180,29605,23349,291,162,31162,22537
336,34,1,2,1,0,0,3,160,138,29606,23351,196,71,31162,22540
337,34,4,0,0,3,1,0,178,151,29610,23351,190,25,31165,22540
338,34,2,3,1,0,0,3,204,152,29612,23354,257,72,31165,22543
339,34,1,0,0,3,1,0,187,114,29613,23354,233,173,31168,22543
340,35,2,1,0,3,1,0,104,101,29615,23355,117,96,31171,22543
341,35,0,1,1,0,0,3,55,48,29615,23356,57,124,31171,22546
342,35,1,0,0,3,1,0,98,91,29616,23356,110,107,31174,22546
343,35,0,1,1,0,0,3,227,185,29616,23357,239,131,31174,22549
344,35,0,3,1,0,0,3,113,99,29616,23360,141,188,31174,22552
345,35,4,0,0,3,1,0,39,32,29620,23360,53,50,31177,22552
346,35,2,0,0,3,1,0,134,107,29622,23360,135,137,31180,22552
347,35,3,0,0,3,1,0,190,151,29625,23360,214,144,31183,22552
348,35,1,0,0,3,1,0,207,159,29626,23360,249,148,31186,22552
349,35,2,0,0,3,1,0,179,162,29628,23360,217,105,31189,22552
350,36,2,3,1,0,0,3,177,148,29630,23363,190,139,31189,22555
351,36,2,3,1,0,0,3,161,129,29632,23366,203,34,31189,22558
352,36,1,3,1,0,0,3,189,151,29633,23369,201,129,31189,22561
353,36,0,0,2,1,2,1,187,114,29633,23369,234,99,31190,22562
354,36,0,2,1,0,0,3,236,182,29633,23371,291,28,31190,22565
355,36,1,2,1,0,0,3,161,140,29634,23373,196,75,31190,22568
356,36,0,0,2,1,2,1,178,151,29634,23373,191,51,31191,22569
357,36,2,3,1,0,0,3,206,155,29636,23376,257,165,31191,22572
358,36,1,0,0,3,1,0,160,138,29637,23376,202,71,31194,22572
359,36,1,1,2,1,2,1,180,163,29638,23377,218,90,31195,22573
360,37,3,0,0,3,1,0,107,101,29641,23377,120,105,31198,22573
361,37,1,2,1,0,0,3,56,50,29642,23379,57,151,31198,22576
362,37,0,4,1,0,0,3,98,95,29642,23383,110,176,31198,22579
363,37,3,1,0,3,1,0,230,186,29645,23384,242,96,31201,22579
364,37,2,2,2,1,2,1,115,101,29647,23386,142,91,31202,22580
365,37,2,2,2,1,2,1,41,34,29649,23388,54,145,31203,22581
366,37,1,1,2,1,2,1,45,52,29650,23389,49,125,31204,22582
367,37,0,4,1,0,0,3,190,155,29650,23393,214,140,31204,22585
368,37,2,0,0,3,1,0,209,159,29652,23393,252,188,31207,22585
369,37,0,0,2,1,2,1,178,151,29652,23393,192,132,31208,22586
370,38,3,2,0,3,1,0,163,140,29655,23395,205,129,31211,22586
371,38,1,0,0,3,1,0,178,148,29656,23395,193,51,31214,22586
372,38,6,2,0,3,1,0,212,157,29662,23397,260,71,31217,22586
373,38,1,0,0,3,1,0,162,129,29663,23397,206,107,31220,22586
374,38,1,2,1,0,0,3,190,153,29664,23399,201,168,31220,22589
375,38,4,1,0,3,1,0,191,115,29668,23400,237,28,31223,22589
376,38,3,1,0,3,1,0,183,164,29671,23401,221,99,31226,22589
377,38,1,2,1,0,0,3,237,184,29672,23403,291,78,31226,22592
378,38,2,3,1,0,0,3,163,143,29674,23406,196,142,31226,22595
379,38,2,1,0,3,1,0,136,108,29676,23407,138,34,31229,22595
0,1,0,0,2,1,2,1,16,22,29676,23407,18,146,31230,22596
1,1,2,3,1,0,0,3,214,160,29678,23410,260,65,31230,22599
2,1,0,1,1,0,0,3,230,187,29678,23411,242,191,31230,22602
3,1,0,0,2,1,2,1,115,101,29678,23411,143,97,31231,22603
4,1,3,1,0,3,1,0,44,35,29681,23412,57,147,31234,22603
5,1,2,0,0,3,1,0,165,143,29683,23412,199,34,31237,22603
6,1,0,3,1,0,0,3,190,158,29683,23415,214,143,31237,22606
7,1,1,1,2,1,2,1,179,152,29684,23416,193,72,31238,22607
8,1,1,1,2,1,2,1,206,172,29685,23417,229,1,31239,22608
9,1,1,0,0,3,1,0,179,148,29686,23417,196,176,31242,22608
10,2,2,1,0,3,1,0,165,141,29688,23418,208,151,31245,22608
11,2,1,2,1,0,0,3,57,52,29689,23420,57,16,31245,22611
12,2,0,1,1,0,0,3,124,110,29689,23421,147,110,31245,22614
13,2,2,0,0,3,1,0,164,129,29691,23421,209,129,31248,22614
14,2,0,0,2,1,2,1,98,95,29691,23421,111,120,31249,22615
15,2,4,1,0,3,1,0,195,116,29695,23422,240,132,31252,22615
16,2,1,2,1,0,0,3,184,166,29696,23424,221,171,31252,22618
17,2,0,0,2,1,2,1,178,143,29696,23424,213,100,31253,22619
18,2,1,1,2,1,2,1,1,1,29697,23425,1,126,31254,22620
19,2,2,0,0,3,1,0,239,184,29699,23425,294,28,31257,22620
20,3,0,3,1,0,0,3,16,25,29699,23428,18,146,31257,22623
21,3,0,0,2,1,2,1,214,160,29699,23428,261,73,31258,22624
22,3,2,0,0,3,1,0,117,101,29701,23428,146,132,31261,22624
23,3,0,0,2,1,2,1,44,35,29701,23428,58,98,31262,22625
24,3,1,4,1,0,0,3,2,5,29702,23432,1,37,31262,22628
25,3,0,1,1,0,0,3,190,159,29702,23433,214,194,31262,22631
26,3,0,0,2,1,2,1,179,152,29702,23433,194,147,31263,22632
27,3,3,2,0,3,1,0,168,145,29705,23435,202,176,31266,22632
28,3,3,0,0,3,1,0,209,172,29708,23435,232,65,31269,22632
29,3,0,0,2,1,2,1,230,187,29708,23435,243,148,31270,22633
30,4,2,0,0,3,1,0,167,141,29710,23435,211,16,31273,22633
31,4,1,3,1,0,0,3,180,151,29711,23438,196,31,31273,22636
32,4,0,2,1,0,0,3,164,131,29711,23440,209,123,31273,22639
33,4,1,0,0,3,1,0,99,95,29712,23440,114,1,31276,22639
34,4,1,0,0,3,1,0,196,116,29713,23440,243,110,31279,22639
35,4,2,2,2,1,2,1,180,145,29715,23442,214,127,31280,22640
36,4,2,1,0,3,1,0,119,102,29717,23443,149,129,31283,22640
37,4,3,0,0,3,1,0,242,184,29720,23443,297,37,31286,22640
38,4,2,4,1,0,0,3,186,170,29722,23447,221,154,31286,22643
39,4,1,0,0,3,1,0,125,110,29723,23447,150,171,31289,22643
40,5,2,1,0,3,1,0,18,26,29725,23448,21,132,31292,22643
41,5,2,0,0,3,1,0,59,52,29727,23448,60,73,31295,22643
42,5,2,1,0,3,1,0,216,161,29729,23449,264,148,31298,22643
43,5,1,0,0,3,1,0,231,187,29730,23449,246,146,31301,22643
44,5,0,2,1,0,0,3,2,7,29730,23451,1,150,31301,22646
45,5,1,5,1,0,0,3,169,150,29731,23456,202,68,31301,22649
46,5,1,3,1,0,0,3,191,162,29732,23459,214,101,31301,22652
47,5,4,1,0,3,1,0,183,153,29736,23460,197,100,31304,22652
48,5,2,1,0,3,1,0,211,173,29738,23461,235,194,31307,22652
49,5,2,0,0,3,1,0,46,35,29740,23461,61,176,31310,22652
50,6,1,4,1,0,0,3,168,145,29741,23465,211,174,31310,22655
51,6,1,1,2,1,2,1,181,152,29742,23466,197,130,31311,22656
52,6,3,2,0,3,1,0,128,112,29745,23468,153,1,31314,22656
53,6,4,1,0,3,1,0,168,132,29749,23469,212,37,31317,22656
54,6,0,1,1,0,0,3,99,96,29749,23470,114,130,31317,22659
55,6,1,1,2,1,2,1,197,117,29750,23471,244,32,31318,22660
56,6,3,0,0,3,1,0,183,145,29753,23471,217,110,31321,22660
57,6,0,2,1,0,0,3,119,104,29753,23473,149,19,31321,22663
58,6,2,3,1,0,0,3,188,173,29755,23476,221,126,31321,22666
59,6,0,1,1,0,0,3,242,185,29755,23477,297,157,31321,22669
60,7,2,0,0,3,1,0,20,26,29757,23477,24,130,31324,22669
61,7,3,0,0,3,1,0,62,52,29760,23477,63,68,31327,22669
62,7,1,0,0,3,1,0,217,161,29761,23477,267,146,31330,22669
63,7,2,1,0,3,1,0,101,97,29763,23478,117,150,31333,22669
64,7,2,0,0,3,1,0,213,173,29765,23478,238,101,31336,22669
65,7,3,0,0,3,1,0,234,187,29768,23478,249,132,31339,22669
66,7,3,1,0,3,1,0,49,36,29771,23479,64,100,31342,22669
67,7,2,0,0,3,1,0,4,7,29773,23479,4,148,31345,22669
68,7,1,0,0,3,1,0,184,153,29774,23479,200,176,31348,22669
69,7,2,4,1,0,0,3,171,154,29776,23483,202,197,31348,22672
70,8,2,0,0,3,1,0,190,173,29778,23483,224,1,31351,22672
71,8,3,0,0,3,1,0,171,145,29781,23483,214,110,31354,22672
72,8,1,0,0,3,1,0,182,152,29782,23483,200,126,31357,22672
73,8,1,0,0,3,1,0,21,26,29783,23483,27,32,31360,22672
74,8,0,2,1,0,0,3,128,114,29783,23485,153,153,31360,22675
75,8,1,0,0,3,1,0,198,117,29784,23485,247,130,31363,22675
76,8,2,1,0,3,1,0,185,146,29786,23486,220,37,31366,22675
77,8,0,2,1,0,0,3,119,106,29786,23488,149,160,31366,22678
78,8,5,0,0,3,1,0,247,185,29791,23488,300,73,31369,22678
79,8,0,4,1,0,0,3,191,166,29791,23492,214,177,31369,22681
80,9,2,1,0,3,1,0,64,53,29793,23493,66,146,31372,22681
81,9,1,1,2,1,2,1,218,162,29794,23494,268,20,31373,22682
82,9,2,1,0,3,1,0,103,98,29796,23495,120,68,31376,22682
83,9,1,5,1,0,0,3,235,192,29797,23500,249,103,31376,22685
84,9,1,1,2,1,2,1,50,37,29798,23501,65,131,31377,22686
85,9,1,2,1,0,0,3,5,9,29799,23503,4,200,31377,22689
86,9,1,6,1,0,0,3,172,160,29800,23509,202,104,31377,22692
87,9,0,2,1,0,0,3,184,155,29800,23511,200,135,31377,22695
88,9,0,0,2,1,2,1,213,173,29800,23511,239,149,31378,22696
89,9,1,0,0,3,1,0,169,132,29801,23511,215,176,31381,22696
90,10,2,0,0,3,1,0,173,145,29803,23511,217,37,31384,22696
91,10,2,0,0,3,1,0,184,152,29805,23511,203,130,31387,22696
92,10,2,1,0,3,1,0,23,27,29807,23512,30,177,31390,22696
93,10,2,0,0,3,1,0,192,173,29809,23512,227,73,31393,22696
94,10,4,1,0,3,1,0,189,147,29813,23513,223,68,31396,22696
95,10,2,1,0,3,1,0,121,107,29815,23514,152,1,31399,22696
96,10,3,4,1,0,0,3,53,41,29818,23518,65,113,31399,22699
97,10,1,2,1,0,0,3,192,168,29819,23520,214,163,31399,22702
98,10,1,0,0,3,1,0,248,185,29820,23520,303,153,31402,22702
99,10,3,2,0,3,1,0,201,119,29823,23522,250,126,31405,22702
100,11,0,6,1,0,0,3,64,59,29823,23528,66,179,31405,22705
101,11,1,1,2,1,2,1,219,163,29824,23529,269,136,31406,22706
102,11,3,1,0,3,1,0,131,115,29827,23530,156,200,31409,22706
103,11,2,1,0,3,1,0,105,99,29829,23531,123,149,31412,22706
104,11,4,1,0,3,1,0,239,193,29833,23532,252,32,31415,22706
105,11,0,1,1,0,0,3,5,10,29833,23533,4,107,31415,22709
106,11,1,0,0,3,1,0,173,160,29834,23533,205,20,31418,22709
107,11,2,0,0,3,1,0,186,155,29836,23533,203,131,31421,22709
108,11,3,0,0,3,1,0,172,132,29839,23533,218,146,31424,22709
109,11,0,0,2,1,2,1,213,173,29839,23533,240,104,31425,22710
110,12,2,1,0,3,1,0,186,153,29841,23534,206,1,31428,22710
111,12,3,2,0,3,1,0,26,29,29844,23536,33,113,31431,22710
112,12,1,1,2,1,2,1,202,120,29845,23537,251,69,31432,22711
113,12,2,2,2,1,2,1,191,149,29847,23539,224,154,31433,22712
114,12,4,0,0,3,1,0,243,193,29851,23539,255,163,31436,22712
115,12,2,0,0,3,1,0,123,107,29853,23539,155,37,31439,22712
116,12,1,2,1,0,0,3,54,43,29854,23541,65,129,31439,22715
117,12,0,1,1,0,0,3,192,169,29854,23542,214,133,31439,22718
118,12,0,1,1,0,0,3,192,174,29854,23543,227,203,31439,22721
119,12,2,0,0,3,1,0,175,145,29856,23543,220,73,31442,22721
120,13,1,1,2,1,2,1,65,60,29857,23544,67,137,31443,22722
121,13,0,1,1,0,0,3,219,164,29857,23545,269,35,31443,22725
122,13,0,0,2,1,2,1,105,99,29857,23545,124,21,31444,22726
123,13,0,2,1,0,0,3,5,12,29857,23547,4,149,31444,22729
124,13,2,1,0,3,1,0,175,161,29859,23548,208,104,31447,22729
125,13,1,1,2,1,2,1,173,133,29860,23549,219,108,31448,22730
126,13,2,0,0,3,1,0,215,173,29862,23549,243,131,31451,22730
127,13,3,0,0,3,1,0,251,185,29865,23549,306,149,31454,22730
128,13,1,2,1,0,0,3,187,157,29866,23551,203,180,31454,22733
129,13,0,0,2,1,2,1,131,115,29866,23551,157,180,31455,22734
130,14,1,2,1,0,0,3,176,147,29867,23553,220,72,31455,22737
131,14,0,1,1,0,0,3,186,154,29867,23554,206,76,31455,22740
132,14,1,1,2,1,2,1,27,30,29868,23555,34,130,31456,22741
133,14,4,1,0,3,1,0,247,194,29872,23556,258,1,31459,22741
134,14,1,1,2,1,2,1,124,108,29873,23557,156,155,31460,22742
135,14,3,3,2,1,2,1,57,46,29876,23560,66,134,31461,22743
136,14,3,2,0,3,1,0,195,171,29879,23562,217,37,31464,22743
137,14,0,0,2,1,2,1,187,157,29879,23562,204,164,31465,22744
138,14,1,1,2,1,2,1,192,150,29880,23563,225,181,31466,22745
139,14,0,0,2,1,2,1,202,120,29880,23563,252,204,31467,22746
140,15,1,3,1,0,0,3,66,63,29881,23566,67,116,31467,22749
141,15,1,0,0,3,1,0,132,115,29882,23566,160,131,31470,22749
142,15,1,0,0,3,1,0,174,133,29883,23566,222,137,31473,22749
143,15,1,1,2,1,2,1,106,100,29884,23567,125,150,31474,22750
144,15,2,2,2,1,2,1,194,152,29886,23569,226,109,31475,22751
145,15,1,0,0,3,1,0,6,12,29887,23569,7,35,31478,22751
146,15,1,1,2,1,2,1,252,186,29888,23570,307,22,31479,22752
147,15,2,1,0,3,1,0,177,162,29890,23571,211,180,31482,22752
148,15,4,2,0,3,1,0,219,175,29894,23573,246,164,31485,22752
149,15,3,1,0,3,1,0,195,175,29897,23574,230,104,31488,22752
150,16,0,1,1,0,0,3,176,148,29897,23575,220,207,31488,22755
151,16,1,1,2,1,2,1,187,155,29898,23576,207,150,31489,22756
152,16,2,0,0,3,1,0,29,30,29900,23576,37,1,31492,22756
153,16,1,0,0,3,1,0,220,164,29901,23576,272,134,31495,22756
154,16,4,0,0,3,1,0,251,194,29905,23576,261,37,31498,22756
155,16,2,1,0,3,1,0,126,109,29907,23577,159,72,31501,22756
156,16,1,2,1,0,0,3,58,48,29908,23579,66,158,31501,22759
157,16,1,2,1,0,0,3,196,173,29909,23581,217,79,31501,22762
158,16,4,2,0,3,1,0,191,159,29913,23583,207,130,31504,22762
159,16,1,0,0,3,1,0,203,120,29914,23583,255,181,31507,22762
160,17,2,0,0,3,1,0,254,186,29916,23583,310,137,31510,22762
161,17,4,0,0,3,1,0,70,63,29920,23583,70,35,31513,22762
162,17,0,0,2,1,2,1,132,115,29920,23583,161,23,31514,22763
163,17,1,2,1,0,0,3,175,135,29921,23585,222,167,31514,22766
164,17,0,2,1,0,0,3,106,102,29921,23587,125,107,31514,22769
165,17,2,0,0,3,1,0,197,175,29923,23587,233,109,31517,22769
166,17,1,2,1,0,0,3,220,177,29924,23589,246,183,31517,22772
167,17,0,3,1,0,0,3,194,155,29924,23592,226,153,31517,22775
168,17,4,0,0,3,1,0,10,12,29928,23592,10,131,31520,22775
169,17,3,1,0,3,1,0,180,163,29931,23593,214,116,31523,22775
170,18,1,2,1,0,0,3,188,157,29932,23595,207,75,31523,22778
171,18,2,2,2,1,2,1,31,32,29934,23597,38,182,31524,22779
172,18,3,0,0,3,1,0,223,164,29937,23597,275,37,31527,22779
173,18,2,1,0,3,1,0,222,178,29939,23598,249,134,31530,22779
174,18,1,2,1,0,0,3,127,111,29940,23600,159,210,31530,22782
175,18,1,2,1,0,0,3,197,175,29941,23602,217,153,31530,22785
176,18,1,1,2,1,2,1,192,160,29942,23603,208,2,31531,22786
177,18,1,0,0,3,1,0,177,148,29943,23603,223,153,31534,22786
178,18,3,1,0,3,1,0,254,195,29946,23604,264,158,31537,22786
179,18,2,0,0,3,1,0,60,48,29948,23604,69,79,31540,22786
180,19,3,1,0,3,1,0,180,149,29951,23605,226,137,31543,22786
181,19,2,2,2,1,2,1,72,65,29953,23607,71,131,31544,22787
182,19,0,0,2,1,2,1,132,115,29953,23607,162,36,31545,22788
183,19,0,2,1,0,0,3,175,137,29953,23609,222,137,31545,22791
184,19,2,1,0,3,1,0,205,121,29955,23610,258,107,31548,22791
185,19,0,1,1,0,0,3,194,156,29955,23611,226,26,31548,22794
186,19,1,4,1,0,0,3,11,16,29956,23615,10,170,31548,22797
187,19,5,1,0,3,1,0,259,187,29961,23616,313,116,31551,22797
188,19,2,0,0,3,1,0,199,175,29963,23616,236,131,31554,22797
189,19,2,0,0,3,1,0,108,102,29965,23616,128,183,31557,22797
190,20,1,1,2,1,2,1,189,158,29966,23617,208,154,31558,22798
191,20,2,0,0,3,1,0,33,32,29968,23617,41,37,31561,22798
192,20,2,3,1,0,0,3,225,167,29970,23620,275,112,31561,22801
193,20,0,1,1,0,0,3,254,196,29970,23621,264,185,31561,22804
194,20,0,0,2,1,2,1,127,111,29970,23621,160,154,31562,22805
195,20,0,2,1,0,0,3,60,50,29970,23623,69,213,31562,22808
196,20,0,1,1,0,0,3,180,164,29970,23624,214,5,31562,22811
197,20,0,0,2,1,2,1,197,175,29970,23624,218,159,31563,22812
198,20,1,2,1,0,0,3,193,162,29971,23626,208,78,31563,22815
199,20,4,1,0,3,1,0,226,179,29975,23627,252,79,31566,22815
200,21,1,1,2,1,2,1,181,150,29976,23628,227,37,31567,22816
201,21,5,0,0,3,1,0,194,158,29981,23628,211,107,31570,22816
202,21,3,5,1,0,0,3,75,70,29984,23633,71,8,31570,22819
203,21,3,1,0,3,1,0,135,116,29987,23634,165,131,31573,22819
204,21,3,0,0,3,1,0,178,137,29990,23634,225,116,31576,22819
205,21,1,1,2,1,2,1,109,103,29991,23635,129,171,31577,22820
206,21,1,1,2,1,2,1,206,122,29992,23636,259,27,31578,22821
207,21,0,2,1,0,0,3,194,158,29992,23638,226,186,31578,22824
208,21,1,0,0,3,1,0,260,187,29993,23638,316,131,31581,22824
209,21,0,1,1,0,0,3,199,176,29993,23639,236,140,31581,22827
210,22,0,2,1,0,0,3,75,72,29993,23641,71,216,31581,22830
211,22,1,1,2,1,2,1,226,168,29994,23642,276,186,31582,22831
212,22,1,1,2,1,2,1,227,180,29995,23643,253,160,31583,22832
213,22,2,3,1,0,0,3,62,53,29997,23646,69,140,31583,22835
214,22,0,2,1,0,0,3,11,18,29997,23648,10,82,31583,22838
215,22,1,0,0,3,1,0,181,164,29998,23648,217,154,31586,22838
216,22,2,1,0,3,1,0,199,176,30000,23649,221,107,31589,22838
217,22,1,1,2,1,2,1,194,163,30001,23650,209,155,31590,22839
218,22,3,0,0,3,1,0,257,196,30004,23650,267,78,31593,22839
219,22,2,1,0,3,1,0,35,33,30006,23651,44,112,31596,22839
220,23,1,1,2,1,2,1,195,159,30007,23652,212,28,31597,22840
221,23,1,1,2,1,2,1,136,117,30008,23653,166,141,31598,22841
222,23,1,1,2,1,2,1,179,138,30009,23654,226,9,31599,22842
223,23,1,2,1,0,0,3,110,105,30010,23656,129,40,31599,22845
224,23,0,1,1,0,0,3,199,177,30010,23657,236,40,31599,22848
225,23,2,2,2,1,2,1,196,160,30012,23659,227,172,31600,22849
226,23,1,2,1,0,0,3,128,113,30013,23661,160,119,31600,22852
227,23,2,1,0,3,1,0,208,123,30015,23662,262,186,31603,22852
228,23,2,1,0,3,1,0,183,151,30017,23663,230,131,31606,22852
229,23,0,1,1,0,0,3,260,188,30017,23664,316,134,31606,22855
230,24,0,1,1,0,0,3,35,34,30017,23665,44,110,31606,22858
231,24,0,2,1,0,0,3,75,74,30017,23667,71,163,31606,22861
232,24,1,1,2,1,2,1,258,197,30018,23668,268,113,31607,22862
233,24,2,1,0,3,1,0,64,54,30020,23669,72,155,31610,22862
234,24,0,1,1,0,0,3,11,19,30020,23670,10,81,31610,22865
235,24,4,1,0,3,1,0,185,165,30024,23671,220,82,31613,22865
236,24,0,2,1,0,0,3,199,178,30024,23673,221,143,31613,22868
237,24,0,1,1,0,0,3,194,164,30024,23674,209,157,31613,22871
238,24,1,1,2,1,2,1,228,181,30025,23675,254,187,31614,22872
239,24,0,0,2,1,2,1,226,168,30025,23675,277,217,31615,22873
240,25,3,2,0,3,1,0,186,153,30028,23677,233,134,31618,22873
241,25,3,1,0,3,1,0,139,118,30031,23678,169,40,31621,22873
242,25,1,0,0,3,1,0,180,138,30032,23678,229,82,31624,22873
243,25,1,0,0,3,1,0,209,123,30033,23678,265,172,31627,22873
244,25,1,2,1,0,0,3,197,162,30034,23680,227,12,31627,22876
245,25,2,3,1,0,0,3,130,116,30036,23683,160,43,31627,22879
246,25,3,0,0,3,1,0,263,188,30039,23683,319,141,31630,22879
247,25,1,2,1,0,0,3,200,180,30040,23685,221,31,31630,22882
248,25,1,1,2,1,2,1,200,178,30041,23686,237,120,31631,22883
249,25,0,0,2,1,2,1,195,159,30041,23686,213,187,31632,22884
250,26,3,2,0,3,1,0,78,76,30044,23688,74,157,31635,22884
251,26,2,0,0,3,1,0,228,168,30046,23688,280,110,31638,22884
252,26,1,1,2,1,2,1,181,139,30047,23689,230,82,31639,22885
253,26,1,2,1,0,0,3,111,107,30048,23691,129,220,31639,22888
254,26,2,2,2,1,2,1,260,199,30050,23693,269,132,31640,22889
255,26,1,1,2,1,2,1,65,55,30051,23694,73,32,31641,22890
256,26,3,2,0,3,1,0,188,167,30054,23696,223,155,31644,22890
257,26,2,0,0,3,1,0,196,164,30056,23696,212,113,31647,22890
258,26,1,3,1,0,0,3,229,184,30057,23699,254,146,31647,22893
259,26,1,2,1,0,0,3,12,21,30058,23701,10,190,31647,22896
260,27,3,2,0,3,1,0,189,155,30061,23703,236,141,31650,22896
261,27,2,0,0,3,1,0,197,159,30063,23703,216,120,31653,22896
262,27,4,1,0,3,1,0,143,119,30067,23704,172,82,31656,22896
263,27,0,0,2,1,2,1,209,123,30067,23704,266,41,31657,22897
264,27,0,1,1,0,0,3,200,179,30067,23705,237,166,31657,22900
265,27,1,4,1,0,0,3,131,120,30068,23709,160,190,31657,22903
266,27,2,1,0,3,1,0,265,189,30070,23710,322,12,31660,22903
267,27,1,1,2,1,2,1,201,181,30071,23711,222,44,31661,22904
268,27,0,1,1,0,0,3,35,35,30071,23712,44,175,31661,22907
269,27,0,2,1,0,0,3,197,164,30071,23714,227,137,31661,22910
270,28,5,4,0,3,1,0,83,80,30076,23718,77,113,31664,22910
271,28,1,3,1,0,0,3,229,171,30077,23721,280,135,31664,22913
272,28,1,0,0,3,1,0,144,119,30078,23721,175,157,31667,22913
273,28,2,1,0,3,1,0,183,140,30080,23722,233,220,31670,22913
274,28,1,2,1,0,0,3,13,23,30081,23724,10,113,31670,22916
275,28,0,1,1,0,0,3,196,165,30081,23725,212,47,31670,22919
276,28,1,1,2,1,2,1,112,108,30082,23726,130,191,31671,22920
277,28,2,1,0,3,1,0,262,200,30084,23727,272,32,31674,22920
278,28,1,0,0,3,1,0,230,184,30085,23727,257,155,31677,22920
279,28,0,4,1,0,0,3,188,171,30085,23731,223,149,31677,22923
280,29,2,0,0,3,1,0,191,155,30087,23731,239,12,31680,22923
281,29,1,2,1,0,0,3,198,161,30088,23733,216,178,31680,22926
282,29,2,1,0,3,1,0,211,124,30090,23734,269,166,31683,22926
283,29,1,0,0,3,1,0,198,164,30091,23734,230,82,31686,22926
284,29,1,2,1,0,0,3,132,122,30092,23736,160,140,31686,22929
285,29,1,4,1,0,0,3,66,59,30093,23740,73,193,31686,22932
286,29,4,0,0,3,1,0,269,189,30097,23740,325,82,31689,22932
287,29,2,0,0,3,1,0,37,35,30099,23740,47,141,31692,22932
288,29,0,1,1,0,0,3,200,180,30099,23741,237,44,31692,22935
289,29,1,2,1,0,0,3,202,183,30100,23743,222,123,31692,22938
290,30,0,1,1,0,0,3,83,81,30100,23744,77,116,31692,22941
291,30,2,1,0,3,1,0,146,120,30102,23745,178,155,31695,22941
292,30,2,0,0,3,1,0,185,140,30104,23745,236,157,31698,22941
293,30,0,1,1,0,0,3,112,109,30104,23746,130,116,31698,22944
294,30,3,1,0,3,1,0,233,185,30107,23747,260,47,31701,22944
295,30,4,1,0,3,1,0,17,24,30111,23748,13,149,31704,22944
296,30,0,0,2,1,2,1,188,171,30111,23748,224,136,31705,22945
297,30,2,4,1,0,0,3,198,169,30113,23752,212,35,31705,22948
298,30,3,1,0,3,1,0,272,190,30116,23753,328,191,31708,22948
299,30,0,2,1,0,0,3,229,173,30116,23755,280,196,31708,22951
300,31,2,1,0,3,1,0,193,156,30118,23756,242,166,31711,22951
301,31,3,1,0,3,1,0,201,162,30121,23757,219,44,31714,22951
302,31,0,0,2,1,2,1,37,35,30121,23757,48,83,31715,22952
303,31,0,2,1,0,0,3,211,126,30121,23759,269,15,31715,22955
304,31,1,0,0,3,1,0,263,200,30122,23759,275,123,31718,22955
305,31,1,1,2,1,2,1,133,123,30123,23760,161,142,31719,22956
306,31,1,1,2,1,2,1,67,60,30124,23761,74,179,31720,22957
307,31,3,1,0,3,1,0,205,184,30127,23762,225,140,31723,22957
308,31,0,2,1,0,0,3,198,166,30127,23764,230,223,31723,22960
309,31,2,1,0,3,1,0,202,181,30129,23765,240,82,31726,22960
310,32,1,1,2,1,2,1,84,82,30130,23766,78,137,31727,22961
311,32,3,1,0,3,1,0,232,174,30133,23767,283,123,31730,22961
312,32,0,2,1,0,0,3,146,122,30133,23769,178,119,31730,22964
313,32,2,2,2,1,2,1,187,142,30135,23771,237,117,31731,22965
314,32,3,1,0,3,1,0,115,110,30138,23772,133,149,31734,22965
315,32,2,0,0,3,1,0,235,185,30140,23772,263,35,31737,22965
316,32,1,3,1,0,0,3,18,27,30141,23775,13,199,31737,22968
317,32,3,2,0,3,1,0,191,173,30144,23777,227,47,31740,22968
318,32,1,1,2,1,2,1,203,182,30145,23778,241,158,31741,22969
319,32,0,1,1,0,0,3,272,191,30145,23779,328,158,31741,22972
320,33,2,0,0,3,1,0,195,156,30147,23779,245,158,31744,22972
321,33,1,2,1,0,0,3,202,164,30148,23781,219,169,31744,22975
322,33,2,1,0,3,1,0,213,127,30150,23782,272,83,31747,22975
323,33,0,2,1,0,0,3,263,202,30150,23784,275,145,31747,22978
324,33,2,2,2,1,2,1,135,125,30152,23786,162,192,31748,22979
325,33,2,1,0,3,1,0,69,61,30154,23787,77,15,31751,22979
326,33,0,1,1,0,0,3,205,185,30154,23788,225,85,31751,22982
327,33,2,2,2,1,2,1,200,171,30156,23790,213,45,31752,22983
328,33,0,3,1,0,0,3,37,38,30156,23793,48,226,31752,22986
329,33,3,0,0,3,1,0,235,174,30159,23793,286,140,31755,22986
330,34,2,2,2,1,2,1,86,84,30161,23795,79,200,31756,22987
331,34,2,1,0,3,1,0,148,123,30163,23796,181,117,31759,22987
332,34,4,2,0,3,1,0,191,144,30167,23798,240,47,31762,22987
333,34,3,2,0,3,1,0,118,112,30170,23800,136,137,31765,22987
334,34,3,3,2,1,2,1,206,185,30173,23803,242,159,31766,22988
335,34,0,1,1,0,0,3,235,186,30173,23804,263,126,31766,22991
336,34,0,4,1,0,0,3,18,31,30173,23808,13,38,31766,22994
337,34,1,0,0,3,1,0,273,191,30174,23808,331,119,31769,22994
338,34,1,1,2,1,2,1,192,174,30175,23809,228,180,31770,22995
339,34,2,1,0,3,1,0,200,167,30177,23810,233,149,31773,22995
340,35,2,0,0,3,1,0,197,156,30179,23810,248,192,31776,22995
341,35,1,4,1,0,0,3,203,168,30180,23814,219,229,31776,22998
342,35,0,0,2,1,2,1,37,38,30180,23814,49,86,31777,22999
343,35,1,0,0,3,1,0,236,174,30181,23814,289,169,31780,22999
344,35,3,0,0,3,1,0,216,127,30184,23814,275,158,31783,22999
345,35,1,0,0,3,1,0,264,202,30185,23814,278,140,31786,22999
346,35,4,1,0,3,1,0,139,126,30189,23815,165,83,31789,22999
347,35,5,1,0,3,1,0,74,62,30194,23816,80,45,31792,22999
348,35,2,2,2,1,2,1,207,187,30196,23818,226,16,31793,23000
349,35,2,2,2,1,2,1,202,173,30198,23820,214,146,31794,23001
350,36,2,4,1,0,0,3,88,88,30200,23824,79,183,31794,23004
351,36,1,2,1,0,0,3,149,125,30201,23826,181,152,31794,23007
352,36,1,0,0,3,1,0,119,112,30202,23826,139,47,31797,23007
353,36,2,0,0,3,1,0,218,127,30204,23826,278,119,31800,23007
354,36,3,1,0,3,1,0,203,168,30207,23827,236,137,31803,23007
355,36,2,2,2,1,2,1,20,33,30209,23829,14,127,31804,23008
356,36,3,1,0,3,1,0,276,192,30212,23830,334,117,31807,23008
357,36,0,2,1,0,0,3,192,176,30212,23832,228,143,31807,23011
358,36,1,1,2,1,2,1,192,145,30213,23833,241,201,31808,23012
359,36,1,0,0,3,1,0,207,185,30214,23833,245,38,31811,23012
360,37,1,1,2,1,2,1,204,169,30215,23834,220,120,31812,23013
361,37,2,1,0,3,1,0,39,39,30217,23835,52,158,31815,23013
362,37,2,0,0,3,1,0,238,174,30219,23835,292,16,31818,23013
363,37,6,0,0,3,1,0,241,186,30225,23835,266,45,31821,23013
364,37,4,0,0,3,1,0,268,202,30229,23835,281,83,31824,23013
365,37,0,1,1,0,0,3,139,127,30229,23836,165,162,31824,23016
366,37,1,1,2,1,2,1,75,63,30230,23837,81,87,31825,23017
367,37,1,3,1,0,0,3,193,179,30231,23840,228,172,31825,23020
368,37,4,2,0,3,1,0,211,189,30235,23842,229,192,31828,23020
369,37,1,3,1,0,0,3,203,176,30236,23845,214,232,31828,23023
370,38,2,2,2,1,2,1,199,158,30238,23847,249,118,31829,23024
371,38,2,1,0,3,1,0,90,89,30240,23848,82,146,31832,23024
372,38,2,2,2,1,2,1,151,127,30242,23850,182,184,31833,23025
373,38,2,2,2,1,2,1,194,147,30244,23852,242,39,31834,23026
374,38,3,4,1,0,0,3,122,116,30247,23856,139,130,31834,23029
375,38,2,0,0,3,1,0,220,127,30249,23856,281,137,31837,23029
376,38,2,1,0,3,1,0,209,186,30251,23857,248,152,31840,23029
377,38,3,0,0,3,1,0,206,168,30254,23857,239,47,31843,23029
378,38,3,0,0,3,1,0,23,33,30257,23857,17,143,31846,23029
379,38,2,2,2,1,2,1,278,194,30259,23859,335,202,31847,23030
0,1,0,1,1,0,0,3,199,159,30259,23860,249,145,31847,23033
1,1,1,1,2,1,2,1,123,117,30260,23861,140,40,31848,23034
2,1,0,0,2,1,2,1,194,147,30260,23861,243,88,31849,23035
3,1,1,0,0,3,1,0,22,23,30261,23861,26,146,31852,23035
4,1,0,2,1,0,0,3,206,170,30261,23863,239,3,31852,23038
5,1,0,2,1,0,0,3,75,65,30261,23865,81,195,31852,23041
6,1,1,2,1,0,0,3,46,54,30262,23867,49,121,31852,23044
7,1,3,1,0,3,1,0,206,177,30265,23868,217,152,31855,23044
8,1,0,0,2,1,2,1,241,186,30265,23868,267,163,31856,23045
9,1,0,1,1,0,0,3,238,175,30265,23869,292,172,31856,23048
10,2,2,3,1,0,0,3,206,172,30267,23872,220,86,31856,23051
11,2,0,1,1,0,0,3,0,1,30267,23873,0,123,31856,23054
12,2,1,1,2,1,2,1,221,128,30268,23874,282,11,31857,23055
13,2,5,1,0,3,1,0,210,205,30273,23875,237,47,31860,23055
14,2,4,2,0,3,1,0,143,129,30277,23877,168,172,31863,23055
15,2,2,0,0,3,1,0,41,39,30279,23877,55,158,31866,23055
16,2,0,1,1,0,0,3,193,180,30279,23878,228,133,31866,23058
17,2,1,2,1,0,0,3,210,161,30280,23880,252,187,31866,23061
18,2,1,0,0,3,1,0,210,186,30281,23880,251,51,31869,23061
19,2,1,2,1,0,0,3,152,129,30282,23882,182,146,31869,23064
20,3,2,3,1,0,0,3,201,162,30284,23885,249,149,31869,23067
21,3,1,3,1,0,0,3,124,120,30285,23888,140,149,31869,23070
22,3,1,1,2,1,2,1,239,176,30286,23889,293,41,31870,23071
23,3,1,0,0,3,1,0,23,23,30287,23889,29,121,31873,23071
24,3,0,3,1,0,0,3,206,173,30287,23892,239,198,31873,23074
25,3,0,3,1,0,0,3,75,68,30287,23895,81,155,31873,23077
26,3,0,1,1,0,0,3,46,55,30287,23896,49,166,31873,23080
27,3,0,1,1,0,0,3,210,162,30287,23897,252,6,31873,23083
28,3,1,1,2,1,2,1,207,178,30288,23898,218,89,31874,23084
29,3,2,3,1,0,0,3,196,150,30290,23901,243,175,31874,23087
30,4,2,0,0,3,1,0,126,120,30292,23901,143,11,31877,23087
31,4,1,0,0,3,1,0,207,172,30293,23901,223,158,31880,23087
32,4,1,1,2,1,2,1,153,130,30294,23902,183,52,31881,23088
33,4,0,0,2,1,2,1,221,128,30294,23902,283,173,31882,23089
34,4,3,1,0,3,1,0,244,187,30297,23903,270,133,31885,23089
35,4,1,1,2,1,2,1,144,130,30298,23904,169,48,31886,23090
36,4,1,0,0,3,1,0,42,39,30299,23904,58,6,31889,23090
37,4,2,0,0,3,1,0,195,180,30301,23904,231,187,31892,23090
38,4,2,0,0,3,1,0,212,186,30303,23904,254,145,31895,23090
39,4,3,1,0,3,1,0,213,206,30306,23905,240,123,31898,23090
40,5,0,0,2,1,2,1,201,162,30306,23905,250,150,31899,23091
41,5,1,0,0,3,1,0,240,176,30307,23905,296,166,31902,23091
42,5,1,0,0,3,1,0,197,150,30308,23905,246,149,31905,23091
43,5,0,0,2,1,2,1,23,23,30308,23905,30,90,31906,23092
44,5,0,1,1,0,0,3,206,174,30308,23906,239,124,31906,23095
45,5,4,0,0,3,1,0,79,68,30312,23906,84,41,31909,23095
46,5,1,0,0,3,1,0,47,55,30313,23906,52,155,31912,23095
47,5,0,1,1,0,0,3,210,163,30313,23907,252,178,31912,23098
48,5,0,0,2,1,2,1,207,178,30313,23907,219,87,31913,23099
49,5,0,0,2,1,2,1,0,1,30313,23907,1,199,31914,23100
50,6,2,1,0,3,1,0,128,121,30315,23908,146,52,31917,23100
51,6,0,2,1,0,0,3,207,174,30315,23910,223,190,31917,23103
52,6,1,0,0,3,1,0,154,130,30316,23910,186,158,31920,23103
53,6,3,1,0,3,1,0,224,129,30319,23911,286,48,31923,23103
54,6,2,0,0,3,1,0,146,130,30321,23911,172,123,31926,23103
55,6,2,0,0,3,1,0,44,39,30323,23911,61,145,31929,23103
56,6,1,0,0,3,1,0,196,180,30324,23911,234,6,31932,23103
57,6,0,4,1,0,0,3,207,182,30324,23915,219,176,31932,23106
58,6,2,0,0,3,1,0,215,206,30326,23915,243,199,31935,23106
59,6,1,0,0,3,1,0,245,187,30327,23915,273,11,31938,23106
60,7,0,0,2,1,2,1,201,162,30327,23915,251,42,31939,23107
61,7,4,1,0,3,1,0,244,177,30331,23916,299,87,31942,23107
62,7,2,0,0,3,1,0,199,150,30333,23916,249,155,31945,23107
63,7,4,2,0,3,1,0,27,25,30337,23918,33,133,31948,23107
64,7,0,1,1,0,0,3,206,175,30337,23919,239,169,31948,23110
65,7,2,0,0,3,1,0,81,68,30339,23919,87,90,31951,23110
66,7,0,3,1,0,0,3,47,58,30339,23922,52,153,31951,23113
67,7,2,0,0,3,1,0,212,163,30341,23922,255,124,31954,23113
68,7,2,0,0,3,1,0,214,186,30343,23922,257,149,31957,23113
69,7,1,3,1,0,0,3,1,4,30344,23925,1,181,31957,23116
70,8,0,1,1,0,0,3,128,122,30344,23926,146,161,31957,23119
71,8,0,0,2,1,2,1,207,174,30344,23926,224,124,31958,23120
72,8,2,0,0,3,1,0,156,130,30346,23926,189,6,31961,23120
73,8,1,2,1,0,0,3,28,27,30347,23928,33,193,31961,23123
74,8,1,1,2,1,2,1,225,130,30348,23929,287,146,31962,23124
75,8,0,0,2,1,2,1,245,187,30348,23929,274,177,31963,23125
76,8,0,1,1,0,0,3,196,181,30348,23930,234,51,31963,23128
77,8,4,1,0,3,1,0,211,183,30352,23931,222,52,31966,23128
78,8,2,1,0,3,1,0,46,40,30354,23932,64,181,31969,23128
79,8,1,2,1,0,0,3,147,132,30355,23934,172,202,31969,23131
80,9,3,1,0,3,1,0,204,163,30358,23935,254,133,31972,23131
81,9,1,1,2,1,2,1,2,5,30359,23936,2,125,31973,23132
82,9,5,1,0,3,1,0,249,178,30364,23937,302,90,31976,23132
83,9,1,1,2,1,2,1,200,151,30365,23938,250,88,31977,23133
84,9,0,0,2,1,2,1,214,186,30365,23938,258,43,31978,23134
85,9,0,0,2,1,2,1,206,175,30365,23938,240,150,31979,23135
86,9,2,0,0,3,1,0,83,68,30367,23938,90,153,31982,23135
87,9,2,3,1,0,0,3,49,61,30369,23941,52,14,31982,23138
88,9,0,1,1,0,0,3,215,207,30369,23942,243,172,31982,23141
89,9,1,0,0,3,1,0,213,163,30370,23942,258,155,31985,23141
90,10,0,2,1,0,0,3,128,124,30370,23944,146,54,31985,23144
91,10,0,3,1,0,0,3,156,133,30370,23947,189,149,31985,23147
92,10,1,0,0,3,1,0,29,27,30371,23947,36,177,31988,23147
93,10,2,3,1,0,0,3,227,133,30373,23950,287,9,31988,23150
94,10,4,1,0,3,1,0,249,188,30377,23951,277,161,31991,23150
95,10,1,0,0,3,1,0,148,132,30378,23951,175,43,31994,23150
96,10,2,0,0,3,1,0,51,61,30380,23951,55,124,31997,23150
97,10,1,3,1,0,0,3,212,186,30381,23954,222,196,31997,23153
98,10,1,2,1,0,0,3,208,176,30382,23956,224,205,31997,23156
99,10,1,2,1,0,0,3,197,183,30383,23958,234,184,31997,23159
100,11,3,2,0,3,1,0,207,165,30386,23960,257,172,32000,23159
101,11,2,0,0,3,1,0,210,176,30388,23960,227,9,32003,23159
102,11,0,0,2,1,2,1,200,151,30388,23960,251,53,32004,23160
103,11,3,0,0,3,1,0,218,207,30391,23960,246,125,32007,23160
104,11,1,2,1,0,0,3,207,177,30392,23962,240,17,32007,23163
105,11,1,0,0,3,1,0,84,68,30393,23962,93,133,32010,23163
106,11,0,0,2,1,2,1,46,40,30393,23962,65,91,32011,23164
107,11,1,2,1,0,0,3,214,165,30394,23964,258,153,32011,23167
108,11,3,2,0,3,1,0,252,180,30397,23966,305,153,32014,23167
109,11,5,0,0,3,1,0,219,186,30402,23966,261,88,32017,23167
110,12,0,1,1,0,0,3,128,125,30402,23967,146,12,32017,23170
111,12,0,2,1,0,0,3,210,178,30402,23969,227,46,32017,23173
112,12,2,2,2,1,2,1,158,135,30404,23971,190,125,32018,23174
113,12,0,2,1,0,0,3,29,29,30404,23973,36,152,32018,23177
114,12,0,0,2,1,2,1,249,188,30404,23973,278,185,32019,23178
115,12,0,4,1,0,0,3,51,65,30404,23977,55,57,32019,23181
116,12,0,3,1,0,0,3,197,186,30404,23980,234,128,32019,23184
117,12,1,1,2,1,2,1,213,187,30405,23981,223,162,32020,23185
118,12,2,1,0,3,1,0,229,134,30407,23982,290,205,32023,23185
119,12,2,2,2,1,2,1,202,153,30409,23984,252,197,32024,23186
120,13,1,2,1,0,0,3,208,167,30410,23986,257,91,32024,23189
121,13,1,1,2,1,2,1,253,181,30411,23987,306,54,32025,23190
122,13,0,1,1,0,0,3,207,178,30411,23988,240,180,32025,23193
123,13,0,0,2,1,2,1,46,40,30411,23988,66,154,32026,23194
124,13,0,1,1,0,0,3,2,6,30411,23989,2,156,32026,23197
125,13,0,1,1,0,0,3,219,187,30411,23990,261,94,32026,23200
126,13,1,0,0,3,1,0,149,132,30412,23990,178,172,32029,23200
127,13,0,3,1,0,0,3,84,71,30412,23993,93,20,32029,23203
128,13,4,2,0,3,1,0,218,167,30416,23995,261,133,32032,23203
129,13,0,1,1,0,0,3,218,208,30416,23996,246,158,32032,23206
130,14,2,1,0,3,1,0,130,126,30418,23997,149,152,32035,23206
131,14,0,0,2,1,2,1,210,178,30418,23997,228,129,32036,23207
132,14,1,2,1,0,0,3,159,137,30419,23999,190,188,32036,23210
133,14,3,0,0,3,1,0,205,153,30422,23999,255,57,32039,23210
134,14,2,0,0,3,1,0,31,29,30424,23999,39,125,32042,23210
135,14,3,2,0,3,1,0,232,136,30427,24001,293,154,32045,23210
136,14,2,1,0,3,1,0,251,189,30429,24002,281,46,32048,23210
137,14,0,3,1,0,0,3,51,68,30429,24005,55,15,32048,23213
138,14,4,2,0,3,1,0,217,189,30433,24007,226,205,32051,23213
139,14,2,1,0,3,1,0,255,182,30435,24008,309,162,32054,23213
140,15,0,0,2,1,2,1,208,167,30435,24008,258,181,32055,23214
141,15,1,1,2,1,2,1,3,7,30436,24009,3,134,32056,23215
142,15,1,0,0,3,1,0,208,178,30437,24009,243,54,32059,23215
143,15,0,1,1,0,0,3,149,133,30437,24010,178,97,32059,23218
144,15,0,0,2,1,2,1,84,71,30437,24010,94,198,32060,23219
145,15,1,0,0,3,1,0,47,40,30438,24010,69,172,32063,23219
146,15,1,4,1,0,0,3,198,190,30439,24014,234,161,32063,23222
147,15,2,0,0,3,1,0,220,167,30441,24014,264,156,32066,23222
148,15,0,0,2,1,2,1,219,187,30441,24014,262,21,32067,23223
149,15,1,0,0,3,1,0,219,208,30442,24014,249,91,32070,23223
150,16,0,1,1,0,0,3,130,127,30442,24015,149,132,32070,23226
151,16,2,0,0,3,1,0,257,182,30444,24015,312,125,32073,23226
152,16,1,0,0,3,1,0,160,137,30445,24015,193,154,32076,23226
153,16,2,0,0,3,1,0,207,153,30447,24015,258,15,32079,23226
154,16,1,1,2,1,2,1,233,137,30448,24016,294,162,32080,23227
155,16,2,2,2,1,2,1,253,191,30450,24018,282,206,32081,23228
156,16,1,2,1,0,0,3,85,73,30451,24020,94,165,32081,23231
157,16,0,3,1,0,0,3,51,71,30451,24023,55,155,32081,23234
158,16,0,0,2,1,2,1,217,189,30451,24023,227,47,32082,23235
159,16,1,1,2,1,2,1,32,30,30452,24024,40,189,32083,23236
160,17,0,0,2,1,2,1,210,178,30452,24024,229,157,32084,23237
161,17,1,1,2,1,2,1,209,168,30453,24025,259,166,32085,23238
162,17,0,3,1,0,0,3,3,10,30453,24028,3,24,32085,23241
163,17,2,1,0,3,1,0,235,138,30455,24029,297,97,32088,23241
164,17,2,1,0,3,1,0,221,188,30457,24030,265,198,32091,23241
165,17,2,0,0,3,1,0,221,208,30459,24030,252,54,32094,23241
166,17,1,0,0,3,1,0,150,133,30460,24030,181,134,32097,23241
167,17,3,0,0,3,1,0,50,40,30463,24030,72,181,32100,23241
168,17,2,0,0,3,1,0,200,190,30465,24030,237,91,32103,23241
169,17,3,2,0,3,1,0,223,169,30468,24032,267,57,32106,23241
170,18,1,1,2,1,2,1,131,128,30469,24033,150,173,32107,23242
171,18,3,0,0,3,1,0,260,182,30472,24033,315,15,32110,23242
172,18,0,0,2,1,2,1,160,137,30472,24033,194,163,32111,23243
173,18,0,1,1,0,0,3,32,31,30472,24034,40,50,32111,23246
174,18,1,1,2,1,2,1,254,192,30473,24035,283,133,32112,23247
175,18,1,1,2,1,2,1,209,179,30474,24036,244,156,32113,23248
176,18,1,3,1,0,0,3,86,76,30475,24039,94,128,32113,23251
177,18,3,0,0,3,1,0,54,71,30478,24039,58,154,32116,23251
178,18,0,0,2,1,2,1,207,153,30478,24039,259,207,32117,23252
179,18,0,2,1,0,0,3,217,191,30478,24041,227,192,32117,23255
180,19,4,0,0,3,1,0,214,178,30482,24041,232,24,32120,23255
181,19,1,2,1,0,0,3,4,12,30483,24043,3,60,32120,23258
182,19,0,1,1,0,0,3,160,138,30483,24044,194,94,32120,23261
183,19,1,1,2,1,2,1,151,134,30484,24045,182,199,32121,23262
184,19,1,1,2,1,2,1,51,41,30485,24046,73,55,32122,23263
185,19,0,1,1,0,0,3,223,170,30485,24047,267,184,32122,23266
186,19,1,2,1,0,0,3,222,190,30486,24049,265,131,32122,23269
187,19,1,0,0,3,1,0,201,190,30487,24049,240,157,32125,23269
188,19,4,3,0,3,1,0,239,141,30491,24052,300,134,32128,23269
189,19,3,0,0,3,1,0,224,208,30494,24052,255,166,32131,23269
190,20,2,1,0,3,1,0,211,169,30496,24053,262,15,32134,23269
191,20,0,4,1,0,0,3,131,132,30496,24057,150,166,32134,23272
192,20,3,2,0,3,1,0,210,155,30499,24059,262,133,32137,23272
193,20,2,1,0,3,1,0,256,193,30501,24060,286,97,32140,23272
194,20,1,2,1,0,0,3,210,181,30502,24062,244,53,32140,23275
195,20,0,1,1,0,0,3,86,77,30502,24063,94,195,32140,23278
196,20,1,0,0,3,1,0,218,191,30503,24063,230,154,32143,23278
197,20,1,1,2,1,2,1,261,183,30504,24064,316,157,32144,23279
198,20,0,0,2,1,2,1,32,31,30504,24064,41,174,32145,23280
199,20,1,0,0,3,1,0,55,71,30505,24064,61,207,32148,23280
200,21,3,0,0,3,1,0,217,178,30508,24064,235,60,32151,23280
201,21,0,0,2,1,2,1,4,12,30508,24064,4,158,32152,23281
202,21,1,1,2,1,2,1,161,139,30509,24065,195,135,32153,23282
203,21,0,1,1,0,0,3,256,194,30509,24066,286,97,32153,23285
204,21,1,2,1,0,0,3,225,210,30510,24068,255,187,32153,23288
205,21,0,0,2,1,2,1,201,190,30510,24068,241,132,32154,23289
206,21,2,1,0,3,1,0,224,191,30512,24069,268,166,32157,23289
207,21,1,1,2,1,2,1,152,135,30513,24070,183,25,32158,23290
208,21,0,1,1,0,0,3,51,42,30513,24071,73,202,32158,23293
209,21,1,0,0,3,1,0,240,141,30514,24071,303,55,32161,23293
210,22,0,0,2,1,2,1,211,169,30514,24071,263,196,32162,23294
211,22,1,1,2,1,2,1,33,32,30515,24072,42,98,32163,23295
212,22,1,0,0,3,1,0,211,181,30516,24072,247,166,32166,23295
213,22,1,3,1,0,0,3,56,74,30517,24075,61,100,32166,23298
214,22,1,2,1,0,0,3,219,193,30518,24077,230,160,32166,23301
215,22,1,0,0,3,1,0,262,183,30519,24077,319,154,32169,23301
216,22,1,0,0,3,1,0,87,77,30520,24077,97,133,32172,23301
217,22,0,1,1,0,0,3,4,13,30520,24078,4,56,32172,23304
218,22,0,0,2,1,2,1,210,155,30520,24078,263,175,32173,23305
219,22,1,0,0,3,1,0,224,170,30521,24078,270,207,32176,23305
220,23,0,0,2,1,2,1,217,178,30521,24078,236,56,32177,23306
221,23,2,2,2,1,2,1,163,141,30523,24080,196,26,32178,23307
222,23,1,1,2,1,2,1,241,142,30524,24081,304,203,32179,23308
223,23,1,0,0,3,1,0,257,194,30525,24081,289,132,32182,23308
224,23,1,1,2,1,2,1,226,211,30526,24082,256,159,32183,23309
225,23,1,1,2,1,2,1,153,136,30527,24083,184,167,32184,23310
226,23,0,0,2,1,2,1,51,42,30527,24083,74,61,32185,23311
227,23,2,1,0,3,1,0,203,191,30529,24084,244,187,32188,23311
228,23,0,0,2,1,2,1,131,132,30529,24084,151,136,32189,23312
229,23,3,0,0,3,1,0,227,191,30532,24084,271,15,32192,23312
230,24,1,0,0,3,1,0,212,169,30533,24084,266,133,32195,23312
231,24,0,0,2,1,2,1,4,13,30533,24084,5,155,32196,23313
232,24,0,1,1,0,0,3,210,156,30533,24085,263,139,32196,23316
233,24,0,1,1,0,0,3,33,33,30533,24086,42,163,32196,23319
234,24,0,1,1,0,0,3,211,182,30533,24087,247,103,32196,23322
235,24,1,1,2,1,2,1,88,78,30534,24088,98,176,32197,23323
236,24,1,1,2,1,2,1,57,75,30535,24089,62,99,32198,23324
237,24,0,1,1,0,0,3,224,171,30535,24090,270,59,32198,23327
238,24,0,0,2,1,2,1,227,191,30535,24090,272,197,32199,23328
239,24,1,0,0,3,1,0,263,183,30536,24090,322,166,32202,23328
240,25,1,1,2,1,2,1,132,133,30537,24091,152,204,32203,23329
241,25,1,0,0,3,1,0,218,178,30538,24091,239,187,32206,23329
242,25,1,2,1,0,0,3,164,143,30539,24093,196,64,32206,23332
243,25,0,2,1,0,0,3,241,144,30539,24095,304,170,32206,23335
244,25,2,1,0,3,1,0,259,195,30541,24096,292,56,32209,23335
245,25,1,1,2,1,2,1,154,137,30542,24097,185,160,32210,23336
246,25,1,1,2,1,2,1,52,43,30543,24098,75,133,32211,23337
247,25,3,2,0,3,1,0,222,195,30546,24100,233,26,32214,23337
248,25,0,1,1,0,0,3,203,192,30546,24101,244,210,32214,23340
249,25,1,0,0,3,1,0,227,211,30547,24101,259,15,32217,23340
250,26,2,1,0,3,1,0,214,170,30549,24102,269,166,32220,23340
251,26,1,1,2,1,2,1,5,14,30550,24103,6,104,32221,23341
252,26,3,1,0,3,1,0,266,184,30553,24104,325,26,32224,23341
253,26,0,1,1,0,0,3,210,157,30553,24105,263,166,32224,23344
254,26,2,0,0,3,1,0,229,211,30555,24105,262,59,32227,23344
255,26,3,1,0,3,1,0,214,183,30558,24106,250,99,32230,23344
256,26,2,0,0,3,1,0,90,78,30560,24106,101,155,32233,23344
257,26,1,0,0,3,1,0,58,75,30561,24106,65,139,32236,23344
258,26,2,1,0,3,1,0,226,172,30563,24107,273,176,32239,23344
259,26,4,1,0,3,1,0,231,192,30567,24108,275,133,32242,23344
260,27,0,3,1,0,0,3,132,136,30567,24111,152,190,32242,23347
261,27,0,2,1,0,0,3,218,180,30567,24113,239,163,32242,23350
262,27,2,2,2,1,2,1,166,145,30569,24115,197,205,32243,23351
263,27,2,0,0,3,1,0,35,33,30571,24115,45,56,32246,23351
264,27,0,0,2,1,2,1,154,137,30571,24115,186,16,32247,23352
265,27,0,4,1,0,0,3,203,196,30571,24119,244,173,32247,23355
266,27,4,0,0,3,1,0,226,195,30575,24119,236,133,32250,23355
267,27,1,3,1,0,0,3,260,198,30576,24122,292,67,32250,23358
268,27,2,0,0,3,1,0,54,43,30578,24122,78,210,32253,23358
269,27,2,2,2,1,2,1,243,146,30580,24124,305,198,32254,23359
270,28,0,0,2,1,2,1,214,170,30580,24124,270,57,32255,23360
271,28,1,1,2,1,2,1,6,15,30581,24125,7,177,32256,23361
272,28,2,5,1,0,0,3,268,189,30583,24130,325,142,32256,23364
273,28,1,1,2,1,2,1,211,158,30584,24131,264,27,32257,23365
274,28,3,2,0,3,1,0,217,185,30587,24133,253,166,32260,23365
275,28,2,2,2,1,2,1,92,80,30589,24135,102,100,32261,23366
276,28,0,0,2,1,2,1,54,43,30589,24135,79,134,32262,23367
277,28,1,0,0,3,1,0,227,172,30590,24135,276,104,32265,23367
278,28,2,0,0,3,1,0,233,192,30592,24135,278,166,32268,23367
279,28,1,1,2,1,2,1,230,212,30593,24136,263,156,32269,23368
280,29,1,0,0,3,1,0,7,15,30594,24136,10,166,32272,23368
281,29,0,1,1,0,0,3,166,146,30594,24137,197,62,32272,23371
282,29,1,0,0,3,1,0,36,33,30595,24137,48,173,32275,23371
283,29,3,1,0,3,1,0,246,147,30598,24138,308,133,32278,23371
284,29,0,3,1,0,0,3,154,140,30598,24141,186,201,32278,23374
285,29,0,4,1,0,0,3,58,79,30598,24145,65,193,32278,23377
286,29,0,0,2,1,2,1,203,196,30598,24145,245,164,32279,23378
287,29,1,4,1,0,0,3,227,199,30599,24149,236,70,32279,23381
288,29,1,1,2,1,2,1,261,199,30600,24150,293,206,32280,23382
289,29,1,0,0,3,1,0,133,136,30601,24150,155,210,32283,23382
290,30,1,1,2,1,2,1,215,171,30602,24151,271,105,32284,23383
291,30,0,0,2,1,2,1,7,15,30602,24151,11,101,32285,23384
292,30,0,0,2,1,2,1,268,189,30602,24151,326,194,32286,23385
293,30,0,2,1,0,0,3,217,187,30602,24153,253,145,32286,23388
294,30,0,1,1,0,0,3,154,141,30602,24154,186,159,32286,23391
295,30,2,2,2,1,2,1,94,82,30604,24156,103,58,32287,23392
296,30,3,0,0,3,1,0,57,43,30607,24156,82,166,32290,23392
297,30,2,1,0,3,1,0,229,173,30609,24157,279,27,32293,23392
298,30,2,1,0,3,1,0,232,213,30611,24158,266,166,32296,23392
299,30,0,0,2,1,2,1,233,192,30611,24158,279,178,32297,23393
300,31,1,0,0,3,1,0,134,136,30612,24158,158,133,32300,23393
301,31,2,3,1,0,0,3,213,161,30614,24161,264,176,32300,23396
302,31,0,4,1,0,0,3,36,37,30614,24165,48,73,32300,23399
303,31,0,0,2,1,2,1,246,147,30614,24165,309,135,32301,23400
304,31,3,1,0,3,1,0,264,200,30617,24166,296,16,32304,23400
305,31,0,2,1,0,0,3,58,81,30617,24168,65,209,32304,23403
306,31,1,0,0,3,1,0,204,196,30618,24168,248,62,32307,23403
307,31,0,1,1,0,0,3,227,200,30618,24169,236,167,32307,23406
308,31,0,0,2,1,2,1,218,180,30618,24169,240,202,32308,23407
309,31,0,0,2,1,2,1,166,146,30618,24169,198,211,32309,23408
310,32,1,2,1,0,0,3,216,173,30619,24171,271,30,32309,23411
311,32,1,3,1,0,0,3,8,18,30620,24174,11,61,32309,23414
312,32,0,0,2,1,2,1,233,192,30620,24174,280,146,32310,23415
313,32,2,1,0,3,1,0,234,214,30622,24175,269,105,32313,23415
314,32,2,3,1,0,0,3,219,190,30624,24178,253,212,32313,23418
315,32,0,0,2,1,2,1,154,141,30624,24178,187,167,32314,23419
316,32,2,1,0,3,1,0,96,83,30626,24179,106,194,32317,23419
317,32,1,3,1,0,0,3,205,199,30627,24182,248,181,32317,23422
318,32,1,0,0,3,1,0,230,173,30628,24182,282,101,32320,23422
319,32,2,2,2,1,2,1,59,45,30630,24184,83,167,32321,23423
320,33,0,2,1,0,0,3,134,138,30630,24186,158,205,32321,23426
321,33,1,0,0,3,1,0,219,180,30631,24186,243,159,32324,23426
322,33,3,1,0,3,1,0,271,190,30634,24187,329,73,32327,23426
323,33,2,1,0,3,1,0,168,147,30636,24188,201,135,32330,23426
324,33,0,0,2,1,2,1,213,161,30636,24188,265,134,32331,23427
325,33,2,1,0,3,1,0,248,148,30638,24189,312,62,32334,23427
326,33,0,3,1,0,0,3,264,203,30638,24192,296,170,32334,23430
327,33,1,1,2,1,2,1,59,82,30639,24193,66,177,32335,23431
328,33,5,6,1,0,0,3,232,206,30644,24199,236,19,32335,23434
329,33,0,2,1,0,0,3,36,39,30644,24201,48,214,32335,23437
330,34,0,0,2,1,2,1,59,45,30644,24201,84,147,32336,23438
331,34,0,2,1,0,0,3,216,175,30644,24203,271,215,32336,23441
332,34,0,1,1,0,0,3,219,181,30644,24204,243,184,32336,23444
333,34,1,1,2,1,2,1,9,19,30645,24205,12,195,32337,23445
334,34,0,1,1,0,0,3,233,193,30645,24206,280,170,32337,23448
335,34,1,1,2,1,2,1,235,215,30646,24207,270,31,32338,23449
336,34,1,0,0,3,1,0,220,190,30647,24207,256,73,32341,23449
337,34,1,1,2,1,2,1,155,142,30648,24208,188,102,32342,23450
338,34,0,0,2,1,2,1,205,199,30648,24208,249,106,32343,23451
339,34,2,0,0,3,1,0,232,173,30650,24208,285,61,32346,23451
340,35,0,2,1,0,0,3,134,140,30650,24210,158,162,32346,23454
341,35,1,0,0,3,1,0,169,147,30651,24210,204,184,32349,23454
342,35,1,1,2,1,2,1,214,162,30652,24211,266,63,32350,23455
343,35,4,2,0,3,1,0,40,41,30656,24213,51,19,32353,23455
344,35,1,0,0,3,1,0,221,190,30657,24213,259,134,32356,23455
345,35,0,1,1,0,0,3,96,84,30657,24214,106,173,32356,23458
346,35,1,2,1,0,0,3,60,84,30658,24216,66,208,32356,23461
347,35,1,2,1,0,0,3,233,208,30659,24218,236,138,32356,23464
348,35,2,0,0,3,1,0,273,190,30661,24218,332,214,32359,23464
349,35,2,2,2,1,2,1,266,205,30663,24220,297,168,32360,23465
350,36,1,0,0,3,1,0,217,175,30664,24220,274,73,32363,23465
351,36,1,2,1,0,0,3,220,183,30665,24222,243,109,32363,23468
352,36,1,0,0,3,1,0,10,19,30666,24222,15,215,32366,23468
353,36,2,2,2,1,2,1,250,150,30668,24224,313,103,32367,23469
354,36,3,0,0,3,1,0,238,215,30671,24224,273,147,32370,23469
355,36,1,0,0,3,1,0,60,45,30672,24224,87,31,32373,23469
356,36,1,2,1,0,0,3,206,201,30673,24226,249,64,32373,23472
357,36,2,1,0,3,1,0,234,174,30675,24227,288,177,32376,23472
358,36,1,0,0,3,1,0,234,193,30676,24227,283,195,32379,23472
359,36,2,2,2,1,2,1,157,144,30678,24229,189,171,32380,23473
360,37,0,2,1,0,0,3,217,177,30678,24231,274,217,32380,23476
361,37,1,2,1,0,0,3,135,142,30679,24233,158,112,32380,23479
362,37,3,0,0,3,1,0,276,190,30682,24233,335,138,32383,23479
363,37,2,4,1,0,0,3,216,166,30684,24237,266,176,32383,23482
364,37,0,0,2,1,2,1,40,41,30684,24237,52,169,32384,23483
365,37,0,0,2,1,2,1,266,205,30684,24237,298,163,32385,23484
366,37,1,0,0,3,1,0,222,190,30685,24237,262,208,32388,23484
367,37,0,0,2,1,2,1,96,84,30685,24237,107,20,32389,23485
368,37,0,1,1,0,0,3,60,85,30685,24238,66,66,32389,23488
369,37,1,0,0,3,1,0,234,208,30686,24238,239,184,32392,23488
370,38,1,1,2,1,2,1,221,184,30687,24239,244,148,32393,23489
371,38,3,0,0,3,1,0,13,19,30690,24239,18,177,32396,23489
372,38,2,2,2,1,2,1,171,149,30692,24241,205,196,32397,23490
373,38,2,3,1,0,0,3,252,153,30694,24244,313,174,32397,23493
374,38,5,2,0,3,1,0,239,195,30699,24246,286,73,32400,23493
375,38,1,0,0,3,1,0,239,215,30700,24246,276,215,32403,23493
376,38,1,0,0,3,1,0,158,144,30701,24246,192,64,32406,23493
377,38,1,0,0,3,1,0,61,45,30702,24246,90,103,32409,23493
378,38,3,1,0,3,1,0,209,202,30705,24247,252,31,32412,23493
379,38,0,0,2,1,2,1,234,174,30705,24247,289,135,32413,23494
0,1,2,2,2,1,2,1,219,179,30707,24249,275,185,32414,23495
1,1,1,0,0,3,1,0,1,0,30708,24249,3,148,32417,23495
2,1,3,0,0,3,1,0,219,166,30711,24249,269,112,32420,23495
3,1,3,3,2,1,2,1,218,166,30714,24252,242,32,32421,23496
4,1,0,0,2,1,2,1,222,190,30714,24252,263,74,32422,23497
5,1,0,2,1,0,0,3,158,146,30714,24254,192,179,32422,23500
6,1,2,0,0,3,1,0,2,0,30716,24254,3,169,32425,23500
7,1,0,0,2,1,2,1,209,202,30716,24254,253,178,32426,23501
8,1,1,2,1,0,0,3,70,63,30717,24256,86,220,32426,23504
9,1,3,0,0,3,1,0,269,205,30720,24256,301,66,32429,23504
10,2,2,0,0,3,1,0,223,184,30722,24256,247,61,32432,23504
11,2,0,0,2,1,2,1,171,149,30722,24256,206,1,32433,23505
12,2,0,1,1,0,0,3,40,42,30722,24257,52,138,32433,23508
13,2,1,1,2,1,2,1,253,154,30723,24258,314,139,32434,23509
14,2,0,1,1,0,0,3,96,85,30723,24259,107,3,32434,23512
15,2,1,1,2,1,2,1,62,46,30724,24260,91,164,32435,23513
16,2,1,2,1,0,0,3,235,176,30725,24262,289,199,32435,23516
17,2,1,1,2,1,2,1,235,209,30726,24263,240,178,32436,23517
18,2,2,0,0,3,1,0,241,195,30728,24263,289,143,32439,23517
19,2,1,2,1,0,0,3,201,212,30729,24265,242,177,32439,23520
20,3,1,2,1,0,0,3,220,181,30730,24267,275,181,32439,23523
21,3,0,0,2,1,2,1,1,0,30730,24267,4,33,32440,23524
22,3,1,0,0,3,1,0,219,166,30731,24267,245,74,32443,23524
23,3,1,2,1,0,0,3,71,65,30732,24269,86,151,32443,23527
24,3,1,1,2,1,2,1,223,191,30733,24270,264,178,32444,23528
25,3,3,0,0,3,1,0,161,146,30736,24270,195,112,32447,23528
26,3,2,1,0,3,1,0,4,1,30738,24271,6,66,32450,23528
27,3,1,0,0,3,1,0,210,202,30739,24271,256,169,32453,23528
28,3,1,2,1,0,0,3,236,178,30740,24273,289,188,32453,23531
29,3,1,1,2,1,2,1,220,167,30741,24274,270,221,32454,23532
30,4,0,0,2,1,2,1,201,212,30741,24274,243,4,32455,23533
31,4,0,1,1,0,0,3,171,150,30741,24275,206,141,32455,23536
32,4,1,1,2,1,2,1,41,43,30742,24276,53,180,32456,23537
33,4,1,0,0,3,1,0,270,205,30743,24276,304,164,32459,23537
34,4,2,1,0,3,1,0,225,192,30745,24277,267,61,32462,23537
35,4,0,1,1,0,0,3,96,86,30745,24278,107,202,32462,23540
36,4,0,1,1,0,0,3,62,47,30745,24279,91,142,32462,23543
37,4,1,0,0,3,1,0,236,209,30746,24279,243,1,32465,23543
38,4,1,3,1,0,0,3,242,198,30747,24282,289,191,32465,23546
39,4,2,2,2,1,2,1,225,186,30749,24284,248,144,32466,23547
40,5,1,0,0,3,1,0,221,181,30750,24284,278,66,32469,23547
41,5,0,0,2,1,2,1,1,0,30750,24284,5,113,32470,23548
42,5,1,1,2,1,2,1,221,168,30751,24285,271,170,32471,23549
43,5,3,1,0,3,1,0,256,155,30754,24286,317,33,32474,23549
44,5,1,2,1,0,0,3,72,67,30755,24288,86,181,32474,23552
45,5,1,1,2,1,2,1,162,147,30756,24289,196,182,32475,23553
46,5,3,3,2,1,2,1,7,4,30759,24292,7,75,32476,23554
47,5,3,0,0,3,1,0,213,202,30762,24292,259,178,32479,23554
48,5,2,0,0,3,1,0,238,178,30764,24292,292,221,32482,23554
49,5,0,1,1,0,0,3,219,167,30764,24293,245,154,32482,23557
50,6,3,1,0,3,1,0,228,187,30767,24294,251,141,32485,23557
51,6,0,3,1,0,0,3,201,215,30767,24297,243,194,32485,23560
52,6,0,1,1,0,0,3,171,151,30767,24298,206,183,32485,23563
53,6,2,0,0,3,1,0,74,67,30769,24298,89,164,32488,23563
54,6,1,1,2,1,2,1,226,193,30770,24299,268,2,32489,23564
55,6,0,1,1,0,0,3,96,87,30770,24300,107,145,32489,23567
56,6,1,0,0,3,1,0,237,209,30771,24300,246,202,32492,23567
57,6,0,1,1,0,0,3,270,206,30771,24301,304,147,32492,23570
58,6,0,3,1,0,0,3,62,50,30771,24304,91,7,32492,23573
59,6,2,2,2,1,2,1,43,45,30773,24306,54,222,32493,23574
60,7,0,0,2,1,2,1,221,181,30773,24306,279,76,32494,23575
61,7,1,4,1,0,0,3,2,4,30774,24310,5,173,32494,23578
62,7,1,1,2,1,2,1,220,168,30775,24311,246,179,32495,23579
63,7,0,0,2,1,2,1,256,155,30775,24311,318,67,32496,23580
64,7,0,1,1,0,0,3,162,148,30775,24312,196,36,32496,23583
65,7,4,1,0,3,1,0,11,5,30779,24313,10,61,32499,23583
66,7,0,0,2,1,2,1,213,202,30779,24313,260,155,32500,23584
67,7,2,1,0,3,1,0,240,179,30781,24314,295,182,32503,23584
68,7,0,2,1,0,0,3,221,170,30781,24316,271,184,32503,23587
69,7,1,0,0,3,1,0,243,198,30782,24316,292,113,32506,23587
70,8,1,2,1,0,0,3,229,189,30783,24318,251,186,32506,23590
71,8,1,1,2,1,2,1,172,152,30784,24319,207,37,32507,23591
72,8,2,4,1,0,0,3,76,71,30786,24323,89,144,32507,23594
73,8,3,0,0,3,1,0,229,193,30789,24323,271,7,32510,23594
74,8,2,2,2,1,2,1,98,89,30791,24325,108,195,32511,23595
75,8,0,2,1,0,0,3,62,52,30791,24327,91,205,32511,23598
76,8,3,1,0,3,1,0,216,203,30794,24328,263,147,32514,23598
77,8,1,1,2,1,2,1,238,210,30795,24329,247,146,32515,23599
78,8,0,2,1,0,0,3,201,217,30795,24331,243,225,32515,23602
79,8,2,1,0,3,1,0,272,207,30797,24332,307,2,32518,23602
80,9,2,0,0,3,1,0,223,181,30799,24332,282,155,32521,23602
81,9,0,1,1,0,0,3,2,5,30799,24333,5,187,32521,23605
82,9,2,2,2,1,2,1,223,172,30801,24335,272,180,32522,23606
83,9,1,0,0,3,1,0,44,45,30802,24335,57,182,32525,23606
84,9,0,1,1,0,0,3,256,156,30802,24336,318,116,32525,23609
85,9,2,2,2,1,2,1,164,150,30804,24338,197,174,32526,23610
86,9,0,2,1,0,0,3,11,7,30804,24340,10,167,32526,23613
87,9,1,2,1,0,0,3,241,181,30805,24342,295,79,32526,23616
88,9,2,1,0,3,1,0,245,199,30807,24343,295,67,32529,23616
89,9,3,0,0,3,1,0,223,168,30810,24343,249,61,32532,23616
90,10,1,1,2,1,2,1,202,218,30811,24344,244,117,32533,23617
91,10,4,1,0,3,1,0,227,169,30815,24345,252,2,32536,23617
92,10,1,0,0,3,1,0,77,71,30816,24345,92,7,32539,23617
93,10,0,0,2,1,2,1,272,207,30816,24345,308,145,32540,23618
94,10,2,1,0,3,1,0,231,194,30818,24346,274,146,32543,23618
95,10,1,0,0,3,1,0,63,52,30819,24346,94,186,32546,23618
96,10,4,0,0,3,1,0,220,203,30823,24346,266,205,32549,23618
97,10,0,2,1,0,0,3,238,212,30823,24348,247,40,32549,23621
98,10,2,0,0,3,1,0,231,189,30825,24348,254,195,32552,23621
99,10,1,4,1,0,0,3,99,93,30826,24352,108,228,32552,23624
100,11,0,0,2,1,2,1,223,181,30826,24352,283,181,32553,23625
101,11,0,0,2,1,2,1,202,218,30826,24352,245,156,32554,23626
102,11,0,0,2,1,2,1,2,5,30826,24352,6,168,32555,23627
103,11,0,1,1,0,0,3,172,153,30826,24353,207,70,32555,23630
104,11,0,1,1,0,0,3,223,173,30826,24354,272,5,32555,23633
105,11,0,0,2,1,2,1,44,45,30826,24354,58,80,32556,23634
106,11,0,0,2,1,2,1,164,150,30826,24354,198,148,32557,23635
107,11,2,1,0,3,1,0,243,182,30828,24355,298,61,32560,23635
108,11,2,2,2,1,2,1,258,158,30830,24357,319,188,32561,23636
109,11,0,0,2,1,2,1,245,199,30830,24357,296,175,32562,23637
110,12,0,1,1,0,0,3,231,190,30830,24358,254,43,32562,23640
111,12,1,2,1,0,0,3,228,171,30831,24360,252,208,32562,23643
112,12,1,0,0,3,1,0,78,71,30832,24360,95,146,32565,23643
113,12,0,0,2,1,2,1,231,194,30832,24360,275,229,32566,23644
114,12,1,1,2,1,2,1,100,94,30833,24361,109,118,32567,23645
115,12,2,4,1,0,0,3,65,56,30835,24365,94,185,32567,23648
116,12,2,0,0,3,1,0,13,7,30837,24365,13,7,32570,23648
117,12,0,2,1,0,0,3,220,205,30837,24367,266,148,32570,23651
118,12,0,1,1,0,0,3,272,208,30837,24368,308,189,32570,23654
119,12,0,0,2,1,2,1,238,212,30837,24368,248,196,32571,23655
120,13,1,0,0,3,1,0,224,181,30838,24368,286,5,32574,23655
121,13,2,1,0,3,1,0,204,219,30840,24369,248,80,32577,23655
122,13,1,5,1,0,0,3,3,10,30841,24374,6,151,32577,23658
123,13,1,0,0,3,1,0,173,153,30842,24374,210,175,32580,23658
124,13,1,0,0,3,1,0,244,182,30843,24374,301,156,32583,23658
125,13,0,1,1,0,0,3,223,174,30843,24375,272,64,32583,23661
126,13,0,0,2,1,2,1,44,45,30843,24375,59,71,32584,23662
127,13,1,0,0,3,1,0,246,199,30844,24375,299,188,32587,23662
128,13,0,2,1,0,0,3,164,152,30844,24377,198,171,32587,23665
129,13,1,1,2,1,2,1,259,159,30845,24378,320,182,32588,23666
130,14,1,1,2,1,2,1,232,191,30846,24379,255,186,32589,23667
131,14,0,1,1,0,0,3,3,11,30846,24380,6,211,32589,23670
132,14,0,0,2,1,2,1,78,71,30846,24380,96,44,32590,23671
133,14,4,1,0,3,1,0,276,209,30850,24381,311,146,32593,23671
134,14,0,0,2,1,2,1,231,194,30850,24381,276,190,32594,23672
135,14,0,1,1,0,0,3,100,95,30850,24382,109,74,32594,23675
136,14,2,0,0,3,1,0,222,205,30852,24382,269,196,32597,23675
137,14,0,1,1,0,0,3,238,213,30852,24383,248,121,32597,23678
138,14,1,1,2,1,2,1,229,172,30853,24384,253,149,32598,23679
139,14,1,2,1,0,0,3,14,9,30854,24386,13,232,32598,23682
140,15,1,1,2,1,2,1,225,182,30855,24387,287,212,32599,23683
141,15,3,3,2,1,2,1,207,222,30858,24390,249,65,32600,23684
142,15,1,3,1,0,0,3,174,156,30859,24393,210,191,32600,23687
143,15,1,1,2,1,2,1,45,46,30860,24394,60,183,32601,23688
144,15,2,1,0,3,1,0,166,153,30862,24395,201,5,32604,23688
145,15,0,1,1,0,0,3,100,96,30862,24396,109,159,32604,23691
146,15,2,0,0,3,1,0,67,56,30864,24396,97,175,32607,23691
147,15,0,4,1,0,0,3,244,186,30864,24400,301,10,32607,23694
148,15,4,0,0,3,1,0,250,199,30868,24400,302,171,32610,23694
149,15,4,0,0,3,1,0,263,159,30872,24400,323,151,32613,23694
150,16,2,2,2,1,2,1,234,193,30874,24402,256,81,32614,23695
151,16,0,2,1,0,0,3,3,13,30874,24404,6,152,32614,23698
152,16,1,0,0,3,1,0,224,174,30875,24404,275,146,32617,23698
153,16,1,1,2,1,2,1,230,173,30876,24405,254,187,32618,23699
154,16,1,2,1,0,0,3,79,73,30877,24407,96,124,32618,23702
155,16,2,1,0,3,1,0,278,210,30879,24408,314,44,32621,23702
156,16,2,0,0,3,1,0,233,194,30881,24408,279,74,32624,23702
157,16,1,2,1,0,0,3,15,11,30882,24410,13,199,32624,23705
158,16,2,0,0,3,1,0,240,213,30884,24410,251,232,32627,23705
159,16,0,1,1,0,0,3,222,206,30884,24411,269,193,32627,23708
160,17,1,0,0,3,1,0,208,222,30885,24411,252,183,32630,23708
161,17,1,1,2,1,2,1,235,194,30886,24412,257,160,32631,23709
162,17,1,1,2,1,2,1,175,157,30887,24413,211,172,32632,23710
163,17,1,1,2,1,2,1,46,47,30888,24414,61,213,32633,23711
164,17,2,0,0,3,1,0,265,159,30890,24414,326,65,32636,23711
165,17,3,0,0,3,1,0,253,199,30893,24414,305,10,32639,23711
166,17,0,1,1,0,0,3,166,154,30893,24415,201,155,32639,23714
167,17,0,4,1,0,0,3,100,100,30893,24419,109,194,32639,23717
168,17,0,3,1,0,0,3,67,59,30893,24422,97,154,32639,23720
169,17,1,0,0,3,1,0,245,186,30894,24422,304,5,32642,23720
170,18,2,1,0,3,1,0,226,175,30896,24423,278,199,32645,23720
171,18,3,2,0,3,1,0,82,75,30899,24425,99,81,32648,23720
172,18,1,0,0,3,1,0,279,210,30900,24425,317,175,32651,23720
173,18,2,1,0,3,1,0,235,195,30902,24426,282,124,32654,23720
174,18,2,1,0,3,1,0,17,12,30904,24427,16,187,32657,23720
175,18,1,1,2,1,2,1,223,207,30905,24428,270,45,32658,23721
176,18,1,0,0,3,1,0,241,213,30906,24428,254,74,32661,23721
177,18,3,2,0,3,1,0,6,15,30909,24430,9,146,32664,23721
178,18,1,2,1,0,0,3,226,184,30910,24432,287,235,32664,23724
179,18,0,1,1,0,0,3,230,174,30910,24433,254,196,32664,23727
180,19,0,0,2,1,2,1,235,194,30910,24433,258,184,32665,23728
181,19,0,0,2,1,2,1,208,222,30910,24433,253,214,32666,23729
182,19,1,5,1,0,0,3,176,162,30911,24438,211,157,32666,23732
183,19,2,1,0,3,1,0,48,48,30913,24439,64,5,32669,23732
184,19,1,1,2,1,2,1,266,160,30914,24440,327,11,32670,23733
185,19,1,0,0,3,1,0,101,100,30915,24440,112,172,32673,23733
186,19,3,0,0,3,1,0,244,213,30918,24440,257,194,32676,23733
187,19,1,0,0,3,1,0,254,199,30919,24440,308,146,32679,23733
188,19,0,3,1,0,0,3,67,62,30919,24443,97,68,32679,23736
189,19,2,1,0,3,1,0,247,187,30921,24444,307,155,32682,23736
190,20,3,1,0,3,1,0,229,185,30924,24445,290,45,32685,23736
191,20,1,0,0,3,1,0,7,15,30925,24445,12,81,32688,23736
192,20,3,2,0,3,1,0,229,177,30928,24447,281,196,32691,23736
193,20,0,1,1,0,0,3,82,76,30928,24448,99,178,32691,23739
194,20,1,0,0,3,1,0,236,195,30929,24448,285,160,32694,23739
195,20,0,1,1,0,0,3,166,155,30929,24449,201,202,32694,23742
196,20,1,2,1,0,0,3,18,14,30930,24451,16,127,32694,23745
197,20,1,1,2,1,2,1,224,208,30931,24452,271,75,32695,23746
198,20,2,1,0,3,1,0,281,211,30933,24453,320,187,32698,23746
199,20,1,1,2,1,2,1,231,175,30934,24454,255,236,32699,23747
200,21,2,1,0,3,1,0,237,195,30936,24455,261,172,32702,23747
201,21,0,1,1,0,0,3,208,223,30936,24456,253,158,32702,23750
202,21,1,1,2,1,2,1,177,163,30937,24457,212,147,32703,23751
203,21,0,0,2,1,2,1,48,48,30937,24457,65,12,32704,23752
204,21,2,1,0,3,1,0,283,212,30939,24458,323,184,32707,23752
205,21,2,0,0,3,1,0,103,100,30941,24458,115,157,32710,23752
206,21,0,0,2,1,2,1,67,62,30941,24458,98,6,32711,23753
207,21,1,0,0,3,1,0,245,213,30942,24458,260,68,32714,23753
208,21,1,1,2,1,2,1,255,200,30943,24459,309,215,32715,23754
209,21,1,0,0,3,1,0,267,160,30944,24459,330,196,32718,23754
210,22,0,1,1,0,0,3,229,186,30944,24460,290,130,32718,23757
211,22,0,1,1,0,0,3,7,16,30944,24461,12,190,32718,23760
212,22,3,1,0,3,1,0,232,178,30947,24462,284,81,32721,23760
213,22,1,0,0,3,1,0,232,175,30948,24462,258,178,32724,23760
214,22,0,0,2,1,2,1,267,160,30948,24462,331,237,32725,23761
215,22,1,1,2,1,2,1,83,77,30949,24463,100,185,32726,23762
216,22,4,4,2,1,2,1,170,159,30953,24467,202,76,32727,23763
217,22,1,1,2,1,2,1,19,15,30954,24468,17,161,32728,23764
218,22,1,2,1,0,0,3,248,189,30955,24470,307,48,32728,23767
219,22,0,4,1,0,0,3,224,212,30955,24474,271,197,32728,23770
220,23,1,1,2,1,2,1,49,49,30956,24475,66,203,32729,23771
221,23,0,0,2,1,2,1,237,195,30956,24475,262,216,32730,23772
222,23,4,3,0,3,1,0,212,226,30960,24478,256,147,32733,23772
223,23,0,3,1,0,0,3,177,166,30960,24481,212,15,32733,23775
224,23,1,0,0,3,1,0,256,200,30961,24481,312,196,32736,23775
225,23,4,2,0,3,1,0,287,214,30965,24483,326,68,32739,23775
226,23,1,1,2,1,2,1,237,196,30966,24484,286,173,32740,23776
227,23,1,2,1,0,0,3,104,102,30967,24486,115,9,32740,23779
228,23,2,3,1,0,0,3,69,65,30969,24489,98,161,32740,23782
229,23,0,0,2,1,2,1,245,213,30969,24489,261,158,32741,23783
230,24,2,3,1,0,0,3,231,189,30971,24492,290,181,32741,23786
231,24,1,2,1,0,0,3,8,18,30972,24494,12,79,32741,23789
232,24,3,1,0,3,1,0,235,179,30975,24495,287,161,32744,23789
233,24,1,1,2,1,2,1,268,161,30976,24496,332,191,32745,23790
234,24,2,0,0,3,1,0,172,159,30978,24496,205,81,32748,23790
235,24,1,1,2,1,2,1,20,16,30979,24497,18,186,32749,23791
236,24,1,0,0,3,1,0,225,212,30980,24497,274,68,32752,23791
237,24,2,0,0,3,1,0,250,189,30982,24497,310,130,32755,23791
238,24,2,1,0,3,1,0,234,176,30984,24498,261,197,32758,23791
239,24,0,0,2,1,2,1,256,200,30984,24498,313,49,32759,23792
240,25,0,0,2,1,2,1,237,195,30984,24498,263,16,32760,23793
241,25,0,1,1,0,0,3,212,227,30984,24499,256,199,32760,23796
242,25,3,1,0,3,1,0,52,50,30987,24500,69,147,32763,23796
243,25,0,0,2,1,2,1,83,77,30987,24500,101,10,32764,23797
244,25,0,3,1,0,0,3,104,105,30987,24503,115,164,32764,23800
245,25,1,0,0,3,1,0,70,65,30988,24503,101,203,32767,23800
246,25,3,2,0,3,1,0,248,215,30991,24505,264,173,32770,23800
247,25,0,1,1,0,0,3,287,215,30991,24506,326,219,32770,23803
248,25,0,1,1,0,0,3,237,197,30991,24507,286,161,32770,23806
249,25,3,2,0,3,1,0,180,168,30994,24509,215,237,32773,23806
250,26,2,0,0,3,1,0,233,189,30996,24509,293,68,32776,23806
251,26,2,1,0,3,1,0,10,19,30998,24510,15,186,32779,23806
252,26,0,1,1,0,0,3,235,180,30998,24511,287,82,32779,23809
253,26,0,1,1,0,0,3,52,51,30998,24512,69,133,32779,23812
254,26,1,1,2,1,2,1,235,177,30999,24513,262,174,32780,23813
255,26,1,2,1,0,0,3,269,163,31000,24515,332,84,32780,23816
256,26,1,0,0,3,1,0,173,159,31001,24515,208,161,32783,23816
257,26,0,1,1,0,0,3,20,17,31001,24516,18,200,32783,23819
258,26,1,4,1,0,0,3,257,204,31002,24520,313,194,32783,23822
259,26,3,1,0,3,1,0,253,190,31005,24521,313,181,32786,23822
260,27,3,1,0,3,1,0,240,196,31008,24522,266,147,32789,23822
261,27,2,0,0,3,1,0,214,227,31010,24522,259,49,32792,23822
262,27,0,3,1,0,0,3,180,171,31010,24525,215,206,32792,23825
263,27,2,1,0,3,1,0,85,78,31012,24526,104,161,32795,23825
264,27,1,2,1,0,0,3,238,199,31013,24528,286,222,32795,23828
265,27,0,2,1,0,0,3,104,107,31013,24530,115,202,32795,23831
266,27,1,1,2,1,2,1,226,213,31014,24531,275,11,32796,23832
267,27,0,0,2,1,2,1,248,215,31014,24531,265,165,32797,23833
268,27,1,2,1,0,0,3,288,217,31015,24533,326,19,32797,23836
269,27,0,2,1,0,0,3,70,67,31015,24535,101,240,32797,23839
270,28,2,2,2,1,2,1,12,21,31017,24537,16,69,32798,23840
271,28,2,1,0,3,1,0,182,172,31019,24538,218,194,32801,23840
272,28,2,0,0,3,1,0,237,180,31021,24538,290,174,32804,23840
273,28,1,3,1,0,0,3,53,54,31022,24541,69,164,32804,23843
274,28,1,0,0,3,1,0,270,163,31023,24541,335,181,32807,23843
275,28,1,1,2,1,2,1,174,160,31024,24542,209,187,32808,23844
276,28,2,1,0,3,1,0,22,18,31026,24543,21,161,32811,23844
277,28,1,1,2,1,2,1,254,191,31027,24544,314,83,32812,23845
278,28,1,0,0,3,1,0,234,189,31028,24544,296,200,32815,23845
279,28,1,0,0,3,1,0,258,204,31029,24544,316,84,32818,23845
0,1,0,1,1,0,0,3,231,216,31029,24545,256,3,32818,23848
1,1,0,1,1,0,0,3,234,190,31029,24546,296,136,32818,23851
2,1,1,0,0,3,1,0,108,101,31030,24546,123,187,32821,23851
3,1,0,2,1,0,0,3,240,198,31030,24548,266,177,32821,23854
4,1,0,3,1,0,0,3,12,24,31030,24551,16,86,32821,23857
5,1,0,0,2,1,2,1,237,180,31030,24551,291,195,32822,23858
6,1,0,1,1,0,0,3,235,178,31030,24552,262,150,32822,23861
7,1,1,0,0,3,1,0,23,18,31031,24552,24,49,32825,23861
8,1,3,0,0,3,1,0,251,215,31034,24552,268,0,32828,23861
9,1,2,0,0,3,1,0,256,191,31036,24552,317,206,32831,23861
10,2,1,0,0,3,1,0,215,227,31037,24552,262,165,32834,23861
11,2,2,2,2,1,2,1,240,201,31039,24554,287,162,32835,23862
12,2,1,2,1,0,0,3,183,174,31040,24556,218,184,32835,23865
13,2,1,1,2,1,2,1,1,1,31041,24557,1,223,32836,23866
14,2,5,3,0,3,1,0,58,57,31046,24560,72,164,32839,23866
15,2,1,0,0,3,1,0,271,163,31047,24560,338,78,32842,23866
16,2,1,1,2,1,2,1,175,161,31048,24561,210,20,32843,23867
17,2,1,0,0,3,1,0,71,67,31049,24561,104,164,32846,23867
18,2,1,1,2,1,2,1,1,1,31050,24562,1,12,32847,23868
19,2,2,1,0,3,1,0,228,214,31052,24563,278,202,32850,23868
20,3,1,3,1,0,0,3,236,181,31053,24566,262,209,32850,23871
21,3,1,2,1,0,0,3,109,103,31054,24568,123,89,32850,23874
22,3,0,1,1,0,0,3,240,199,31054,24569,266,226,32850,23877
23,3,1,2,1,0,0,3,13,26,31055,24571,16,52,32850,23880
24,3,1,0,0,3,1,0,176,161,31056,24571,213,187,32853,23880
25,3,0,3,1,0,0,3,23,21,31056,24574,24,198,32853,23883
26,3,2,0,0,3,1,0,258,191,31058,24574,320,0,32856,23883
27,3,1,0,0,3,1,0,252,215,31059,24574,271,136,32859,23883
28,3,0,0,2,1,2,1,231,216,31059,24574,257,178,32860,23884
29,3,1,0,0,3,1,0,235,190,31060,24574,299,3,32863,23884
30,4,1,1,2,1,2,1,238,181,31061,24575,292,165,32864,23885
31,4,0,0,2,1,2,1,215,227,31061,24575,263,21,32865,23886
32,4,0,0,2,1,2,1,183,174,31061,24575,219,79,32866,23887
33,4,1,0,0,3,1,0,2,1,31062,24575,4,164,32869,23887
34,4,2,0,0,3,1,0,60,57,31064,24575,75,165,32872,23887
35,4,0,1,1,0,0,3,271,164,31064,24576,338,153,32872,23890
36,4,0,2,1,0,0,3,71,69,31064,24578,104,190,32872,23893
37,4,0,1,1,0,0,3,1,2,31064,24579,1,165,32872,23896
38,4,2,2,2,1,2,1,230,216,31066,24581,279,13,32873,23897
39,4,2,1,0,3,1,0,242,200,31068,24582,269,202,32876,23897
40,5,3,1,0,3,1,0,234,217,31071,24583,260,184,32879,23897
41,5,1,1,2,1,2,1,236,191,31072,24584,300,179,32880,23898
42,5,0,0,2,1,2,1,109,103,31072,24584,124,1,32881,23899
43,5,2,1,0,3,1,0,15,27,31074,24585,19,136,32884,23899
44,5,1,0,0,3,1,0,237,181,31075,24585,265,52,32887,23899
45,5,0,1,1,0,0,3,240,202,31075,24586,287,212,32887,23902
46,5,2,2,2,1,2,1,178,163,31077,24588,214,90,32888,23903
47,5,2,1,0,3,1,0,25,22,31079,24589,27,3,32891,23903
48,5,1,0,0,3,1,0,253,215,31080,24589,274,198,32894,23903
49,5,1,0,0,3,1,0,259,191,31081,24589,323,226,32897,23903
50,6,0,0,2,1,2,1,234,217,31081,24589,261,203,32898,23904
51,6,1,0,0,3,1,0,216,227,31082,24589,266,79,32901,23904
52,6,5,1,0,3,1,0,247,201,31087,24590,272,165,32904,23904
53,6,2,0,0,3,1,0,185,174,31089,24590,222,153,32907,23904
54,6,3,0,0,3,1,0,241,181,31092,24590,295,13,32910,23904
55,6,1,0,0,3,1,0,3,1,31093,24590,7,165,32913,23904
56,6,2,0,0,3,1,0,62,57,31095,24590,78,164,32916,23904
57,6,3,0,0,3,1,0,74,69,31098,24590,107,212,32919,23904
58,6,1,1,2,1,2,1,2,3,31099,24591,2,191,32920,23905
59,6,3,2,0,3,1,0,233,218,31102,24593,282,21,32923,23905
60,7,0,3,1,0,0,3,15,30,31102,24596,19,229,32923,23908
61,7,0,0,2,1,2,1,253,215,31102,24596,275,180,32924,23909
62,7,0,1,1,0,0,3,236,192,31102,24597,300,168,32924,23912
63,7,1,0,0,3,1,0,110,103,31103,24597,127,52,32927,23912
64,7,1,1,2,1,2,1,272,165,31104,24598,339,137,32928,23913
65,7,2,1,0,3,1,0,242,203,31106,24599,290,3,32931,23913
66,7,3,0,0,3,1,0,181,163,31109,24599,217,198,32934,23913
67,7,1,0,0,3,1,0,75,69,31110,24599,110,1,32937,23913
68,7,0,1,1,0,0,3,25,23,31110,24600,27,206,32937,23916
69,7,2,0,0,3,1,0,239,181,31112,24600,268,184,32940,23916
70,8,1,0,0,3,1,0,217,227,31113,24600,269,165,32943,23916
71,8,4,0,0,3,1,0,251,201,31117,24600,275,21,32946,23916
72,8,1,2,1,0,0,3,186,176,31118,24602,222,93,32946,23919
73,8,0,2,1,0,0,3,241,183,31118,24604,295,168,32946,23922
74,8,0,1,1,0,0,3,3,2,31118,24605,7,215,32946,23925
75,8,4,1,0,3,1,0,6,4,31122,24606,5,153,32949,23925
76,8,3,0,0,3,1,0,237,217,31125,24606,264,13,32952,23925
77,8,1,1,2,1,2,1,260,192,31126,24607,324,165,32953,23926
78,8,0,2,1,0,0,3,233,220,31126,24609,282,82,32953,23929
79,8,1,0,0,3,1,0,63,57,31127,24609,81,191,32956,23929
80,9,3,1,0,3,1,0,78,70,31130,24610,113,198,32959,23929
81,9,0,4,1,0,0,3,236,196,31130,24614,300,209,32959,23932
82,9,0,1,1,0,0,3,15,31,31130,24615,19,6,32959,23935
83,9,0,0,2,1,2,1,239,181,31130,24615,269,181,32960,23936
84,9,1,0,0,3,1,0,273,165,31131,24615,342,1,32963,23936
85,9,2,1,0,3,1,0,244,204,31133,24616,293,137,32966,23936
86,9,2,2,2,1,2,1,27,25,31135,24618,28,185,32967,23937
87,9,1,3,1,0,0,3,254,218,31136,24621,275,232,32967,23940
88,9,0,1,1,0,0,3,110,104,31136,24622,127,171,32967,23943
89,9,0,0,2,1,2,1,181,163,31136,24622,218,53,32968,23944
90,10,0,0,2,1,2,1,241,183,31136,24622,296,166,32969,23945
91,10,2,1,0,3,1,0,65,58,31138,24623,84,215,32972,23945
92,10,2,1,0,3,1,0,253,202,31140,24624,278,82,32975,23945
93,10,2,1,0,3,1,0,219,228,31142,24625,272,191,32978,23945
94,10,0,3,1,0,0,3,186,179,31142,24628,222,4,32978,23948
95,10,0,1,1,0,0,3,3,3,31142,24629,7,96,32978,23951
96,10,0,1,1,0,0,3,27,26,31142,24630,28,171,32978,23954
97,10,3,4,1,0,0,3,236,224,31145,24634,282,156,32978,23957
98,10,4,5,1,0,0,3,241,222,31149,24639,264,168,32978,23960
99,10,2,2,2,1,2,1,262,194,31151,24641,325,22,32979,23961
100,11,1,2,1,0,0,3,274,167,31152,24643,342,201,32979,23964
101,11,1,1,2,1,2,1,111,105,31153,24644,128,233,32980,23965
102,11,1,1,2,1,2,1,16,32,31154,24645,20,172,32981,23966
103,11,2,1,0,3,1,0,188,180,31156,24646,225,181,32984,23966
104,11,1,2,1,0,0,3,182,165,31157,24648,218,9,32984,23969
105,11,0,3,1,0,0,3,78,73,31157,24651,113,188,32984,23972
106,11,0,2,1,0,0,3,6,6,31157,24653,5,56,32984,23975
107,11,1,1,2,1,2,1,255,219,31158,24654,276,14,32985,23976
108,11,2,2,2,1,2,1,241,183,31160,24656,270,172,32986,23977
109,11,2,3,1,0,0,3,246,207,31162,24659,293,212,32986,23980
110,12,2,1,0,3,1,0,243,223,31164,24660,267,156,32989,23980
111,12,0,0,2,1,2,1,65,58,31164,24660,85,97,32990,23981
112,12,0,0,2,1,2,1,236,196,31164,24660,301,23,32991,23982
113,12,1,1,2,1,2,1,254,203,31165,24661,279,169,32992,23983
114,12,1,1,2,1,2,1,220,229,31166,24662,273,138,32993,23984
115,12,2,0,0,3,1,0,243,183,31168,24662,299,191,32996,23984
116,12,2,2,2,1,2,1,5,5,31170,24664,8,5,32997,23985
117,12,1,1,2,1,2,1,28,27,31171,24665,29,167,32998,23986
118,12,4,0,0,3,1,0,240,224,31175,24665,285,215,33001,23986
119,12,2,1,0,3,1,0,264,195,31177,24666,328,82,33004,23986
120,13,1,0,0,3,1,0,112,105,31178,24666,131,9,33007,23986
121,13,1,0,0,3,1,0,17,32,31179,24666,23,14,33010,23986
122,13,0,1,1,0,0,3,188,181,31179,24667,225,59,33010,23989
123,13,1,2,1,0,0,3,242,185,31180,24669,270,215,33010,23992
124,13,1,1,2,1,2,1,275,168,31181,24670,343,189,33011,23993
125,13,1,3,1,0,0,3,247,210,31182,24673,293,175,33011,23996
126,13,1,0,0,3,1,0,183,165,31183,24673,221,233,33014,23996
127,13,0,0,2,1,2,1,78,73,31183,24673,114,182,33015,23997
128,13,1,0,0,3,1,0,7,6,31184,24673,8,201,33018,23997
129,13,1,1,2,1,2,1,256,220,31185,24674,277,173,33019,23998
130,14,2,1,0,3,1,0,266,196,31187,24675,331,97,33022,23998
131,14,6,0,0,3,1,0,260,203,31193,24675,282,156,33025,23998
132,14,1,1,2,1,2,1,221,230,31194,24676,274,60,33026,23999
133,14,1,2,1,0,0,3,18,34,31195,24678,23,172,33026,24002
134,14,3,0,0,3,1,0,246,183,31198,24678,302,5,33029,24002
135,14,2,0,0,3,1,0,7,5,31200,24678,11,138,33032,24002
136,14,1,2,1,0,0,3,29,29,31201,24680,29,85,33032,24005
137,14,1,1,2,1,2,1,241,225,31202,24681,286,192,33033,24006
138,14,2,2,2,1,2,1,245,225,31204,24683,268,168,33034,24007
139,14,1,1,2,1,2,1,237,197,31205,24684,302,216,33035,24008
140,15,0,0,2,1,2,1,221,230,31205,24684,275,216,33036,24009
141,15,1,1,2,1,2,1,113,106,31206,24685,132,24,33037,24010
142,15,0,3,1,0,0,3,188,184,31206,24688,225,178,33037,24013
143,15,4,0,0,3,1,0,69,58,31210,24688,88,9,33040,24013
144,15,1,1,2,1,2,1,243,186,31211,24689,271,173,33041,24014
145,15,2,2,2,1,2,1,249,212,31213,24691,294,190,33042,24015
146,15,2,0,0,3,1,0,185,165,31215,24691,224,173,33045,24015
147,15,1,1,2,1,2,1,79,74,31216,24692,115,15,33046,24016
148,15,0,0,2,1,2,1,275,168,31216,24692,344,234,33047,24017
149,15,0,0,2,1,2,1,7,6,31216,24692,9,183,33048,24018
150,16,1,0,0,3,1,0,238,197,31217,24692,305,192,33051,24018
151,16,2,1,0,3,1,0,262,204,31219,24693,285,5,33054,24018
152,16,3,0,0,3,1,0,21,34,31222,24693,26,168,33057,24018
153,16,2,3,1,0,0,3,9,8,31224,24696,11,204,33057,24021
154,16,1,1,2,1,2,1,30,30,31225,24697,30,139,33058,24022
155,16,1,1,2,1,2,1,242,226,31226,24698,287,61,33059,24023
156,16,1,0,0,3,1,0,267,196,31227,24698,334,156,33062,24023
157,16,0,2,1,0,0,3,256,222,31227,24700,277,88,33062,24026
158,16,3,2,0,3,1,0,249,185,31230,24702,305,97,33065,24026
159,16,4,3,0,3,1,0,249,228,31234,24705,271,216,33068,24026
160,17,0,0,2,1,2,1,113,106,31234,24705,133,174,33069,24027
161,17,1,4,1,0,0,3,222,234,31235,24709,275,186,33069,24030
162,17,0,1,1,0,0,3,188,185,31235,24710,225,237,33069,24033
163,17,0,1,1,0,0,3,9,9,31235,24711,11,193,33069,24036
164,17,2,0,0,3,1,0,71,58,31237,24711,91,216,33072,24036
165,17,1,1,2,1,2,1,276,169,31238,24712,345,16,33073,24037
166,17,3,3,2,1,2,1,252,215,31241,24715,295,25,33074,24038
167,17,0,3,1,0,0,3,185,168,31241,24718,224,176,33074,24041
168,17,3,2,0,3,1,0,82,76,31244,24720,118,168,33077,24041
169,17,0,3,1,0,0,3,7,9,31244,24723,9,181,33077,24044
170,18,4,1,0,3,1,0,242,198,31248,24724,308,5,33080,24044
171,18,1,1,2,1,2,1,263,205,31249,24725,286,205,33081,24045
172,18,0,1,1,0,0,3,21,35,31249,24726,26,219,33081,24048
173,18,3,0,0,3,1,0,252,185,31252,24726,308,61,33084,24048
174,18,2,2,2,1,2,1,245,188,31254,24728,272,89,33085,24049
175,18,1,1,2,1,2,1,31,31,31255,24729,31,157,33086,24050
176,18,1,0,0,3,1,0,243,226,31256,24729,290,9,33089,24050
177,18,1,0,0,3,1,0,250,228,31257,24729,274,97,33092,24050
178,18,2,0,0,3,1,0,269,196,31259,24729,337,139,33095,24050
179,18,2,3,1,0,0,3,258,225,31261,24732,277,195,33095,24053
180,19,2,3,1,0,0,3,190,188,31263,24735,225,171,33095,24056
181,19,0,0,2,1,2,1,9,9,31263,24735,12,217,33096,24057
182,19,0,2,1,0,0,3,276,171,31263,24737,345,179,33096,24060
183,19,2,2,2,1,2,1,254,217,31265,24739,296,17,33097,24061
184,19,0,2,1,0,0,3,185,170,31265,24741,224,92,33097,24064
185,19,1,1,2,1,2,1,83,77,31266,24742,119,175,33098,24065
186,19,1,3,1,0,0,3,8,12,31267,24745,9,28,33098,24068
187,19,0,0,2,1,2,1,243,226,31267,24745,291,238,33099,24069
188,19,2,2,2,1,2,1,73,60,31269,24747,92,194,33100,24070
189,19,2,2,2,1,2,1,224,236,31271,24749,276,182,33101,24071
190,20,2,1,0,3,1,0,271,197,31273,24750,340,186,33104,24071
191,20,2,0,0,3,1,0,252,228,31275,24750,277,61,33107,24071
192,20,1,0,0,3,1,0,243,198,31276,24750,311,205,33110,24071
193,20,0,0,2,1,2,1,113,106,31276,24750,134,220,33111,24072
194,20,4,1,0,3,1,0,267,206,31280,24751,289,139,33114,24072
195,20,5,0,0,3,1,0,257,185,31285,24751,311,9,33117,24072
196,20,0,0,2,1,2,1,245,188,31285,24751,273,196,33118,24073
197,20,1,0,0,3,1,0,32,31,31286,24751,34,5,33121,24073
198,20,2,0,0,3,1,0,260,225,31288,24751,280,97,33124,24073
199,20,1,1,2,1,2,1,22,36,31289,24752,27,158,33125,24074
200,21,1,0,0,3,1,0,258,185,31290,24752,314,194,33128,24074
201,21,1,2,1,0,0,3,225,238,31291,24754,276,20,33128,24077
202,21,3,3,2,1,2,1,193,191,31294,24757,226,180,33129,24078
203,21,3,1,0,3,1,0,12,10,31297,24758,15,175,33132,24078
204,21,2,0,0,3,1,0,75,60,31299,24758,95,28,33135,24078
205,21,1,1,2,1,2,1,277,172,31300,24759,346,172,33136,24079
206,21,2,2,2,1,2,1,256,219,31302,24761,297,159,33137,24080
207,21,4,2,0,3,1,0,87,79,31306,24763,122,92,33140,24080
208,21,0,1,1,0,0,3,8,13,31306,24764,9,220,33140,24083
209,21,0,1,1,0,0,3,243,227,31306,24765,291,185,33140,24086
210,22,3,1,0,3,1,0,274,198,31309,24766,343,194,33143,24086
211,22,3,2,0,3,1,0,255,230,31312,24768,280,238,33146,24086
212,22,2,1,0,3,1,0,245,199,31314,24769,314,61,33149,24086
213,22,1,0,0,3,1,0,114,106,31315,24769,137,139,33152,24086
214,22,4,2,0,3,1,0,26,38,31319,24771,30,205,33155,24086
215,22,2,3,1,0,0,3,247,191,31321,24774,273,8,33155,24089
216,22,1,1,2,1,2,1,257,220,31322,24775,298,98,33156,24090
217,22,0,0,2,1,2,1,185,170,31322,24775,225,221,33157,24091
218,22,1,1,2,1,2,1,33,32,31323,24776,35,187,33158,24092
219,22,1,0,0,3,1,0,261,225,31324,24776,283,9,33161,24092
220,23,3,1,0,3,1,0,270,207,31327,24777,292,185,33164,24092
221,23,1,1,2,1,2,1,226,239,31328,24778,277,181,33165,24093
222,23,4,0,0,3,1,0,197,191,31332,24778,229,28,33168,24093
223,23,2,1,0,3,1,0,260,186,31334,24779,317,220,33171,24093
224,23,0,0,2,1,2,1,12,10,31334,24779,16,21,33172,24094
225,23,2,1,0,3,1,0,77,61,31336,24780,98,172,33175,24094
226,23,1,1,2,1,2,1,278,173,31337,24781,347,197,33176,24095
227,23,3,3,2,1,2,1,90,82,31340,24784,123,160,33177,24096
228,23,2,0,0,3,1,0,10,13,31342,24784,12,92,33180,24096
229,23,0,2,1,0,0,3,243,229,31342,24786,291,178,33180,24099
230,24,0,0,2,1,2,1,245,199,31342,24786,315,195,33181,24100
231,24,0,0,2,1,2,1,114,106,31342,24786,138,206,33182,24101
232,24,1,4,1,0,0,3,27,42,31343,24790,30,190,33182,24104
233,24,0,0,2,1,2,1,247,191,31343,24790,274,10,33183,24105
234,24,1,0,0,3,1,0,258,220,31344,24790,301,8,33186,24105
235,24,1,1,2,1,2,1,186,171,31345,24791,226,140,33187,24106
236,24,2,0,0,3,1,0,35,32,31347,24791,38,238,33190,24106
237,24,0,1,1,0,0,3,261,226,31347,24792,283,64,33190,24109
238,24,1,0,0,3,1,0,279,173,31348,24792,350,98,33193,24109
239,24,1,1,2,1,2,1,275,199,31349,24793,344,186,33194,24110
240,25,1,1,2,1,2,1,271,208,31350,24794,293,173,33195,24111
241,25,1,0,0,3,1,0,227,239,31351,24794,280,160,33198,24111
242,25,0,1,1,0,0,3,197,192,31351,24795,229,224,33198,24114
243,25,1,0,0,3,1,0,261,186,31352,24795,320,28,33201,24114
244,25,1,2,1,0,0,3,13,12,31353,24797,16,200,33201,24117
245,25,0,0,2,1,2,1,77,61,31353,24797,99,93,33202,24118
246,25,1,1,2,1,2,1,11,14,31354,24798,13,99,33203,24119
247,25,2,1,0,3,1,0,277,200,31356,24799,347,21,33206,24119
248,25,2,0,0,3,1,0,245,229,31358,24799,294,181,33209,24119
249,25,3,0,0,3,1,0,258,230,31361,24799,283,178,33212,24119
250,26,2,2,2,1,2,1,263,228,31363,24801,284,221,33213,24120
251,26,0,2,1,0,0,3,245,201,31363,24803,315,241,33213,24123
252,26,0,1,1,0,0,3,114,107,31363,24804,138,193,33213,24126
253,26,0,1,1,0,0,3,27,43,31363,24805,30,198,33213,24129
254,26,1,1,2,1,2,1,280,174,31364,24806,351,11,33214,24130
255,26,1,2,1,0,0,3,259,222,31365,24808,301,67,33214,24133
256,26,2,1,0,3,1,0,188,172,31367,24809,229,8,33217,24133
257,26,1,0,0,3,1,0,91,82,31368,24809,126,140,33220,24133
258,26,1,0,0,3,1,0,36,32,31369,24809,41,186,33223,24133
259,26,2,2,2,1,2,1,249,193,31371,24811,275,207,33224,24134
260,27,3,0,0,3,1,0,261,230,31374,24811,286,93,33227,24134
261,27,1,0,0,3,1,0,278,200,31375,24811,350,178,33230,24134
262,27,0,1,1,0,0,3,271,209,31375,24812,293,24,33230,24137
263,27,0,2,1,0,0,3,227,241,31375,24814,280,102,33230,24140
264,27,1,4,1,0,0,3,198,196,31376,24818,229,203,33230,24143
265,27,4,0,0,3,1,0,265,186,31380,24818,323,181,33233,24143
266,27,1,1,2,1,2,1,14,13,31381,24819,17,29,33234,24144
267,27,1,1,2,1,2,1,78,62,31382,24820,100,161,33235,24145
268,27,2,0,0,3,1,0,13,14,31384,24820,16,224,33238,24145
269,27,0,0,2,1,2,1,245,229,31384,24820,295,174,33239,24146
270,28,1,0,0,3,1,0,246,201,31385,24820,318,24,33242,24146
271,28,1,1,2,1,2,1,115,108,31386,24821,139,199,33243,24147
272,28,0,3,1,0,0,3,27,46,31386,24824,30,224,33243,24150
273,28,0,5,1,0,0,3,249,198,31386,24829,275,244,33243,24153
274,28,0,2,1,0,0,3,280,176,31386,24831,351,70,33243,24156
275,28,1,0,0,3,1,0,260,222,31387,24831,304,207,33246,24156
276,28,1,3,1,0,0,3,189,175,31388,24834,229,196,33246,24159
277,28,1,0,0,3,1,0,92,82,31389,24834,129,11,33249,24159
278,28,1,0,0,3,1,0,14,14,31390,24834,19,140,33252,24159
279,28,1,0,0,3,1,0,264,228,31391,24834,287,186,33255,24159
280,29,0,0,2,1,2,1,271,209,31391,24834,294,103,33256,24160
281,29,0,2,1,0,0,3,246,203,31391,24836,318,177,33256,24163
282,29,2,0,0,3,1,0,16,13,31393,24836,20,161,33259,24163
283,29,1,1,2,1,2,1,79,63,31394,24837,101,9,33260,24164
284,29,3,0,0,3,1,0,39,32,31397,24837,44,181,33263,24164
285,29,0,0,2,1,2,1,245,229,31397,24837,296,141,33264,24165
286,29,4,0,0,3,1,0,265,230,31401,24837,289,29,33267,24165
287,29,1,5,1,0,0,3,279,205,31402,24842,350,206,33267,24168
288,29,0,2,1,0,0,3,227,243,31402,24844,280,227,33267,24171
289,30,2,1,0,3,1,0,29,47,31404,24845,33,178,33270,24171
290,30,3,1,0,3,1,0,118,109,31407,24846,142,224,33273,24171
291,30,2,2,2,1,2,1,200,198,31409,24848,230,208,33274,24172
292,30,1,1,2,1,2,1,250,199,31410,24849,276,25,33275,24173
293,30,0,2,1,0,0,3,280,178,31410,24851,351,199,33275,24176
294,30,1,0,0,3,1,0,261,222,31411,24851,307,244,33278,24176
295,30,1,0,0,3,1,0,190,175,31412,24851,232,186,33281,24176
296,30,2,0,0,3,1,0,94,82,31414,24851,132,70,33284,24176
297,30,3,1,0,3,1,0,17,15,31417,24852,22,11,33287,24176
298,30,2,2,2,1,2,1,266,230,31419,24854,288,200,33288,24177
299,31,4,1,0,3,1,0,269,231,31423,24855,292,206,33291,24177
300,31,3,0,0,3,1,0,249,203,31426,24855,321,181,33294,24177
301,31,1,1,2,1,2,1,228,244,31427,24856,281,10,33295,24178
302,31,0,0,2,1,2,1,265,186,31427,24856,324,162,33296,24179
303,31,2,2,2,1,2,1,81,65,31429,24858,102,142,33297,24180
304,31,2,2,2,1,2,1,41,34,31431,24860,45,30,33298,24181
305,31,1,2,1,0,0,3,246,231,31432,24862,296,106,33298,24184
306,31,1,0,0,3,1,0,280,205,31433,24862,353,177,33301,24184
307,31,1,1,2,1,2,1,272,210,31434,24863,295,228,33302,24185
308,32,1,1,2,1,2,1,95,83,31435,24864,133,225,33303,24186
309,32,1,2,1,0,0,3,201,200,31436,24866,230,14,33303,24189
310,32,3,1,0,3,1,0,84,66,31439,24867,105,208,33306,24189
311,32,1,1,2,1,2,1,281,179,31440,24868,352,179,33307,24190
312,32,0,0,2,1,2,1,261,222,31440,24868,308,200,33308,24191
313,32,0,4,1,0,0,3,190,179,31440,24872,232,203,33308,24194
314,32,2,1,0,3,1,0,19,16,31442,24873,25,244,33311,24194
315,32,2,1,0,3,1,0,268,231,31444,24874,291,30,33314,24194
316,32,1,0,0,3,1,0,119,109,31445,24874,145,25,33317,24194
317,32,1,1,2,1,2,1,251,200,31446,24875,277,187,33318,24195
0,1,0,0,2,1,2,1,29,29,31446,24875,30,1,33319,24196
1,1,1,0,0,3,1,0,30,58,31447,24875,3,38,33322,24196
2,1,3,0,0,3,1,0,3,0,31450,24875,3,102,33325,24196
3,1,3,0,0,3,1,0,265,68,31453,24875,294,102,33328,24196
4,1,1,3,1,0,0,3,1,3,31454,24878,0,3,33328,24199
5,1,3,1,0,3,1,0,3,1,31457,24879,3,0,33331,24199
6,1,3,1,0,3,1,0,3,1,31460,24880,3,0,33334,24199
7,1,2,2,2,1,2,1,2,2,31462,24882,1,1,33335,24200
8,1,1,1,2,1,2,1,205,35,31463,24883,103,1,33336,24201
9,2,4,2,0,3,1,0,4,2,31467,24885,3,0,33339,24201
10,2,6,0,0,3,1,0,6,0,31473,24885,3,0,33342,24201
11,2,1,0,0,3,1,0,1,0,31474,24885,3,0,33345,24201
12,2,1,1,2,1,2,1,1,1,31475,24886,1,1,33346,24202
13,2,0,0,2,1,2,1,0,0,31475,24886,1,1,33347,24203
14,2,3,2,0,3,1,0,137,78,31478,24888,128,0,33350,24203
15,2,3,1,0,3,1,0,3,1,31481,24889,3,87,33353,24203
16,2,3,5,1,0,0,3,79,81,31484,24894,38,3,33353,24206
17,2,1,3,1,0,0,3,1,3,31485,24897,0,105,33353,24209
18,3,4,2,0,3,1,0,141,80,31489,24899,131,3,33356,24209
19,3,0,3,1,0,0,3,3,4,31489,24902,3,4,33356,24212
20,3,2,1,0,3,1,0,4,3,31491,24903,4,0,33359,24212
21,3,3,1,0,3,1,0,4,4,31494,24904,3,87,33362,24212
22,3,3,0,0,3,1,0,7,2,31497,24904,6,105,33365,24212
23,3,3,0,0,3,1,0,6,1,31500,24904,6,102,33368,24212
24,3,1,1,2,1,2,1,4,1,31501,24905,4,1,33369,24213
25,3,2,3,1,0,0,3,3,3,31503,24908,3,3,33369,24216
26,3,3,1,0,3,1,0,9,1,31506,24909,6,1,33372,24216
27,4,0,3,1,0,0,3,79,84,31506,24912,38,4,33372,24219
28,4,2,0,0,3,1,0,207,35,31508,24912,106,38,33375,24219
29,4,4,2,0,3,1,0,33,31,31512,24914,33,0,33378,24219
30,4,2,2,2,1,2,1,32,60,31514,24916,4,2,33379,24220
31,4,0,5,1,0,0,3,265,73,31514,24921,294,4,33379,24223
32,4,4,0,0,3,1,0,4,0,31518,24921,4,0,33382,24223
33,4,4,0,0,3,1,0,7,1,31522,24921,6,0,33385,24223
34,4,2,2,2,1,2,1,3,5,31524,24923,1,4,33386,24224
35,4,1,1,2,1,2,1,2,2,31525,24924,2,103,33387,24225
36,5,1,2,1,0,0,3,4,5,31526,24926,3,7,33387,24228
37,5,2,0,0,3,1,0,9,2,31528,24926,9,102,33390,24228
38,5,3,1,0,3,1,0,12,2,31531,24927,9,3,33393,24228
39,5,2,1,0,3,1,0,6,5,31533,24928,6,0,33396,24228
40,5,2,1,0,3,1,0,143,81,31535,24929,134,0,33399,24228
41,5,1,2,1,0,0,3,3,4,31536,24931,2,108,33399,24231
42,5,2,0,0,3,1,0,209,35,31538,24931,109,1,33402,24231
43,5,2,2,2,1,2,1,5,7,31540,24933,2,1,33403,24232
44,5,1,0,0,3,1,0,5,3,31541,24933,7,0,33406,24232
45,6,3,2,0,3,1,0,268,75,31544,24935,297,2,33409,24232
46,6,2,0,0,3,1,0,7,3,31546,24935,10,103,33412,24232
47,6,0,0,2,1,2,1,3,4,31546,24935,4,88,33413,24233
48,6,2,4,1,0,0,3,81,88,31548,24939,38,6,33413,24236
49,6,1,2,1,0,0,3,8,3,31549,24941,6,7,33413,24239
50,6,0,1,1,0,0,3,32,61,31549,24942,4,4,33413,24242
51,6,0,0,2,1,2,1,33,31,31549,24942,34,5,33414,24243
52,6,3,2,0,3,1,0,9,3,31552,24944,9,38,33417,24243
53,6,0,0,2,1,2,1,4,1,31552,24944,5,8,33418,24244
54,7,2,2,2,1,2,1,8,7,31554,24946,7,109,33419,24245
55,7,1,1,2,1,2,1,13,3,31555,24947,10,5,33420,24246
56,7,1,0,0,3,1,0,4,4,31556,24947,5,0,33423,24246
57,7,3,2,0,3,1,0,8,9,31559,24949,5,0,33426,24246
58,7,2,2,2,1,2,1,6,2,31561,24951,5,8,33427,24247
59,7,0,2,1,0,0,3,143,83,31561,24953,134,3,33427,24250
60,7,2,1,0,3,1,0,211,36,31563,24954,112,102,33430,24250
61,7,3,0,0,3,1,0,35,61,31566,24954,7,1,33433,24250
62,7,1,0,0,3,1,0,5,5,31567,24954,6,1,33436,24250
63,8,0,0,2,1,2,1,3,4,31567,24954,5,103,33437,24251
64,8,2,0,0,3,1,0,213,36,31569,24954,115,3,33440,24251
65,8,1,2,1,0,0,3,144,85,31570,24956,134,112,33440,24254
66,8,1,2,1,0,0,3,10,4,31571,24958,9,3,33440,24257
67,8,4,2,0,3,1,0,10,4,31575,24960,8,5,33443,24257
68,8,2,1,0,3,1,0,6,5,31577,24961,8,0,33446,24257
69,8,1,1,2,1,2,1,269,76,31578,24962,298,2,33447,24258
70,8,0,0,2,1,2,1,8,7,31578,24962,8,7,33448,24259
71,8,3,0,0,3,1,0,16,3,31581,24962,13,38,33451,24259
72,9,3,0,0,3,1,0,13,4,31584,24962,12,88,33454,24259
73,9,2,2,2,1,2,1,11,5,31586,24964,10,2,33455,24260
74,9,2,1,0,3,1,0,10,10,31588,24965,8,103,33458,24260
75,9,0,1,1,0,0,3,5,6,31588,24966,6,7,33458,24263
76,9,0,1,1,0,0,3,8,4,31588,24967,6,11,33458,24266
77,9,2,4,1,0,0,3,83,92,31590,24971,38,8,33458,24269
78,9,1,0,0,3,1,0,8,3,31591,24971,13,2,33461,24269
79,9,4,1,0,3,1,0,37,32,31595,24972,37,3,33464,24269
80,9,3,2,0,3,1,0,7,3,31598,24974,8,3,33467,24269
81,10,1,2,1,0,0,3,214,38,31599,24976,115,115,33467,24272
82,10,3,2,0,3,1,0,38,63,31602,24978,10,5,33470,24272
83,10,1,1,2,1,2,1,270,77,31603,24979,299,1,33471,24273
84,10,2,0,0,3,1,0,10,7,31605,24979,11,38,33474,24273
85,10,2,2,2,1,2,1,146,87,31607,24981,135,9,33475,24274
86,10,1,0,0,3,1,0,17,3,31608,24981,16,2,33478,24274
87,10,3,2,0,3,1,0,13,6,31611,24983,11,7,33481,24274
88,10,3,0,0,3,1,0,9,5,31614,24983,11,103,33484,24274
89,10,1,4,1,0,0,3,4,8,31615,24987,5,6,33484,24277
90,11,1,1,2,1,2,1,38,33,31616,24988,38,4,33485,24278
91,11,4,1,0,3,1,0,11,4,31620,24989,11,88,33488,24278
92,11,3,1,0,3,1,0,11,4,31623,24990,16,7,33491,24278
93,11,3,1,0,3,1,0,16,5,31626,24991,15,2,33494,24278
94,11,2,1,0,3,1,0,272,78,31628,24992,302,7,33497,24278
95,11,1,3,1,0,0,3,84,95,31629,24995,38,14,33497,24281
96,11,3,0,0,3,1,0,11,4,31632,24995,9,38,33500,24281
97,11,0,2,1,0,0,3,4,10,31632,24997,5,11,33500,24284
98,11,2,0,0,3,1,0,13,5,31634,24997,13,103,33503,24284
99,12,3,5,1,0,0,3,8,11,31637,25002,6,8,33503,24287
100,12,2,0,0,3,1,0,216,38,31639,25002,118,2,33506,24287
101,12,0,2,1,0,0,3,146,89,31639,25004,135,5,33506,24290
102,12,1,4,1,0,0,3,12,8,31640,25008,11,12,33506,24293
103,12,0,1,1,0,0,3,17,4,31640,25009,16,17,33506,24296
104,12,1,0,0,3,1,0,11,10,31641,25009,11,6,33509,24296
105,12,0,0,2,1,2,1,38,63,31641,25009,11,4,33510,24297
106,12,2,2,2,1,2,1,40,35,31643,25011,39,104,33511,24298
107,12,2,1,0,3,1,0,11,6,31645,25012,14,2,33514,24298
108,13,1,4,1,0,0,3,85,99,31646,25016,38,41,33514,24301
109,13,2,1,0,3,1,0,15,7,31648,25017,14,103,33517,24301
110,13,2,1,0,3,1,0,13,5,31650,25018,19,88,33520,24301
111,13,3,2,0,3,1,0,13,9,31653,25020,14,1,33523,24301
112,13,1,4,1,0,0,3,273,82,31654,25024,302,7,33523,24304
113,13,0,1,1,0,0,3,16,6,31654,25025,15,10,33523,24307
114,13,1,2,1,0,0,3,14,7,31655,25027,13,14,33523,24310
115,13,1,1,2,1,2,1,5,11,31656,25028,6,8,33524,24311
116,13,1,1,2,1,2,1,12,5,31657,25029,10,116,33525,24312
117,14,4,2,0,3,1,0,21,6,31661,25031,19,103,33528,24312
118,14,2,1,0,3,1,0,218,39,31663,25032,121,17,33531,24312
119,14,1,1,2,1,2,1,39,64,31664,25033,12,11,33532,24313
120,14,1,5,1,0,0,3,9,16,31665,25038,6,7,33532,24316
121,14,2,0,0,3,1,0,13,6,31667,25038,17,12,33535,24316
122,14,3,0,0,3,1,0,15,8,31670,25038,14,8,33538,24316
123,14,2,2,2,1,2,1,14,7,31672,25040,11,6,33539,24317
124,14,0,1,1,0,0,3,85,100,31672,25041,38,5,33539,24320
125,14,1,1,2,1,2,1,41,36,31673,25042,40,7,33540,24321
126,15,1,0,0,3,1,0,147,89,31674,25042,138,41,33543,24321
127,15,3,1,0,3,1,0,276,83,31677,25043,305,116,33546,24321
128,15,1,2,1,0,0,3,16,9,31678,25045,14,11,33546,24324
129,15,2,0,0,3,1,0,7,11,31680,25045,9,1,33549,24324
130,15,0,0,2,1,2,1,16,6,31680,25045,16,15,33550,24325
131,15,2,0,0,3,1,0,15,5,31682,25045,22,2,33553,24325
132,15,3,0,0,3,1,0,14,10,31685,25045,14,88,33556,24325
133,15,5,0,0,3,1,0,18,9,31690,25045,17,104,33559,24325
134,15,4,0,0,3,1,0,18,7,31694,25045,16,7,33562,24325
135,16,4,2,0,3,1,0,222,41,31698,25047,124,15,33565,24325
136,16,2,2,2,1,2,1,15,8,31700,25049,18,7,33566,24326
137,16,1,1,2,1,2,1,86,101,31701,25050,39,104,33567,24327
138,16,1,0,0,3,1,0,42,36,31702,25050,43,8,33570,24327
139,16,2,4,1,0,0,3,41,68,31704,25054,12,20,33570,24330
140,16,2,1,0,3,1,0,16,8,31706,25055,14,11,33573,24330
141,16,1,1,2,1,2,1,277,84,31707,25056,306,8,33574,24331
142,16,0,2,1,0,0,3,9,18,31707,25058,6,15,33574,24334
143,16,2,1,0,3,1,0,17,9,31709,25059,17,7,33577,24334
144,17,4,1,0,3,1,0,19,6,31713,25060,25,8,33580,24334
145,17,1,1,2,1,2,1,17,7,31714,25061,17,8,33581,24335
146,17,5,2,0,3,1,0,26,8,31719,25063,22,1,33584,24335
147,17,2,0,0,3,1,0,18,9,31721,25063,17,5,33587,24335
148,17,1,1,2,1,2,1,87,102,31722,25064,40,3,33588,24336
149,17,2,1,0,3,1,0,20,8,31724,25065,19,7,33591,24336
150,17,0,2,1,0,0,3,14,12,31724,25067,14,14,33591,24339
151,17,0,4,1,0,0,3,9,22,31724,25071,6,119,33591,24342
152,17,1,3,1,0,0,3,148,92,31725,25074,138,91,33591,24345
153,18,2,2,2,1,2,1,19,11,31727,25076,18,42,33592,24346
154,18,3,1,0,3,1,0,225,42,31730,25077,127,7,33595,24346
155,18,3,1,0,3,1,0,44,69,31733,25078,15,104,33598,24346
156,18,1,1,2,1,2,1,43,37,31734,25079,44,12,33599,24347
157,18,0,0,2,1,2,1,277,84,31734,25079,307,16,33600,24348
158,18,0,1,1,0,0,3,7,12,31734,25080,9,18,33600,24351
159,18,2,0,0,3,1,0,21,6,31736,25080,28,14,33603,24351
160,18,6,2,0,3,1,0,24,11,31742,25082,20,20,33606,24351
161,18,1,0,0,3,1,0,17,8,31743,25082,17,104,33609,24351
162,19,4,0,0,3,1,0,28,11,31747,25082,23,5,33612,24351
163,19,2,2,2,1,2,1,150,94,31749,25084,139,9,33613,24352
164,19,1,1,2,1,2,1,226,43,31750,25085,128,9,33614,24353
165,19,2,1,0,3,1,0,16,13,31752,25086,17,104,33617,24353
166,19,1,2,1,0,0,3,10,24,31753,25088,6,10,33617,24356
167,19,3,1,0,3,1,0,29,9,31756,25089,25,119,33620,24356
168,19,5,0,0,3,1,0,23,9,31761,25089,20,1,33623,24356
169,19,2,0,0,3,1,0,19,7,31763,25089,20,3,33626,24356
170,19,2,2,2,1,2,1,17,10,31765,25091,19,9,33627,24357
171,20,3,1,0,3,1,0,19,14,31768,25092,20,7,33630,24357
172,20,0,0,2,1,2,1,19,11,31768,25092,19,15,33631,24358
173,20,2,2,2,1,2,1,46,71,31770,25094,16,92,33632,24359
174,20,1,0,0,3,1,0,88,102,31771,25094,43,9,33635,24359
175,20,0,1,1,0,0,3,17,9,31771,25095,17,8,33635,24362
176,20,3,0,0,3,1,0,23,8,31774,25095,22,18,33638,24362
177,20,3,0,0,3,1,0,46,37,31777,25095,47,104,33641,24362
178,20,1,2,1,0,0,3,22,8,31778,25097,28,23,33641,24365
179,20,0,3,1,0,0,3,10,27,31778,25100,6,19,33641,24368
180,21,1,1,2,1,2,1,47,72,31779,25101,17,2,33642,24369
181,21,5,2,0,3,1,0,12,14,31784,25103,12,119,33645,24369
182,21,6,1,0,3,1,0,23,11,31790,25104,22,42,33648,24369
183,21,2,1,0,3,1,0,31,10,31792,25105,28,104,33651,24369
184,21,1,5,1,0,0,3,151,99,31793,25110,139,15,33651,24372
185,21,0,3,1,0,0,3,226,46,31793,25113,128,21,33651,24375
186,21,1,4,1,0,0,3,29,15,31794,25117,23,12,33651,24378
187,21,2,1,0,3,1,0,25,10,31796,25118,23,3,33654,24378
188,21,0,0,2,1,2,1,277,84,31796,25118,308,11,33655,24379
189,22,2,0,0,3,1,0,21,7,31798,25118,23,8,33658,24379
190,22,0,0,2,1,2,1,29,15,31798,25118,24,10,33659,24380
191,22,0,1,1,0,0,3,31,11,31798,25119,28,18,33659,24383
192,22,2,1,0,3,1,0,153,100,31800,25120,142,15,33662,24383
193,22,3,0,0,3,1,0,13,27,31803,25120,9,92,33665,24383
194,22,1,1,2,1,2,1,13,15,31804,25121,13,4,33666,24384
195,22,7,1,0,3,1,0,29,9,31811,25122,31,104,33669,24384
196,22,1,1,2,1,2,1,24,9,31812,25123,23,24,33670,24385
197,22,1,0,0,3,1,0,20,11,31813,25123,22,119,33673,24385
198,23,3,0,0,3,1,0,22,14,31816,25123,23,42,33676,24385
199,23,3,3,2,1,2,1,91,105,31819,25126,44,12,33677,24386
200,23,2,1,0,3,1,0,19,10,31821,25127,20,2,33680,24386
201,23,1,0,0,3,1,0,26,10,31822,25127,26,9,33683,24386
202,23,0,4,1,0,0,3,23,15,31822,25131,22,22,33683,24389
203,23,0,2,1,0,0,3,226,48,31822,25133,128,10,33683,24392
204,23,2,2,2,1,2,1,48,39,31824,25135,48,22,33684,24393
205,23,2,0,0,3,1,0,49,72,31826,25135,20,104,33687,24393
206,23,1,1,2,1,2,1,278,85,31827,25136,309,13,33688,24394
207,24,1,1,2,1,2,1,25,10,31828,25137,24,3,33689,24395
208,24,4,0,0,3,1,0,157,100,31832,25137,145,104,33692,24395
209,24,0,2,1,0,0,3,29,17,31832,25139,24,18,33692,24398
210,24,1,4,1,0,0,3,30,13,31833,25143,31,122,33692,24401
211,24,2,2,2,1,2,1,24,16,31835,25145,24,5,33693,24402
212,24,1,1,2,1,2,1,27,11,31836,25146,27,11,33694,24403
213,24,1,0,0,3,1,0,22,7,31837,25146,26,42,33697,24403
214,24,2,0,0,3,1,0,15,15,31839,25146,16,8,33700,24403
215,24,4,1,0,3,1,0,35,12,31843,25147,31,92,33703,24403
216,25,1,0,0,3,1,0,14,27,31844,25147,12,104,33706,24403
217,25,4,3,0,3,1,0,95,108,31848,25150,47,10,33709,24403
218,25,6,1,0,3,1,0,26,12,31854,25151,25,9,33712,24403
219,25,1,1,2,1,2,1,49,40,31855,25152,49,9,33713,24404
220,25,3,2,0,3,1,0,229,50,31858,25154,131,18,33716,24404
221,25,5,1,0,3,1,0,24,11,31863,25155,23,13,33719,24404
222,25,2,1,0,3,1,0,25,16,31865,25156,25,24,33722,24404
223,25,0,0,2,1,2,1,35,12,31865,25156,32,23,33723,24405
224,25,1,1,2,1,2,1,50,73,31866,25157,21,13,33724,24406
225,26,2,1,0,3,1,0,280,86,31868,25158,312,104,33727,24406
226,26,2,0,0,3,1,0,29,11,31870,25158,30,92,33730,24406
227,26,2,0,0,3,1,0,17,15,31872,25158,19,42,33733,24406
228,26,5,1,0,3,1,0,29,17,31877,25159,27,11,33736,24406
229,26,2,3,1,0,0,3,159,103,31879,25162,145,25,33736,24409
230,26,0,1,1,0,0,3,29,18,31879,25163,24,8,33736,24412
231,26,1,1,2,1,2,1,26,11,31880,25164,25,123,33737,24413
232,26,1,4,1,0,0,3,31,17,31881,25168,31,6,33737,24416
233,26,4,0,0,3,1,0,26,7,31885,25168,29,18,33740,24416
234,27,1,0,0,3,1,0,27,11,31886,25168,28,13,33743,24416
235,27,4,1,0,3,1,0,30,13,31890,25169,28,104,33746,24416
236,27,1,2,1,0,0,3,50,42,31891,25171,49,21,33746,24419
237,27,1,1,2,1,2,1,18,16,31892,25172,20,11,33747,24420
238,27,1,0,0,3,1,0,281,86,31893,25172,315,18,33750,24420
239,27,2,1,0,3,1,0,31,12,31895,25173,33,42,33753,24420
240,27,2,1,0,3,1,0,26,12,31897,25174,26,92,33756,24420
241,27,1,3,1,0,0,3,96,111,31898,25177,47,26,33756,24423
242,27,2,2,2,1,2,1,52,75,31900,25179,22,26,33757,24424
243,28,3,1,0,3,1,0,28,17,31903,25180,28,9,33760,24424
244,28,0,1,1,0,0,3,229,51,31903,25181,131,16,33760,24427
245,28,0,0,2,1,2,1,14,27,31903,25181,13,105,33761,24428
246,28,4,2,0,3,1,0,34,15,31907,25183,31,11,33764,24428
247,28,1,0,0,3,1,0,53,75,31908,25183,25,9,33767,24428
248,28,3,2,0,3,1,0,32,19,31911,25185,30,26,33770,24428
249,28,1,0,0,3,1,0,36,12,31912,25185,35,13,33773,24428
250,28,3,0,0,3,1,0,53,42,31915,25185,52,8,33776,24428
251,28,0,2,1,0,0,3,159,105,31915,25187,145,27,33776,24431
252,29,2,0,0,3,1,0,33,12,31917,25187,36,26,33779,24431
253,29,1,3,1,0,0,3,282,89,31918,25190,315,95,33779,24434
254,29,2,3,1,0,0,3,31,21,31920,25193,24,107,33779,24437
255,29,4,5,1,0,0,3,100,116,31924,25198,47,126,33779,24440
256,29,0,1,1,0,0,3,26,13,31924,25199,26,24,33779,24443
257,29,2,3,1,0,0,3,29,14,31926,25202,28,21,33779,24446
258,29,2,1,0,3,1,0,20,17,31928,25203,23,11,33782,24446
259,29,3,0,0,3,1,0,29,7,31931,25203,32,6,33785,24446
260,29,3,2,0,3,1,0,34,19,31934,25205,34,42,33788,24446
261,30,1,4,1,0,0,3,15,31,31935,25209,13,14,33788,24449
262,30,1,0,0,3,1,0,33,19,31936,25209,33,9,33791,24449
263,30,0,0,2,1,2,1,159,105,31936,25209,146,10,33792,24450
264,30,2,6,1,0,0,3,102,122,31938,25215,47,9,33792,24453
265,30,1,1,2,1,2,1,29,18,31939,25216,29,96,33793,24454
266,30,1,1,2,1,2,1,34,13,31940,25217,37,127,33794,24455
267,30,2,0,0,3,1,0,31,7,31942,25217,35,16,33797,24455
268,30,0,4,1,0,0,3,29,18,31942,25221,28,11,33797,24458
269,30,2,2,2,1,2,1,38,14,31944,25223,36,12,33798,24459
270,31,3,0,0,3,1,0,34,21,31947,25223,27,13,33801,24459
271,31,2,1,0,3,1,0,22,18,31949,25224,26,16,33804,24459
272,31,5,2,0,3,1,0,58,44,31954,25226,55,42,33807,24459
273,31,1,2,1,0,0,3,230,53,31955,25228,131,110,33807,24462
274,31,3,1,0,3,1,0,32,19,31958,25229,32,21,33810,24462
275,31,0,2,1,0,0,3,34,17,31958,25231,31,29,33810,24465
276,31,1,1,2,1,2,1,283,90,31959,25232,316,28,33811,24466
277,31,1,2,1,0,0,3,54,77,31960,25234,25,29,33811,24469
278,31,6,1,0,3,1,0,32,14,31966,25235,29,105,33814,24469
279,32,1,2,1,0,0,3,34,21,31967,25237,33,31,33814,24472
280,32,2,1,0,3,1,0,104,123,31969,25238,50,24,33817,24472
281,32,2,0,0,3,1,0,36,17,31971,25238,34,10,33820,24472
282,32,5,1,0,3,1,0,63,45,31976,25239,58,96,33823,24472
283,32,2,2,2,1,2,1,17,33,31978,25241,14,13,33824,24473
284,32,4,1,0,3,1,0,35,8,31982,25242,38,110,33827,24473
285,32,4,2,0,3,1,0,33,20,31986,25244,31,9,33830,24473
286,32,3,1,0,3,1,0,35,15,31989,25245,32,29,33833,24473
287,32,3,1,0,3,1,0,37,20,31992,25246,37,14,33836,24473
288,33,3,1,0,3,1,0,162,106,31995,25247,149,13,33839,24473
289,33,4,0,0,3,1,0,38,13,31999,25247,40,105,33842,24473
290,33,1,2,1,0,0,3,35,23,32000,25249,27,32,33842,24476
291,33,3,2,0,3,1,0,20,35,32003,25251,17,11,33845,24476
292,33,1,2,1,0,0,3,231,55,32004,25253,131,12,33845,24479
293,33,2,1,0,3,1,0,40,15,32006,25254,39,9,33848,24479
294,33,5,1,0,3,1,0,37,20,32011,25255,35,10,33851,24479
295,33,2,4,1,0,0,3,36,25,32013,25259,33,19,33851,24482
296,33,5,0,0,3,1,0,59,77,32018,25259,28,127,33854,24482
297,34,0,1,1,0,0,3,104,124,32018,25260,50,99,33854,24485
298,34,0,0,2,1,2,1,63,45,32018,25260,59,14,33855,24486
299,34,3,0,0,3,1,0,39,17,32021,25260,37,21,33858,24486
300,34,1,1,2,1,2,1,36,16,32022,25261,33,15,33859,24487
301,34,1,0,0,3,1,0,284,90,32023,25261,319,42,33862,24487
302,34,5,1,0,3,1,0,38,21,32028,25262,34,24,33865,24487
303,34,1,4,1,0,0,3,23,22,32029,25266,26,113,33865,24490
304,34,0,0,2,1,2,1,37,20,32029,25266,38,30,33866,24491
305,34,3,1,0,3,1,0,38,9,32032,25267,41,31,33869,24491
0,1,0,2,1,0,0,3,162,108,32032,25269,149,14,33869,24494
1,1,2,1,0,3,1,0,65,46,32034,25270,62,19,33872,24494
2,1,2,2,2,1,2,1,37,25,32036,25272,28,16,33873,24495
3,1,2,2,2,1,2,1,2,2,32038,25274,1,13,33874,24496
4,1,0,0,2,1,2,1,20,35,32038,25274,18,14,33875,24497
5,1,3,1,0,3,1,0,40,21,32041,25275,38,30,33878,24497
6,1,1,4,1,0,0,3,285,94,32042,25279,319,35,33878,24500
7,1,0,0,2,1,2,1,36,25,32042,25279,34,10,33879,24501
8,1,0,1,1,0,0,3,231,56,32042,25280,131,34,33879,24504
9,2,2,0,0,3,1,0,40,13,32044,25280,43,24,33882,24504
10,2,4,0,0,3,1,0,27,22,32048,25280,29,42,33885,24504
11,2,1,0,0,3,1,0,41,15,32049,25280,42,34,33888,24504
12,2,3,0,0,3,1,0,39,16,32052,25280,36,127,33891,24504
13,2,2,1,0,3,1,0,41,18,32054,25281,40,99,33894,24504
14,2,2,2,2,1,2,1,40,23,32056,25283,35,11,33895,24505
15,2,5,1,0,3,1,0,43,10,32061,25284,44,14,33898,24505
16,2,4,2,0,3,1,0,41,22,32065,25286,41,21,33901,24505
17,2,2,0,0,3,1,0,61,77,32067,25286,31,113,33904,24505
18,3,0,2,1,0,0,3,65,48,32067,25288,62,37,33904,24508
19,3,2,1,0,3,1,0,29,23,32069,25289,32,14,33907,24508
20,3,1,5,1,0,0,3,38,30,32070,25294,28,37,33907,24511
21,3,1,1,2,1,2,1,163,109,32071,25295,150,12,33908,24512
22,3,2,2,2,1,2,1,233,58,32073,25297,132,20,33909,24513
23,3,1,1,2,1,2,1,42,19,32074,25298,41,15,33910,24514
24,3,4,0,0,3,1,0,44,21,32078,25298,41,16,33913,24514
25,3,2,2,2,1,2,1,22,37,32080,25300,19,36,33914,24515
26,3,0,3,1,0,0,3,36,28,32080,25303,34,33,33914,24518
27,4,4,1,0,3,1,0,47,11,32084,25304,47,10,33917,24518
28,4,2,1,0,3,1,0,4,3,32086,25305,4,99,33920,24518
29,4,4,1,0,3,1,0,44,14,32090,25306,46,42,33923,24518
30,4,2,1,0,3,1,0,63,78,32092,25307,34,13,33926,24518
31,4,3,1,0,3,1,0,43,24,32095,25308,38,127,33929,24518
32,4,0,3,1,0,0,3,285,97,32095,25311,319,24,33929,24521
33,4,0,3,1,0,0,3,41,25,32095,25314,41,27,33929,24524
34,4,2,2,2,1,2,1,41,18,32097,25316,37,15,33930,24525
35,4,6,1,0,3,1,0,47,16,32103,25317,45,113,33933,24525
36,5,2,1,0,3,1,0,67,49,32105,25318,65,37,33936,24525
37,5,1,0,0,3,1,0,286,97,32106,25318,322,16,33939,24525
38,5,0,1,1,0,0,3,36,29,32106,25319,34,40,33939,24528
39,5,4,0,0,3,1,0,48,21,32110,25319,44,10,33942,24528
40,5,2,3,1,0,0,3,44,22,32112,25322,41,39,33942,24531
41,5,3,0,0,3,1,0,41,30,32115,25322,31,20,33945,24531
42,5,1,3,1,0,0,3,234,61,32116,25325,132,18,33945,24534
43,5,3,3,2,1,2,1,25,40,32119,25328,20,34,33946,24535
44,5,2,3,1,0,0,3,165,112,32121,25331,150,17,33946,24538
45,6,1,2,1,0,0,3,64,80,32122,25333,34,102,33946,24541
46,6,2,0,0,3,1,0,43,25,32124,25333,44,113,33949,24541
47,6,0,3,1,0,0,3,25,43,32124,25336,20,18,33949,24544
48,6,5,0,0,3,1,0,34,23,32129,25336,35,127,33952,24544
49,6,4,0,0,3,1,0,45,18,32133,25336,40,12,33955,24544
50,6,2,2,2,1,2,1,49,18,32135,25338,46,40,33956,24545
51,6,1,2,1,0,0,3,5,5,32136,25340,4,30,33956,24548
52,6,5,2,0,3,1,0,49,16,32141,25342,49,24,33959,24548
53,6,2,2,2,1,2,1,45,26,32143,25344,39,14,33960,24549
54,7,7,1,0,3,1,0,56,19,32150,25345,49,127,33963,24549
55,7,2,0,0,3,1,0,38,29,32152,25345,37,42,33966,24549
56,7,1,1,2,1,2,1,42,31,32153,25346,32,15,33967,24550
57,7,1,0,0,3,1,0,235,61,32154,25346,135,17,33970,24550
58,7,1,1,2,1,2,1,48,12,32155,25347,48,38,33971,24551
59,7,2,1,0,3,1,0,50,22,32157,25348,47,18,33974,24551
60,7,2,0,0,3,1,0,7,5,32159,25348,7,16,33977,24551
61,7,2,3,1,0,0,3,288,100,32161,25351,322,23,33977,24554
62,7,0,2,1,0,0,3,165,114,32161,25353,150,13,33977,24557
63,8,2,0,0,3,1,0,46,22,32163,25353,44,12,33980,24557
64,8,3,0,0,3,1,0,48,26,32166,25353,42,40,33983,24557
65,8,1,1,2,1,2,1,35,24,32167,25354,36,19,33984,24558
66,8,4,3,0,3,1,0,71,52,32171,25357,68,102,33987,24558
67,8,1,3,1,0,0,3,26,46,32172,25360,20,33,33987,24561
68,8,2,2,2,1,2,1,51,18,32174,25362,50,114,33988,24562
69,8,1,0,0,3,1,0,44,25,32175,25362,47,40,33991,24562
70,8,0,3,1,0,0,3,45,21,32175,25365,40,27,33991,24565
71,8,0,2,1,0,0,3,64,82,32175,25367,34,37,33991,24568
72,9,2,2,2,1,2,1,50,14,32177,25369,49,34,33992,24569
73,9,2,1,0,3,1,0,48,23,32179,25370,47,23,33995,24569
74,9,0,4,1,0,0,3,7,9,32179,25374,7,41,33995,24572
75,9,1,1,2,1,2,1,43,32,32180,25375,33,13,33996,24573
76,9,1,0,0,3,1,0,57,19,32181,25375,52,17,33999,24573
77,9,0,1,1,0,0,3,64,83,32181,25376,34,16,33999,24576
78,9,4,1,0,3,1,0,75,53,32185,25377,71,27,34002,24576
79,9,4,0,0,3,1,0,49,21,32189,25377,43,42,34005,24576
80,9,2,0,0,3,1,0,237,61,32191,25377,138,114,34008,24576
81,10,3,1,0,3,1,0,291,101,32194,25378,325,102,34011,24576
82,10,4,1,0,3,1,0,30,47,32198,25379,23,40,34014,24576
83,10,0,2,1,0,0,3,165,116,32198,25381,150,18,34014,24579
84,10,1,0,0,3,1,0,39,29,32199,25381,40,16,34017,24579
85,10,1,4,1,0,0,3,49,30,32200,25385,42,22,34017,24582
86,10,1,1,2,1,2,1,51,15,32201,25386,50,19,34018,24583
87,10,1,0,0,3,1,0,51,22,32202,25386,50,127,34021,24583
88,10,1,1,2,1,2,1,45,26,32203,25387,48,42,34022,24584
89,10,1,1,2,1,2,1,36,25,32204,25388,37,38,34023,24585
90,11,3,1,0,3,1,0,240,62,32207,25389,141,42,34026,24585
91,11,0,4,1,0,0,3,75,57,32207,25393,71,43,34026,24588
92,11,1,0,0,3,1,0,166,116,32208,25393,153,40,34029,24588
93,11,4,0,0,3,1,0,47,32,32212,25393,36,27,34032,24588
94,11,2,2,2,1,2,1,53,20,32214,25395,51,39,34033,24589
95,11,0,1,1,0,0,3,291,102,32214,25396,325,19,34033,24592
96,11,6,0,0,3,1,0,51,26,32220,25396,51,19,34036,24592
97,11,3,1,0,3,1,0,67,84,32223,25397,37,17,34039,24592
98,11,0,1,1,0,0,3,48,24,32223,25398,47,37,34039,24595
99,12,0,0,2,1,2,1,30,47,32223,25398,24,115,34040,24596
100,12,1,0,0,3,1,0,241,62,32224,25398,144,19,34043,24596
101,12,1,2,1,0,0,3,76,59,32225,25400,71,25,34043,24599
102,12,1,1,2,1,2,1,8,10,32226,25401,8,24,34044,24600
103,12,0,1,1,0,0,3,49,22,32226,25402,43,19,34044,24603
104,12,6,4,0,3,1,0,55,34,32232,25406,45,43,34047,24603
105,12,4,0,0,3,1,0,57,20,32236,25406,54,13,34050,24603
106,12,3,0,0,3,1,0,54,22,32239,25406,53,27,34053,24603
107,12,4,1,0,3,1,0,61,20,32243,25407,55,18,34056,24603
108,13,1,3,1,0,0,3,292,105,32244,25410,325,42,34056,24606
109,13,1,2,1,0,0,3,68,86,32245,25412,37,130,34056,24609
110,13,1,1,2,1,2,1,48,33,32246,25413,37,41,34057,24610
111,13,1,1,2,1,2,1,49,25,32247,25414,48,43,34058,24611
112,13,2,2,2,1,2,1,53,17,32249,25416,51,103,34059,24612
113,13,2,2,2,1,2,1,41,31,32251,25418,41,18,34060,24613
114,13,0,4,1,0,0,3,36,29,32251,25422,37,22,34060,24616
115,13,2,1,0,3,1,0,53,27,32253,25423,54,42,34063,24616
116,13,0,0,2,1,2,1,166,116,32253,25423,154,38,34064,24617
117,14,2,0,0,3,1,0,56,22,32255,25423,56,18,34067,24617
118,14,2,2,2,1,2,1,243,64,32257,25425,145,26,34068,24618
119,14,1,2,1,0,0,3,31,49,32258,25427,24,16,34068,24621
120,14,3,1,0,3,1,0,79,60,32261,25428,74,18,34071,24621
121,14,6,1,0,3,1,0,67,21,32267,25429,58,24,34074,24621
122,14,1,2,1,0,0,3,9,12,32268,25431,8,25,34074,24624
123,14,1,1,2,1,2,1,167,117,32269,25432,155,28,34075,24625
124,14,0,3,1,0,0,3,68,89,32269,25435,37,46,34075,24628
125,14,0,0,2,1,2,1,57,20,32269,25435,55,20,34076,24629
126,15,7,0,0,3,1,0,56,25,32276,25435,51,42,34079,24629
127,15,3,3,2,1,2,1,56,30,32279,25438,55,20,34080,24630
128,15,3,0,0,3,1,0,44,31,32282,25438,44,103,34083,24630
129,15,1,2,1,0,0,3,293,107,32283,25440,325,133,34083,24633
130,15,4,1,0,3,1,0,57,18,32287,25441,54,115,34086,24633
131,15,2,0,0,3,1,0,51,22,32289,25441,46,42,34089,24633
132,15,4,0,0,3,1,0,40,29,32293,25441,40,41,34092,24633
133,15,2,6,1,0,0,3,57,40,32295,25447,45,46,34092,24636
134,15,5,1,0,3,1,0,53,34,32300,25448,40,38,34095,24636
135,16,2,0,0,3,1,0,46,31,32302,25448,47,18,34098,24636
136,16,2,0,0,3,1,0,59,20,32304,25448,58,20,34101,24636
137,16,4,0,0,3,1,0,60,22,32308,25448,59,16,34104,24636
138,16,0,5,1,0,0,3,167,122,32308,25453,155,29,34104,24639
139,16,1,0,0,3,1,0,68,21,32309,25453,61,103,34107,24639
140,16,2,0,0,3,1,0,33,49,32311,25453,27,133,34110,24639
141,16,2,2,2,1,2,1,59,42,32313,25455,46,26,34111,24640
142,16,0,1,1,0,0,3,9,13,32313,25456,8,49,34111,24643
143,16,0,0,2,1,2,1,40,29,32313,25456,41,25,34112,24644
144,17,1,3,1,0,0,3,294,110,32314,25459,325,44,34112,24647
145,17,0,1,1,0,0,3,56,26,32314,25460,51,23,34112,24650
146,17,7,0,0,3,1,0,86,60,32321,25460,77,115,34115,24650
147,17,2,0,0,3,1,0,70,89,32323,25460,40,42,34118,24650
148,17,1,0,0,3,1,0,57,30,32324,25460,58,18,34121,24650
149,17,4,0,0,3,1,0,61,18,32328,25460,57,28,34124,24650
150,17,2,1,0,3,1,0,245,65,32330,25461,148,38,34127,24650
151,17,3,2,0,3,1,0,54,24,32333,25463,49,46,34130,24650
152,17,1,5,1,0,0,3,54,39,32334,25468,40,45,34130,24653
153,18,3,3,2,1,2,1,49,34,32337,25471,48,134,34131,24654
154,18,0,2,1,0,0,3,294,112,32337,25473,325,32,34131,24657
155,18,3,0,0,3,1,0,170,122,32340,25473,158,103,34134,24657
156,18,5,0,0,3,1,0,64,20,32345,25473,61,44,34137,24657
157,18,0,1,1,0,0,3,40,30,32345,25474,41,23,34137,24660
158,18,2,1,0,3,1,0,35,50,32347,25475,30,26,34140,24660
159,18,1,1,2,1,2,1,61,23,32348,25476,60,50,34141,24661
160,18,2,1,0,3,1,0,59,31,32350,25477,61,18,34144,24661
161,18,1,1,2,1,2,1,60,43,32351,25478,47,46,34145,24662
162,19,3,1,0,3,1,0,71,22,32354,25479,64,23,34148,24662
163,19,2,0,0,3,1,0,56,39,32356,25479,43,18,34151,24662
164,19,1,1,2,1,2,1,246,66,32357,25480,149,17,34152,24663
165,19,3,0,0,3,1,0,59,26,32360,25480,54,115,34155,24663
166,19,2,0,0,3,1,0,88,60,32362,25480,80,38,34158,24663
167,19,4,2,0,3,1,0,58,26,32366,25482,52,50,34161,24663
168,19,4,0,0,3,1,0,13,13,32370,25482,11,42,34164,24663
169,19,4,1,0,3,1,0,68,21,32374,25483,64,25,34167,24663
170,19,2,0,0,3,1,0,72,89,32376,25483,43,28,34170,24663
171,20,4,3,0,3,1,0,60,42,32380,25486,46,134,34173,24663
172,20,3,1,0,3,1,0,173,123,32383,25487,161,42,34176,24663
173,20,1,0,0,3,1,0,41,30,32384,25487,44,103,34179,24663
174,20,0,2,1,0,0,3,61,20,32384,25489,57,21,34179,24666
175,20,1,1,2,1,2,1,60,27,32385,25490,55,47,34180,24667
176,20,0,2,1,0,0,3,72,91,32385,25492,43,29,34180,24670
177,20,0,3,1,0,0,3,59,34,32385,25495,61,47,34180,24673
178,20,0,6,1,0,0,3,49,40,32385,25501,48,41,34180,24676
179,20,1,2,1,0,0,3,295,114,32386,25503,325,49,34180,24679
180,21,2,3,1,0,0,3,70,24,32388,25506,64,21,34180,24682
181,21,2,0,0,3,1,0,63,23,32390,25506,63,115,34183,24682
182,21,2,0,0,3,1,0,37,50,32392,25506,33,25,34186,24682
183,21,1,0,0,3,1,0,89,60,32393,25506,83,23,34189,24682
184,21,0,2,1,0,0,3,246,68,32393,25508,149,53,34189,24685
185,21,1,1,2,1,2,1,61,44,32394,25509,48,29,34190,24686
186,21,4,1,0,3,1,0,75,23,32398,25510,67,17,34193,24686
187,21,0,1,1,0,0,3,13,14,32398,25511,11,35,34193,24689
188,21,3,1,0,3,1,0,61,27,32401,25512,55,23,34196,24689
189,22,1,0,0,3,1,0,61,42,32402,25512,49,103,34199,24689
190,22,1,1,2,1,2,1,62,28,32403,25513,56,48,34200,24690
191,22,1,1,2,1,2,1,50,41,32404,25514,49,116,34201,24691
192,22,1,4,1,0,0,3,296,118,32405,25518,325,45,34201,24694
193,22,2,1,0,3,1,0,62,28,32407,25519,58,134,34204,24694
194,22,3,0,0,3,1,0,62,34,32410,25519,64,47,34207,24694
195,22,4,1,0,3,1,0,65,21,32414,25520,60,23,34210,24694
196,22,3,0,0,3,1,0,64,44,32417,25520,51,41,34213,24694
197,22,1,4,1,0,0,3,42,34,32418,25524,44,52,34213,24697
198,23,1,0,0,3,1,0,14,14,32419,25524,14,23,34216,24697
199,23,4,0,0,3,1,0,250,68,32423,25524,152,29,34219,24697
200,23,3,1,0,3,1,0,40,51,32426,25525,36,21,34222,24697
201,23,0,2,1,0,0,3,89,62,32426,25527,83,20,34222,24700
202,23,4,0,0,3,1,0,76,91,32430,25527,46,25,34225,24700
203,23,1,4,1,0,0,3,174,127,32431,25531,161,56,34225,24703
204,23,1,0,0,3,1,0,71,24,32432,25531,67,21,34228,24703
205,23,3,2,0,3,1,0,78,25,32435,25533,70,29,34231,24703
206,23,3,3,2,1,2,1,66,26,32438,25536,64,36,34232,24704
207,24,0,0,2,1,2,1,50,41,32438,25536,50,37,34233,24705
208,24,2,1,0,3,1,0,42,52,32440,25537,39,103,34236,24705
209,24,1,0,0,3,1,0,15,14,32441,25537,17,116,34239,24705
210,24,3,1,0,3,1,0,69,27,32444,25538,67,21,34242,24705
211,24,2,0,0,3,1,0,44,34,32446,25538,47,20,34245,24705
212,24,4,1,0,3,1,0,69,22,32450,25539,63,134,34248,24705
213,24,0,0,2,1,2,1,64,44,32450,25539,52,24,34249,24706
214,24,1,0,0,3,1,0,63,28,32451,25539,59,25,34252,24706
215,24,2,6,1,0,0,3,80,31,32453,25545,70,55,34252,24709
216,25,3,1,0,3,1,0,92,63,32456,25546,86,45,34255,24709
217,25,1,3,1,0,0,3,63,37,32457,25549,64,26,34255,24712
218,25,0,2,1,0,0,3,62,30,32457,25551,58,32,34255,24715
219,25,4,2,0,3,1,0,65,44,32461,25553,52,116,34258,24715
220,25,3,1,0,3,1,0,253,69,32464,25554,155,47,34261,24715
221,25,3,1,0,3,1,0,79,92,32467,25555,49,55,34264,24715
222,25,1,1,2,1,2,1,64,29,32468,25556,60,22,34265,24716
223,25,3,0,0,3,1,0,72,22,32471,25556,66,48,34268,24716
224,25,0,2,1,0,0,3,296,120,32471,25558,325,44,34268,24719
225,26,2,0,0,3,1,0,46,34,32473,25558,50,21,34271,24719
226,26,1,0,0,3,1,0,16,14,32474,25558,20,20,34274,24719
227,26,2,1,0,3,1,0,176,128,32476,25559,164,134,34277,24719
228,26,0,2,1,0,0,3,42,54,32476,25561,39,27,34277,24722
229,26,0,2,1,0,0,3,50,43,32476,25563,50,59,34277,24725
230,26,5,1,0,3,1,0,85,32,32481,25564,73,37,34280,24725
231,26,0,2,1,0,0,3,71,26,32481,25566,67,32,34280,24728
232,26,3,1,0,3,1,0,67,45,32484,25567,55,25,34283,24728
233,26,0,0,2,1,2,1,69,27,32484,25567,68,104,34284,24729
234,27,0,1,1,0,0,3,176,129,32484,25568,164,28,34284,24732
235,27,3,1,0,3,1,0,95,64,32487,25569,89,26,34287,24732
236,27,1,1,2,1,2,1,254,70,32488,25570,156,28,34288,24733
237,27,4,1,0,3,1,0,69,45,32492,25571,55,45,34291,24733
238,27,1,1,2,1,2,1,51,44,32493,25572,51,56,34292,24734
239,27,1,0,0,3,1,0,70,27,32494,25572,71,48,34295,24734
240,27,3,1,0,3,1,0,65,31,32497,25573,61,22,34298,24734
241,27,0,3,1,0,0,3,296,123,32497,25576,325,35,34298,24737
242,27,2,0,0,3,1,0,74,22,32499,25576,69,47,34301,24737
243,28,3,2,0,3,1,0,70,47,32502,25578,58,116,34304,24737
244,28,1,3,1,0,0,3,64,40,32503,25581,64,40,34304,24740
245,28,2,0,0,3,1,0,87,32,32505,25581,76,45,34307,24740
246,28,2,0,0,3,1,0,73,26,32507,25581,70,134,34310,24740
247,28,3,1,0,3,1,0,67,30,32510,25582,63,104,34313,24740
248,28,2,0,0,3,1,0,81,92,32512,25582,52,20,34316,24740
249,28,1,0,0,3,1,0,17,14,32513,25582,23,32,34319,24740
250,28,6,0,0,3,1,0,80,22,32519,25582,72,21,34322,24740
251,28,2,2,2,1,2,1,48,36,32521,25584,51,45,34323,24741
252,29,0,2,1,0,0,3,176,131,32521,25586,164,31,34323,24744
253,29,2,2,2,1,2,1,72,29,32523,25588,72,57,34324,24745
254,29,1,2,1,0,0,3,255,72,32524,25590,156,24,34324,24748
255,29,0,0,2,1,2,1,95,64,32524,25590,90,36,34325,24749
256,29,2,1,0,3,1,0,19,15,32526,25591,26,47,34328,24749
257,29,0,5,1,0,0,3,69,50,32526,25596,55,62,34328,24752
258,29,3,0,0,3,1,0,299,123,32529,25596,328,22,34331,24752
259,29,1,3,1,0,0,3,43,57,32530,25599,39,29,34331,24755
260,29,3,0,0,3,1,0,54,44,32533,25599,54,28,34334,24755
261,30,3,2,0,3,1,0,90,34,32536,25601,79,45,34337,24755
262,30,2,4,1,0,0,3,83,96,32538,25605,52,43,34337,24758
263,30,3,0,0,3,1,0,70,30,32541,25605,66,116,34340,24758
264,30,2,2,2,1,2,1,75,28,32543,25607,71,105,34341,24759
265,30,0,1,1,0,0,3,64,41,32543,25608,64,137,34341,24762
266,30,1,0,0,3,1,0,49,36,32544,25608,54,32,34344,24762
267,30,3,1,0,3,1,0,83,23,32547,25609,75,20,34347,24762
268,30,4,2,0,3,1,0,74,49,32551,25611,61,45,34350,24762
269,30,1,1,2,1,2,1,66,32,32552,25612,62,49,34351,24763
270,31,0,3,1,0,0,3,255,75,32552,25615,156,140,34351,24766
271,31,1,1,2,1,2,1,70,51,32553,25616,56,30,34352,24767
272,31,2,3,1,0,0,3,301,126,32555,25619,328,27,34352,24770
273,31,0,2,1,0,0,3,19,17,32555,25621,26,25,34352,24773
274,31,0,1,1,0,0,3,176,132,32555,25622,164,60,34352,24776
275,31,1,2,1,0,0,3,55,46,32556,25624,54,39,34352,24779
276,31,2,1,0,3,1,0,74,30,32558,25625,75,45,34355,24779
277,31,2,1,0,3,1,0,92,35,32560,25626,82,31,34358,24779
278,31,2,0,0,3,1,0,85,23,32562,25626,78,28,34361,24779
279,32,1,1,2,1,2,1,65,42,32563,25627,65,21,34362,24780
280,32,2,4,1,0,0,3,68,36,32565,25631,62,46,34362,24783
281,32,3,2,0,3,1,0,52,38,32568,25633,57,116,34365,24783
282,32,1,3,1,0,0,3,75,52,32569,25636,61,108,34365,24786
283,32,2,1,0,3,1,0,45,58,32571,25637,42,32,34368,24786
284,32,1,3,1,0,0,3,96,67,32572,25640,90,50,34368,24789
285,32,1,2,1,0,0,3,76,30,32573,25642,71,65,34368,24792
286,32,1,0,0,3,1,0,71,30,32574,25642,69,45,34371,24792
287,32,1,1,2,1,2,1,84,97,32575,25643,53,50,34372,24793
288,33,1,1,2,1,2,1,66,43,32576,25644,66,109,34373,24794
289,33,2,2,2,1,2,1,77,54,32578,25646,62,31,34374,24795
290,33,1,1,2,1,2,1,85,98,32579,25647,54,46,34375,24796
291,33,2,2,2,1,2,1,303,128,32581,25649,329,117,34376,24797
292,33,5,2,0,3,1,0,24,19,32586,25651,29,140,34379,24797
293,33,2,0,0,3,1,0,87,23,32588,25651,81,45,34382,24797
294,33,4,1,0,3,1,0,75,31,32592,25652,72,27,34385,24797
295,33,5,0,0,3,1,0,97,35,32597,25652,85,32,34388,24797
296,33,3,4,1,0,0,3,79,34,32600,25656,71,49,34388,24800
297,34,3,5,1,0,0,3,58,51,32603,25661,54,24,34388,24803
298,34,3,2,0,3,1,0,258,77,32606,25663,159,50,34391,24803
299,34,1,3,1,0,0,3,53,41,32607,25666,57,68,34391,24806
300,34,1,3,1,0,0,3,177,135,32608,25669,164,53,34391,24809
301,34,2,3,1,0,0,3,72,54,32610,25672,56,42,34391,24812
302,34,1,3,1,0,0,3,97,70,32611,25675,90,28,34391,24815
303,34,4,2,0,3,1,0,49,60,32615,25677,45,60,34394,24815
304,34,1,0,0,3,1,0,75,30,32616,25677,78,28,34397,24815
305,34,1,2,1,0,0,3,69,38,32617,25679,62,34,34397,24818
0,1,1,1,2,1,2,1,105,125,32618,25680,51,110,34398,24819
1,1,3,2,0,3,1,0,27,21,32621,25682,32,53,34401,24819
2,1,1,1,2,1,2,1,98,71,32622,25683,91,137,34402,24820
3,1,1,1,2,1,2,1,70,39,32623,25684,63,46,34403,24821
4,1,0,1,1,0,0,3,77,55,32623,25685,62,45,34403,24824
5,1,4,1,0,3,1,0,83,35,32627,25686,74,28,34406,24824
6,1,2,2,2,1,2,1,55,43,32629,25688,58,33,34407,24825
7,1,0,2,1,0,0,3,72,56,32629,25690,56,37,34407,24828
8,1,2,2,2,1,2,1,89,25,32631,25692,82,47,34408,24829
9,2,5,0,0,3,1,0,102,35,32636,25692,88,140,34411,24829
10,2,0,1,1,0,0,3,258,78,32636,25693,159,63,34411,24832
11,2,0,1,1,0,0,3,0,1,32636,25694,0,34,34411,24835
12,2,1,3,1,0,0,3,50,63,32637,25697,45,31,34411,24838
13,2,1,1,2,1,2,1,76,32,32638,25698,73,50,34412,24839
14,2,1,1,2,1,2,1,67,44,32639,25699,67,106,34413,24840
15,2,2,2,2,1,2,1,60,53,32641,25701,55,51,34414,24841
16,2,3,1,0,3,1,0,78,31,32644,25702,81,27,34417,24841
17,2,1,6,1,0,0,3,86,104,32645,25708,54,71,34417,24844
18,3,1,0,0,3,1,0,28,21,32646,25708,35,140,34420,24844
19,3,1,1,2,1,2,1,78,56,32647,25709,63,138,34421,24845
20,3,2,4,1,0,0,3,52,67,32649,25713,45,36,34421,24848
21,3,5,0,0,3,1,0,94,25,32654,25713,85,110,34424,24848
22,3,0,0,2,1,2,1,78,31,32654,25713,82,51,34425,24849
23,3,1,2,1,0,0,3,71,41,32655,25715,63,48,34425,24852
24,3,0,2,1,0,0,3,105,127,32655,25717,51,37,34425,24855
25,3,1,3,1,0,0,3,87,107,32656,25720,54,66,34425,24858
26,3,1,3,1,0,0,3,68,47,32657,25723,67,56,34425,24861
27,4,0,1,1,0,0,3,60,54,32657,25724,55,31,34425,24864
28,4,3,0,0,3,1,0,101,71,32660,25724,94,106,34428,24864
29,4,0,4,1,0,0,3,0,5,32660,25728,0,40,34428,24867
30,4,1,1,2,1,2,1,29,22,32661,25729,36,28,34429,24868
31,4,1,1,2,1,2,1,259,79,32662,25730,160,32,34430,24869
32,4,1,0,0,3,1,0,56,43,32663,25730,61,48,34433,24869
33,4,1,0,0,3,1,0,84,35,32664,25730,77,46,34436,24869
34,4,5,1,0,3,1,0,107,36,32669,25731,91,47,34439,24869
35,4,2,2,2,1,2,1,74,58,32671,25733,57,72,34440,24870
36,5,2,0,0,3,1,0,96,25,32673,25733,88,51,34443,24870
37,5,2,6,1,0,0,3,107,133,32675,25739,51,69,34443,24873
38,5,1,3,1,0,0,3,75,61,32676,25742,57,39,34443,24876
39,5,2,2,2,1,2,1,54,69,32678,25744,46,41,34444,24877
40,5,2,0,0,3,1,0,78,32,32680,25744,76,138,34447,24877
41,5,2,1,0,3,1,0,73,42,32682,25745,66,110,34450,24877
42,5,4,0,0,3,1,0,82,31,32686,25745,85,140,34453,24877
43,5,1,0,0,3,1,0,79,56,32687,25745,66,56,34456,24877
44,5,0,3,1,0,0,3,68,50,32687,25748,67,40,34456,24880
45,6,0,1,1,0,0,3,101,72,32687,25749,94,35,34456,24883
46,6,1,2,1,0,0,3,1,7,32688,25751,0,34,34456,24886
47,6,1,1,2,1,2,1,30,23,32689,25752,37,47,34457,24887
48,6,1,1,2,1,2,1,57,44,32690,25753,62,29,34458,24888
49,6,0,0,2,1,2,1,87,107,32690,25753,55,107,34459,24889
50,6,1,1,2,1,2,1,61,55,32691,25754,56,73,34460,24890
51,6,1,0,0,3,1,0,85,35,32692,25754,80,51,34463,24890
52,6,2,1,0,3,1,0,261,80,32694,25755,163,47,34466,24890
53,6,3,0,0,3,1,0,110,36,32697,25755,94,48,34469,24890
54,7,2,0,0,3,1,0,77,61,32699,25755,60,110,34472,24890
55,7,5,1,0,3,1,0,83,33,32704,25756,79,41,34475,24890
56,7,1,2,1,0,0,3,80,58,32705,25758,66,43,34475,24893
57,7,3,3,2,1,2,1,76,45,32708,25761,67,40,34476,24894
58,7,1,0,0,3,1,0,97,25,32709,25761,91,69,34479,24894
59,7,3,3,2,1,2,1,85,34,32712,25764,86,52,34480,24895
60,7,0,1,1,0,0,3,107,134,32712,25765,51,141,34480,24898
61,7,3,2,0,3,1,0,71,52,32715,25767,70,140,34483,24898
62,7,0,6,1,0,0,3,54,75,32715,25773,46,59,34483,24901
63,8,1,1,2,1,2,1,88,108,32716,25774,56,41,34484,24902
64,8,1,0,0,3,1,0,108,134,32717,25774,54,52,34487,24902
65,8,0,3,1,0,0,3,1,10,32717,25777,0,32,34487,24905
66,8,3,3,2,1,2,1,60,47,32720,25780,63,52,34488,24906
67,8,3,0,0,3,1,0,104,72,32723,25780,97,47,34491,24906
68,8,1,1,2,1,2,1,98,26,32724,25781,92,36,34492,24907
69,8,4,0,0,3,1,0,114,36,32728,25781,97,110,34495,24907
70,8,2,2,2,1,2,1,73,54,32730,25783,71,49,34496,24908
71,8,3,0,0,3,1,0,88,35,32733,25783,83,47,34499,24908
72,9,3,3,2,1,2,1,79,48,32736,25786,68,74,34500,24909
73,9,1,1,2,1,2,1,105,73,32737,25787,98,70,34501,24910
74,9,0,3,1,0,0,3,261,83,32737,25790,163,46,34501,24913
75,9,3,2,0,3,1,0,117,38,32740,25792,100,107,34504,24913
76,9,0,2,1,0,0,3,85,36,32740,25794,86,44,34504,24916
77,9,1,2,1,0,0,3,62,57,32741,25796,56,39,34504,24919
78,9,2,3,1,0,0,3,56,78,32743,25799,46,52,34504,24922
79,9,3,0,0,3,1,0,80,61,32746,25799,63,34,34507,24922
80,9,1,2,1,0,0,3,31,25,32747,25801,37,144,34507,24925
81,10,1,0,0,3,1,0,81,58,32748,25801,69,34,34510,24925
82,10,2,0,0,3,1,0,64,57,32750,25801,59,107,34513,24925
83,10,0,0,2,1,2,1,88,108,32750,25801,57,141,34514,24926
84,10,1,4,1,0,0,3,57,82,32751,25805,46,113,34514,24929
85,10,2,2,2,1,2,1,85,35,32753,25807,80,75,34515,24930
86,10,1,2,1,0,0,3,2,12,32754,25809,0,62,34515,24933
87,10,6,3,0,3,1,0,85,51,32760,25812,71,52,34518,24933
88,10,0,1,1,0,0,3,31,26,32760,25813,37,73,34518,24936
89,10,1,2,1,0,0,3,61,49,32761,25815,63,50,34518,24939
90,11,0,0,2,1,2,1,105,73,32761,25815,99,42,34519,24940
91,11,0,2,1,0,0,3,98,28,32761,25817,92,49,34519,24943
92,11,1,5,1,0,0,3,109,139,32762,25822,54,42,34519,24946
93,11,4,0,0,3,1,0,121,38,32766,25822,103,32,34522,24946
94,11,1,2,1,0,0,3,74,56,32767,25824,71,47,34522,24949
95,11,1,2,1,0,0,3,86,38,32768,25826,86,50,34522,24952
96,11,3,0,0,3,1,0,91,35,32771,25826,86,52,34525,24952
97,11,2,1,0,3,1,0,82,62,32773,25827,66,144,34528,24952
98,11,2,1,0,3,1,0,263,84,32775,25828,166,52,34531,24952
99,12,0,1,1,0,0,3,263,85,32775,25829,166,37,34531,24955
100,12,4,0,0,3,1,0,35,26,32779,25829,40,42,34534,24955
101,12,4,1,0,3,1,0,61,83,32783,25830,49,107,34537,24955
102,12,2,2,2,1,2,1,66,59,32785,25832,60,51,34538,24956
103,12,3,2,0,3,1,0,91,110,32788,25834,60,32,34541,24956
104,12,0,0,2,1,2,1,61,49,32788,25834,64,74,34542,24957
105,12,5,2,0,3,1,0,90,37,32793,25836,83,141,34545,24957
106,12,2,4,1,0,0,3,4,16,32795,25840,0,78,34545,24960
107,12,5,1,0,3,1,0,126,39,32800,25841,106,52,34548,24960
108,13,1,6,1,0,0,3,67,65,32801,25847,60,65,34548,24963
109,13,0,2,1,0,0,3,82,64,32801,25849,66,55,34548,24966
110,13,2,0,0,3,1,0,6,16,32803,25849,3,113,34551,24966
111,13,2,0,0,3,1,0,100,28,32805,25849,95,50,34554,24966
112,13,1,1,2,1,2,1,75,57,32806,25850,72,52,34555,24967
113,13,4,1,0,3,1,0,65,50,32810,25851,67,47,34558,24967
114,13,3,0,0,3,1,0,93,37,32813,25851,86,107,34561,24967
115,13,1,1,2,1,2,1,82,59,32814,25852,70,75,34562,24968
116,13,5,1,0,3,1,0,90,52,32819,25853,74,141,34565,24968
117,14,0,3,1,0,0,3,263,88,32819,25856,166,45,34565,24971
118,14,2,0,0,3,1,0,93,110,32821,25856,63,42,34568,24971
119,14,1,1,2,1,2,1,36,27,32822,25857,41,38,34569,24972
120,14,1,1,2,1,2,1,62,84,32823,25858,50,53,34570,24973
121,14,2,2,2,1,2,1,111,141,32825,25860,55,33,34571,24974
122,14,1,2,1,0,0,3,106,75,32826,25862,99,81,34571,24977
123,14,1,2,1,0,0,3,127,41,32827,25864,106,52,34571,24980
124,14,0,2,1,0,0,3,86,40,32827,25866,86,55,34571,24983
125,14,2,2,2,1,2,1,93,37,32829,25868,87,145,34572,24984
126,15,0,0,2,1,2,1,6,16,32829,25868,4,51,34573,24985
127,15,2,0,0,3,1,0,95,37,32831,25868,90,45,34576,24985
128,15,2,0,0,3,1,0,95,37,32833,25868,89,55,34579,24985
129,15,3,1,0,3,1,0,114,142,32836,25869,58,53,34582,24985
130,15,3,1,0,3,1,0,103,29,32839,25870,98,65,34585,24985
131,15,1,1,2,1,2,1,94,111,32840,25871,64,114,34586,24986
132,15,2,0,0,3,1,0,77,57,32842,25871,75,33,34589,24986
133,15,2,1,0,3,1,0,84,60,32844,25872,73,52,34592,24986
134,15,3,0,0,3,1,0,68,50,32847,25872,70,141,34595,24986
135,16,1,1,2,1,2,1,91,53,32848,25873,75,43,34596,24987
136,16,2,0,0,3,1,0,38,27,32850,25873,44,47,34599,24987
137,16,1,1,2,1,2,1,68,66,32851,25874,61,146,34600,24988
138,16,0,0,2,1,2,1,86,40,32851,25874,87,108,34601,24989
139,16,2,0,0,3,1,0,105,29,32853,25874,101,38,34604,24989
140,16,4,4,2,1,2,1,86,68,32857,25878,67,142,34605,24990
141,16,2,2,2,1,2,1,265,90,32859,25880,167,56,34606,24991
142,16,3,1,0,3,1,0,65,85,32862,25881,53,52,34609,24991
143,16,3,0,0,3,1,0,130,41,32865,25881,109,75,34612,24991
144,17,3,2,0,3,1,0,98,39,32868,25883,93,33,34615,24991
145,17,1,2,1,0,0,3,7,18,32869,25885,4,55,34615,24994
146,17,0,0,2,1,2,1,77,57,32869,25885,76,52,34616,24995
147,17,0,0,2,1,2,1,106,75,32869,25885,100,115,34617,24996
148,17,1,1,2,1,2,1,95,112,32870,25886,65,66,34618,24997
149,17,3,1,0,3,1,0,87,61,32873,25887,76,53,34621,24997
150,17,2,2,2,1,2,1,70,52,32875,25889,71,56,34622,24998
151,17,3,2,0,3,1,0,98,39,32878,25891,92,45,34625,24998
152,17,2,4,1,0,0,3,116,146,32880,25895,58,84,34625,25001
153,18,0,3,1,0,0,3,86,43,32880,25898,87,78,34625,25004
154,18,2,1,0,3,1,0,88,69,32882,25899,70,52,34628,25004
155,18,2,0,0,3,1,0,70,66,32884,25899,64,47,34631,25004
156,18,1,1,2,1,2,1,92,54,32885,25900,76,147,34632,25005
157,18,1,6,1,0,0,3,266,96,32886,25906,167,69,34632,25008
158,18,0,0,2,1,2,1,38,27,32886,25906,45,109,34633,25009
159,18,0,0,2,1,2,1,87,61,32886,25906,77,85,34634,25010
160,18,2,1,0,3,1,0,100,40,32888,25907,95,38,34637,25010
161,18,2,4,1,0,0,3,67,89,32890,25911,53,145,34637,25013
162,19,1,3,1,0,0,3,131,44,32891,25914,109,150,34637,25016
163,19,0,1,1,0,0,3,88,70,32891,25915,70,36,34637,25019
164,19,1,0,0,3,1,0,267,96,32892,25915,170,52,34640,25019
165,19,0,0,2,1,2,1,98,39,32892,25915,94,57,34641,25020
166,19,4,1,0,3,1,0,90,44,32896,25916,90,52,34644,25020
167,19,0,2,1,0,0,3,77,59,32896,25918,76,46,34644,25023
168,19,1,1,2,1,2,1,117,147,32897,25919,59,46,34645,25024
169,19,3,0,0,3,1,0,108,29,32900,25919,104,56,34648,25024
170,19,2,0,0,3,1,0,108,75,32902,25919,103,47,34651,25024
171,20,1,4,1,0,0,3,68,93,32903,25923,53,58,34651,25027
172,20,1,1,2,1,2,1,8,19,32904,25924,5,54,34652,25028
173,20,2,2,2,1,2,1,72,68,32906,25926,65,146,34653,25029
174,20,0,4,1,0,0,3,38,31,32906,25930,45,118,34653,25032
175,20,1,5,1,0,0,3,93,59,32907,25935,76,72,34653,25035
176,20,3,2,0,3,1,0,73,54,32910,25937,74,85,34656,25035
177,20,3,1,0,3,1,0,90,62,32913,25938,80,109,34659,25035
178,20,0,0,2,1,2,1,100,40,32913,25938,96,79,34660,25036
179,20,2,1,0,3,1,0,97,113,32915,25939,68,38,34663,25036
180,21,0,1,1,0,0,3,38,32,32915,25940,45,57,34663,25039
181,21,0,1,1,0,0,3,90,45,32915,25941,90,41,34663,25042
182,21,3,0,0,3,1,0,270,96,32918,25941,173,150,34666,25042
183,21,3,3,2,1,2,1,111,78,32921,25944,104,37,34667,25043
184,21,7,0,0,3,1,0,138,44,32928,25944,112,46,34670,25043
185,21,2,1,0,3,1,0,99,114,32930,25945,71,52,34673,25043
186,21,0,3,1,0,0,3,68,96,32930,25948,53,88,34673,25046
187,21,2,4,1,0,0,3,100,43,32932,25952,94,49,34673,25049
188,21,1,3,1,0,0,3,118,150,32933,25955,59,59,34673,25052
189,22,2,1,0,3,1,0,74,69,32935,25956,68,118,34676,25052
190,22,2,1,0,3,1,0,79,60,32937,25957,79,57,34679,25052
191,22,4,1,0,3,1,0,97,60,32941,25958,79,109,34682,25052
192,22,2,2,2,1,2,1,90,72,32943,25960,71,53,34683,25053
193,22,2,2,2,1,2,1,75,56,32945,25962,75,73,34684,25054
194,22,0,3,1,0,0,3,90,65,32945,25965,80,50,34684,25057
195,22,1,1,2,1,2,1,109,30,32946,25966,105,147,34685,25058
196,22,3,1,0,3,1,0,103,41,32949,25967,99,58,34688,25058
197,22,1,1,2,1,2,1,9,20,32950,25968,6,80,34689,25059
198,23,1,2,1,0,0,3,100,116,32951,25970,71,56,34689,25062
199,23,1,1,2,1,2,1,101,44,32952,25971,95,110,34690,25063
200,23,1,1,2,1,2,1,271,97,32953,25972,174,38,34691,25064
201,23,2,2,2,1,2,1,113,80,32955,25974,105,59,34692,25065
202,23,2,1,0,3,1,0,140,45,32957,25975,115,49,34695,25065
203,23,2,0,0,3,1,0,77,56,32959,25975,78,41,34698,25065
204,23,2,1,0,3,1,0,76,70,32961,25976,71,57,34701,25065
205,23,3,2,0,3,1,0,12,22,32964,25978,9,59,34704,25065
206,23,0,2,1,0,0,3,38,34,32964,25980,45,91,34704,25068
207,24,2,3,1,0,0,3,120,153,32966,25983,59,53,34704,25071
208,24,3,5,1,0,0,3,100,65,32969,25988,79,55,34704,25074
209,24,1,0,0,3,1,0,80,60,32970,25988,82,150,34707,25074
210,24,1,0,0,3,1,0,69,96,32971,25988,56,57,34710,25074
211,24,2,1,0,3,1,0,92,73,32973,25989,74,80,34713,25074
212,24,2,1,0,3,1,0,105,42,32975,25990,102,73,34716,25074
213,24,4,0,0,3,1,0,94,65,32979,25990,83,147,34719,25074
214,24,1,1,2,1,2,1,110,31,32980,25991,106,47,34720,25075
215,24,0,1,1,0,0,3,90,46,32980,25992,90,121,34720,25078
216,25,2,0,0,3,1,0,79,56,32982,25992,81,49,34723,25078
217,25,1,2,1,0,0,3,272,99,32983,25994,174,60,34723,25081
218,25,2,0,0,3,1,0,14,22,32985,25994,12,110,34726,25081
219,25,2,0,0,3,1,0,142,45,32987,25994,118,56,34729,25081
220,25,0,2,1,0,0,3,101,46,32987,25996,95,94,34729,25084
221,25,0,3,1,0,0,3,100,119,32987,25999,71,62,34729,25087
222,25,2,1,0,3,1,0,40,35,32989,26000,48,59,34732,25087
223,25,4,1,0,3,1,0,117,81,32993,26001,108,41,34735,25087
224,25,3,1,0,3,1,0,79,71,32996,26002,74,38,34738,25087
225,26,1,1,2,1,2,1,81,61,32997,26003,83,122,34739,25088
226,26,2,1,0,3,1,0,94,74,32999,26004,77,73,34742,25088
227,26,1,0,0,3,1,0,121,153,33000,26004,62,56,34745,25088
228,26,1,0,0,3,1,0,101,65,33001,26004,82,53,34748,25088
229,26,1,1,2,1,2,1,91,47,33002,26005,91,48,34749,25089
230,26,0,1,1,0,0,3,117,82,33002,26006,108,65,34749,25092
231,26,1,0,0,3,1,0,95,65,33003,26006,86,57,34752,25092
232,26,3,0,0,3,1,0,113,31,33006,26006,109,150,34755,25092
233,26,0,1,1,0,0,3,101,47,33006,26007,95,58,34755,25095
234,27,3,2,0,3,1,0,17,24,33009,26009,15,147,34758,25095
235,27,1,3,1,0,0,3,101,122,33010,26012,71,63,34758,25098
236,27,2,0,0,3,1,0,144,45,33012,26012,121,57,34761,25098
237,27,0,2,1,0,0,3,69,98,33012,26014,56,41,34761,25101
238,27,0,4,1,0,0,3,79,75,33012,26018,74,61,34761,25104
239,27,4,0,0,3,1,0,276,99,33016,26018,177,110,34764,25104
240,27,2,1,0,3,1,0,107,43,33018,26019,105,49,34767,25104
241,27,2,3,1,0,0,3,93,50,33020,26022,91,97,34767,25107
242,27,0,3,1,0,0,3,81,64,33020,26025,83,83,34767,25110
243,28,1,1,2,1,2,1,102,48,33021,26026,96,123,34768,25111
244,28,2,1,0,3,1,0,97,66,33023,26027,89,56,34771,25111
245,28,1,2,1,0,0,3,122,155,33024,26029,62,44,34771,25114
246,28,2,0,0,3,1,0,96,74,33026,26029,80,65,34774,25114
247,28,2,2,2,1,2,1,119,84,33028,26031,109,74,34775,25115
248,28,2,1,0,3,1,0,81,57,33030,26032,84,150,34778,25115
249,28,4,0,0,3,1,0,44,35,33034,26032,51,48,34781,25115
250,28,1,2,1,0,0,3,102,67,33035,26034,82,62,34781,25118
251,28,4,1,0,3,1,0,117,32,33039,26035,112,53,34784,25118
252,29,1,0,0,3,1,0,108,43,33040,26035,108,56,34787,25118
253,29,3,0,0,3,1,0,84,57,33043,26035,87,123,34790,25118
254,29,2,0,0,3,1,0,104,48,33045,26035,99,147,34793,25118
255,29,1,1,2,1,2,1,18,25,33046,26036,16,58,34794,25119
256,29,1,3,1,0,0,3,123,158,33047,26039,62,77,34794,25122
257,29,1,0,0,3,1,0,98,66,33048,26039,92,48,34797,25122
258,29,1,1,2,1,2,1,102,123,33049,26040,72,63,34798,25123
259,29,3,1,0,3,1,0,84,65,33052,26041,86,63,34801,25123
260,29,4,0,0,3,1,0,121,32,33056,26041,115,41,34804,25123
261,30,0,2,1,0,0,3,69,100,33056,26043,56,153,34804,25126
262,30,3,3,2,1,2,1,122,87,33059,26046,110,62,34805,25127
263,30,0,2,1,0,0,3,102,69,33059,26048,82,47,34805,25130
264,30,2,0,0,3,1,0,278,99,33061,26048,180,53,34808,25130
265,30,1,3,1,0,0,3,80,78,33062,26051,74,86,34808,25133
266,30,3,2,0,3,1,0,99,76,33065,26053,83,110,34811,25133
267,30,1,1,2,1,2,1,45,36,33066,26054,52,66,34812,25134
268,30,6,0,0,3,1,0,99,50,33072,26054,94,49,34815,25134
269,30,2,3,1,0,0,3,146,48,33074,26057,121,100,34815,25137
270,31,1,1,2,1,2,1,122,33,33075,26058,116,64,34816,25138
271,31,2,1,0,3,1,0,86,66,33077,26059,89,48,34819,25138
272,31,2,1,0,3,1,0,125,159,33079,26060,65,147,34822,25138
273,31,4,0,0,3,1,0,106,69,33083,26060,85,58,34825,25138
274,31,1,3,1,0,0,3,100,53,33084,26063,94,80,34825,25141
275,31,2,2,2,1,2,1,71,102,33086,26065,57,87,34826,25142
276,31,1,3,1,0,0,3,103,126,33087,26068,72,156,34826,25145
277,31,3,0,0,3,1,0,101,66,33090,26068,95,123,34829,25145
278,31,2,0,0,3,1,0,110,43,33092,26068,111,62,34832,25145
279,32,0,4,1,0,0,3,99,80,33092,26072,83,66,34832,25148
280,32,5,2,0,3,1,0,151,50,33097,26074,124,47,34835,25148
281,32,3,1,0,3,1,0,125,88,33100,26075,113,58,34838,25148
282,32,1,1,2,1,2,1,81,79,33101,26076,75,57,34839,25149
283,32,0,2,1,0,0,3,278,101,33101,26078,180,103,34839,25152
284,32,5,2,0,3,1,0,109,50,33106,26080,102,53,34842,25152
285,32,1,2,1,0,0,3,19,27,33107,26082,16,52,34842,25155
286,32,6,0,0,3,1,0,116,43,33113,26082,114,41,34845,25155
287,32,3,1,0,3,1,0,87,58,33116,26083,90,110,34848,25155
288,33,1,1,2,1,2,1,107,70,33117,26084,86,88,34849,25156
289,33,4,0,0,3,1,0,104,53,33121,26084,97,156,34852,25156
290,33,0,0,2,1,2,1,71,102,33121,26084,58,48,34853,25157
291,33,5,3,0,3,1,0,283,104,33126,26087,183,147,34856,25157
292,33,4,2,0,3,1,0,155,52,33130,26089,127,53,34859,25157
293,33,2,4,1,0,0,3,101,84,33132,26093,83,55,34859,25160
294,33,3,2,0,3,1,0,48,38,33135,26095,55,62,34862,25160
295,33,2,0,0,3,1,0,83,79,33137,26095,78,66,34865,25160
296,33,5,0,0,3,1,0,127,33,33142,26095,119,110,34868,25160
297,34,3,0,0,3,1,0,104,66,33145,26095,98,41,34871,25160
298,34,1,2,1,0,0,3,104,128,33146,26097,72,61,34871,25163
299,34,4,2,0,3,1,0,23,29,33150,26099,19,48,34874,25163
300,34,0,2,1,0,0,3,86,68,33150,26101,89,106,34874,25166
301,34,1,0,0,3,1,0,126,88,33151,26101,116,64,34877,25166
302,34,1,0,0,3,1,0,117,43,33152,26101,117,123,34880,25166
303,34,0,1,1,0,0,3,87,59,33152,26102,90,60,34880,25169
304,34,2,0,0,3,1,0,127,159,33154,26102,68,66,34883,25169
305,34,3,1,0,3,1,0,112,51,33157,26103,105,80,34886,25169
0,1,3,0,0,3,1,0,130,33,33160,26103,122,147,34889,25169
1,1,2,3,1,0,0,3,85,82,33162,26106,78,83,34889,25172
2,1,1,4,1,0,0,3,105,132,33163,26110,72,51,34889,25175
3,1,0,0,2,1,2,1,112,51,33163,26110,106,62,34890,25176
4,1,4,2,0,3,1,0,105,86,33167,26112,86,66,34893,25176
5,1,0,0,2,1,2,1,68,0,33167,26112,103,124,34894,25177
6,1,1,1,2,1,2,1,105,67,33168,26113,99,137,34895,25178
7,1,3,1,0,3,1,0,90,60,33171,26114,93,41,34898,25178
8,1,2,1,0,3,1,0,25,30,33173,26115,22,66,34901,25178
9,2,2,0,0,3,1,0,128,88,33175,26115,119,306,34904,25178
10,2,1,3,1,0,0,3,108,73,33176,26118,86,159,34904,25181
11,2,0,2,1,0,0,3,283,106,33176,26120,183,67,34904,25184
12,2,2,1,0,3,1,0,157,127,33178,26121,192,48,34907,25184
13,2,5,0,0,3,1,0,160,52,33183,26121,130,53,34910,25184
14,2,1,4,1,0,0,3,118,47,33184,26125,117,91,34910,25187
15,2,3,2,0,3,1,0,107,55,33187,26127,100,106,34913,25187
16,2,2,0,0,3,1,0,88,68,33189,26127,92,55,34916,25187
17,2,4,2,0,3,1,0,52,40,33193,26129,58,62,34919,25187
18,3,3,0,0,3,1,0,163,52,33196,26129,133,137,34922,25187
19,3,4,1,0,3,1,0,72,1,33200,26130,106,51,34925,25187
20,3,1,2,1,0,0,3,53,42,33201,26132,58,69,34925,25190
21,3,1,5,1,0,0,3,106,137,33202,26137,72,162,34925,25193
22,3,1,1,2,1,2,1,129,89,33203,26138,120,63,34926,25194
23,3,2,1,0,3,1,0,132,34,33205,26139,125,66,34929,25194
24,3,2,4,1,0,0,3,107,90,33207,26143,86,44,34929,25197
25,3,1,2,1,0,0,3,284,108,33208,26145,183,51,34929,25200
26,3,6,0,0,3,1,0,118,51,33214,26145,109,55,34932,25200
27,4,3,3,2,1,2,1,110,93,33217,26148,87,107,34933,25201
28,4,2,2,2,1,2,1,108,139,33219,26150,73,63,34934,25202
29,4,1,1,2,1,2,1,109,74,33220,26151,87,84,34935,25203
30,4,0,4,1,0,0,3,85,86,33220,26155,78,150,34935,25206
31,4,2,0,0,3,1,0,27,30,33222,26155,25,306,34938,25206
32,4,3,3,2,1,2,1,160,130,33225,26158,193,52,34939,25207
33,4,3,1,0,3,1,0,121,48,33228,26159,120,124,34942,25207
34,4,1,0,0,3,1,0,91,60,33229,26159,96,91,34945,25207
35,4,2,0,0,3,1,0,107,67,33231,26159,102,69,34948,25207
36,5,1,1,2,1,2,1,285,109,33232,26160,184,54,34949,25208
37,5,1,1,2,1,2,1,119,52,33233,26161,110,68,34950,25209
38,5,1,0,0,3,1,0,110,74,33234,26161,90,51,34953,25209
39,5,1,4,1,0,0,3,54,46,33235,26165,58,140,34953,25212
40,5,0,0,2,1,2,1,163,52,33235,26165,134,307,34954,25213
41,5,1,1,2,1,2,1,89,69,33236,26166,93,108,34955,25214
42,5,1,1,2,1,2,1,28,31,33237,26167,26,56,34956,25215
43,5,1,1,2,1,2,1,108,56,33238,26168,101,64,34957,25216
44,5,4,0,0,3,1,0,125,48,33242,26168,123,150,34960,25216
45,6,2,1,0,3,1,0,134,35,33244,26169,128,162,34963,25216
46,6,2,0,0,3,1,0,74,1,33246,26169,109,44,34966,25216
47,6,2,2,2,1,2,1,121,54,33248,26171,111,85,34967,25217
48,6,3,3,2,1,2,1,111,142,33251,26174,74,67,34968,25218
49,6,1,5,1,0,0,3,130,94,33252,26179,120,127,34968,25221
50,6,3,0,0,3,1,0,111,56,33255,26179,104,140,34971,25221
51,6,4,2,0,3,1,0,114,95,33259,26181,90,52,34974,25221
52,6,2,1,0,3,1,0,109,68,33261,26182,105,63,34977,25221
53,6,2,1,0,3,1,0,87,87,33263,26183,81,64,34980,25221
54,7,0,0,2,1,2,1,160,130,33263,26183,194,308,34981,25222
55,7,0,3,1,0,0,3,110,77,33263,26186,90,94,34981,25225
56,7,4,1,0,3,1,0,93,70,33267,26187,96,63,34984,25225
57,7,1,1,2,1,2,1,88,88,33268,26188,82,55,34985,25226
58,7,3,3,2,1,2,1,133,97,33271,26191,121,69,34986,25227
59,7,3,0,0,3,1,0,94,60,33274,26191,99,162,34989,25227
60,7,1,0,0,3,1,0,126,48,33275,26191,126,56,34992,25227
61,7,3,0,0,3,1,0,288,109,33278,26191,187,69,34995,25227
62,7,4,0,0,3,1,0,167,52,33282,26191,137,108,34998,25227
63,8,2,1,0,3,1,0,113,57,33284,26192,107,85,35001,25227
64,8,1,4,1,0,0,3,55,50,33285,26196,58,47,35001,25230
65,8,3,3,2,1,2,1,112,71,33288,26199,106,151,35002,25231
66,8,0,0,2,1,2,1,28,31,33288,26199,27,128,35003,25232
67,8,6,0,0,3,1,0,140,35,33294,26199,131,140,35006,25232
68,8,2,3,1,0,0,3,113,145,33296,26202,74,67,35006,25235
69,8,2,1,0,3,1,0,116,96,33298,26203,93,308,35009,25235
70,8,4,2,0,3,1,0,130,50,33302,26205,129,51,35012,25235
71,8,5,0,0,3,1,0,126,54,33307,26205,114,52,35015,25235
72,9,0,1,1,0,0,3,74,2,33307,26206,109,97,35015,25238
73,9,0,0,2,1,2,1,133,97,33307,26206,122,163,35016,25239
74,9,4,3,0,3,1,0,164,133,33311,26209,197,55,35019,25239
75,9,2,1,0,3,1,0,290,110,33313,26210,190,47,35022,25239
76,9,3,0,0,3,1,0,143,35,33316,26210,134,56,35025,25239
77,9,1,2,1,0,0,3,95,62,33317,26212,99,70,35025,25242
78,9,2,1,0,3,1,0,95,71,33319,26213,99,69,35028,25242
79,9,2,1,0,3,1,0,169,53,33321,26214,140,63,35031,25242
80,9,1,1,2,1,2,1,89,89,33322,26215,83,70,35032,25243
81,10,2,2,2,1,2,1,166,135,33324,26217,198,71,35033,25244
82,10,1,2,1,0,0,3,56,52,33325,26219,58,154,35033,25247
83,10,4,2,0,3,1,0,116,73,33329,26221,109,128,35036,25247
84,10,1,1,2,1,2,1,127,55,33330,26222,115,109,35037,25248
85,10,2,3,1,0,0,3,118,99,33332,26225,93,70,35037,25251
86,10,1,1,2,1,2,1,111,78,33333,26226,91,56,35038,25252
87,10,1,0,0,3,1,0,96,71,33334,26226,102,85,35041,25252
88,10,6,1,0,3,1,0,34,32,33340,26227,30,51,35044,25252
89,10,3,1,0,3,1,0,116,58,33343,26228,110,308,35047,25252
90,11,2,1,0,3,1,0,115,146,33345,26229,77,70,35050,25252
91,11,3,2,0,3,1,0,92,91,33348,26231,86,97,35053,25252
92,11,3,1,0,3,1,0,77,3,33351,26232,112,56,35056,25252
93,11,5,0,0,3,1,0,295,110,33356,26232,193,140,35059,25252
94,11,0,0,2,1,2,1,143,35,33356,26232,135,64,35060,25253
95,11,2,1,0,3,1,0,135,98,33358,26233,125,85,35063,25253
96,11,1,2,1,0,0,3,131,52,33359,26235,129,50,35063,25256
97,11,0,2,1,0,0,3,34,34,33359,26237,30,72,35063,25259
98,11,2,2,2,1,2,1,97,64,33361,26239,100,53,35064,25260
99,12,3,0,0,3,1,0,59,52,33364,26239,61,128,35067,25260
100,12,0,1,1,0,0,3,143,36,33364,26240,135,73,35067,25263
101,12,2,0,0,3,1,0,118,58,33366,26240,113,51,35070,25263
102,12,2,2,2,1,2,1,129,57,33368,26242,116,57,35071,25264
103,12,1,1,2,1,2,1,170,54,33369,26243,141,164,35072,25265
104,12,3,3,2,1,2,1,99,74,33372,26246,103,155,35073,25266
105,12,0,2,1,0,0,3,77,5,33372,26248,112,74,35073,25269
106,12,2,0,0,3,1,0,118,73,33374,26248,112,70,35076,25269
107,12,1,1,2,1,2,1,167,136,33375,26249,199,51,35077,25270
108,13,5,2,0,3,1,0,123,101,33380,26251,96,64,35080,25270
109,13,1,4,1,0,0,3,136,102,33381,26255,125,143,35080,25273
110,13,0,3,1,0,0,3,111,81,33381,26258,91,56,35080,25276
111,13,3,1,0,3,1,0,100,65,33384,26259,103,56,35083,25276
112,13,3,0,0,3,1,0,95,91,33387,26259,89,308,35086,25276
113,13,1,1,2,1,2,1,35,35,33388,26260,31,98,35087,25277
114,13,2,1,0,3,1,0,297,111,33390,26261,196,85,35090,25277
115,13,0,3,1,0,0,3,115,149,33390,26264,77,112,35090,25280
116,13,2,2,2,1,2,1,133,54,33392,26266,130,73,35091,25281
117,14,1,1,2,1,2,1,171,55,33393,26267,142,71,35092,25282
118,14,2,1,0,3,1,0,79,6,33395,26268,115,57,35095,25282
119,14,2,2,2,1,2,1,120,60,33397,26270,114,156,35096,25283
120,14,3,0,0,3,1,0,146,36,33400,26270,138,51,35099,25283
121,14,1,0,0,3,1,0,60,52,33401,26270,64,74,35102,25283
122,14,3,0,0,3,1,0,121,73,33404,26270,115,51,35105,25283
123,14,0,3,1,0,0,3,167,139,33404,26273,199,76,35105,25286
124,14,0,0,2,1,2,1,99,74,33404,26273,104,165,35106,25287
125,14,5,2,0,3,1,0,134,59,33409,26275,119,128,35109,25287
126,15,1,2,1,0,0,3,137,104,33410,26277,125,101,35109,25290
127,15,1,1,2,1,2,1,36,36,33411,26278,32,65,35110,25291
128,15,3,1,0,3,1,0,126,102,33414,26279,99,143,35113,25291
129,15,2,2,2,1,2,1,299,113,33416,26281,197,57,35114,25292
130,15,1,2,1,0,0,3,112,83,33417,26283,91,59,35114,25295
131,15,0,4,1,0,0,3,95,95,33417,26287,89,115,35114,25298
132,15,3,1,0,3,1,0,136,55,33420,26288,133,85,35117,25298
133,15,3,0,0,3,1,0,103,65,33423,26288,106,308,35120,25298
134,15,3,2,0,3,1,0,118,151,33426,26290,80,73,35123,25298
135,16,2,0,0,3,1,0,123,73,33428,26290,118,57,35126,25298
136,16,4,0,0,3,1,0,150,36,33432,26290,141,128,35129,25298
137,16,1,2,1,0,0,3,121,62,33433,26292,114,104,35129,25301
138,16,2,2,2,1,2,1,62,54,33435,26294,65,309,35130,25302
139,16,2,6,1,0,0,3,173,61,33437,26300,142,79,35130,25305
140,16,1,2,1,0,0,3,127,104,33438,26302,99,77,35130,25308
141,16,4,1,0,3,1,0,171,140,33442,26303,202,165,35133,25308
142,16,1,2,1,0,0,3,100,76,33443,26305,104,54,35133,25311
143,16,1,3,1,0,0,3,138,107,33444,26308,125,54,35133,25314
144,17,1,2,1,0,0,3,37,38,33445,26310,32,74,35133,25317
145,17,4,3,0,3,1,0,122,154,33449,26313,83,156,35136,25317
146,17,1,2,1,0,0,3,96,97,33450,26315,89,68,35136,25320
147,17,3,1,0,3,1,0,137,60,33453,26316,122,143,35139,25320
148,17,1,2,1,0,0,3,80,8,33454,26318,115,118,35139,25323
149,17,3,2,0,3,1,0,106,67,33457,26320,109,128,35142,25323
150,17,1,0,0,3,1,0,137,55,33458,26320,136,57,35145,25323
151,17,2,0,0,3,1,0,114,83,33460,26320,94,73,35148,25323
152,17,1,5,1,0,0,3,124,78,33461,26325,118,88,35148,25326
153,18,1,1,2,1,2,1,63,55,33462,26326,66,105,35149,25327
154,18,1,5,1,0,0,3,122,67,33463,26331,114,77,35149,25330
155,18,2,2,2,1,2,1,116,85,33465,26333,95,80,35150,25331
156,18,1,0,0,3,1,0,300,113,33466,26333,200,309,35153,25331
157,18,3,0,0,3,1,0,140,55,33469,26333,139,165,35156,25331
158,18,1,2,1,0,0,3,139,109,33470,26335,125,121,35156,25334
159,18,5,2,0,3,1,0,105,78,33475,26337,107,57,35159,25334
160,18,2,1,0,3,1,0,173,141,33477,26338,205,59,35162,25334
161,18,2,0,0,3,1,0,175,61,33479,26338,145,54,35165,25334
162,19,3,1,0,3,1,0,140,61,33482,26339,125,54,35168,25334
163,19,3,0,0,3,1,0,125,67,33485,26339,117,128,35171,25334
164,19,1,1,2,1,2,1,64,56,33486,26340,67,58,35172,25335
165,19,1,2,1,0,0,3,38,40,33487,26342,32,83,35172,25338
166,19,2,2,2,1,2,1,129,106,33489,26344,100,157,35173,25339
167,19,3,1,0,3,1,0,125,155,33492,26345,86,54,35176,25339
168,19,2,0,0,3,1,0,82,8,33494,26345,118,143,35179,25339
169,19,2,5,1,0,0,3,126,83,33496,26350,118,80,35179,25342
170,19,1,0,0,3,1,0,151,36,33497,26350,144,88,35182,25342
171,20,2,1,0,3,1,0,118,86,33499,26351,98,68,35185,25342
172,20,3,2,0,3,1,0,99,99,33502,26353,92,80,35188,25342
173,20,1,2,1,0,0,3,301,115,33503,26355,200,168,35188,25345
174,20,1,0,0,3,1,0,140,109,33504,26355,128,59,35191,25345
175,20,1,0,0,3,1,0,176,61,33505,26355,148,73,35194,25345
176,20,3,1,0,3,1,0,85,9,33508,26356,121,77,35197,25345
177,20,1,1,2,1,2,1,107,68,33509,26357,110,58,35198,25346
178,20,0,1,1,0,0,3,173,142,33509,26358,205,124,35198,25349
179,20,1,1,2,1,2,1,106,79,33510,26359,108,106,35199,25350
180,21,1,1,2,1,2,1,141,56,33511,26360,140,84,35200,25351
181,21,3,0,0,3,1,0,132,106,33514,26360,103,54,35203,25351
182,21,3,1,0,3,1,0,41,41,33517,26361,35,157,35206,25351
183,21,1,2,1,0,0,3,119,88,33518,26363,98,131,35206,25354
184,21,2,0,0,3,1,0,127,67,33520,26363,120,58,35209,25354
185,21,1,1,2,1,2,1,127,84,33521,26364,119,125,35210,25355
186,21,3,1,0,3,1,0,143,62,33524,26365,128,309,35213,25355
187,21,1,1,2,1,2,1,126,156,33525,26366,87,144,35214,25356
188,21,2,0,0,3,1,0,66,56,33527,26366,70,88,35217,25356
189,22,1,2,1,0,0,3,141,111,33528,26368,128,83,35217,25359
190,22,0,3,1,0,0,3,99,102,33528,26371,92,57,35217,25362
191,22,0,2,1,0,0,3,107,70,33528,26373,110,76,35217,25365
192,22,1,2,1,0,0,3,86,11,33529,26375,121,91,35217,25368
193,22,2,2,2,1,2,1,175,144,33531,26377,206,69,35218,25369
194,22,1,1,2,1,2,1,127,157,33532,26378,88,132,35219,25370
195,22,0,2,1,0,0,3,132,108,33532,26380,103,109,35219,25373
196,22,1,2,1,0,0,3,128,86,33533,26382,119,171,35219,25376
197,22,2,1,0,3,1,0,153,37,33535,26383,147,58,35222,25376
198,23,0,0,2,1,2,1,107,70,33535,26383,111,55,35223,25377
199,23,3,2,0,3,1,0,179,63,33538,26385,151,109,35226,25377
200,23,2,0,0,3,1,0,303,115,33540,26385,203,157,35229,25377
201,23,2,1,0,3,1,0,177,145,33542,26386,209,76,35232,25377
202,23,5,1,0,3,1,0,146,57,33547,26387,143,58,35235,25377
203,23,1,1,2,1,2,1,120,89,33548,26388,99,310,35236,25378
204,23,1,1,2,1,2,1,42,42,33549,26389,36,126,35237,25379
205,23,5,2,0,3,1,0,71,58,33554,26391,73,59,35240,25379
206,23,1,3,1,0,0,3,107,82,33555,26394,108,80,35240,25382
207,24,2,1,0,3,1,0,181,64,33557,26395,154,57,35243,25382
208,24,2,0,0,3,1,0,145,62,33559,26395,131,84,35246,25382
209,24,1,3,1,0,0,3,72,61,33560,26398,73,61,35246,25385
210,24,0,1,1,0,0,3,141,112,33560,26399,128,58,35246,25388
211,24,1,1,2,1,2,1,128,68,33561,26400,121,60,35247,25389
212,24,3,1,0,3,1,0,89,12,33564,26401,124,171,35250,25389
213,24,1,1,2,1,2,1,304,116,33565,26402,204,84,35251,25390
214,24,1,0,0,3,1,0,108,82,33566,26402,111,144,35254,25390
215,24,3,0,0,3,1,0,156,37,33569,26402,150,80,35257,25390
216,25,3,2,0,3,1,0,102,104,33572,26404,95,144,35260,25390
217,25,0,0,2,1,2,1,132,108,33572,26404,104,133,35261,25391
218,25,1,0,0,3,1,0,90,12,33573,26404,127,157,35264,25391
219,25,1,1,2,1,2,1,43,43,33574,26405,37,58,35265,25392
220,25,0,2,1,0,0,3,127,159,33574,26407,88,94,35265,25395
221,25,1,0,0,3,1,0,129,86,33575,26407,122,58,35268,25395
222,25,4,0,0,3,1,0,160,37,33579,26407,153,76,35271,25395
223,25,3,1,0,3,1,0,110,71,33582,26408,114,69,35274,25395
224,25,2,2,2,1,2,1,147,64,33584,26410,132,85,35275,25396
225,26,1,2,1,0,0,3,121,91,33585,26412,99,83,35275,25399
226,26,3,3,2,1,2,1,46,46,33588,26415,38,62,35276,25400
227,26,1,1,2,1,2,1,103,105,33589,26416,96,134,35277,25401
228,26,2,3,1,0,0,3,179,148,33591,26419,209,97,35277,25404
229,26,3,0,0,3,1,0,113,71,33594,26419,117,157,35280,25404
230,26,1,1,2,1,2,1,130,87,33595,26420,123,110,35281,25405
231,26,1,2,1,0,0,3,147,59,33596,26422,143,129,35281,25408
232,26,1,1,2,1,2,1,109,83,33597,26423,112,311,35282,25409
233,26,4,0,0,3,1,0,132,68,33601,26423,124,69,35285,25409
234,27,4,0,0,3,1,0,136,68,33605,26423,127,58,35288,25409
235,27,3,1,0,3,1,0,144,113,33608,26424,131,62,35291,25409
236,27,3,0,0,3,1,0,135,108,33611,26424,107,171,35294,25409
237,27,1,2,1,0,0,3,305,118,33612,26426,204,87,35294,25412
238,27,1,0,0,3,1,0,182,64,33613,26426,157,60,35297,25412
239,27,1,1,2,1,2,1,73,62,33614,26427,74,59,35298,25413
240,27,1,0,0,3,1,0,180,148,33615,26427,212,110,35301,25413
241,27,0,2,1,0,0,3,109,85,33615,26429,112,88,35301,25416
242,27,1,1,2,1,2,1,161,38,33616,26430,154,312,35302,25417
243,28,3,2,0,3,1,0,93,14,33619,26432,130,69,35305,25417
244,28,1,2,1,0,0,3,114,73,33620,26434,117,100,35305,25420
245,28,2,1,0,3,1,0,123,92,33622,26435,102,157,35308,25420
246,28,2,1,0,3,1,0,105,106,33624,26436,99,58,35311,25420
247,28,2,1,0,3,1,0,149,65,33626,26437,135,76,35314,25420
248,28,2,0,0,3,1,0,48,46,33628,26437,41,144,35317,25420
249,28,2,2,2,1,2,1,129,161,33630,26439,89,61,35318,25421
250,28,2,0,0,3,1,0,149,59,33632,26439,146,83,35321,25421
251,28,0,0,2,1,2,1,305,118,33632,26439,205,130,35322,25422
252,29,3,1,0,3,1,0,112,86,33635,26440,115,87,35325,25422
253,29,2,2,2,1,2,1,137,110,33637,26442,108,63,35326,25423
254,29,3,1,0,3,1,0,185,65,33640,26443,160,157,35329,25423
255,29,2,1,0,3,1,0,138,69,33642,26444,130,171,35332,25423
256,29,0,2,1,0,0,3,73,64,33642,26446,74,133,35332,25426
257,29,1,1,2,1,2,1,150,66,33643,26447,136,60,35333,25427
258,29,2,1,0,3,1,0,182,149,33645,26448,215,134,35336,25427
259,29,1,0,0,3,1,0,131,87,33646,26448,126,312,35339,25427
260,29,1,2,1,0,0,3,124,94,33647,26450,102,91,35339,25430
261,30,2,2,2,1,2,1,307,120,33649,26452,206,62,35340,25431
262,30,2,2,2,1,2,1,116,75,33651,26454,118,84,35341,25432
263,30,1,2,1,0,0,3,130,163,33652,26456,89,61,35341,25435
264,30,2,3,1,0,0,3,187,68,33654,26459,160,61,35341,25438
265,30,5,0,0,3,1,0,154,59,33659,26459,149,144,35344,25438
266,30,0,0,2,1,2,1,93,14,33659,26459,131,77,35345,25439
267,30,3,0,0,3,1,0,164,38,33662,26459,157,110,35348,25439
268,30,0,1,1,0,0,3,144,114,33662,26460,131,72,35348,25442
269,30,1,1,2,1,2,1,106,107,33663,26461,100,172,35349,25443
270,31,0,1,1,0,0,3,48,47,33663,26462,41,64,35349,25446
271,31,3,0,0,3,1,0,140,110,33666,26462,111,100,35352,25446
272,31,0,2,1,0,0,3,307,122,33666,26464,206,113,35352,25449
273,31,1,1,2,1,2,1,131,164,33667,26465,90,313,35353,25450
274,31,1,2,1,0,0,3,125,96,33668,26467,102,147,35353,25453
275,31,4,1,0,3,1,0,110,108,33672,26468,103,62,35356,25453
276,31,2,0,0,3,1,0,156,59,33674,26468,152,72,35359,25453
277,31,1,1,2,1,2,1,117,76,33675,26469,119,134,35360,25454
278,31,2,2,2,1,2,1,146,116,33677,26471,132,78,35361,25455
279,32,2,1,0,3,1,0,114,87,33679,26472,118,134,35364,25455
280,32,0,2,1,0,0,3,182,151,33679,26474,215,87,35364,25458
281,32,4,3,0,3,1,0,97,17,33683,26477,134,87,35367,25458
282,32,3,0,0,3,1,0,153,66,33686,26477,139,157,35370,25458
283,32,1,1,2,1,2,1,139,70,33687,26478,131,64,35371,25459
284,32,2,1,0,3,1,0,133,88,33689,26479,129,61,35374,25459
285,32,1,1,2,1,2,1,74,65,33690,26480,75,173,35375,25460
286,32,3,2,0,3,1,0,167,40,33693,26482,160,60,35378,25460
287,32,0,2,1,0,0,3,187,70,33693,26484,160,94,35378,25463
288,33,4,1,0,3,1,0,144,111,33697,26485,114,62,35381,25463
289,33,5,1,0,3,1,0,161,60,33702,26486,155,313,35384,25463
290,33,1,1,2,1,2,1,308,123,33703,26487,207,73,35385,25464
291,33,1,2,1,0,0,3,49,49,33704,26489,41,103,35385,25467
292,33,1,1,2,1,2,1,126,97,33705,26490,103,135,35386,25468
293,33,2,2,2,1,2,1,119,78,33707,26492,120,148,35387,25469
294,33,2,5,1,0,0,3,133,169,33709,26497,90,116,35387,25472
295,33,1,2,1,0,0,3,147,118,33710,26499,132,67,35387,25475
296,33,2,1,0,3,1,0,112,109,33712,26500,106,78,35390,25475
297,34,1,2,1,0,0,3,98,19,33713,26502,134,63,35390,25478
298,34,2,1,0,3,1,0,135,89,33715,26503,132,87,35393,25478
299,34,1,1,2,1,2,1,140,71,33716,26504,132,95,35394,25479
300,34,0,3,1,0,0,3,74,68,33716,26507,75,90,35394,25482
301,34,0,1,1,0,0,3,182,152,33716,26508,215,160,35394,25485
302,34,2,2,2,1,2,1,169,42,33718,26510,161,65,35395,25486
303,34,2,0,0,3,1,0,189,70,33720,26510,163,134,35398,25486
304,34,3,1,0,3,1,0,117,88,33723,26511,121,61,35401,25486
305,34,2,2,2,1,2,1,155,68,33725,26513,140,174,35402,25487
0,1,2,0,0,3,1,0,51,49,33727,26513,44,62,35405,25487
1,1,1,2,1,0,0,3,145,113,33728,26515,114,37,35405,25490
2,1,1,1,2,1,2,1,99,20,33729,26516,135,117,35406,25491
3,1,1,1,2,1,2,1,309,124,33730,26517,208,118,35407,25492
4,1,0,3,1,0,0,3,126,100,33730,26520,103,81,35407,25495
5,1,0,1,1,0,0,3,112,110,33730,26521,106,98,35407,25498
6,1,2,3,1,0,0,3,184,155,33732,26524,215,70,35407,25501
7,1,4,1,0,3,1,0,173,43,33736,26525,164,87,35410,25501
8,1,1,3,1,0,0,3,128,162,33737,26528,68,106,35410,25504
9,2,1,1,2,1,2,1,162,61,33738,26529,156,91,35411,25505
10,2,6,1,0,3,1,0,195,71,33744,26530,166,134,35414,25505
11,2,1,2,1,0,0,3,77,132,33745,26532,182,177,35414,25508
12,2,2,2,2,1,2,1,157,70,33747,26534,141,64,35415,25509
13,2,2,2,2,1,2,1,121,80,33749,26536,121,314,35416,25510
14,2,1,3,1,0,0,3,141,74,33750,26539,132,138,35416,25513
15,2,2,1,0,3,1,0,137,90,33752,26540,135,110,35419,25513
16,2,3,2,0,3,1,0,180,137,33755,26542,167,148,35422,25513
17,2,3,1,0,3,1,0,120,89,33758,26543,124,61,35425,25513
18,3,0,1,1,0,0,3,126,101,33758,26544,103,317,35425,25516
19,3,3,0,0,3,1,0,131,162,33761,26544,71,81,35428,25516
20,3,2,0,0,3,1,0,147,113,33763,26544,117,118,35431,25516
21,3,0,0,2,1,2,1,184,155,33763,26544,216,38,35432,25517
22,3,2,1,0,3,1,0,53,50,33765,26545,47,87,35435,25517
23,3,3,0,0,3,1,0,115,110,33768,26545,109,70,35438,25517
24,3,1,2,1,0,0,3,163,63,33769,26547,156,65,35438,25520
25,3,1,1,2,1,2,1,310,125,33770,26548,209,118,35439,25521
26,3,1,3,1,0,0,3,174,46,33771,26551,164,109,35439,25524
27,4,1,0,0,3,1,0,185,155,33772,26551,219,110,35442,25524
28,4,3,2,0,3,1,0,102,22,33775,26553,138,64,35445,25524
29,4,3,1,0,3,1,0,183,138,33778,26554,170,61,35448,25524
30,4,1,3,1,0,0,3,78,135,33779,26557,182,84,35448,25527
31,4,3,1,0,3,1,0,150,114,33782,26558,120,65,35451,25527
32,4,2,0,0,3,1,0,197,71,33784,26558,169,87,35454,25527
33,4,2,0,0,3,1,0,122,89,33786,26558,127,138,35457,25527
34,4,3,1,0,3,1,0,313,126,33789,26559,212,177,35460,25527
35,4,0,0,2,1,2,1,157,70,33789,26559,142,99,35461,25528
36,5,2,1,0,3,1,0,159,71,33791,26560,145,148,35464,25528
37,5,2,1,0,3,1,0,176,47,33793,26561,167,61,35467,25528
38,5,0,1,1,0,0,3,141,75,33793,26562,132,94,35467,25531
39,5,3,1,0,3,1,0,56,51,33796,26563,50,109,35470,25531
40,5,1,2,1,0,0,3,164,65,33797,26565,156,113,35470,25534
41,5,0,0,2,1,2,1,137,90,33797,26565,136,65,35471,25535
42,5,3,0,0,3,1,0,105,22,33800,26565,141,70,35474,25535
43,5,3,1,0,3,1,0,124,81,33803,26566,124,118,35477,25535
44,5,0,1,1,0,0,3,78,136,33803,26567,182,137,35477,25538
45,6,2,1,0,3,1,0,133,163,33805,26568,74,137,35480,25538
46,6,1,1,2,1,2,1,184,139,33806,26569,171,39,35481,25539
47,6,1,1,2,1,2,1,116,111,33807,26570,110,149,35482,25540
48,6,1,1,2,1,2,1,125,82,33808,26571,125,95,35483,25541
49,6,1,4,1,0,0,3,127,105,33809,26575,103,121,35483,25544
50,6,1,0,0,3,1,0,142,75,33810,26575,135,177,35486,25544
51,6,0,1,1,0,0,3,164,66,33810,26576,156,141,35486,25547
52,6,4,0,0,3,1,0,201,71,33814,26576,172,317,35489,25547
53,6,1,0,0,3,1,0,138,90,33815,26576,139,70,35492,25547
54,7,2,6,1,0,0,3,80,142,33817,26582,182,90,35492,25550
55,7,2,5,1,0,0,3,315,131,33819,26587,212,144,35492,25553
56,7,4,2,0,3,1,0,60,53,33823,26589,53,61,35495,25553
57,7,0,4,1,0,0,3,185,159,33823,26593,219,102,35495,25556
58,7,2,3,1,0,0,3,118,114,33825,26596,110,87,35495,25559
59,7,1,1,2,1,2,1,185,140,33826,26597,172,318,35496,25560
60,7,1,0,0,3,1,0,123,89,33827,26597,130,113,35499,25560
61,7,3,1,0,3,1,0,162,72,33830,26598,148,65,35502,25560
62,7,1,0,0,3,1,0,151,114,33831,26598,123,109,35505,25560
63,8,6,1,0,3,1,0,131,83,33837,26599,128,65,35508,25560
64,8,6,1,0,3,1,0,133,106,33843,26600,106,137,35511,25560
65,8,2,1,0,3,1,0,135,164,33845,26601,77,95,35514,25560
66,8,4,1,0,3,1,0,109,23,33849,26602,144,39,35517,25560
67,8,2,3,1,0,0,3,140,93,33851,26605,139,152,35517,25563
68,8,3,0,0,3,1,0,204,71,33854,26605,175,118,35520,25563
69,8,4,0,0,3,1,0,168,66,33858,26605,159,70,35523,25563
70,8,2,2,2,1,2,1,144,77,33860,26607,136,122,35524,25564
71,8,0,0,2,1,2,1,176,47,33860,26607,168,178,35525,25565
72,9,1,4,1,0,0,3,136,168,33861,26611,77,93,35525,25568
73,9,3,0,0,3,1,0,207,71,33864,26611,178,87,35528,25568
74,9,2,1,0,3,1,0,170,67,33866,26612,162,61,35531,25568
75,9,1,1,2,1,2,1,316,132,33867,26613,213,66,35532,25569
76,9,1,1,2,1,2,1,163,73,33868,26614,149,145,35533,25570
77,9,2,2,2,1,2,1,153,116,33870,26616,124,319,35534,25571
78,9,3,2,0,3,1,0,188,161,33873,26618,222,178,35537,25571
79,9,1,3,1,0,0,3,81,145,33874,26621,182,68,35537,25574
80,9,1,1,2,1,2,1,124,90,33875,26622,131,119,35538,25575
81,10,2,0,0,3,1,0,120,114,33877,26622,113,39,35541,25575
82,10,2,2,2,1,2,1,133,85,33879,26624,129,138,35542,25576
83,10,2,2,2,1,2,1,146,79,33881,26626,137,71,35543,25577
84,10,1,3,1,0,0,3,134,109,33882,26629,106,116,35543,25580
85,10,3,1,0,3,1,0,179,48,33885,26630,171,152,35546,25580
86,10,0,1,1,0,0,3,109,24,33885,26631,144,105,35546,25583
87,10,2,2,2,1,2,1,62,55,33887,26633,54,96,35547,25584
88,10,1,5,1,0,0,3,141,98,33888,26638,139,112,35547,25587
89,10,2,1,0,3,1,0,187,141,33890,26639,175,122,35550,25587
90,11,4,0,0,3,1,0,183,48,33894,26639,174,39,35553,25587
91,11,2,0,0,3,1,0,172,67,33896,26639,165,178,35556,25587
92,11,2,0,0,3,1,0,165,73,33898,26639,152,96,35559,25587
93,11,1,0,0,3,1,0,208,71,33899,26639,181,66,35562,25587
94,11,3,1,0,3,1,0,144,99,33902,26640,142,93,35565,25587
95,11,1,1,2,1,2,1,137,169,33903,26641,78,320,35566,25588
96,11,1,3,1,0,0,3,189,164,33904,26644,222,64,35566,25591
97,11,3,3,2,1,2,1,149,82,33907,26647,138,120,35567,25592
98,11,1,0,0,3,1,0,125,90,33908,26647,134,138,35570,25592
99,12,2,2,2,1,2,1,189,143,33910,26649,176,69,35571,25593
100,12,3,2,0,3,1,0,123,116,33913,26651,116,116,35574,25593
101,12,2,2,2,1,2,1,155,118,33915,26653,125,153,35575,25594
102,12,2,0,0,3,1,0,64,55,33917,26653,57,71,35578,25594
103,12,0,1,1,0,0,3,316,133,33917,26654,213,90,35578,25597
104,12,2,4,1,0,0,3,111,28,33919,26658,144,148,35578,25600
105,12,0,0,2,1,2,1,133,85,33919,26658,130,106,35579,25601
106,12,0,4,1,0,0,3,81,149,33919,26662,182,125,35579,25604
107,12,1,2,1,0,0,3,135,111,33920,26664,106,115,35579,25607
108,13,1,0,0,3,1,0,150,82,33921,26664,141,93,35582,25607
109,13,2,0,0,3,1,0,191,164,33923,26664,225,138,35585,25607
110,13,2,0,0,3,1,0,174,67,33925,26664,168,39,35588,25607
111,13,4,1,0,3,1,0,187,49,33929,26665,177,96,35591,25607
112,13,1,1,2,1,2,1,138,170,33930,26666,79,121,35592,25608
113,13,1,1,2,1,2,1,126,91,33931,26667,135,116,35593,25609
114,13,1,2,1,0,0,3,65,57,33932,26669,57,128,35593,25612
115,13,3,1,0,3,1,0,138,112,33935,26670,109,66,35596,25612
116,13,1,3,1,0,0,3,145,102,33936,26673,142,323,35596,25615
117,14,0,4,1,0,0,3,81,153,33936,26677,182,119,35596,25618
118,14,0,1,1,0,0,3,155,119,33936,26678,125,67,35596,25621
119,14,1,5,1,0,0,3,317,138,33937,26683,213,72,35596,25624
120,14,2,2,2,1,2,1,135,87,33939,26685,131,154,35597,25625
121,14,0,2,1,0,0,3,111,30,33939,26687,144,93,35597,25628
122,14,1,1,2,1,2,1,124,117,33940,26688,117,149,35598,25629
123,14,0,5,1,0,0,3,189,148,33940,26693,176,181,35598,25632
124,14,1,2,1,0,0,3,166,75,33941,26695,152,74,35598,25635
125,14,4,3,0,3,1,0,212,74,33945,26698,184,106,35601,25635
126,15,2,0,0,3,1,0,152,82,33947,26698,144,154,35604,25635
127,15,2,5,1,0,0,3,191,153,33949,26703,176,109,35604,25638
128,15,0,1,1,0,0,3,111,31,33949,26704,144,141,35604,25641
129,15,1,3,1,0,0,3,82,156,33950,26707,182,119,35604,25644
130,15,5,0,0,3,1,0,192,49,33955,26707,180,119,35607,25644
131,15,3,1,0,3,1,0,68,58,33958,26708,60,66,35610,25644
132,15,1,1,2,1,2,1,127,92,33959,26709,136,97,35611,25645
133,15,2,4,1,0,0,3,147,106,33961,26713,142,70,35611,25648
134,15,2,2,2,1,2,1,137,89,33963,26715,132,129,35612,25649
135,16,1,1,2,1,2,1,139,113,33964,26716,110,40,35613,25650
136,16,0,2,1,0,0,3,317,140,33964,26718,213,100,35613,25653
137,16,0,1,1,0,0,3,138,171,33964,26719,79,184,35613,25656
138,16,2,2,2,1,2,1,126,119,33966,26721,118,122,35614,25657
139,16,1,2,1,0,0,3,192,166,33967,26723,225,326,35614,25660
140,16,3,1,0,3,1,0,195,50,33970,26724,183,72,35617,25660
141,16,1,1,2,1,2,1,128,93,33971,26725,137,94,35618,25661
142,16,2,0,0,3,1,0,214,74,33973,26725,187,129,35621,25661
143,16,2,2,2,1,2,1,176,69,33975,26727,169,94,35622,25662
144,17,0,0,2,1,2,1,155,119,33975,26727,126,67,35623,25663
145,17,2,1,0,3,1,0,113,32,33977,26728,147,184,35626,25663
146,17,1,1,2,1,2,1,83,157,33978,26729,183,75,35627,25664
147,17,5,0,0,3,1,0,219,74,33983,26729,190,154,35630,25664
148,17,0,3,1,0,0,3,152,85,33983,26732,144,75,35630,25667
149,17,3,0,0,3,1,0,140,89,33986,26732,135,70,35633,25667
150,17,0,1,1,0,0,3,317,141,33986,26733,213,112,35633,25670
151,17,0,2,1,0,0,3,191,155,33986,26735,176,152,35633,25673
152,17,3,2,0,3,1,0,169,77,33989,26737,155,119,35636,25673
153,18,2,0,0,3,1,0,197,50,33991,26737,186,75,35639,25673
154,18,4,1,0,3,1,0,72,59,33995,26738,63,141,35642,25673
155,18,2,0,0,3,1,0,154,85,33997,26738,147,40,35645,25673
156,18,2,2,2,1,2,1,128,121,33999,26740,119,327,35646,25674
157,18,0,1,1,0,0,3,140,90,33999,26741,135,122,35646,25677
158,18,1,0,0,3,1,0,139,171,34000,26741,82,154,35649,25677
159,18,1,2,1,0,0,3,148,108,34001,26743,142,103,35649,25680
160,18,3,1,0,3,1,0,179,70,34004,26744,172,129,35652,25680
161,18,0,3,1,0,0,3,139,116,34004,26747,110,125,35652,25683
162,19,2,0,0,3,1,0,171,77,34006,26747,158,70,35655,25683
163,19,1,2,1,0,0,3,114,34,34007,26749,147,125,35655,25686
164,19,1,1,2,1,2,1,73,60,34008,26750,64,95,35656,25687
165,19,1,0,0,3,1,0,84,157,34009,26750,186,125,35659,25687
166,19,4,1,0,3,1,0,159,120,34013,26751,129,94,35662,25687
167,19,0,0,2,1,2,1,197,50,34013,26751,187,113,35663,25688
168,19,0,0,2,1,2,1,317,141,34013,26751,214,120,35664,25689
169,19,2,2,2,1,2,1,130,95,34015,26753,138,76,35665,25690
170,19,1,0,0,3,1,0,193,166,34016,26753,228,67,35668,25690
171,20,0,0,2,1,2,1,84,157,34016,26753,187,104,35669,25691
172,20,2,1,0,3,1,0,221,75,34018,26754,193,120,35672,25691
173,20,0,0,2,1,2,1,191,155,34018,26754,177,142,35673,25692
174,20,2,0,0,3,1,0,132,95,34020,26754,141,154,35676,25692
175,20,2,1,0,3,1,0,173,78,34022,26755,161,327,35679,25692
176,20,2,1,0,3,1,0,181,71,34024,26756,175,67,35682,25692
177,20,1,0,0,3,1,0,141,90,34025,26756,138,152,35685,25692
178,20,0,2,1,0,0,3,148,110,34025,26758,142,187,35685,25695
179,20,3,1,0,3,1,0,157,86,34028,26759,150,70,35688,25695
180,21,0,0,2,1,2,1,193,166,34028,26759,229,126,35689,25696
181,21,0,2,1,0,0,3,317,143,34028,26761,214,128,35689,25699
182,21,3,1,0,3,1,0,162,121,34031,26762,132,113,35692,25699
183,21,2,0,0,3,1,0,130,121,34033,26762,122,129,35695,25699
184,21,4,0,0,3,1,0,77,60,34037,26762,67,40,35698,25699
185,21,1,0,0,3,1,0,140,171,34038,26762,85,76,35701,25699
186,21,0,2,1,0,0,3,114,36,34038,26764,147,97,35701,25702
187,21,2,2,2,1,2,1,141,118,34040,26766,111,76,35702,25703
188,21,0,1,1,0,0,3,197,51,34040,26767,187,98,35702,25706
189,22,1,3,1,0,0,3,174,81,34041,26770,161,129,35702,25709
190,22,0,0,2,1,2,1,84,157,34041,26770,188,68,35703,25710
191,22,4,0,0,3,1,0,166,121,34045,26770,135,187,35706,25710
192,22,3,1,0,3,1,0,224,76,34048,26771,196,76,35709,25710
193,22,0,1,1,0,0,3,317,144,34048,26772,214,100,35709,25713
194,22,2,1,0,3,1,0,183,72,34050,26773,178,327,35712,25713
195,22,3,0,0,3,1,0,143,171,34053,26773,88,70,35715,25713
196,22,1,2,1,0,0,3,194,168,34054,26775,229,155,35715,25716
197,22,2,4,1,0,0,3,134,99,34056,26779,141,101,35715,25719
198,23,2,4,1,0,0,3,159,90,34058,26783,150,131,35715,25722
199,23,2,0,0,3,1,0,143,118,34060,26783,114,113,35718,25722
200,23,1,1,2,1,2,1,192,156,34061,26784,178,77,35719,25723
201,23,2,0,0,3,1,0,143,90,34063,26784,141,120,35722,25723
202,23,3,2,0,3,1,0,133,123,34066,26786,125,142,35725,25723
203,23,2,1,0,3,1,0,116,37,34068,26787,150,104,35728,25723
204,23,6,1,0,3,1,0,154,111,34074,26788,145,40,35731,25723
205,23,0,1,1,0,0,3,77,61,34074,26789,67,157,35731,25726
206,23,4,2,0,3,1,0,201,53,34078,26791,190,129,35734,25726
207,24,2,1,0,3,1,0,319,145,34080,26792,217,327,35737,25726
208,24,3,2,0,3,1,0,136,125,34083,26794,128,187,35740,25726
209,24,0,2,1,0,0,3,194,170,34083,26796,229,104,35740,25729
210,24,1,1,2,1,2,1,144,119,34084,26797,115,77,35741,25730
211,24,3,1,0,3,1,0,169,122,34087,26798,138,77,35744,25730
212,24,1,2,1,0,0,3,175,83,34088,26800,161,103,35744,25733
213,24,1,1,2,1,2,1,144,172,34089,26801,89,156,35745,25734
214,24,3,0,0,3,1,0,227,76,34092,26801,199,40,35748,25734
215,24,3,2,0,3,1,0,186,74,34095,26803,181,129,35751,25734
216,25,2,1,0,3,1,0,86,158,34097,26804,191,157,35754,25734
217,25,2,1,0,3,1,0,145,91,34099,26805,144,187,35757,25734
218,25,1,1,2,1,2,1,176,84,34100,26806,162,143,35758,25735
219,25,2,0,0,3,1,0,161,90,34102,26806,153,120,35761,25735
220,25,1,0,0,3,1,0,117,37,34103,26806,153,70,35764,25735
221,25,3,0,0,3,1,0,195,156,34106,26806,181,104,35767,25735
222,25,0,0,2,1,2,1,154,111,34106,26806,146,114,35768,25736
223,25,1,1,2,1,2,1,135,100,34107,26807,142,69,35769,25737
224,25,1,3,1,0,0,3,228,79,34108,26810,199,159,35769,25740
225,26,2,2,2,1,2,1,146,174,34110,26812,90,130,35770,25741
226,26,0,3,1,0,0,3,194,173,34110,26815,229,134,35770,25744
227,26,1,1,2,1,2,1,145,120,34111,26816,116,104,35771,25745
228,26,0,1,1,0,0,3,136,126,34111,26817,128,107,35771,25748
229,26,6,1,0,3,1,0,83,62,34117,26818,70,327,35774,25748
230,26,2,0,0,3,1,0,137,100,34119,26818,145,40,35777,25748
231,26,3,0,0,3,1,0,189,74,34122,26818,184,143,35780,25748
232,26,1,0,0,3,1,0,202,53,34123,26818,193,129,35783,25748
233,26,6,2,0,3,1,0,160,113,34129,26820,149,104,35786,25748
234,27,3,1,0,3,1,0,148,92,34132,26821,147,104,35789,25748
235,27,2,0,0,3,1,0,178,84,34134,26821,165,187,35792,25748
236,27,1,0,0,3,1,0,320,145,34135,26821,220,157,35795,25748
237,27,3,1,0,3,1,0,120,38,34138,26822,156,77,35798,25748
238,27,2,3,1,0,0,3,197,159,34140,26825,181,123,35798,25751
239,27,1,3,1,0,0,3,137,129,34141,26828,128,73,35798,25754
240,27,2,1,0,3,1,0,230,80,34143,26829,202,77,35801,25754
241,27,1,4,1,0,0,3,170,126,34144,26833,138,162,35801,25757
242,27,1,2,1,0,0,3,87,160,34145,26835,191,117,35801,25760
243,28,3,4,1,0,0,3,163,117,34148,26839,149,146,35801,25763
244,28,0,2,1,0,0,3,194,175,34148,26841,229,107,35801,25766
245,28,1,4,1,0,0,3,146,124,34149,26845,116,110,35801,25769
246,28,2,1,0,3,1,0,148,175,34151,26846,93,40,35804,25769
247,28,2,1,0,3,1,0,163,91,34153,26847,156,327,35807,25769
248,28,1,1,2,1,2,1,84,63,34154,26848,71,130,35808,25770
249,28,2,2,2,1,2,1,139,102,34156,26850,146,131,35809,25771
250,28,2,1,0,3,1,0,191,75,34158,26851,187,134,35812,25771
251,28,1,0,0,3,1,0,203,53,34159,26851,196,69,35815,25771
252,29,1,1,2,1,2,1,149,93,34160,26852,148,78,35816,25772
253,29,1,0,0,3,1,0,85,63,34161,26852,74,123,35819,25772
254,29,0,0,2,1,2,1,170,126,34161,26852,139,147,35820,25773
255,29,0,5,1,0,0,3,178,89,34161,26857,165,137,35820,25776
256,29,2,3,1,0,0,3,89,163,34163,26860,191,76,35820,25779
257,29,1,1,2,1,2,1,164,118,34164,26861,150,163,35821,25780
258,29,1,4,1,0,0,3,164,95,34165,26865,156,120,35821,25783
259,29,2,3,1,0,0,3,199,162,34167,26868,181,72,35821,25786
260,29,1,0,0,3,1,0,121,38,34168,26868,159,157,35824,25786
261,30,3,1,0,3,1,0,233,81,34171,26869,205,187,35827,25786
262,30,1,3,1,0,0,3,200,165,34172,26872,181,110,35827,25789
263,30,5,2,0,3,1,0,175,128,34177,26874,142,104,35830,25789
264,30,2,2,2,1,2,1,322,147,34179,26876,221,41,35831,25790
265,30,0,2,1,0,0,3,146,126,34179,26878,116,166,35831,25793
266,30,2,2,2,1,2,1,150,177,34181,26880,94,121,35832,25794
267,30,1,3,1,0,0,3,195,178,34182,26883,229,134,35832,25797
268,30,3,2,0,3,1,0,142,104,34185,26885,149,327,35835,25797
269,30,2,0,0,3,1,0,139,129,34187,26885,131,77,35838,25797
270,31,1,1,2,1,2,1,122,39,34188,26886,160,131,35839,25798
271,31,3,1,0,3,1,0,167,96,34191,26887,159,72,35842,25798
272,31,4,1,0,3,1,0,237,82,34195,26888,208,110,35845,25798
273,31,3,0,0,3,1,0,152,93,34198,26888,151,41,35848,25798
274,31,1,4,1,0,0,3,151,181,34199,26892,94,81,35848,25801
275,31,0,1,1,0,0,3,191,76,34199,26893,187,160,35848,25804
276,31,2,0,0,3,1,0,148,126,34201,26893,119,187,35851,25804
277,31,0,0,2,1,2,1,203,53,34201,26893,197,148,35852,25805
278,31,1,0,0,3,1,0,165,118,34202,26893,153,134,35855,25805
279,32,1,0,0,3,1,0,140,129,34203,26893,134,110,35858,25805
280,32,1,1,2,1,2,1,176,129,34204,26894,143,124,35859,25806
281,32,0,2,1,0,0,3,195,180,34204,26896,229,80,35859,25809
282,32,1,3,1,0,0,3,323,150,34205,26899,221,79,35859,25812
283,32,2,3,1,0,0,3,202,168,34207,26902,181,140,35859,25815
284,32,0,0,2,1,2,1,89,163,34207,26902,192,328,35860,25816
285,32,1,1,2,1,2,1,143,105,34208,26903,150,122,35861,25817
286,32,1,1,2,1,2,1,86,64,34209,26904,75,167,35862,25818
287,32,0,2,1,0,0,3,178,91,34209,26906,165,107,35862,25821
288,33,2,2,2,1,2,1,167,120,34211,26908,154,132,35863,25822
289,33,0,1,1,0,0,3,143,106,34211,26909,150,190,35863,25825
290,33,3,0,0,3,1,0,206,53,34214,26909,200,328,35866,25825
291,33,1,0,0,3,1,0,152,181,34215,26909,97,72,35869,25825
292,33,3,0,0,3,1,0,181,91,34218,26909,168,41,35872,25825
293,33,2,0,0,3,1,0,239,82,34220,26909,211,79,35875,25825
294,33,1,1,2,1,2,1,196,181,34221,26910,230,111,35876,25826
295,33,3,2,0,3,1,0,170,98,34224,26912,162,148,35879,25826
296,33,1,4,1,0,0,3,192,80,34225,26916,187,113,35879,25829
297,34,1,0,0,3,1,0,149,126,34226,26916,122,160,35882,25829
298,34,3,0,0,3,1,0,89,64,34229,26916,78,122,35885,25829
299,34,2,1,0,3,1,0,91,164,34231,26917,195,167,35888,25829
300,34,1,3,1,0,0,3,177,132,34232,26920,143,137,35888,25832
301,34,3,3,2,1,2,1,155,96,34235,26923,152,81,35889,25833
302,34,1,4,1,0,0,3,203,172,34236,26927,181,110,35889,25836
303,34,4,5,1,0,0,3,327,155,34240,26932,221,84,35889,25839
304,34,1,2,1,0,0,3,123,41,34241,26934,160,127,35889,25842
305,34,2,3,1,0,0,3,142,132,34243,26937,134,143,35889,25845
0,1,3,1,0,3,1,0,150,119,34246,26938,135,79,35892,25845
1,1,3,2,0,3,1,0,195,82,34249,26940,190,81,35895,25845
2,1,0,3,1,0,0,3,170,101,34249,26943,162,170,35895,25848
3,1,1,1,2,1,2,1,153,182,34250,26944,98,114,35896,25849
4,1,2,2,2,1,2,1,144,134,34252,26946,135,144,35897,25850
5,1,3,1,0,3,1,0,180,133,34255,26947,146,24,35900,25850
6,1,1,1,2,1,2,1,144,107,34256,26948,151,138,35901,25851
7,1,2,2,2,1,2,1,91,66,34258,26950,79,329,35902,25852
8,1,1,0,0,3,1,0,134,169,34259,26950,93,132,35905,25852
9,2,3,0,0,3,1,0,158,96,34262,26950,155,160,35908,25852
10,2,0,3,1,0,0,3,303,131,34262,26953,329,193,35908,25855
11,2,3,0,0,3,1,0,209,53,34265,26953,203,127,35911,25855
12,2,1,4,1,0,0,3,182,95,34266,26957,168,75,35911,25858
13,2,2,2,2,1,2,1,205,174,34268,26959,182,111,35912,25859
14,2,2,0,0,3,1,0,241,82,34270,26959,214,84,35915,25859
15,2,0,2,1,0,0,3,123,43,34270,26961,160,125,35915,25862
16,2,1,1,2,1,2,1,168,121,34271,26962,155,112,35916,25863
17,2,3,0,0,3,1,0,152,126,34274,26962,125,65,35919,25863
18,3,2,0,0,3,1,0,146,107,34276,26962,154,132,35922,25863
19,3,1,0,0,3,1,0,151,119,34277,26962,138,24,35925,25863
20,3,1,1,2,1,2,1,181,134,34278,26963,147,145,35926,25864
21,3,1,6,1,0,0,3,124,49,34279,26969,160,82,35926,25867
22,3,2,1,0,3,1,0,93,67,34281,26970,82,138,35929,25867
23,3,0,2,1,0,0,3,134,171,34281,26972,93,173,35929,25870
24,3,0,0,2,1,2,1,170,101,34281,26972,163,128,35930,25871
25,3,1,1,2,1,2,1,145,135,34282,26973,136,82,35931,25872
26,3,2,0,0,3,1,0,197,82,34284,26973,193,114,35934,25872
27,4,0,1,1,0,0,3,153,183,34284,26974,98,68,35934,25875
28,4,2,0,0,3,1,0,170,121,34286,26974,158,84,35937,25875
29,4,1,1,2,1,2,1,182,135,34287,26975,148,194,35938,25876
30,4,3,0,0,3,1,0,208,174,34290,26975,185,24,35941,25876
31,4,2,0,0,3,1,0,154,126,34292,26975,128,138,35944,25876
32,4,4,0,0,3,1,0,213,53,34296,26975,206,75,35947,25876
33,4,0,1,1,0,0,3,170,102,34296,26976,163,163,35947,25879
34,4,4,1,0,3,1,0,162,97,34300,26977,158,329,35950,25879
35,4,3,1,0,3,1,0,244,83,34303,26978,217,125,35953,25879
36,5,1,3,1,0,0,3,304,134,34304,26981,329,114,35953,25882
37,5,0,0,2,1,2,1,151,119,34304,26981,139,69,35954,25883
38,5,2,2,2,1,2,1,184,97,34306,26983,169,174,35955,25884
39,5,0,6,1,0,0,3,124,55,34306,26989,160,148,35955,25887
40,5,3,0,0,3,1,0,96,67,34309,26989,85,132,35958,25887
41,5,3,1,0,3,1,0,149,108,34312,26990,157,112,35961,25887
42,5,1,0,0,3,1,0,198,82,34313,26990,196,128,35964,25887
43,5,0,1,1,0,0,3,145,136,34313,26991,136,85,35964,25890
44,5,2,1,0,3,1,0,172,122,34315,26992,161,114,35967,25890
45,6,2,0,0,3,1,0,136,171,34317,26992,96,112,35970,25890
46,6,0,0,2,1,2,1,124,55,34317,26992,161,139,35971,25891
47,6,2,1,0,3,1,0,98,68,34319,26993,88,75,35974,25891
48,6,2,1,0,3,1,0,156,127,34321,26994,131,148,35977,25891
49,6,3,1,0,3,1,0,156,184,34324,26995,101,82,35980,25891
50,6,1,1,2,1,2,1,152,120,34325,26996,140,126,35981,25892
51,6,0,2,1,0,0,3,208,176,34325,26998,185,177,35981,25895
52,6,3,0,0,3,1,0,165,97,34328,26998,161,24,35984,25895
53,6,2,0,0,3,1,0,151,108,34330,26998,160,114,35987,25895
54,7,0,0,2,1,2,1,182,135,34330,26998,149,115,35988,25896
55,7,3,3,2,1,2,1,175,125,34333,27001,162,330,35989,25897
56,7,2,0,0,3,1,0,215,53,34335,27001,209,84,35992,25897
57,7,3,1,0,3,1,0,173,103,34338,27002,166,85,35995,25897
58,7,2,1,0,3,1,0,246,84,34340,27003,220,69,35998,25897
59,7,2,2,2,1,2,1,306,136,34342,27005,330,129,35999,25898
60,7,2,0,0,3,1,0,200,82,34344,27005,199,194,36002,25898
61,7,3,3,2,1,2,1,148,139,34347,27008,137,133,36003,25899
62,7,2,1,0,3,1,0,186,98,34349,27009,172,163,36006,25899
63,8,2,0,0,3,1,0,158,127,34351,27009,134,112,36009,25899
64,8,4,1,0,3,1,0,140,172,34355,27010,99,75,36012,25899
65,8,1,1,2,1,2,1,153,121,34356,27011,141,331,36013,25900
66,8,0,1,1,0,0,3,156,185,34356,27012,101,197,36013,25903
67,8,1,0,0,3,1,0,209,176,34357,27012,188,82,36016,25903
68,8,1,2,1,0,0,3,307,138,34358,27014,330,129,36016,25906
69,8,1,2,1,0,0,3,216,55,34359,27016,209,151,36016,25909
70,8,5,0,0,3,1,0,170,97,34364,27016,164,84,36019,25909
71,8,3,1,0,3,1,0,176,104,34367,27017,169,139,36022,25909
72,9,1,1,2,1,2,1,125,56,34368,27018,162,115,36023,25910
73,9,2,1,0,3,1,0,153,109,34370,27019,163,129,36026,25910
74,9,0,2,1,0,0,3,158,129,34370,27021,134,180,36026,25913
75,9,1,1,2,1,2,1,176,126,34371,27022,163,164,36027,25914
76,9,1,1,2,1,2,1,247,85,34372,27023,221,134,36028,25915
77,9,1,0,0,3,1,0,187,98,34373,27023,175,69,36031,25915
78,9,2,5,1,0,0,3,184,140,34375,27028,149,132,36031,25918
79,9,1,1,2,1,2,1,149,140,34376,27029,138,25,36032,25919
80,9,1,5,1,0,0,3,99,73,34377,27034,88,118,36032,25922
81,10,1,2,1,0,0,3,100,75,34378,27036,88,85,36032,25925
82,10,2,2,2,1,2,1,158,187,34380,27038,102,113,36033,25926
83,10,0,1,1,0,0,3,307,139,34380,27039,330,88,36033,25929
84,10,1,3,1,0,0,3,188,101,34381,27042,175,154,36033,25932
85,10,1,2,1,0,0,3,154,123,34382,27044,141,137,36033,25935
86,10,1,1,2,1,2,1,126,57,34383,27045,163,76,36034,25936
87,10,1,3,1,0,0,3,171,100,34384,27048,164,183,36034,25939
88,10,1,1,2,1,2,1,141,173,34385,27049,100,85,36035,25940
89,10,3,1,0,3,1,0,203,83,34388,27050,202,115,36038,25940
90,11,2,1,0,3,1,0,160,130,34390,27051,137,129,36041,25940
91,11,2,0,0,3,1,0,155,109,34392,27051,166,197,36044,25940
92,11,6,0,0,3,1,0,222,55,34398,27051,212,164,36047,25940
93,11,0,3,1,0,0,3,209,179,34398,27054,188,121,36047,25943
94,11,3,6,1,0,0,3,310,145,34401,27060,330,157,36047,25946
95,11,1,0,0,3,1,0,150,140,34402,27060,141,132,36050,25946
96,11,2,0,0,3,1,0,186,140,34404,27060,152,331,36053,25946
97,11,4,2,0,3,1,0,180,128,34408,27062,166,139,36056,25946
98,11,2,4,1,0,0,3,178,108,34410,27066,169,72,36056,25949
99,12,1,1,2,1,2,1,155,124,34411,27067,142,77,36057,25950
100,12,1,4,1,0,0,3,189,105,34412,27071,175,116,36057,25953
101,12,2,0,0,3,1,0,143,173,34414,27071,103,25,36060,25953
102,12,2,3,1,0,0,3,160,190,34416,27074,102,140,36060,25956
103,12,1,1,2,1,2,1,101,76,34417,27075,89,89,36061,25957
104,12,3,1,0,3,1,0,250,86,34420,27076,224,85,36064,25957
105,12,2,2,2,1,2,1,128,59,34422,27078,164,86,36065,25958
106,12,1,1,2,1,2,1,204,84,34423,27079,203,184,36066,25959
107,12,0,2,1,0,0,3,171,102,34423,27081,164,118,36066,25962
108,13,3,1,0,3,1,0,181,109,34426,27082,172,116,36069,25962
109,13,0,5,1,0,0,3,155,129,34426,27087,142,200,36069,25965
110,13,5,1,0,3,1,0,227,56,34431,27088,215,331,36072,25965
111,13,2,2,2,1,2,1,162,192,34433,27090,103,158,36073,25966
112,13,1,2,1,0,0,3,311,147,34434,27092,330,89,36073,25969
113,13,0,0,2,1,2,1,160,130,34434,27092,138,141,36074,25970
114,13,5,0,0,3,1,0,209,84,34439,27092,206,139,36077,25970
115,13,1,0,0,3,1,0,144,173,34440,27092,106,85,36080,25970
116,13,2,2,2,1,2,1,152,142,34442,27094,142,122,36081,25971
117,14,2,3,1,0,0,3,130,62,34444,27097,164,28,36081,25974
118,14,3,0,0,3,1,0,189,140,34447,27097,155,164,36084,25974
119,14,2,4,1,0,0,3,211,183,34449,27101,188,135,36084,25977
120,14,1,3,1,0,0,3,190,108,34450,27104,175,132,36084,25980
121,14,1,0,0,3,1,0,172,102,34451,27104,167,72,36087,25980
122,14,0,2,1,0,0,3,101,78,34451,27106,89,187,36087,25983
123,14,2,1,0,3,1,0,157,110,34453,27107,169,77,36090,25983
124,14,4,2,0,3,1,0,184,130,34457,27109,169,89,36093,25983
125,14,3,0,0,3,1,0,253,86,34460,27109,227,118,36096,25983
126,15,0,1,1,0,0,3,181,110,34460,27110,172,80,36096,25986
127,15,1,1,2,1,2,1,212,184,34461,27111,189,140,36097,25987
128,15,0,1,1,0,0,3,311,148,34461,27112,330,88,36097,25990
129,15,0,1,1,0,0,3,172,103,34461,27113,167,161,36097,25993
130,15,5,2,0,3,1,0,232,58,34466,27115,218,116,36100,25993
131,15,3,0,0,3,1,0,165,192,34469,27115,106,331,36103,25993
132,15,3,0,0,3,1,0,212,84,34472,27115,209,89,36106,25993
133,15,2,2,2,1,2,1,146,175,34474,27117,107,201,36107,25994
134,15,0,0,2,1,2,1,155,129,34474,27117,143,90,36108,25995
135,16,2,1,0,3,1,0,191,141,34476,27118,158,141,36111,25995
136,16,1,1,2,1,2,1,153,143,34477,27119,143,133,36112,25996
137,16,3,1,0,3,1,0,133,63,34480,27120,167,72,36115,25996
138,16,1,1,2,1,2,1,254,87,34481,27121,228,165,36116,25997
139,16,2,1,0,3,1,0,192,109,34483,27122,178,28,36119,25997
140,16,1,0,0,3,1,0,185,130,34484,27122,172,187,36122,25997
141,16,2,1,0,3,1,0,103,79,34486,27123,92,118,36125,25997
142,16,1,1,2,1,2,1,158,111,34487,27124,170,136,36126,25998
143,16,1,1,2,1,2,1,161,131,34488,27125,139,123,36127,25999
144,17,5,1,0,3,1,0,177,104,34493,27126,170,140,36130,25999
145,17,2,2,2,1,2,1,183,112,34495,27128,173,89,36131,26000
146,17,3,2,0,3,1,0,257,89,34498,27130,231,201,36134,26000
147,17,2,1,0,3,1,0,163,132,34500,27131,142,90,36137,26000
148,17,1,4,1,0,0,3,213,188,34501,27135,189,334,36137,26003
149,17,3,2,0,3,1,0,168,194,34504,27137,109,165,36140,26003
150,17,0,4,1,0,0,3,191,145,34504,27141,158,83,36140,26006
151,17,3,1,0,3,1,0,149,176,34507,27142,110,136,36143,26006
152,17,2,1,0,3,1,0,234,59,34509,27143,221,28,36146,26006
153,18,4,0,0,3,1,0,196,109,34513,27143,181,89,36149,26006
154,18,0,2,1,0,0,3,133,65,34513,27145,167,126,36149,26009
155,18,5,2,0,3,1,0,108,81,34518,27147,95,116,36152,26009
156,18,0,1,1,0,0,3,155,130,34518,27148,143,121,36152,26012
157,18,2,0,0,3,1,0,313,148,34520,27148,333,141,36155,26012
158,18,0,1,1,0,0,3,153,144,34520,27149,143,190,36155,26015
159,18,0,2,1,0,0,3,212,86,34520,27151,209,164,36155,26018
160,18,1,4,1,0,0,3,159,115,34521,27155,170,92,36155,26021
161,18,1,0,0,3,1,0,150,176,34522,27155,113,133,36158,26021
162,19,0,0,2,1,2,1,159,115,34522,27155,171,73,36159,26022
163,19,2,1,0,3,1,0,165,133,34524,27156,145,28,36162,26022
164,19,1,0,0,3,1,0,235,59,34525,27156,224,126,36165,26022
165,19,0,1,1,0,0,3,213,189,34525,27157,189,168,36165,26025
166,19,3,1,0,3,1,0,194,146,34528,27158,161,133,36168,26025
167,19,4,2,0,3,1,0,187,114,34532,27160,176,136,36171,26025
168,19,1,0,0,3,1,0,186,130,34533,27160,175,201,36174,26025
169,19,4,2,0,3,1,0,261,91,34537,27162,234,140,36177,26025
170,19,2,1,0,3,1,0,155,145,34539,27163,146,334,36180,26025
171,20,1,1,2,1,2,1,169,195,34540,27164,110,91,36181,26026
172,20,0,0,2,1,2,1,235,59,34540,27164,225,90,36182,26027
173,20,3,1,0,3,1,0,190,115,34543,27165,179,334,36185,26027
174,20,2,0,0,3,1,0,152,176,34545,27165,116,140,36188,26027
175,20,3,1,0,3,1,0,316,149,34548,27166,336,83,36191,26027
176,20,1,3,1,0,0,3,214,192,34549,27169,189,167,36191,26030
177,20,1,1,2,1,2,1,178,105,34550,27170,171,202,36192,26031
178,20,1,0,0,3,1,0,156,130,34551,27170,146,92,36195,26031
179,20,1,2,1,0,0,3,213,88,34552,27172,209,119,36195,26034
180,21,0,0,2,1,2,1,169,195,34552,27172,111,91,36196,26035
181,21,0,0,2,1,2,1,178,105,34552,27172,172,142,36197,26036
182,21,1,3,1,0,0,3,109,84,34553,27175,95,94,36197,26039
183,21,4,2,0,3,1,0,265,93,34557,27177,237,28,36200,26039
184,21,0,3,1,0,0,3,152,179,34557,27180,116,124,36200,26042
185,21,2,2,2,1,2,1,158,132,34559,27182,147,191,36201,26043
186,21,0,1,1,0,0,3,133,66,34559,27183,167,122,36201,26046
187,21,0,2,1,0,0,3,213,90,34559,27185,209,86,36201,26049
188,21,3,1,0,3,1,0,199,110,34562,27186,184,92,36204,26049
189,22,0,0,2,1,2,1,214,192,34562,27186,190,134,36205,26050
190,22,2,2,2,1,2,1,157,147,34564,27188,147,169,36206,26051
191,22,1,3,1,0,0,3,195,149,34565,27191,161,143,36206,26054
192,22,1,0,0,3,1,0,191,115,34566,27191,182,126,36209,26054
193,22,2,0,0,3,1,0,167,133,34568,27191,148,202,36212,26054
194,22,2,1,0,3,1,0,237,60,34570,27192,228,136,36215,26054
195,22,1,1,2,1,2,1,317,150,34571,27193,337,74,36216,26055
196,22,2,0,0,3,1,0,161,115,34573,27193,174,334,36219,26055
197,22,0,2,1,0,0,3,186,132,34573,27195,175,170,36219,26058
198,23,0,2,1,0,0,3,133,68,34573,27197,167,95,36219,26061
199,23,3,6,1,0,0,3,170,139,34576,27203,148,127,36219,26064
200,23,0,0,2,1,2,1,169,195,34576,27203,112,29,36220,26065
201,23,0,1,1,0,0,3,158,133,34576,27204,147,146,36220,26068
202,23,3,0,0,3,1,0,181,105,34579,27204,175,122,36223,26068
203,23,1,2,1,0,0,3,162,117,34580,27206,174,194,36223,26071
204,23,3,1,0,3,1,0,112,85,34583,27207,98,136,36226,26071
205,23,2,4,1,0,0,3,216,196,34585,27211,190,89,36226,26074
206,23,0,3,1,0,0,3,152,182,34585,27214,116,173,36226,26077
207,24,0,2,1,0,0,3,157,149,34585,27216,147,205,36226,26080
208,24,4,1,0,3,1,0,195,116,34589,27217,185,94,36229,26080
209,24,1,1,2,1,2,1,196,150,34590,27218,162,75,36230,26081
210,24,2,0,0,3,1,0,267,93,34592,27218,240,91,36233,26081
211,24,3,0,0,3,1,0,202,110,34595,27218,187,334,36236,26081
212,24,2,2,2,1,2,1,319,152,34597,27220,338,127,36237,26082
213,24,2,1,0,3,1,0,188,133,34599,27221,178,134,36240,26082
214,24,3,0,0,3,1,0,240,60,34602,27221,231,142,36243,26082
215,24,1,1,2,1,2,1,214,91,34603,27222,210,170,36244,26083
216,25,2,0,0,3,1,0,218,196,34605,27222,193,75,36247,26083
217,25,2,0,0,3,1,0,204,110,34607,27222,190,94,36250,26083
218,25,1,0,0,3,1,0,134,68,34608,27222,170,205,36253,26083
219,25,2,0,0,3,1,0,269,93,34610,27222,243,89,36256,26083
220,25,0,1,1,0,0,3,181,106,34610,27223,175,137,36256,26086
221,25,0,5,1,0,0,3,170,144,34610,27228,148,173,36256,26089
222,25,0,1,1,0,0,3,319,153,34610,27229,338,125,36256,26092
223,25,1,2,1,0,0,3,189,135,34611,27231,178,139,36256,26095
224,25,4,1,0,3,1,0,244,61,34615,27232,234,127,36259,26095
225,26,2,1,0,3,1,0,159,150,34617,27233,150,146,36262,26095
226,26,2,1,0,3,1,0,114,86,34619,27234,101,29,36265,26095
227,26,0,3,1,0,0,3,162,120,34619,27237,174,176,36265,26098
228,26,0,4,1,0,0,3,196,154,34619,27241,162,98,36265,26101
229,26,1,0,0,3,1,0,153,182,34620,27241,119,91,36268,26101
230,26,2,0,0,3,1,0,197,116,34622,27241,188,142,36271,26101
231,26,0,4,1,0,0,3,169,199,34622,27245,112,197,36271,26104
232,26,1,2,1,0,0,3,159,135,34623,27247,147,130,36271,26107
233,26,3,1,0,3,1,0,217,92,34626,27248,213,334,36274,26107
234,27,3,0,0,3,1,0,322,153,34629,27248,341,173,36277,26107
235,27,2,1,0,3,1,0,206,111,34631,27249,193,205,36280,26107
236,27,0,2,1,0,0,3,169,201,34631,27251,112,130,36280,26110
237,27,1,1,2,1,2,1,270,94,34632,27252,244,126,36281,26111
238,27,2,1,0,3,1,0,220,197,34634,27253,196,94,36284,26111
239,27,2,2,2,1,2,1,191,137,34636,27255,179,90,36285,26112
240,27,3,1,0,3,1,0,173,145,34639,27256,151,334,36288,26112
241,27,0,2,1,0,0,3,181,108,34639,27258,175,142,36288,26115
242,27,2,2,2,1,2,1,246,63,34641,27260,235,76,36289,26116
243,28,2,1,0,3,1,0,193,138,34643,27261,182,142,36292,26116
244,28,0,1,1,0,0,3,196,155,34643,27262,162,94,36292,26119
245,28,3,1,0,3,1,0,220,93,34646,27263,216,29,36295,26119
246,28,4,1,0,3,1,0,118,87,34650,27264,104,137,36298,26119
247,28,0,1,1,0,0,3,134,69,34650,27265,170,176,36298,26122
248,28,2,2,2,1,2,1,208,113,34652,27267,194,131,36299,26123
249,28,0,3,1,0,0,3,162,123,34652,27270,174,133,36299,26126
250,28,1,0,0,3,1,0,160,150,34653,27270,153,76,36302,26126
251,28,0,2,1,0,0,3,270,96,34653,27272,244,200,36302,26129
252,29,1,1,2,1,2,1,174,146,34654,27273,152,99,36303,26130
253,29,2,2,2,1,2,1,324,155,34656,27275,342,335,36304,26131
254,29,2,4,1,0,0,3,199,120,34658,27279,188,179,36304,26134
255,29,3,0,0,3,1,0,223,93,34661,27279,219,142,36307,26134
256,29,2,3,1,0,0,3,171,204,34663,27282,112,149,36307,26137
257,29,2,1,0,3,1,0,155,183,34665,27283,122,133,36310,26137
258,29,1,2,1,0,0,3,160,137,34666,27285,147,129,36310,26140
259,29,0,1,1,0,0,3,160,151,34666,27286,153,97,36310,26143
260,29,3,0,0,3,1,0,249,63,34669,27286,238,205,36313,26143
261,30,3,1,0,3,1,0,121,88,34672,27287,107,176,36316,26143
262,30,1,3,1,0,0,3,221,200,34673,27290,196,97,36316,26146
263,30,0,1,1,0,0,3,134,70,34673,27291,170,203,36316,26149
264,30,2,2,2,1,2,1,183,110,34675,27293,176,91,36317,26150
265,30,2,0,0,3,1,0,272,96,34677,27293,247,137,36320,26150
266,30,4,2,0,3,1,0,200,157,34681,27295,165,131,36323,26150
267,30,3,1,0,3,1,0,196,139,34684,27296,185,76,36326,26150
268,30,3,1,0,3,1,0,165,124,34687,27297,177,29,36329,26150
269,30,0,1,1,0,0,3,208,114,34687,27298,194,145,36329,26153
270,31,1,1,2,1,2,1,325,156,34688,27299,343,150,36330,26154
271,31,1,1,2,1,2,1,184,111,34689,27300,177,98,36331,26155
272,31,1,1,2,1,2,1,224,94,34690,27301,220,98,36332,26156
273,31,5,1,0,3,1,0,204,121,34695,27302,191,205,36335,26156
274,31,0,3,1,0,0,3,160,140,34695,27305,147,182,36335,26159
275,31,2,2,2,1,2,1,251,65,34697,27307,239,100,36336,26160
276,31,0,2,1,0,0,3,171,206,34697,27309,112,94,36336,26163
277,31,2,1,0,3,1,0,157,184,34699,27310,125,335,36339,26163
278,31,1,1,2,1,2,1,222,201,34700,27311,197,130,36340,26164
279,32,1,0,0,3,1,0,166,124,34701,27311,180,176,36343,26164
280,32,2,0,0,3,1,0,274,96,34703,27311,250,133,36346,26164
281,32,2,0,0,3,1,0,123,88,34705,27311,110,76,36349,26164
282,32,0,2,1,0,0,3,196,141,34705,27313,185,32,36349,26167
283,32,2,2,2,1,2,1,176,148,34707,27315,153,146,36350,26168
284,32,2,0,0,3,1,0,210,114,34709,27315,197,142,36353,26168
285,32,0,2,1,0,0,3,200,159,34709,27317,165,206,36353,26171
286,32,1,2,1,0,0,3,161,153,34710,27319,153,134,36353,26174
287,32,1,1,2,1,2,1,135,71,34711,27320,171,138,36354,26175
288,33,1,2,1,0,0,3,201,161,34712,27322,165,101,36354,26178
289,33,4,1,0,3,1,0,208,122,34716,27323,194,32,36357,26178
290,33,0,1,1,0,0,3,171,207,34716,27324,112,149,36357,26181
291,33,4,0,0,3,1,0,255,65,34720,27324,242,150,36360,26181
292,33,6,2,0,3,1,0,280,98,34726,27326,253,335,36363,26181
293,33,2,2,2,1,2,1,224,203,34728,27328,198,206,36364,26182
294,33,1,1,2,1,2,1,177,149,34729,27329,154,95,36365,26183
295,33,1,3,1,0,0,3,185,114,34730,27332,177,103,36365,26186
296,33,1,2,1,0,0,3,158,186,34731,27334,125,179,36365,26189
297,34,0,2,1,0,0,3,135,73,34731,27336,171,145,36365,26192
298,34,1,3,1,0,0,3,197,144,34732,27339,185,137,36365,26195
299,34,1,0,0,3,1,0,225,94,34733,27339,223,76,36368,26195
300,34,1,3,1,0,0,3,124,91,34734,27342,110,185,36368,26198
301,34,1,1,2,1,2,1,326,157,34735,27343,344,207,36369,26199
302,34,2,3,1,0,0,3,162,143,34737,27346,147,141,36369,26202
303,34,2,1,0,3,1,0,168,125,34739,27347,183,98,36372,26202
304,34,1,1,2,1,2,1,162,154,34740,27348,154,131,36373,26203
305,34,2,2,2,1,2,1,212,116,34742,27350,198,134,36374,26204
0,1,1,1,2,1,2,1,159,187,34743,27351,126,207,36375,26205
1,1,3,0,0,3,1,0,165,154,34746,27351,157,160,36378,26205
2,1,1,2,1,0,0,3,198,146,34747,27353,185,188,36378,26208
3,1,1,2,1,0,0,3,213,118,34748,27355,198,148,36378,26211
4,1,1,4,1,0,0,3,172,211,34749,27359,112,137,36378,26214
5,1,0,5,1,0,0,3,168,130,34749,27364,183,152,36378,26217
6,1,2,2,2,1,2,1,210,124,34751,27366,195,132,36379,26218
7,1,1,3,1,0,0,3,111,79,34752,27369,140,210,36379,26221
8,1,1,1,2,1,2,1,163,144,34753,27370,148,99,36380,26222
9,2,2,2,2,1,2,1,203,163,34755,27372,166,104,36381,26223
10,2,2,0,0,3,1,0,226,203,34757,27372,201,101,36384,26223
11,2,2,2,2,1,2,1,257,67,34759,27374,243,180,36385,26224
12,2,1,2,1,0,0,3,186,116,34760,27376,177,98,36385,26227
13,2,0,3,1,0,0,3,124,94,34760,27379,110,105,36385,26230
14,2,3,1,0,3,1,0,180,150,34763,27380,157,141,36388,26230
15,2,2,2,2,1,2,1,198,183,34765,27382,231,77,36389,26231
16,2,2,0,0,3,1,0,227,94,34767,27382,226,150,36392,26231
17,2,1,0,0,3,1,0,281,98,34768,27382,256,137,36395,26231
18,3,1,2,1,0,0,3,227,205,34769,27384,201,101,36395,26234
19,3,0,1,1,0,0,3,163,145,34769,27385,148,140,36395,26237
20,3,1,2,1,0,0,3,258,69,34770,27387,243,144,36395,26240
21,3,0,4,1,0,0,3,124,98,34770,27391,110,191,36395,26243
22,3,2,1,0,3,1,0,161,188,34772,27392,129,132,36398,26243
23,3,3,4,1,0,0,3,171,134,34775,27396,183,153,36398,26246
24,3,1,0,0,3,1,0,112,79,34776,27396,143,160,36401,26246
25,3,1,2,1,0,0,3,199,148,34777,27398,185,140,36401,26249
26,3,0,1,1,0,0,3,180,151,34777,27399,157,155,36401,26252
27,4,1,1,2,1,2,1,187,117,34778,27400,178,105,36402,26253
28,4,0,0,2,1,2,1,172,211,34778,27400,113,181,36403,26254
29,4,4,1,0,3,1,0,231,95,34782,27401,229,148,36406,26254
30,4,1,0,0,3,1,0,204,163,34783,27401,169,207,36409,26254
31,4,3,1,0,3,1,0,216,119,34786,27402,201,105,36412,26254
32,4,0,0,2,1,2,1,281,98,34786,27402,257,102,36413,26255
33,4,1,1,2,1,2,1,166,155,34787,27403,158,100,36414,26256
34,4,0,3,1,0,0,3,198,186,34787,27406,231,213,36414,26259
35,4,2,0,0,3,1,0,212,124,34789,27406,198,77,36417,26259
36,5,2,0,0,3,1,0,214,124,34791,27406,201,144,36420,26259
37,5,1,1,2,1,2,1,125,99,34792,27407,111,106,36421,26260
38,5,0,4,1,0,0,3,161,192,34792,27411,129,194,36421,26263
39,5,3,1,0,3,1,0,230,206,34795,27412,204,100,36424,26263
40,5,3,1,0,3,1,0,207,164,34798,27413,172,153,36427,26263
41,5,3,1,0,3,1,0,234,96,34801,27414,232,101,36430,26263
42,5,2,0,0,3,1,0,200,186,34803,27414,234,181,36433,26263
43,5,1,1,2,1,2,1,172,135,34804,27415,184,106,36434,26264
44,5,1,0,0,3,1,0,259,69,34805,27415,246,140,36437,26264
45,6,1,5,1,0,0,3,200,153,34806,27420,185,105,36437,26267
46,6,4,1,0,3,1,0,220,120,34810,27421,204,101,36440,26267
47,6,0,3,1,0,0,3,163,148,34810,27424,148,135,36440,26270
48,6,2,0,0,3,1,0,189,117,34812,27424,181,160,36443,26270
49,6,1,1,2,1,2,1,173,212,34813,27425,114,149,36444,26271
50,6,2,0,0,3,1,0,114,79,34815,27425,146,77,36447,26271
51,6,0,1,1,0,0,3,281,99,34815,27426,257,158,36447,26274
52,6,0,2,1,0,0,3,125,101,34815,27428,111,143,36447,26277
53,6,0,2,1,0,0,3,180,153,34815,27430,157,216,36447,26280
54,7,0,3,1,0,0,3,166,158,34815,27433,158,138,36447,26283
55,7,0,0,2,1,2,1,172,135,34815,27433,185,101,36448,26284
56,7,5,1,0,3,1,0,264,70,34820,27434,249,207,36451,26284
57,7,2,2,2,1,2,1,216,126,34822,27436,202,161,36452,26285
58,7,1,3,1,0,0,3,231,209,34823,27439,204,197,36452,26288
59,7,0,0,2,1,2,1,161,192,34823,27439,130,145,36453,26289
60,7,2,0,0,3,1,0,202,153,34825,27439,188,106,36456,26289
61,7,2,1,0,3,1,0,222,121,34827,27440,207,140,36459,26289
62,7,5,0,0,3,1,0,239,96,34832,27440,235,181,36462,26289
63,8,2,1,0,3,1,0,127,102,34834,27441,114,101,36465,26289
64,8,2,1,0,3,1,0,191,118,34836,27442,184,105,36468,26289
65,8,1,1,2,1,2,1,208,165,34837,27443,173,198,36469,26290
66,8,0,1,1,0,0,3,163,149,34837,27444,148,80,36469,26293
67,8,3,0,0,3,1,0,203,186,34840,27444,237,149,36472,26293
68,8,3,2,0,3,1,0,267,72,34843,27446,252,106,36475,26293
69,8,0,2,1,0,0,3,173,214,34843,27448,114,161,36475,26296
70,8,1,1,2,1,2,1,181,154,34844,27449,158,154,36476,26297
71,8,1,1,2,1,2,1,115,80,34845,27450,147,144,36477,26298
72,9,2,2,2,1,2,1,117,82,34847,27452,148,146,36478,26299
73,9,3,0,0,3,1,0,205,153,34850,27452,191,161,36481,26299
74,9,1,1,2,1,2,1,282,100,34851,27453,258,102,36482,26300
75,9,2,2,2,1,2,1,218,128,34853,27455,203,141,36483,26301
76,9,0,3,1,0,0,3,172,138,34853,27458,185,141,36483,26304
77,9,2,2,2,1,2,1,224,123,34855,27460,208,208,36484,26305
78,9,0,1,1,0,0,3,231,210,34855,27461,204,184,36484,26308
79,9,1,2,1,0,0,3,162,194,34856,27463,130,164,36484,26311
80,9,0,2,1,0,0,3,166,160,34856,27465,158,219,36484,26314
81,10,0,2,1,0,0,3,231,212,34856,27467,204,211,36484,26317
82,10,0,2,1,0,0,3,203,188,34856,27469,237,157,36484,26320
83,10,1,0,0,3,1,0,283,100,34857,27469,261,106,36487,26320
84,10,1,1,2,1,2,1,164,150,34858,27470,149,102,36488,26321
85,10,0,1,1,0,0,3,173,215,34858,27471,114,109,36488,26324
86,10,1,1,2,1,2,1,163,195,34859,27472,131,142,36489,26325
87,10,1,1,2,1,2,1,240,97,34860,27473,236,220,36490,26326
88,10,2,0,0,3,1,0,174,138,34862,27473,188,144,36493,26326
89,10,3,1,0,3,1,0,211,166,34865,27474,176,102,36496,26326
90,11,0,0,2,1,2,1,224,123,34865,27474,209,185,36497,26327
91,11,2,1,0,3,1,0,175,216,34867,27475,117,105,36500,26327
92,11,2,2,2,1,2,1,183,156,34869,27477,159,107,36501,26328
93,11,0,2,1,0,0,3,191,120,34869,27479,184,201,36501,26331
94,11,1,0,0,3,1,0,268,72,34870,27479,255,149,36504,26331
95,11,3,1,0,3,1,0,130,103,34873,27480,117,161,36507,26331
96,11,2,2,2,1,2,1,242,99,34875,27482,237,142,36508,26332
97,11,1,1,2,1,2,1,206,154,34876,27483,192,81,36509,26333
98,11,0,1,1,0,0,3,166,161,34876,27484,158,147,36509,26336
99,12,3,1,0,3,1,0,120,83,34879,27485,151,142,36512,26336
100,12,1,0,0,3,1,0,167,161,34880,27485,161,146,36515,26336
101,12,1,1,2,1,2,1,164,196,34881,27486,132,106,36516,26337
102,12,1,1,2,1,2,1,284,101,34882,27487,262,158,36517,26338
103,12,0,0,2,1,2,1,130,103,34882,27487,118,186,36518,26339
104,12,2,1,0,3,1,0,208,155,34884,27488,195,149,36521,26339
105,12,2,2,2,1,2,1,220,130,34886,27490,204,221,36522,26340
106,12,1,2,1,0,0,3,192,122,34887,27492,184,105,36522,26343
107,12,1,0,0,3,1,0,204,188,34888,27492,240,164,36525,26343
108,13,1,1,2,1,2,1,212,167,34889,27493,177,143,36526,26344
109,13,2,1,0,3,1,0,185,157,34891,27494,162,161,36529,26344
110,13,0,0,2,1,2,1,175,216,34891,27494,118,202,36530,26345
111,13,3,2,0,3,1,0,234,214,34894,27496,207,107,36533,26345
112,13,2,1,0,3,1,0,176,139,34896,27497,191,102,36536,26345
113,13,1,1,2,1,2,1,165,151,34897,27498,150,148,36537,26346
114,13,5,0,0,3,1,0,273,72,34902,27498,258,81,36540,26346
115,13,1,1,2,1,2,1,225,124,34903,27499,210,110,36541,26347
116,13,3,0,0,3,1,0,245,99,34906,27499,240,211,36544,26347
117,14,0,1,1,0,0,3,204,189,34906,27500,240,149,36544,26350
118,14,2,2,2,1,2,1,194,124,34908,27502,185,150,36545,26351
119,14,3,1,0,3,1,0,287,102,34911,27503,265,102,36548,26351
120,14,0,4,1,0,0,3,130,107,34911,27507,118,109,36548,26354
121,14,3,2,0,3,1,0,167,198,34914,27509,135,158,36551,26354
122,14,2,2,2,1,2,1,122,85,34916,27511,152,187,36552,26355
123,14,5,1,0,3,1,0,225,131,34921,27512,207,105,36555,26355
124,14,0,1,1,0,0,3,212,168,34921,27513,177,224,36555,26358
125,14,3,3,2,1,2,1,211,158,34924,27516,196,165,36556,26359
126,15,2,0,0,3,1,0,187,157,34926,27516,165,81,36559,26359
127,15,1,3,1,0,0,3,205,192,34927,27519,240,145,36559,26362
128,15,3,3,2,1,2,1,237,217,34930,27522,208,149,36560,26363
129,15,0,0,2,1,2,1,165,151,34930,27522,151,203,36561,26364
130,15,3,1,0,3,1,0,197,125,34933,27523,188,211,36564,26364
131,15,0,2,1,0,0,3,167,163,34933,27525,161,113,36564,26367
132,15,6,1,0,3,1,0,251,100,34939,27526,243,107,36567,26367
133,15,0,0,2,1,2,1,175,216,34939,27526,119,159,36568,26368
134,15,2,0,0,3,1,0,275,72,34941,27526,261,109,36571,26368
135,16,2,0,0,3,1,0,178,139,34943,27526,194,187,36574,26368
136,16,3,0,0,3,1,0,170,198,34946,27526,138,102,36577,26368
137,16,2,1,0,3,1,0,214,169,34948,27527,180,150,36580,26368
138,16,1,0,0,3,1,0,288,102,34949,27527,268,161,36583,26368
139,16,0,0,2,1,2,1,130,107,34949,27527,119,150,36584,26369
140,16,0,1,1,0,0,3,122,86,34949,27528,152,146,36584,26372
141,16,0,4,1,0,0,3,225,135,34949,27532,207,168,36584,26375
142,16,2,0,0,3,1,0,213,158,34951,27532,199,105,36587,26375
143,16,1,0,0,3,1,0,226,124,34952,27532,213,224,36590,26375
144,17,2,1,0,3,1,0,177,217,34954,27533,122,145,36593,26375
145,17,0,0,2,1,2,1,165,151,34954,27533,152,114,36594,26376
146,17,3,1,0,3,1,0,254,101,34957,27534,246,146,36597,26376
147,17,1,2,1,0,0,3,227,126,34958,27536,213,152,36597,26379
148,17,2,2,2,1,2,1,239,219,34960,27538,209,82,36598,26380
149,17,1,0,0,3,1,0,168,163,34961,27538,164,107,36601,26380
150,17,3,0,0,3,1,0,190,157,34964,27538,168,211,36604,26380
151,17,1,1,2,1,2,1,179,140,34965,27539,195,162,36605,26381
152,17,1,1,2,1,2,1,276,73,34966,27540,262,204,36606,26382
153,18,1,3,1,0,0,3,206,195,34967,27543,240,155,36606,26385
154,18,2,0,0,3,1,0,216,169,34969,27543,183,102,36609,26385
155,18,1,4,1,0,0,3,191,161,34970,27547,168,112,36609,26388
156,18,2,0,0,3,1,0,290,102,34972,27547,271,150,36612,26388
157,18,1,2,1,0,0,3,123,88,34973,27549,152,117,36612,26391
158,18,0,2,1,0,0,3,165,153,34973,27551,152,171,36612,26394
159,18,1,3,1,0,0,3,131,110,34974,27554,119,227,36612,26397
160,18,3,1,0,3,1,0,200,126,34977,27555,191,159,36615,26397
161,18,0,1,1,0,0,3,177,218,34977,27556,122,85,36615,26400
162,19,1,0,0,3,1,0,228,126,34978,27556,216,105,36618,26400
163,19,1,1,2,1,2,1,226,136,34979,27557,208,108,36619,26401
164,19,1,2,1,0,0,3,169,165,34980,27559,164,214,36619,26404
165,19,1,0,0,3,1,0,255,101,34981,27559,249,150,36622,26404
166,19,1,1,2,1,2,1,180,141,34982,27560,196,147,36623,26405
167,19,0,1,1,0,0,3,213,159,34982,27561,199,230,36623,26408
168,19,1,1,2,1,2,1,240,220,34983,27562,210,163,36624,26409
169,19,2,0,0,3,1,0,172,198,34985,27562,141,187,36627,26409
170,19,4,3,0,3,1,0,294,105,34989,27565,274,145,36630,26409
171,20,3,2,0,3,1,0,180,220,34992,27567,125,108,36633,26409
172,20,0,1,1,0,0,3,206,196,34992,27568,240,120,36633,26412
173,20,1,2,1,0,0,3,192,163,34993,27570,168,207,36633,26415
174,20,4,0,0,3,1,0,169,153,34997,27570,155,150,36636,26415
175,20,0,0,2,1,2,1,216,169,34997,27570,184,113,36637,26416
176,20,2,1,0,3,1,0,202,127,34999,27571,194,155,36640,26416
177,20,3,0,0,3,1,0,279,73,35002,27571,265,102,36643,26416
178,20,1,2,1,0,0,3,132,112,35003,27573,119,162,36643,26419
179,20,4,0,0,3,1,0,259,101,35007,27573,252,85,36646,26419
180,21,0,2,1,0,0,3,169,167,35007,27575,164,150,36646,26422
181,21,1,2,1,0,0,3,173,200,35008,27577,141,166,36646,26425
182,21,2,4,1,0,0,3,228,140,35010,27581,208,210,36646,26428
183,21,1,3,1,0,0,3,181,223,35011,27584,125,108,36646,26431
184,21,1,1,2,1,2,1,181,142,35012,27585,197,151,36647,26432
185,21,0,2,1,0,0,3,169,155,35012,27587,155,233,36647,26435
186,21,2,3,1,0,0,3,125,91,35014,27590,152,217,36647,26438
187,21,0,2,1,0,0,3,228,128,35014,27592,216,174,36647,26441
188,21,1,0,0,3,1,0,214,159,35015,27592,202,145,36650,26441
189,22,2,0,0,3,1,0,134,112,35017,27592,122,85,36653,26441
190,22,2,2,2,1,2,1,194,165,35019,27594,169,188,36654,26442
191,22,2,0,0,3,1,0,261,101,35021,27594,255,113,36657,26442
192,22,3,1,0,3,1,0,209,197,35024,27595,243,102,36660,26442
193,22,0,2,1,0,0,3,202,129,35024,27597,194,153,36660,26445
194,22,1,1,2,1,2,1,241,221,35025,27598,211,163,36661,26446
195,22,2,0,0,3,1,0,281,73,35027,27598,268,108,36664,26446
196,22,1,2,1,0,0,3,217,171,35028,27600,184,158,36664,26449
197,22,3,0,0,3,1,0,297,105,35031,27600,277,120,36667,26449
198,23,1,0,0,3,1,0,170,155,35032,27600,158,166,36670,26449
199,23,1,0,0,3,1,0,229,128,35033,27600,219,145,36673,26449
200,23,3,1,0,3,1,0,300,106,35036,27601,280,85,36676,26449
201,23,4,0,0,3,1,0,198,165,35040,27601,172,151,36679,26449
202,23,3,1,0,3,1,0,217,160,35043,27602,205,217,36682,26449
203,23,1,1,2,1,2,1,182,224,35044,27603,126,159,36683,26450
204,23,2,2,2,1,2,1,127,93,35046,27605,153,114,36684,26451
205,23,0,1,1,0,0,3,202,130,35046,27606,194,236,36684,26454
206,23,0,1,1,0,0,3,169,168,35046,27607,164,177,36684,26457
207,24,1,1,2,1,2,1,170,169,35047,27608,165,164,36685,26458
208,24,2,3,1,0,0,3,183,145,35049,27611,197,123,36685,26461
209,24,0,2,1,0,0,3,241,223,35049,27613,211,156,36685,26464
210,24,0,1,1,0,0,3,173,201,35049,27614,141,111,36685,26467
211,24,3,0,0,3,1,0,220,171,35052,27614,187,188,36688,26467
212,24,1,3,1,0,0,3,210,200,35053,27617,243,153,36688,26470
213,24,1,1,2,1,2,1,229,141,35054,27618,209,218,36689,26471
214,24,2,1,0,3,1,0,263,102,35056,27619,258,210,36692,26471
215,24,4,1,0,3,1,0,285,74,35060,27620,271,108,36695,26471
216,25,2,2,2,1,2,1,222,173,35062,27622,188,167,36696,26472
217,25,2,1,0,3,1,0,231,129,35064,27623,222,156,36699,26472
218,25,4,0,0,3,1,0,304,106,35068,27623,283,188,36702,26472
219,25,3,1,0,3,1,0,137,113,35071,27624,125,153,36705,26472
220,25,1,1,2,1,2,1,230,142,35072,27625,210,152,36706,26473
221,25,1,0,0,3,1,0,128,93,35073,27625,156,177,36709,26473
222,25,1,1,2,1,2,1,184,146,35074,27626,198,237,36710,26474
223,25,1,1,2,1,2,1,218,161,35075,27627,206,103,36711,26475
224,25,3,1,0,3,1,0,176,202,35078,27628,144,108,36714,26475
225,26,5,0,0,3,1,0,207,130,35083,27628,197,111,36717,26475
226,26,1,0,0,3,1,0,171,169,35084,27628,168,85,36720,26475
227,26,1,3,1,0,0,3,211,203,35085,27631,243,213,36720,26478
228,26,2,1,0,3,1,0,200,166,35087,27632,175,123,36723,26478
229,26,4,1,0,3,1,0,245,224,35091,27633,214,145,36726,26478
230,26,2,0,0,3,1,0,184,224,35093,27633,129,218,36729,26478
231,26,5,2,0,3,1,0,268,104,35098,27635,261,159,36732,26478
232,26,3,1,0,3,1,0,173,156,35101,27636,161,114,36735,26478
233,26,3,0,0,3,1,0,288,74,35104,27636,274,164,36738,26478
234,27,0,3,1,0,0,3,173,159,35104,27639,161,167,36738,26481
235,27,1,1,2,1,2,1,185,147,35105,27640,199,157,36739,26482
236,27,0,3,1,0,0,3,176,205,35105,27643,144,126,36739,26485
237,27,1,0,0,3,1,0,305,106,35106,27643,286,153,36742,26485
238,27,3,1,0,3,1,0,131,94,35109,27644,159,108,36745,26485
239,27,1,2,1,0,0,3,223,175,35110,27646,188,180,36745,26488
240,27,1,1,2,1,2,1,246,225,35111,27647,215,238,36746,26489
241,27,1,3,1,0,0,3,212,206,35112,27650,243,221,36746,26492
242,27,4,0,0,3,1,0,234,142,35116,27650,213,103,36749,26492
243,28,0,0,2,1,2,1,234,142,35116,27650,214,115,36750,26493
244,28,1,1,2,1,2,1,138,114,35117,27651,126,153,36751,26494
245,28,0,2,1,0,0,3,131,96,35117,27653,159,216,36751,26497
246,28,4,1,0,3,1,0,204,167,35121,27654,178,145,36754,26497
247,28,2,0,0,3,1,0,220,161,35123,27654,209,157,36757,26497
248,28,2,1,0,3,1,0,209,131,35125,27655,200,85,36760,26497
249,28,2,1,0,3,1,0,290,75,35127,27656,277,180,36763,26497
250,28,4,1,0,3,1,0,175,170,35131,27657,171,188,36766,26497
251,28,1,2,1,0,0,3,232,131,35132,27659,222,170,36766,26500
252,29,1,3,1,0,0,3,247,228,35133,27662,215,129,36766,26503
253,29,3,0,0,3,1,0,226,175,35136,27662,191,111,36769,26503
254,29,0,1,1,0,0,3,204,168,35136,27663,178,156,36769,26506
255,29,2,0,0,3,1,0,187,147,35138,27663,202,85,36772,26506
256,29,4,1,0,3,1,0,294,76,35142,27664,280,159,36775,26506
257,29,8,0,0,3,1,0,276,104,35150,27664,264,170,36778,26506
258,29,1,2,1,0,0,3,185,226,35151,27666,129,106,36778,26509
259,29,2,1,0,3,1,0,175,160,35153,27667,164,221,36781,26509
260,29,2,2,2,1,2,1,234,133,35155,27669,223,217,36782,26510
261,30,2,3,1,0,0,3,133,99,35157,27672,159,156,36782,26513
262,30,4,2,0,3,1,0,213,133,35161,27674,203,145,36785,26513
263,30,4,3,0,3,1,0,179,173,35165,27677,174,115,36788,26513
264,30,1,5,1,0,0,3,177,210,35166,27682,144,241,36788,26516
265,30,1,4,1,0,0,3,213,210,35167,27686,243,111,36788,26519
266,30,1,1,2,1,2,1,235,143,35168,27687,215,189,36789,26520
267,30,2,2,2,1,2,1,140,116,35170,27689,127,181,36790,26521
268,30,3,0,0,3,1,0,223,161,35173,27689,212,167,36793,26521
269,30,5,0,0,3,1,0,310,106,35178,27689,289,157,36796,26521
270,31,1,2,1,0,0,3,205,170,35179,27691,178,162,36796,26524
271,31,3,1,0,3,1,0,178,161,35182,27692,167,111,36799,26524
272,31,1,1,2,1,2,1,180,174,35183,27693,175,218,36800,26525
273,31,1,0,0,3,1,0,248,228,35184,27693,218,156,36803,26525
274,31,3,0,0,3,1,0,237,133,35187,27693,226,85,36806,26525
275,31,2,0,0,3,1,0,187,226,35189,27693,132,170,36809,26525
276,31,2,0,0,3,1,0,278,104,35191,27693,267,129,36812,26525
277,31,5,1,0,3,1,0,192,148,35196,27694,205,221,36815,26525
278,31,5,1,0,3,1,0,299,77,35201,27695,283,145,36818,26525
279,32,1,0,0,3,1,0,227,175,35202,27695,194,157,36821,26525
280,32,0,1,1,0,0,3,177,211,35202,27696,144,159,36821,26528
281,32,1,2,1,0,0,3,141,118,35203,27698,127,114,36821,26531
282,32,2,1,0,3,1,0,237,144,35205,27699,218,167,36824,26531
283,32,2,3,1,0,0,3,215,213,35207,27702,243,118,36824,26534
284,32,1,0,0,3,1,0,224,161,35208,27702,215,189,36827,26534
285,32,0,1,1,0,0,3,133,100,35208,27703,159,109,36827,26537
286,32,0,2,1,0,0,3,213,135,35208,27705,203,184,36827,26540
287,32,1,0,0,3,1,0,311,106,35209,27705,292,241,36830,26540
288,33,4,0,0,3,1,0,303,77,35213,27705,286,170,36833,26540
289,33,3,0,0,3,1,0,251,228,35216,27705,221,184,36836,26540
290,33,1,1,2,1,2,1,193,149,35217,27706,206,219,36837,26541
291,33,4,0,0,3,1,0,209,170,35221,27706,181,109,36840,26541
292,33,2,1,0,3,1,0,179,212,35223,27707,147,162,36843,26541
293,33,1,0,0,3,1,0,179,161,35224,27707,170,157,36846,26541
294,33,1,0,0,3,1,0,225,161,35225,27707,218,156,36849,26541
295,33,2,1,0,3,1,0,143,119,35227,27708,130,145,36852,26541
296,33,1,0,0,3,1,0,134,100,35228,27708,162,167,36855,26541
297,34,2,3,1,0,0,3,239,147,35230,27711,218,132,36855,26544
298,34,4,1,0,3,1,0,184,175,35234,27712,178,159,36858,26544
299,34,3,1,0,3,1,0,281,105,35237,27713,270,114,36861,26544
300,34,1,3,1,0,0,3,216,216,35238,27716,243,114,36861,26547
301,34,0,2,1,0,0,3,227,177,35238,27718,194,88,36861,26550
302,34,4,1,0,3,1,0,315,107,35242,27719,295,221,36864,26550
303,34,3,0,0,3,1,0,216,135,35245,27719,206,189,36867,26550
304,34,1,3,1,0,0,3,188,229,35246,27722,132,244,36867,26553
305,34,3,5,1,0,0,3,240,138,35249,27727,226,121,36867,26556
0,1,0,3,1,0,0,3,184,178,35249,27730,178,135,36867,26559
1,1,3,0,0,3,1,0,74,102,35252,27730,61,114,36870,26559
2,1,3,2,0,3,1,0,318,109,35255,27732,298,162,36873,26559
3,1,2,1,0,3,1,0,211,171,35257,27733,184,244,36876,26559
4,1,4,1,0,3,1,0,220,136,35261,27734,209,148,36879,26559
5,1,4,2,0,3,1,0,147,121,35265,27736,133,189,36882,26559
6,1,2,1,0,3,1,0,283,106,35267,27737,273,167,36885,26559
7,1,1,2,1,0,0,3,189,231,35268,27739,132,162,36885,26562
8,1,3,3,2,1,2,1,196,152,35271,27742,207,146,36886,26563
9,2,1,3,1,0,0,3,180,164,35272,27745,170,159,36886,26566
10,2,1,2,1,0,0,3,241,140,35273,27747,226,63,36886,26569
11,2,2,0,0,3,1,0,241,147,35275,27747,221,109,36889,26569
12,2,1,1,2,1,2,1,228,178,35276,27748,195,115,36890,26570
13,2,0,1,1,0,0,3,251,229,35276,27749,221,187,36890,26573
14,2,3,1,0,3,1,0,306,78,35279,27750,289,121,36893,26573
15,2,2,0,0,3,1,0,227,161,35281,27750,221,157,36896,26573
16,2,1,1,2,1,2,1,135,101,35282,27751,163,222,36897,26574
17,2,1,4,1,0,0,3,328,159,35283,27755,221,222,36897,26577
18,3,2,2,2,1,2,1,330,161,35285,27757,222,115,36898,26578
19,3,1,2,1,0,0,3,221,138,35286,27759,209,165,36898,26581
20,3,1,2,1,0,0,3,185,180,35287,27761,178,149,36898,26584
21,3,2,0,0,3,1,0,149,121,35289,27761,136,167,36901,26584
22,3,2,2,2,1,2,1,213,173,35291,27763,185,163,36902,26585
23,3,5,0,0,3,1,0,288,106,35296,27763,276,157,36905,26585
24,3,0,2,1,0,0,3,74,104,35296,27765,61,247,36905,26588
25,3,2,1,0,3,1,0,198,153,35298,27766,210,135,36908,26588
26,3,2,0,0,3,1,0,320,109,35300,27766,301,189,36911,26588
27,4,1,2,1,0,0,3,190,233,35301,27768,132,112,36911,26591
28,4,2,4,1,0,0,3,215,177,35303,27772,185,190,36911,26594
29,4,3,0,0,3,1,0,309,78,35306,27772,292,222,36914,26594
30,4,0,3,1,0,0,3,251,232,35306,27775,221,162,36914,26597
31,4,2,0,0,3,1,0,230,178,35308,27775,198,222,36917,26597
32,4,2,0,0,3,1,0,229,161,35310,27775,224,189,36920,26597
33,4,1,0,0,3,1,0,136,101,35311,27775,166,167,36923,26597
34,4,2,1,0,3,1,0,243,148,35313,27776,224,148,36926,26597
35,4,1,1,2,1,2,1,199,154,35314,27777,211,64,36927,26598
36,5,0,2,1,0,0,3,136,103,35314,27779,166,168,36927,26601
37,5,1,2,1,0,0,3,252,234,35315,27781,221,152,36927,26604
38,5,1,3,1,0,0,3,181,167,35316,27784,170,160,36927,26607
39,5,2,1,0,3,1,0,332,162,35318,27785,225,121,36930,26607
40,5,2,1,0,3,1,0,151,122,35320,27786,139,115,36933,26607
41,5,1,1,2,1,2,1,186,181,35321,27787,179,248,36934,26608
42,5,4,0,0,3,1,0,245,140,35325,27787,229,135,36937,26608
43,5,1,1,2,1,2,1,222,139,35326,27788,210,65,36938,26609
44,5,1,0,0,3,1,0,321,109,35327,27788,304,190,36941,26609
45,6,1,2,1,0,0,3,191,235,35328,27790,132,155,36941,26612
46,6,0,2,1,0,0,3,288,108,35328,27792,276,151,36941,26615
47,6,2,1,0,3,1,0,217,178,35330,27793,188,189,36944,26615
48,6,1,0,0,3,1,0,187,181,35331,27793,182,115,36947,26615
49,6,1,7,1,0,0,3,230,168,35332,27800,224,225,36947,26618
50,6,1,2,1,0,0,3,310,80,35333,27802,292,165,36947,26621
51,6,1,1,2,1,2,1,75,105,35334,27803,62,223,36948,26622
52,6,1,0,0,3,1,0,200,154,35335,27803,214,167,36951,26622
53,6,0,2,1,0,0,3,243,150,35335,27805,224,166,36951,26625
54,7,2,1,0,3,1,0,247,141,35337,27806,232,115,36954,26625
55,7,0,1,1,0,0,3,332,163,35337,27807,225,115,36954,26628
56,7,3,2,0,3,1,0,154,124,35340,27809,142,121,36957,26628
57,7,4,0,0,3,1,0,325,109,35344,27809,307,160,36960,26628
58,7,0,2,1,0,0,3,252,236,35344,27811,221,68,36960,26631
59,7,0,4,1,0,0,3,243,154,35344,27815,224,193,36960,26634
60,7,0,4,1,0,0,3,230,182,35344,27819,198,251,36960,26637
61,7,1,1,2,1,2,1,223,140,35345,27820,211,136,36961,26638
62,7,1,2,1,0,0,3,137,105,35346,27822,166,192,36961,26641
63,8,1,0,0,3,1,0,182,167,35347,27822,173,151,36964,26641
64,8,4,0,0,3,1,0,314,80,35351,27822,295,115,36967,26641
65,8,0,0,2,1,2,1,288,108,35351,27822,277,224,36968,26642
66,8,3,1,0,3,1,0,233,169,35354,27823,227,155,36971,26642
67,8,1,1,2,1,2,1,218,179,35355,27824,189,166,36972,26643
68,8,3,1,0,3,1,0,194,236,35358,27825,135,167,36975,26643
69,8,2,5,1,0,0,3,77,110,35360,27830,62,228,36975,26646
70,8,1,1,2,1,2,1,201,155,35361,27831,215,169,36976,26647
71,8,1,2,1,0,0,3,188,183,35362,27833,182,169,36976,26650
72,9,0,1,1,0,0,3,201,156,35362,27834,215,163,36976,26653
73,9,0,2,1,0,0,3,332,165,35362,27836,225,227,36976,26656
74,9,1,1,2,1,2,1,253,237,35363,27837,222,116,36977,26657
75,9,0,2,1,0,0,3,77,112,35363,27839,62,118,36977,26660
76,9,3,0,0,3,1,0,250,141,35366,27839,235,192,36980,26660
77,9,3,0,0,3,1,0,328,109,35369,27839,310,115,36983,26660
78,9,1,4,1,0,0,3,289,112,35370,27843,277,254,36983,26663
79,9,3,0,0,3,1,0,246,154,35373,27843,227,136,36986,26663
80,9,0,4,1,0,0,3,230,186,35373,27847,198,169,36986,26666
81,10,1,3,1,0,0,3,251,144,35374,27850,235,172,36986,26669
82,10,3,0,0,3,1,0,221,179,35377,27850,192,68,36989,26669
83,10,1,1,2,1,2,1,183,168,35378,27851,174,194,36990,26670
84,10,1,3,1,0,0,3,195,239,35379,27854,135,257,36990,26673
85,10,2,0,0,3,1,0,156,124,35381,27854,145,118,36993,26673
86,10,2,4,1,0,0,3,225,144,35383,27858,211,231,36993,26676
87,10,2,2,2,1,2,1,235,171,35385,27860,228,152,36994,26677
88,10,2,1,0,3,1,0,139,106,35387,27861,169,121,36997,26677
89,10,1,2,1,0,0,3,231,188,35388,27863,198,172,36997,26680
90,11,0,0,2,1,2,1,139,106,35388,27863,170,156,36998,26681
91,11,3,2,0,3,1,0,249,156,35391,27865,230,163,37001,26681
92,11,1,0,0,3,1,0,254,237,35392,27865,225,192,37004,26681
93,11,2,1,0,3,1,0,223,180,35394,27866,195,121,37007,26681
94,11,0,0,2,1,2,1,77,112,35394,27866,63,153,37008,26682
95,11,2,2,2,1,2,1,190,185,35396,27868,183,195,37009,26683
96,11,1,2,1,0,0,3,315,82,35397,27870,295,139,37009,26686
97,11,0,0,2,1,2,1,225,144,35397,27870,212,228,37010,26687
98,11,4,3,0,3,1,0,332,112,35401,27873,313,167,37013,26687
99,12,0,4,1,0,0,3,251,148,35401,27877,235,159,37013,26690
100,12,1,1,2,1,2,1,290,113,35402,27878,278,69,37014,26691
101,12,0,8,1,0,0,3,332,173,35402,27886,225,260,37014,26694
102,12,2,2,2,1,2,1,197,241,35404,27888,136,117,37015,26695
103,12,4,1,0,3,1,0,194,186,35408,27889,186,115,37018,26695
104,12,0,1,1,0,0,3,156,125,35408,27890,145,234,37018,26698
105,12,3,1,0,3,1,0,238,172,35411,27891,231,172,37021,26698
106,12,4,2,0,3,1,0,205,158,35415,27893,218,169,37024,26698
107,12,0,1,1,0,0,3,183,169,35415,27894,174,175,37024,26701
108,13,2,0,0,3,1,0,251,156,35417,27894,233,167,37027,26701
109,13,3,3,2,1,2,1,80,115,35420,27897,64,164,37028,26702
110,13,2,1,0,3,1,0,225,181,35422,27898,198,153,37031,26702
111,13,0,2,1,0,0,3,205,160,35422,27900,218,198,37031,26705
112,13,1,2,1,0,0,3,232,190,35423,27902,198,231,37031,26708
113,13,5,1,0,3,1,0,320,83,35428,27903,298,192,37034,26708
114,13,1,2,1,0,0,3,255,239,35429,27905,225,237,37034,26711
115,13,1,3,1,0,0,3,140,109,35430,27908,170,142,37034,26714
116,13,2,0,0,3,1,0,227,144,35432,27908,215,118,37037,26714
117,14,1,1,2,1,2,1,157,126,35433,27909,146,143,37038,26715
118,14,0,3,1,0,0,3,194,189,35433,27912,186,124,37038,26718
119,14,3,3,2,1,2,1,254,151,35436,27915,236,261,37039,26719
120,14,1,0,0,3,1,0,291,113,35437,27915,281,169,37042,26719
121,14,3,1,0,3,1,0,200,242,35440,27916,139,115,37045,26719
122,14,0,2,1,0,0,3,80,117,35440,27918,64,178,37045,26722
123,14,1,0,0,3,1,0,333,112,35441,27918,316,117,37048,26722
124,14,2,1,0,3,1,0,185,170,35443,27919,177,159,37051,26722
125,14,3,1,0,3,1,0,335,174,35446,27920,228,172,37054,26722
126,15,1,1,2,1,2,1,201,243,35447,27921,140,154,37055,26723
127,15,2,2,2,1,2,1,234,192,35449,27923,199,70,37056,26724
128,15,5,0,0,3,1,0,256,156,35454,27923,236,115,37059,26724
129,15,1,2,1,0,0,3,256,241,35455,27925,225,234,37059,26727
130,15,2,3,1,0,0,3,256,154,35457,27928,236,121,37059,26730
131,15,2,2,2,1,2,1,187,172,35459,27930,178,125,37060,26731
132,15,3,0,0,3,1,0,323,83,35462,27930,301,237,37063,26731
133,15,0,1,1,0,0,3,140,110,35462,27931,170,172,37063,26734
134,15,1,1,2,1,2,1,239,173,35463,27932,232,199,37064,26735
135,16,1,2,1,0,0,3,336,176,35464,27934,228,170,37064,26738
136,16,1,1,2,1,2,1,158,127,35465,27935,147,179,37065,26739
137,16,2,2,2,1,2,1,229,146,35467,27937,216,165,37066,26740
138,16,3,3,2,1,2,1,208,163,35470,27940,219,238,37067,26741
139,16,0,1,1,0,0,3,80,118,35470,27941,64,146,37067,26744
140,16,1,1,2,1,2,1,292,114,35471,27942,282,160,37068,26745
141,16,3,2,0,3,1,0,197,191,35474,27944,189,192,37071,26745
142,16,3,2,0,3,1,0,228,183,35477,27946,201,117,37074,26745
143,16,3,1,0,3,1,0,326,84,35480,27947,304,172,37077,26745
144,17,1,0,0,3,1,0,235,192,35481,27947,202,154,37080,26745
145,17,2,3,1,0,0,3,203,246,35483,27950,140,237,37080,26748
146,17,3,0,0,3,1,0,336,112,35486,27950,319,121,37083,26748
147,17,1,1,2,1,2,1,257,155,35487,27951,237,173,37084,26749
148,17,0,1,1,0,0,3,187,173,35487,27952,178,73,37084,26752
149,17,0,7,1,0,0,3,140,117,35487,27959,170,202,37084,26755
150,17,1,2,1,0,0,3,257,158,35488,27961,236,264,37084,26758
151,17,1,1,2,1,2,1,240,174,35489,27962,233,116,37085,26759
152,17,2,0,0,3,1,0,258,241,35491,27962,228,125,37088,26759
153,18,4,0,0,3,1,0,201,191,35495,27962,192,237,37091,26759
154,18,3,1,0,3,1,0,339,177,35498,27963,231,146,37094,26759
155,18,3,1,0,3,1,0,260,159,35501,27964,239,160,37097,26759
156,18,2,1,0,3,1,0,338,113,35503,27965,322,173,37100,26759
157,18,0,0,2,1,2,1,258,241,35503,27965,229,171,37101,26760
158,18,4,0,0,3,1,0,212,163,35507,27965,222,117,37104,26760
159,18,3,1,0,3,1,0,83,119,35510,27966,67,116,37107,26760
160,18,3,1,0,3,1,0,329,85,35513,27967,307,165,37110,26760
161,18,5,1,0,3,1,0,297,115,35518,27968,285,192,37113,26760
162,19,1,1,2,1,2,1,241,175,35519,27969,234,180,37114,26761
163,19,1,1,2,1,2,1,188,174,35520,27970,179,172,37115,26762
164,19,1,0,0,3,1,0,159,127,35521,27970,150,154,37118,26762
165,19,1,1,2,1,2,1,202,192,35522,27971,193,74,37119,26763
166,19,1,1,2,1,2,1,230,147,35523,27972,217,161,37120,26764
167,19,2,3,1,0,0,3,142,120,35525,27975,170,175,37120,26767
168,19,1,1,2,1,2,1,204,247,35526,27976,141,126,37121,26768
169,19,2,0,0,3,1,0,331,85,35528,27976,310,202,37124,26768
170,19,1,2,1,0,0,3,229,185,35529,27978,201,241,37124,26771
171,20,2,1,0,3,1,0,237,193,35531,27979,205,117,37127,26771
172,20,3,3,2,1,2,1,215,166,35534,27982,223,117,37128,26772
173,20,0,2,1,0,0,3,257,157,35534,27984,237,244,37128,26775
174,20,1,2,1,0,0,3,160,129,35535,27986,150,176,37128,26778
175,20,0,1,1,0,0,3,339,178,35535,27987,231,77,37128,26781
176,20,0,0,2,1,2,1,241,175,35535,27987,235,265,37129,26782
177,20,3,1,0,3,1,0,300,116,35538,27988,288,121,37132,26782
178,20,2,1,0,3,1,0,190,175,35540,27989,182,175,37135,26782
179,20,0,2,1,0,0,3,204,249,35540,27991,141,183,37135,26785
180,21,2,0,0,3,1,0,232,147,35542,27991,220,126,37138,26785
181,21,1,0,0,3,1,0,238,193,35543,27991,208,172,37141,26785
182,21,4,0,0,3,1,0,342,113,35547,27991,325,237,37144,26785
183,21,1,1,2,1,2,1,230,186,35548,27992,202,122,37145,26786
184,21,2,2,2,1,2,1,260,243,35550,27994,230,147,37146,26787
185,21,2,2,2,1,2,1,262,161,35552,27996,240,193,37147,26788
186,21,1,0,0,3,1,0,143,120,35553,27996,173,165,37150,26788
187,21,1,0,0,3,1,0,84,119,35554,27996,70,202,37153,26788
188,21,3,1,0,3,1,0,334,86,35557,27997,313,154,37156,26788
189,22,3,2,0,3,1,0,163,131,35560,27999,153,161,37159,26788
190,22,0,4,1,0,0,3,257,161,35560,28003,237,186,37159,26791
191,22,1,0,0,3,1,0,242,175,35561,28003,238,117,37162,26791
192,22,1,0,0,3,1,0,343,113,35562,28003,328,175,37165,26791
193,22,3,0,0,3,1,0,207,249,35565,28003,144,77,37168,26791
194,22,6,1,0,3,1,0,345,179,35571,28004,234,117,37171,26791
195,22,2,4,1,0,0,3,192,179,35573,28008,182,268,37171,26794
196,22,1,0,0,3,1,0,203,192,35574,28008,196,176,37174,26794
197,22,3,0,0,3,1,0,303,116,35577,28008,291,126,37177,26794
198,23,1,0,0,3,1,0,231,186,35578,28008,205,165,37180,26794
199,23,2,1,0,3,1,0,244,176,35580,28009,241,237,37183,26794
200,23,1,2,1,0,0,3,144,122,35581,28011,173,247,37183,26797
201,23,1,1,2,1,2,1,239,194,35582,28012,209,194,37184,26798
202,23,0,0,2,1,2,1,262,161,35582,28012,241,78,37185,26799
203,23,2,1,0,3,1,0,336,87,35584,28013,316,172,37188,26799
204,23,3,1,0,3,1,0,235,148,35587,28014,223,202,37191,26799
205,23,0,0,2,1,2,1,260,243,35587,28014,231,155,37192,26800
206,23,0,0,2,1,2,1,215,166,35587,28014,224,123,37193,26801
207,24,1,1,2,1,2,1,85,120,35588,28015,71,127,37194,26802
208,24,1,2,1,0,0,3,236,150,35589,28017,223,178,37194,26805
209,24,1,3,1,0,0,3,346,182,35590,28020,234,189,37194,26808
210,24,2,2,2,1,2,1,345,115,35592,28022,329,162,37195,26809
211,24,2,1,0,3,1,0,205,193,35594,28023,199,165,37198,26809
212,24,1,4,1,0,0,3,193,183,35595,28027,182,150,37198,26812
213,24,1,0,0,3,1,0,304,116,35596,28027,294,117,37201,26812
214,24,1,1,2,1,2,1,258,162,35597,28028,238,118,37202,26813
215,24,0,1,1,0,0,3,163,132,35597,28029,153,271,37202,26816
216,25,1,1,2,1,2,1,216,167,35598,28030,225,156,37203,26817
217,25,2,1,0,3,1,0,264,162,35600,28031,244,118,37206,26817
218,25,0,1,1,0,0,3,239,195,35600,28032,209,181,37206,26820
219,25,2,1,0,3,1,0,233,187,35602,28033,208,237,37209,26820
220,25,2,2,2,1,2,1,87,122,35604,28035,72,177,37210,26821
221,25,0,0,2,1,2,1,336,87,35604,28035,317,124,37211,26822
222,25,1,3,1,0,0,3,305,119,35605,28038,294,250,37211,26825
223,25,1,0,0,3,1,0,208,249,35606,28038,147,194,37214,26825
224,25,3,1,0,3,1,0,247,177,35609,28039,244,172,37217,26825
225,26,0,3,1,0,0,3,193,186,35609,28042,182,120,37217,26828
226,26,3,0,0,3,1,0,348,115,35612,28042,332,150,37220,26828
227,26,1,2,1,0,0,3,261,245,35613,28044,231,192,37220,26831
228,26,2,0,0,3,1,0,241,195,35615,28044,212,165,37223,26831
229,26,2,1,0,3,1,0,348,183,35617,28045,237,202,37226,26831
230,26,1,1,2,1,2,1,164,133,35618,28046,154,79,37227,26832
231,26,2,1,0,3,1,0,146,123,35620,28047,176,124,37230,26832
232,26,3,2,0,3,1,0,239,152,35623,28049,226,271,37233,26832
233,26,1,1,2,1,2,1,259,163,35624,28050,239,128,37234,26833
234,27,2,1,0,3,1,0,235,188,35626,28051,211,172,37237,26833
235,27,0,2,1,0,0,3,205,195,35626,28053,199,159,37237,26836
236,27,2,3,1,0,0,3,89,125,35628,28056,72,184,37237,26839
237,27,5,0,0,3,1,0,213,249,35633,28056,150,250,37240,26839
238,27,0,2,1,0,0,3,193,188,35633,28058,182,121,37240,26842
239,27,2,0,0,3,1,0,218,167,35635,28058,228,237,37243,26842
240,27,5,1,0,3,1,0,252,178,35640,28059,247,177,37246,26842
241,27,4,1,0,3,1,0,340,88,35644,28060,320,162,37249,26842
242,27,2,1,0,3,1,0,307,120,35646,28061,297,192,37252,26842
243,28,1,2,1,0,0,3,262,247,35647,28063,231,127,37252,26845
244,28,2,2,2,1,2,1,261,165,35649,28065,240,166,37253,26846
245,28,3,0,0,3,1,0,351,115,35652,28065,335,79,37256,26846
246,28,0,0,2,1,2,1,239,152,35652,28065,227,121,37257,26847
247,28,2,2,2,1,2,1,243,197,35654,28067,213,151,37258,26848
248,28,3,2,0,3,1,0,267,164,35657,28069,247,128,37261,26848
249,28,2,5,1,0,0,3,148,128,35659,28074,176,274,37261,26851
250,28,0,1,1,0,0,3,348,184,35659,28075,237,197,37261,26854
251,28,3,4,1,0,0,3,167,137,35662,28079,154,205,37261,26857
252,29,2,0,0,3,1,0,169,137,35664,28079,157,121,37264,26857
253,29,0,3,1,0,0,3,239,155,35664,28082,227,200,37264,26860
254,29,5,1,0,3,1,0,356,116,35669,28083,338,159,37267,26860
255,29,3,2,0,3,1,0,216,251,35672,28085,153,151,37270,26860
256,29,0,3,1,0,0,3,205,198,35672,28088,199,195,37270,26863
257,29,0,0,2,1,2,1,89,125,35672,28088,73,173,37271,26864
258,29,1,2,1,0,0,3,236,190,35673,28090,211,165,37271,26867
259,29,1,2,1,0,0,3,219,169,35674,28092,228,277,37271,26870
260,29,5,0,0,3,1,0,312,120,35679,28092,300,184,37274,26870
261,30,2,1,0,3,1,0,264,248,35681,28093,234,166,37277,26870
262,30,1,0,0,3,1,0,349,184,35682,28093,240,177,37280,26870
263,30,3,2,0,3,1,0,196,190,35685,28095,185,237,37283,26870
264,30,2,3,1,0,0,3,269,167,35687,28098,247,253,37283,26873
265,30,3,2,0,3,1,0,151,130,35690,28100,179,79,37286,26873
266,30,3,3,2,1,2,1,255,181,35693,28103,248,128,37287,26874
267,30,1,3,1,0,0,3,262,168,35694,28106,240,208,37287,26877
268,30,1,1,2,1,2,1,244,198,35695,28107,214,129,37288,26878
269,30,1,0,0,3,1,0,341,88,35696,28107,323,121,37291,26878
270,31,0,3,1,0,0,3,236,193,35696,28110,211,198,37291,26881
271,31,2,1,0,3,1,0,207,199,35698,28111,202,173,37294,26881
272,31,7,0,0,3,1,0,246,155,35705,28111,230,121,37297,26881
273,31,0,2,1,0,0,3,89,127,35705,28113,73,168,37297,26884
274,31,1,1,2,1,2,1,170,138,35706,28114,158,185,37298,26885
275,31,1,2,1,0,0,3,350,186,35707,28116,240,169,37298,26888
276,31,3,1,0,3,1,0,315,121,35710,28117,303,151,37301,26888
277,31,2,1,0,3,1,0,221,170,35712,28118,231,200,37304,26888
278,31,3,0,0,3,1,0,359,116,35715,28118,341,277,37307,26888
279,32,2,0,0,3,1,0,264,168,35717,28118,243,237,37310,26888
280,32,2,0,0,3,1,0,246,198,35719,28118,217,128,37313,26888
281,32,4,3,0,3,1,0,273,170,35723,28121,250,177,37316,26888
282,32,2,2,2,1,2,1,198,192,35725,28123,186,254,37317,26889
283,32,2,2,2,1,2,1,266,250,35727,28125,235,122,37318,26890
284,32,2,1,0,3,1,0,153,131,35729,28126,182,159,37321,26890
285,32,1,5,1,0,0,3,217,256,35730,28131,153,211,37321,26893
286,32,1,1,2,1,2,1,256,182,35731,28132,249,130,37322,26894
287,32,4,1,0,3,1,0,345,89,35735,28133,326,79,37325,26894
288,33,3,1,0,3,1,0,318,122,35738,28134,306,121,37328,26894
289,33,3,0,0,3,1,0,353,186,35741,28134,243,168,37331,26894
290,33,0,1,1,0,0,3,170,139,35741,28135,158,172,37331,26897
291,33,3,0,0,3,1,0,348,89,35744,28135,329,198,37334,26897
292,33,5,0,0,3,1,0,251,155,35749,28135,233,173,37337,26897
293,33,1,4,1,0,0,3,90,131,35750,28139,73,203,37337,26900
294,33,3,3,2,1,2,1,210,202,35753,28142,203,255,37338,26901
295,33,4,0,0,3,1,0,225,170,35757,28142,234,185,37341,26901
296,33,2,2,2,1,2,1,238,195,35759,28144,212,152,37342,26902
297,34,2,3,1,0,0,3,248,201,35761,28147,217,214,37342,26905
298,34,1,0,0,3,1,0,257,182,35762,28147,252,79,37345,26905
299,34,2,5,1,0,0,3,155,136,35764,28152,182,125,37345,26908
300,34,6,0,0,3,1,0,279,170,35770,28152,253,237,37348,26908
301,34,2,2,2,1,2,1,219,258,35772,28154,154,178,37349,26909
302,34,0,0,2,1,2,1,359,116,35772,28154,342,131,37350,26910
303,34,1,2,1,0,0,3,267,252,35773,28156,235,280,37350,26913
304,34,2,3,1,0,0,3,200,195,35775,28159,186,131,37350,26916
305,34,1,1,2,1,2,1,265,169,35776,28160,244,160,37351,26917
0,1,2,3,1,0,0,3,172,142,35778,28163,158,171,37351,26920
1,1,0,1,1,0,0,3,219,259,35778,28164,154,82,37351,26923
2,1,1,1,2,1,2,1,349,90,35779,28165,330,126,37352,26924
3,1,4,0,0,3,1,0,363,116,35783,28165,345,152,37355,26924
4,1,1,1,2,1,2,1,268,253,35784,28166,236,1,37356,26925
5,1,1,2,1,0,0,3,211,204,35785,28168,203,3,37356,26928
6,1,2,0,0,3,1,0,328,157,35787,28168,347,214,37359,26928
7,1,5,1,0,3,1,0,256,156,35792,28169,236,131,37362,26928
8,1,5,0,0,3,1,0,284,170,35797,28169,256,160,37365,26928
9,2,0,1,1,0,0,3,225,171,35797,28170,234,175,37365,26931
10,2,3,0,0,3,1,0,356,186,35800,28170,246,32,37368,26931
11,2,0,1,1,0,0,3,90,132,35800,28171,73,283,37368,26934
12,2,1,2,1,0,0,3,77,2,35801,28173,114,258,37368,26937
13,2,4,2,0,3,1,0,242,197,35805,28175,215,131,37371,26937
14,2,2,0,0,3,1,0,259,182,35807,28175,255,237,37374,26937
15,2,3,0,0,3,1,0,321,122,35810,28175,309,185,37377,26937
16,2,1,4,1,0,0,3,111,216,35811,28179,72,201,37377,26940
17,2,1,1,2,1,2,1,249,202,35812,28180,218,179,37378,26941
18,3,3,1,0,3,1,0,214,205,35815,28181,206,1,37381,26941
19,3,5,0,0,3,1,0,354,90,35820,28181,333,3,37384,26941
20,3,0,1,1,0,0,3,328,158,35820,28182,347,134,37384,26944
21,3,0,2,1,0,0,3,356,188,35820,28184,246,188,37384,26947
22,3,1,2,1,0,0,3,173,144,35821,28186,158,261,37384,26950
23,3,5,0,0,3,1,0,224,259,35826,28186,157,126,37387,26950
24,3,3,5,1,0,0,3,252,207,35829,28191,218,217,37387,26953
25,3,1,1,2,1,2,1,260,183,35830,28192,256,83,37388,26954
26,3,0,0,2,1,2,1,284,170,35830,28192,257,180,37389,26955
27,4,1,1,2,1,2,1,112,217,35831,28193,73,33,37390,26956
28,4,1,1,2,1,2,1,91,133,35832,28194,74,172,37391,26957
29,4,6,1,0,3,1,0,369,117,35838,28195,348,175,37394,26957
30,4,2,4,1,0,0,3,270,257,35840,28199,236,134,37394,26960
31,4,1,1,2,1,2,1,78,3,35841,28200,115,153,37395,26961
32,4,0,1,1,0,0,3,225,172,35841,28201,234,240,37395,26964
33,4,3,2,0,3,1,0,245,199,35844,28203,218,201,37398,26964
34,4,0,4,1,0,0,3,256,160,35844,28207,236,286,37398,26967
35,4,4,2,0,3,1,0,325,124,35848,28209,312,160,37401,26967
36,5,1,2,1,0,0,3,329,160,35849,28211,347,86,37401,26970
37,5,0,7,1,0,0,3,214,212,35849,28218,206,264,37401,26973
38,5,2,2,2,1,2,1,226,261,35851,28220,158,189,37402,26974
39,5,3,0,0,3,1,0,357,90,35854,28220,336,134,37405,26974
40,5,1,1,2,1,2,1,285,171,35855,28221,258,218,37406,26975
41,5,3,5,1,0,0,3,255,212,35858,28226,218,129,37406,26978
42,5,1,2,1,0,0,3,261,185,35859,28228,256,6,37406,26981
43,5,2,3,1,0,0,3,358,191,35861,28231,246,4,37406,26984
44,5,0,2,1,0,0,3,173,146,35861,28233,158,183,37406,26987
45,6,4,0,0,3,1,0,249,199,35865,28233,221,33,37409,26987
46,6,4,4,2,1,2,1,82,7,35869,28237,116,176,37410,26988
47,6,3,3,2,1,2,1,273,260,35872,28240,237,173,37411,26989
48,6,3,0,0,3,1,0,94,133,35875,28240,77,160,37414,26989
49,6,1,1,2,1,2,1,257,161,35876,28241,237,135,37415,26990
50,6,1,0,0,3,1,0,326,124,35877,28241,315,153,37418,26990
51,6,0,1,1,0,0,3,112,218,35877,28242,73,243,37418,26993
52,6,1,3,1,0,0,3,226,175,35878,28245,234,204,37418,26996
53,6,3,0,0,3,1,0,372,117,35881,28245,351,286,37421,26996
54,7,1,1,2,1,2,1,256,213,35882,28246,219,136,37422,26997
55,7,0,2,1,0,0,3,358,193,35882,28248,246,267,37422,27000
56,7,0,2,1,0,0,3,82,9,35882,28250,116,289,37422,27003
57,7,1,0,0,3,1,0,274,260,35883,28250,240,86,37425,27003
58,7,2,1,0,3,1,0,251,200,35885,28251,224,6,37428,27003
59,7,2,1,0,3,1,0,331,161,35887,28252,350,176,37431,27003
60,7,2,2,2,1,2,1,287,173,35889,28254,259,244,37432,27004
61,7,1,1,2,1,2,1,227,176,35890,28255,235,154,37433,27005
62,7,2,1,0,3,1,0,328,125,35892,28256,318,183,37436,27005
63,8,2,1,0,3,1,0,263,186,35894,28257,259,160,37439,27005
64,8,1,0,0,3,1,0,215,212,35895,28257,209,134,37442,27005
65,8,2,0,0,3,1,0,175,146,35897,28257,161,189,37445,27005
66,8,4,0,0,3,1,0,376,117,35901,28257,354,86,37448,27005
67,8,0,5,1,0,0,3,331,166,35901,28262,350,176,37448,27008
68,8,3,3,2,1,2,1,115,221,35904,28265,74,5,37449,27009
69,8,1,1,2,1,2,1,227,262,35905,28266,159,219,37450,27010
70,8,4,0,0,3,1,0,261,161,35909,28266,240,129,37453,27010
71,8,5,0,0,3,1,0,362,90,35914,28266,339,204,37456,27010
72,9,6,0,0,3,1,0,382,117,35920,28266,357,6,37459,27010
73,9,2,0,0,3,1,0,276,260,35922,28266,243,183,37462,27010
74,9,0,4,1,0,0,3,256,217,35922,28270,219,292,37462,27013
75,9,2,1,0,3,1,0,265,187,35924,28271,262,204,37465,27013
76,9,2,2,2,1,2,1,360,195,35926,28273,247,177,37466,27014
77,9,4,1,0,3,1,0,255,201,35930,28274,227,134,37469,27014
78,9,3,0,0,3,1,0,331,125,35933,28274,321,244,37472,27014
79,9,2,0,0,3,1,0,96,133,35935,28274,80,136,37475,27014
80,9,3,1,0,3,1,0,85,10,35938,28275,119,33,37478,27014
81,10,1,1,2,1,2,1,116,222,35939,28276,75,87,37479,27015
82,10,1,1,2,1,2,1,216,213,35940,28277,210,161,37480,27016
83,10,4,1,0,3,1,0,335,167,35944,28278,353,189,37483,27016
84,10,1,2,1,0,0,3,228,178,35945,28280,235,270,37483,27019
85,10,1,1,2,1,2,1,176,147,35946,28281,162,130,37484,27020
86,10,2,1,0,3,1,0,263,162,35948,28282,243,5,37487,27020
87,10,0,1,1,0,0,3,227,263,35948,28283,159,157,37487,27023
88,10,3,0,0,3,1,0,365,90,35951,28283,342,219,37490,27023
89,10,2,3,1,0,0,3,289,176,35953,28286,259,179,37490,27026
90,11,2,4,1,0,0,3,278,264,35955,28290,243,137,37490,27029
91,11,2,1,0,3,1,0,362,196,35957,28291,250,130,37493,27029
92,11,1,0,0,3,1,0,383,117,35958,28291,360,183,37496,27029
93,11,2,0,0,3,1,0,367,90,35960,28291,345,177,37499,27029
94,11,1,0,0,3,1,0,290,176,35961,28291,262,33,37502,27029
95,11,1,1,2,1,2,1,257,218,35962,28292,220,7,37503,27030
96,11,3,0,0,3,1,0,268,187,35965,28292,265,136,37506,27030
97,11,3,0,0,3,1,0,88,10,35968,28292,122,244,37509,27030
98,11,4,1,0,3,1,0,335,126,35972,28293,324,87,37512,27030
99,12,2,3,1,0,0,3,178,150,35974,28296,162,180,37512,27033
100,12,2,0,0,3,1,0,118,222,35976,28296,78,161,37515,27033
101,12,1,4,1,0,0,3,336,171,35977,28300,353,273,37515,27036
102,12,2,1,0,3,1,0,265,163,35979,28301,246,157,37518,27036
103,12,3,2,0,3,1,0,99,135,35982,28303,83,5,37521,27036
104,12,2,0,0,3,1,0,230,178,35984,28303,238,179,37524,27036
105,12,1,7,1,0,0,3,279,271,35985,28310,243,295,37524,27039
106,12,0,1,1,0,0,3,216,214,35985,28311,210,207,37524,27042
107,12,0,2,1,0,0,3,255,203,35985,28313,227,222,37524,27045
108,13,2,3,1,0,0,3,180,153,35987,28316,162,139,37524,27048
109,13,0,3,1,0,0,3,362,199,35987,28319,250,298,37524,27051
110,13,3,0,0,3,1,0,386,117,35990,28319,363,179,37527,27051
111,13,3,0,0,3,1,0,91,10,35993,28319,125,130,37530,27051
112,13,1,2,1,0,0,3,119,224,35994,28321,78,192,37530,27054
113,13,5,0,0,3,1,0,273,187,35999,28321,268,33,37533,27054
114,13,1,0,0,3,1,0,336,126,36000,28321,327,137,37536,27054
115,13,1,3,1,0,0,3,228,266,36001,28324,159,186,37536,27057
116,13,2,2,2,1,2,1,101,137,36003,28326,84,208,37537,27058
117,14,3,3,2,1,2,1,282,274,36006,28329,244,158,37538,27059
118,14,1,1,2,1,2,1,266,164,36007,28330,247,8,37539,27060
119,14,0,2,1,0,0,3,290,178,36007,28332,262,183,37539,27063
120,14,0,2,1,0,0,3,336,173,36007,28334,353,247,37539,27066
121,14,3,1,0,3,1,0,260,219,36010,28335,223,5,37542,27066
122,14,5,1,0,3,1,0,372,91,36015,28336,348,139,37545,27066
123,14,2,1,0,3,1,0,338,127,36017,28337,330,273,37548,27066
124,14,4,1,0,3,1,0,259,204,36021,28338,230,87,37551,27066
125,14,5,2,0,3,1,0,235,180,36026,28340,241,161,37554,27066
126,15,0,3,1,0,0,3,91,13,36026,28343,125,211,37554,27069
127,15,6,0,0,3,1,0,392,117,36032,28343,366,192,37557,27069
128,15,1,5,1,0,0,3,229,271,36033,28348,159,182,37557,27072
129,15,1,4,1,0,0,3,181,157,36034,28352,162,301,37557,27075
130,15,0,0,2,1,2,1,216,214,36034,28352,211,34,37558,27076
131,15,3,1,0,3,1,0,276,188,36037,28353,271,130,37561,27076
132,15,0,0,2,1,2,1,101,137,36037,28353,85,138,37562,27077
133,15,1,4,1,0,0,3,120,228,36038,28357,78,225,37562,27080
134,15,2,1,0,3,1,0,364,200,36040,28358,253,186,37565,27080
135,16,0,3,1,0,0,3,229,274,36040,28361,159,142,37565,27083
136,16,0,0,2,1,2,1,181,157,36040,28361,163,162,37566,27084
137,16,2,1,0,3,1,0,292,179,36042,28362,265,192,37569,27084
138,16,0,4,1,0,0,3,259,208,36042,28366,230,276,37569,27087
139,16,2,1,0,3,1,0,268,165,36044,28367,250,87,37572,27087
140,16,2,3,1,0,0,3,262,222,36046,28370,223,161,37572,27090
141,16,8,0,0,3,1,0,380,91,36054,28370,351,34,37575,27090
142,16,1,2,1,0,0,3,236,182,36055,28372,241,11,37575,27093
143,16,0,2,1,0,0,3,338,129,36055,28374,330,8,37575,27096
144,17,2,0,0,3,1,0,103,137,36057,28374,88,247,37578,27096
145,17,0,0,2,1,2,1,91,13,36057,28374,126,139,37579,27097
146,17,4,2,0,3,1,0,368,202,36061,28376,256,182,37582,27097
147,17,3,1,0,3,1,0,395,118,36064,28377,369,211,37585,27097
148,17,0,3,1,0,0,3,282,277,36064,28380,244,133,37585,27100
149,17,1,3,1,0,0,3,277,191,36065,28383,271,304,37585,27103
150,17,2,2,2,1,2,1,338,175,36067,28385,354,187,37586,27104
151,17,2,2,2,1,2,1,218,216,36069,28387,212,226,37587,27105
152,17,0,2,1,0,0,3,120,230,36069,28389,78,186,37587,27108
153,18,3,2,0,3,1,0,271,167,36072,28391,253,192,37590,27108
154,18,3,0,0,3,1,0,295,179,36075,28391,268,161,37593,27108
155,18,3,1,0,3,1,0,184,158,36078,28392,166,226,37596,27108
156,18,2,4,1,0,0,3,220,220,36080,28396,212,90,37596,27111
157,18,3,0,0,3,1,0,239,182,36083,28396,244,133,37599,27111
158,18,2,0,0,3,1,0,231,274,36085,28396,162,162,37602,27111
159,18,5,1,0,3,1,0,343,176,36090,28397,357,8,37605,27111
160,18,2,2,2,1,2,1,122,232,36092,28399,79,277,37606,27112
161,18,4,4,2,1,2,1,384,95,36096,28403,352,183,37607,27113
162,19,1,1,2,1,2,1,369,203,36097,28404,257,143,37608,27114
163,19,0,2,1,0,0,3,259,210,36097,28406,230,250,37608,27117
164,19,2,0,0,3,1,0,284,277,36099,28406,247,34,37611,27117
165,19,2,1,0,3,1,0,397,119,36101,28407,372,139,37614,27117
166,19,2,3,1,0,0,3,105,140,36103,28410,88,14,37614,27120
167,19,2,1,0,3,1,0,93,14,36105,28411,129,187,37617,27120
168,19,0,1,1,0,0,3,277,192,36105,28412,271,189,37617,27123
169,19,6,2,0,3,1,0,344,131,36111,28414,333,304,37620,27123
170,19,0,2,1,0,0,3,262,224,36111,28416,223,214,37620,27126
171,20,3,0,0,3,1,0,346,176,36114,28416,360,162,37623,27126
172,20,2,2,2,1,2,1,273,169,36116,28418,254,184,37624,27127
173,20,1,2,1,0,0,3,232,276,36117,28420,162,142,37624,27130
174,20,6,0,0,3,1,0,390,95,36123,28420,355,90,37627,27130
175,20,5,0,0,3,1,0,300,179,36128,28420,271,14,37630,27130
176,20,2,1,0,3,1,0,286,278,36130,28421,250,226,37633,27130
177,20,4,3,0,3,1,0,188,161,36134,28424,169,161,37636,27130
178,20,5,0,0,3,1,0,402,119,36139,28424,375,8,37639,27130
179,20,2,0,0,3,1,0,222,220,36141,28424,215,133,37642,27130
180,21,0,3,1,0,0,3,369,206,36141,28427,257,217,37642,27133
181,21,1,0,0,3,1,0,260,210,36142,28427,233,304,37645,27133
182,21,1,1,2,1,2,1,263,225,36143,28428,224,251,37646,27134
183,21,2,1,0,3,1,0,107,141,36145,28429,91,189,37649,27134
184,21,4,0,0,3,1,0,348,131,36149,28429,336,34,37652,27134
185,21,4,1,0,3,1,0,97,15,36153,28430,132,192,37655,27134
186,21,2,1,0,3,1,0,241,183,36155,28431,247,187,37658,27134
187,21,3,2,0,3,1,0,125,234,36158,28433,82,143,37661,27134
188,21,2,2,2,1,2,1,279,194,36160,28435,272,278,37662,27135
189,22,1,0,0,3,1,0,223,220,36161,28435,218,251,37665,27135
190,22,3,0,0,3,1,0,303,179,36164,28435,274,90,37668,27135
191,22,2,2,2,1,2,1,265,227,36166,28437,225,279,37669,27136
192,22,6,0,0,3,1,0,266,210,36172,28437,236,8,37672,27136
193,22,3,2,0,3,1,0,276,171,36175,28439,257,189,37675,27136
194,22,5,0,0,3,1,0,395,95,36180,28439,358,162,37678,27136
195,22,2,1,0,3,1,0,288,279,36182,28440,253,14,37681,27136
196,22,1,0,0,3,1,0,242,183,36183,28440,250,226,37684,27136
197,22,0,1,1,0,0,3,346,177,36183,28441,360,164,37684,27139
198,23,0,1,1,0,0,3,107,142,36183,28442,91,136,37684,27142
199,23,0,0,2,1,2,1,279,194,36183,28442,273,193,37685,27143
200,23,0,3,1,0,0,3,188,164,36183,28445,169,37,37685,27146
201,23,2,4,1,0,0,3,99,19,36185,28449,132,187,37685,27149
202,23,0,0,2,1,2,1,369,206,36185,28449,258,143,37686,27150
203,23,1,5,1,0,0,3,224,225,36186,28454,218,307,37686,27153
204,23,1,1,2,1,2,1,403,120,36187,28455,376,227,37687,27154
205,23,0,3,1,0,0,3,125,237,36187,28458,82,190,37687,27157
206,23,2,1,0,3,1,0,234,277,36189,28459,165,217,37690,27157
207,24,1,1,2,1,2,1,347,178,36190,28460,361,144,37691,27158
208,24,1,5,1,0,0,3,267,215,36191,28465,236,167,37691,27161
209,24,0,2,1,0,0,3,288,281,36191,28467,253,282,37691,27164
210,24,4,1,0,3,1,0,280,172,36195,28468,260,162,37694,27164
211,24,4,2,0,3,1,0,269,229,36199,28470,228,189,37697,27164
212,24,3,2,0,3,1,0,245,185,36202,28472,253,90,37700,27164
213,24,4,2,0,3,1,0,307,181,36206,28474,277,8,37703,27164
214,24,4,0,0,3,1,0,352,131,36210,28474,339,14,37706,27164
215,24,2,1,0,3,1,0,397,96,36212,28475,361,251,37709,27164
216,25,0,0,2,1,2,1,279,194,36212,28475,274,144,37710,27165
217,25,1,0,0,3,1,0,108,142,36213,28475,94,193,37713,27165
218,25,2,0,0,3,1,0,405,120,36215,28475,379,162,37716,27165
219,25,2,3,1,0,0,3,226,228,36217,28478,218,190,37716,27168
220,25,3,2,0,3,1,0,237,279,36220,28480,168,37,37719,27168
221,25,0,0,2,1,2,1,188,164,36220,28480,170,218,37720,27169
222,25,1,1,2,1,2,1,281,173,36221,28481,261,228,37721,27170
223,25,1,1,2,1,2,1,126,238,36222,28482,83,137,37722,27171
224,25,4,0,0,3,1,0,401,96,36226,28482,364,8,37725,27171
225,26,3,1,0,3,1,0,102,20,36229,28483,135,14,37728,27171
226,26,0,3,1,0,0,3,269,232,36229,28486,228,40,37728,27174
227,26,2,3,1,0,0,3,354,134,36231,28489,339,192,37728,27177
228,26,0,4,1,0,0,3,369,210,36231,28493,258,170,37728,27180
229,26,3,2,0,3,1,0,270,217,36234,28495,239,190,37731,27180
230,26,0,1,1,0,0,3,108,143,36234,28496,94,285,37731,27183
231,26,1,0,0,3,1,0,308,181,36235,28496,280,307,37734,27183
232,26,1,0,0,3,1,0,246,185,36236,28496,256,144,37737,27183
233,26,0,2,1,0,0,3,288,283,36236,28498,253,254,37737,27186
234,27,3,2,0,3,1,0,240,281,36239,28500,171,8,37740,27186
235,27,3,3,2,1,2,1,229,231,36242,28503,219,191,37741,27187
236,27,1,2,1,0,0,3,348,180,36243,28505,361,140,37741,27190
237,27,1,0,0,3,1,0,270,232,36244,28505,231,193,37744,27190
238,27,1,0,0,3,1,0,309,181,36245,28505,283,144,37747,27190
239,27,1,1,2,1,2,1,370,211,36246,28506,259,91,37748,27191
240,27,3,2,0,3,1,0,282,196,36249,28508,277,228,37751,27191
241,27,3,0,0,3,1,0,191,164,36252,28508,173,14,37754,27191
242,27,3,1,0,3,1,0,404,97,36255,28509,367,285,37757,27191
243,28,2,2,2,1,2,1,283,175,36257,28511,262,219,37758,27192
244,28,3,4,1,0,0,3,273,221,36260,28515,239,195,37758,27195
245,28,1,0,0,3,1,0,247,185,36261,28515,259,40,37761,27195
246,28,2,6,1,0,0,3,110,149,36263,28521,94,173,37761,27198
247,28,1,2,1,0,0,3,289,285,36264,28523,253,165,37761,27201
248,28,0,0,2,1,2,1,102,20,36264,28523,136,145,37762,27202
249,28,2,5,1,0,0,3,128,243,36266,28528,83,310,37762,27205
250,28,4,0,0,3,1,0,409,120,36270,28528,382,254,37765,27205
251,28,3,0,0,3,1,0,357,134,36273,28528,342,190,37768,27205
252,29,1,4,1,0,0,3,241,285,36274,28532,171,313,37768,27208
253,29,5,0,0,3,1,0,234,231,36279,28532,222,173,37771,27208
254,29,1,0,0,3,1,0,248,185,36280,28532,262,193,37774,27208
255,29,1,1,2,1,2,1,349,181,36281,28533,362,220,37775,27209
256,29,1,0,0,3,1,0,274,221,36282,28533,242,165,37778,27209
257,29,2,0,0,3,1,0,130,243,36284,28533,86,190,37781,27209
258,29,5,0,0,3,1,0,196,164,36289,28533,176,8,37784,27209
259,29,0,3,1,0,0,3,110,152,36289,28536,94,231,37784,27212
260,29,3,3,2,1,2,1,286,178,36292,28539,263,286,37785,27213
261,30,1,1,2,1,2,1,371,212,36293,28540,260,15,37786,27214
262,30,2,3,1,0,0,3,311,184,36295,28543,283,148,37786,27217
263,30,6,2,0,3,1,0,410,99,36301,28545,370,193,37789,27217
264,30,2,1,0,3,1,0,359,135,36303,28546,345,140,37792,27217
265,30,1,1,2,1,2,1,103,21,36304,28547,137,92,37793,27218
266,30,2,1,0,3,1,0,411,121,36306,28548,385,40,37796,27218
267,30,2,0,0,3,1,0,243,285,36308,28548,174,254,37799,27218
268,30,1,1,2,1,2,1,271,233,36309,28549,232,145,37800,27219
269,30,0,0,2,1,2,1,282,196,36309,28549,278,192,37801,27220
270,31,2,1,0,3,1,0,276,222,36311,28550,245,190,37804,27220
271,31,2,0,0,3,1,0,132,243,36313,28550,89,173,37807,27220
272,31,0,1,1,0,0,3,248,186,36313,28551,262,316,37807,27223
273,31,4,1,0,3,1,0,290,179,36317,28552,266,254,37810,27223
274,31,2,1,0,3,1,0,361,136,36319,28553,348,220,37813,27223
275,31,4,1,0,3,1,0,114,153,36323,28554,97,40,37816,27223
276,31,1,1,2,1,2,1,290,286,36324,28555,254,196,37817,27224
277,31,2,1,0,3,1,0,105,22,36326,28556,140,165,37820,27224
278,31,3,1,0,3,1,0,414,122,36329,28557,388,148,37823,27224
279,32,1,0,0,3,1,0,350,181,36330,28557,365,15,37826,27224
280,32,2,2,2,1,2,1,273,235,36332,28559,233,93,37827,27225
281,32,2,1,0,3,1,0,313,185,36334,28560,286,140,37830,27225
282,32,4,2,0,3,1,0,414,101,36338,28562,373,192,37833,27225
283,32,2,1,0,3,1,0,284,197,36340,28563,281,8,37836,27225
284,32,0,4,1,0,0,3,371,216,36340,28567,260,234,37836,27228
285,32,3,1,0,3,1,0,237,232,36343,28568,225,193,37839,27228
286,32,0,3,1,0,0,3,243,288,36343,28571,174,289,37839,27231
287,32,3,2,0,3,1,0,199,166,36346,28573,179,145,37842,27231
288,33,3,1,0,3,1,0,287,198,36349,28574,284,190,37845,27231
289,33,0,0,2,1,2,1,371,216,36349,28574,261,255,37846,27232
290,33,3,1,0,3,1,0,417,123,36352,28575,391,140,37849,27232
291,33,1,4,1,0,0,3,106,26,36353,28579,140,237,37849,27235
292,33,4,2,0,3,1,0,294,288,36357,28581,257,220,37852,27235
293,33,1,4,1,0,0,3,351,185,36358,28585,365,319,37852,27238
294,33,1,3,1,0,0,3,115,156,36359,28588,97,195,37852,27241
295,33,6,2,0,3,1,0,243,234,36365,28590,228,196,37855,27241
296,33,1,0,0,3,1,0,133,243,36366,28590,92,145,37858,27241
297,34,2,1,0,3,1,0,275,236,36368,28591,236,165,37861,27241
298,34,0,2,1,0,0,3,361,138,36368,28593,348,151,37861,27244
299,34,1,0,0,3,1,0,314,185,36369,28593,289,289,37864,27244
300,34,2,3,1,0,0,3,245,291,36371,28596,174,18,37864,27247
301,34,2,4,1,0,0,3,201,170,36373,28600,179,96,37864,27250
302,34,4,1,0,3,1,0,418,102,36377,28601,376,173,37867,27250
303,34,4,5,1,0,0,3,280,227,36381,28606,245,196,37867,27253
304,34,6,1,0,3,1,0,296,180,36387,28607,269,40,37870,27253
305,34,3,0,0,3,1,0,251,186,36390,28607,265,8,37873,27253
0,1,1,3,1,0,0,3,202,173,36391,28610,179,199,37873,27256
1,1,2,2,2,1,2,1,298,182,36393,28612,270,320,37874,27257
2,1,0,1,1,0,0,3,133,244,36393,28613,92,148,37874,27260
3,1,3,1,0,3,1,0,118,157,36396,28614,100,73,37877,27260
4,1,1,1,2,1,2,1,266,170,36397,28615,245,290,37878,27261
5,1,0,4,1,0,0,3,280,231,36397,28619,245,193,37878,27264
6,1,2,2,2,1,2,1,363,140,36399,28621,349,122,37879,27265
7,1,2,4,1,0,0,3,245,238,36401,28625,228,176,37879,27268
8,1,4,0,0,3,1,0,318,185,36405,28625,292,8,37882,27268
9,2,4,1,0,3,1,0,159,137,36409,28626,185,96,37885,27268
10,2,1,3,1,0,0,3,252,189,36410,28629,265,176,37885,27271
11,2,5,0,0,3,1,0,423,102,36415,28629,379,18,37888,27271
12,2,0,2,1,0,0,3,245,293,36415,28631,174,198,37888,27274
13,2,1,1,2,1,2,1,107,27,36416,28632,141,141,37889,27275
14,2,1,1,2,1,2,1,276,237,36417,28633,237,238,37890,27276
15,2,0,2,1,0,0,3,74,70,36417,28635,75,223,37890,27279
16,2,3,1,0,3,1,0,290,199,36420,28636,287,255,37893,27279
17,2,3,1,0,3,1,0,420,124,36423,28637,394,151,37896,27279
18,3,3,0,0,3,1,0,301,182,36426,28637,273,255,37899,27279
19,3,1,4,1,0,0,3,119,161,36427,28641,100,323,37899,27282
20,3,1,2,1,0,0,3,246,240,36428,28643,228,125,37899,27285
21,3,2,0,0,3,1,0,135,244,36430,28643,95,193,37902,27285
22,3,2,3,1,0,0,3,109,30,36432,28646,141,202,37902,27288
23,3,3,3,2,1,2,1,269,173,36435,28649,246,74,37903,27289
24,3,1,1,2,1,2,1,364,141,36436,28650,350,177,37904,27290
25,3,0,0,2,1,2,1,318,185,36436,28650,293,149,37905,27291
26,3,0,2,1,0,0,3,280,233,36436,28652,245,293,37905,27294
27,4,2,1,0,3,1,0,247,294,36438,28653,177,18,37908,27294
28,4,1,1,2,1,2,1,281,234,36439,28654,246,199,37909,27295
29,4,0,0,2,1,2,1,276,237,36439,28654,238,177,37910,27296
30,4,0,3,1,0,0,3,74,73,36439,28657,75,154,37910,27299
31,4,1,2,1,0,0,3,291,201,36440,28659,287,99,37910,27302
32,4,2,2,2,1,2,1,204,175,36442,28661,180,126,37911,27303
33,4,3,1,0,3,1,0,423,125,36445,28662,397,149,37914,27303
34,4,5,0,0,3,1,0,428,102,36450,28662,382,8,37917,27303
35,4,0,3,1,0,0,3,364,144,36450,28665,350,226,37917,27306
36,5,1,3,1,0,0,3,136,247,36451,28668,95,258,37917,27309
37,5,1,1,2,1,2,1,277,238,36452,28669,239,9,37918,27310
38,5,1,2,1,0,0,3,253,191,36453,28671,265,144,37918,27313
39,5,1,0,0,3,1,0,247,240,36454,28671,231,99,37921,27313
40,5,3,1,0,3,1,0,272,174,36457,28672,249,177,37924,27313
41,5,1,4,1,0,0,3,160,141,36458,28676,185,326,37924,27316
42,5,0,1,1,0,0,3,247,295,36458,28677,177,241,37924,27319
43,5,2,1,0,3,1,0,303,183,36460,28678,276,226,37927,27319
44,5,1,3,1,0,0,3,75,76,36461,28681,75,296,37927,27322
45,6,5,1,0,3,1,0,323,186,36466,28682,296,126,37930,27322
46,6,4,1,0,3,1,0,432,103,36470,28683,385,193,37933,27322
47,6,2,1,0,3,1,0,121,162,36472,28684,103,149,37936,27322
48,6,5,0,0,3,1,0,428,125,36477,28684,400,199,37939,27322
49,6,3,1,0,3,1,0,294,202,36480,28685,290,18,37942,27322
50,6,6,2,0,3,1,0,210,177,36486,28687,183,74,37945,27322
51,6,3,2,0,3,1,0,367,146,36489,28689,353,154,37948,27322
52,6,4,1,0,3,1,0,285,235,36493,28690,249,202,37951,27322
53,6,2,3,1,0,0,3,111,33,36495,28693,141,180,37951,27325
54,7,2,3,1,0,0,3,274,177,36497,28696,249,147,37951,27328
55,7,4,0,0,3,1,0,164,141,36501,28696,188,74,37954,27328
56,7,1,0,0,3,1,0,248,295,36502,28696,180,99,37957,27328
57,7,2,0,0,3,1,0,255,191,36504,28696,268,258,37960,27328
58,7,4,2,0,3,1,0,307,185,36508,28698,279,9,37963,27328
59,7,1,1,2,1,2,1,278,239,36509,28699,240,178,37964,27329
60,7,3,3,2,1,2,1,139,250,36512,28702,96,242,37965,27330
61,7,0,1,1,0,0,3,247,241,36512,28703,231,229,37965,27333
62,7,1,1,2,1,2,1,429,126,36513,28704,401,327,37966,27334
63,8,3,0,0,3,1,0,142,250,36516,28704,99,154,37969,27334
64,8,0,3,1,0,0,3,121,165,36516,28707,103,196,37969,27337
65,8,2,0,0,3,1,0,434,103,36518,28707,388,149,37972,27337
66,8,0,0,2,1,2,1,111,33,36518,28707,142,127,37973,27338
67,8,1,2,1,0,0,3,76,78,36519,28709,75,202,37973,27341
68,8,0,4,1,0,0,3,210,181,36519,28713,183,299,37973,27344
69,8,2,0,0,3,1,0,296,202,36521,28713,293,202,37976,27344
70,8,2,0,0,3,1,0,325,186,36523,28713,299,147,37979,27344
71,8,5,1,0,3,1,0,372,147,36528,28714,356,180,37982,27344
72,9,3,0,0,3,1,0,258,191,36531,28714,271,74,37985,27344
73,9,2,0,0,3,1,0,287,235,36533,28714,252,18,37988,27344
74,9,2,1,0,3,1,0,166,142,36535,28715,191,180,37991,27344
75,9,2,1,0,3,1,0,309,186,36537,28716,282,178,37994,27344
76,9,1,0,0,3,1,0,279,239,36538,28716,243,258,37997,27344
77,9,0,2,1,0,0,3,247,243,36538,28718,231,330,37997,27347
78,9,4,2,0,3,1,0,115,35,36542,28720,145,242,38000,27347
79,9,4,1,0,3,1,0,433,127,36546,28721,404,99,38003,27347
80,9,1,1,2,1,2,1,249,296,36547,28722,181,230,38004,27348
81,10,2,4,1,0,0,3,327,190,36549,28726,299,199,38004,27351
82,10,1,2,1,0,0,3,77,80,36550,28728,75,333,38004,27354
83,10,0,1,1,0,0,3,274,178,36550,28729,249,205,38004,27357
84,10,3,0,0,3,1,0,299,202,36553,28729,296,299,38007,27357
85,10,0,4,1,0,0,3,121,169,36553,28733,103,205,38007,27360
86,10,3,1,0,3,1,0,213,182,36556,28734,186,154,38010,27360
87,10,2,1,0,3,1,0,144,251,36558,28735,102,9,38013,27360
88,10,2,0,0,3,1,0,260,191,36560,28735,274,127,38016,27360
89,10,1,1,2,1,2,1,373,148,36561,28736,357,148,38017,27361
90,11,4,1,0,3,1,0,278,179,36565,28737,252,18,38020,27361
91,11,2,1,0,3,1,0,251,297,36567,28738,184,74,38023,27361
92,11,0,2,1,0,0,3,309,188,36567,28740,282,157,38023,27364
93,11,4,1,0,3,1,0,119,36,36571,28741,148,99,38026,27364
94,11,4,0,0,3,1,0,291,235,36575,28741,255,258,38029,27364
95,11,1,1,2,1,2,1,280,240,36576,28742,244,150,38030,27365
96,11,1,2,1,0,0,3,167,144,36577,28744,191,181,38030,27368
97,11,0,4,1,0,0,3,433,131,36577,28748,404,233,38030,27371
98,11,4,0,0,3,1,0,438,103,36581,28748,391,242,38033,27371
99,12,2,4,1,0,0,3,215,186,36583,28752,186,336,38033,27374
100,12,2,0,0,3,1,0,79,80,36585,28752,78,148,38036,27374
101,12,2,2,2,1,2,1,169,146,36587,28754,192,300,38037,27375
102,12,3,0,0,3,1,0,330,190,36590,28754,302,180,38040,27375
103,12,2,1,0,3,1,0,146,252,36592,28755,105,205,38043,27375
104,12,6,0,0,3,1,0,305,202,36598,28755,299,9,38046,27375
105,12,0,3,1,0,0,3,121,172,36598,28758,103,245,38046,27378
106,12,2,0,0,3,1,0,262,191,36600,28758,277,205,38049,27378
107,12,1,1,2,1,2,1,248,244,36601,28759,232,200,38050,27379
108,13,1,2,1,0,0,3,310,190,36602,28761,282,153,38050,27382
109,13,2,1,0,3,1,0,282,241,36604,28762,247,127,38053,27382
110,13,1,0,0,3,1,0,120,36,36605,28762,151,157,38056,27382
111,13,6,1,0,3,1,0,297,236,36611,28763,258,99,38059,27382
112,13,4,0,0,3,1,0,442,103,36615,28763,394,181,38062,27382
113,13,2,1,0,3,1,0,253,298,36617,28764,187,300,38065,27382
114,13,2,1,0,3,1,0,280,180,36619,28765,255,258,38068,27382
115,13,3,2,0,3,1,0,376,150,36622,28767,360,74,38071,27382
116,13,3,0,0,3,1,0,333,190,36625,28767,305,18,38074,27382
117,14,0,3,1,0,0,3,305,205,36625,28770,299,236,38074,27385
118,14,3,1,0,3,1,0,218,187,36628,28771,189,9,38077,27385
119,14,4,1,0,3,1,0,446,104,36632,28772,397,148,38080,27385
120,14,3,3,2,1,2,1,251,247,36635,28775,233,206,38081,27386
121,14,1,1,2,1,2,1,263,192,36636,28776,278,246,38082,27387
122,14,2,1,0,3,1,0,435,132,36638,28777,407,200,38085,27387
123,14,1,1,2,1,2,1,80,81,36639,28778,79,19,38086,27388
124,14,2,1,0,3,1,0,123,173,36641,28779,106,180,38089,27388
125,14,2,0,0,3,1,0,171,146,36643,28779,195,205,38092,27388
126,15,3,2,0,3,1,0,285,243,36646,28781,250,205,38095,27388
127,15,4,0,0,3,1,0,257,298,36650,28781,190,127,38098,27388
128,15,1,0,0,3,1,0,121,36,36651,28781,154,153,38101,27388
129,15,4,0,0,3,1,0,301,236,36655,28781,261,157,38104,27388
130,15,2,5,1,0,0,3,282,185,36657,28786,255,339,38104,27391
131,15,0,1,1,0,0,3,305,206,36657,28787,299,77,38104,27394
132,15,1,0,0,3,1,0,377,150,36658,28787,363,258,38107,27394
133,15,1,0,0,3,1,0,334,190,36659,28787,308,99,38110,27394
134,15,1,1,2,1,2,1,147,253,36660,28788,106,301,38111,27395
135,16,0,2,1,0,0,3,446,106,36660,28790,397,209,38111,27398
136,16,0,0,2,1,2,1,251,247,36660,28790,234,181,38112,27399
137,16,5,0,0,3,1,0,440,132,36665,28790,410,9,38115,27399
138,16,2,0,0,3,1,0,125,173,36667,28790,109,19,38118,27399
139,16,0,3,1,0,0,3,218,190,36667,28793,189,239,38118,27402
140,16,0,0,2,1,2,1,310,190,36667,28793,283,247,38119,27403
141,16,1,3,1,0,0,3,81,84,36668,28796,79,203,38119,27406
142,16,0,1,1,0,0,3,263,193,36668,28797,278,184,38119,27409
143,16,0,0,2,1,2,1,171,146,36668,28797,196,149,38120,27410
144,17,1,2,1,0,0,3,286,245,36669,28799,250,212,38120,27413
145,17,1,1,2,1,2,1,252,248,36670,28800,235,154,38121,27414
146,17,3,2,0,3,1,0,124,38,36673,28802,157,77,38124,27414
147,17,1,2,1,0,0,3,126,175,36674,28804,109,261,38124,27417
148,17,0,3,1,0,0,3,282,188,36674,28807,255,208,38124,27420
149,17,2,0,0,3,1,0,149,253,36676,28807,109,127,38127,27420
150,17,3,1,0,3,1,0,380,151,36679,28808,366,301,38130,27420
151,17,1,0,0,3,1,0,335,190,36680,28808,311,339,38133,27420
152,17,1,3,1,0,0,3,302,239,36681,28811,261,187,38133,27423
153,18,3,0,0,3,1,0,84,84,36684,28811,82,181,38136,27423
154,18,1,1,2,1,2,1,287,246,36685,28812,251,150,38137,27424
155,18,3,0,0,3,1,0,174,146,36688,28812,199,239,38140,27424
156,18,4,1,0,3,1,0,444,133,36692,28813,413,261,38143,27424
157,18,0,0,2,1,2,1,257,298,36692,28813,191,10,38144,27425
158,18,6,1,0,3,1,0,452,107,36698,28814,400,157,38147,27425
159,18,1,2,1,0,0,3,306,208,36699,28816,299,250,38147,27428
160,18,2,0,0,3,1,0,265,193,36701,28816,281,19,38150,27428
161,18,3,0,0,3,1,0,313,190,36704,28816,286,99,38153,27428
162,19,3,3,2,1,2,1,221,193,36707,28819,190,188,38154,27429
163,19,1,3,1,0,0,3,125,41,36708,28822,157,211,38154,27432
164,19,0,0,2,1,2,1,282,188,36708,28822,256,155,38155,27433
165,19,3,1,0,3,1,0,383,152,36711,28823,369,203,38158,27433
166,19,1,3,1,0,0,3,336,193,36712,28826,311,215,38158,27436
167,19,1,1,2,1,2,1,127,176,36713,28827,110,302,38159,27437
168,19,2,1,0,3,1,0,454,108,36715,28828,403,127,38162,27437
169,19,1,0,0,3,1,0,150,253,36716,28828,112,150,38165,27437
170,19,2,0,0,3,1,0,254,248,36718,28828,238,77,38168,27437
171,20,4,0,0,3,1,0,310,208,36722,28828,302,157,38171,27437
172,20,1,2,1,0,0,3,288,248,36723,28830,251,242,38171,27440
173,20,1,2,1,0,0,3,85,86,36724,28832,82,102,38171,27443
174,20,2,3,1,0,0,3,304,242,36726,28835,261,253,38171,27446
175,20,1,1,2,1,2,1,175,147,36727,28836,200,11,38172,27447
176,20,1,1,2,1,2,1,314,191,36728,28837,287,20,38173,27448
177,20,2,1,0,3,1,0,267,194,36730,28838,284,339,38176,27448
178,20,0,0,2,1,2,1,257,298,36730,28838,192,262,38177,27449
179,20,1,1,2,1,2,1,445,134,36731,28839,414,182,38178,27450
180,21,4,0,0,3,1,0,340,193,36735,28839,314,77,38181,27450
181,21,0,0,2,1,2,1,254,248,36735,28839,239,212,38182,27451
182,21,3,0,0,3,1,0,386,152,36738,28839,372,20,38185,27451
183,21,2,0,0,3,1,0,284,188,36740,28839,259,127,38188,27451
184,21,1,0,0,3,1,0,222,193,36741,28839,193,155,38191,27451
185,21,1,0,0,3,1,0,258,298,36742,28839,195,150,38194,27451
186,21,2,1,0,3,1,0,127,42,36744,28840,160,203,38197,27451
187,21,1,1,2,1,2,1,128,177,36745,28841,111,189,38198,27452
188,21,1,0,0,3,1,0,455,108,36746,28841,406,302,38201,27452
189,22,2,0,0,3,1,0,306,242,36748,28841,264,11,38204,27452
190,22,1,0,0,3,1,0,268,194,36749,28841,287,212,38207,27452
191,22,3,0,0,3,1,0,448,134,36752,28841,417,215,38210,27452
192,22,1,1,2,1,2,1,289,249,36753,28842,252,103,38211,27453
193,22,0,0,2,1,2,1,85,86,36753,28842,83,263,38212,27454
194,22,2,0,0,3,1,0,152,253,36755,28842,115,182,38215,27454
195,22,4,2,0,3,1,0,179,149,36759,28844,203,157,38218,27454
196,23,1,0,0,3,1,0,129,177,36760,28844,114,150,38221,27454
197,23,2,0,0,3,1,0,286,188,36762,28844,262,242,38224,27454
198,23,0,3,1,0,0,3,254,251,36762,28847,239,305,38224,27457
199,23,0,0,2,1,2,1,127,42,36762,28847,161,21,38225,27458
200,23,4,2,0,3,1,0,318,193,36766,28849,290,203,38228,27458
201,23,1,2,1,0,0,3,180,151,36767,28851,203,158,38228,27461
202,23,3,0,0,3,1,0,458,108,36770,28851,409,77,38231,27461
203,23,1,1,2,1,2,1,259,299,36771,28852,196,190,38232,27462
204,23,3,4,1,0,0,3,225,197,36774,28856,193,256,38232,27465
205,24,0,1,1,0,0,3,85,87,36774,28857,83,130,38232,27468
206,24,4,2,0,3,1,0,156,255,36778,28859,118,215,38235,27468
207,24,2,1,0,3,1,0,388,153,36780,28860,375,11,38238,27468
208,24,2,2,2,1,2,1,291,251,36782,28862,253,158,38239,27469
209,24,0,1,1,0,0,3,268,195,36782,28863,287,106,38239,27472
210,24,2,1,0,3,1,0,312,209,36784,28864,305,182,38242,27472
211,24,2,0,0,3,1,0,342,193,36786,28864,317,263,38245,27472
212,24,1,2,1,0,0,3,319,195,36787,28866,290,308,38245,27475
213,24,1,0,0,3,1,0,307,242,36788,28866,267,339,38248,27475
214,25,3,1,0,3,1,0,262,300,36791,28867,199,158,38251,27475
215,25,0,0,2,1,2,1,254,251,36791,28867,240,151,38252,27476
216,25,0,0,2,1,2,1,129,177,36791,28867,115,12,38253,27477
217,25,4,3,0,3,1,0,229,200,36795,28870,196,212,38256,27477
218,25,2,3,1,0,0,3,288,191,36797,28873,262,206,38256,27480
219,25,2,1,0,3,1,0,87,88,36799,28874,86,190,38259,27480
220,25,1,1,2,1,2,1,449,135,36800,28875,418,257,38260,27481
221,25,5,1,0,3,1,0,185,152,36805,28876,206,21,38263,27481
222,25,0,2,1,0,0,3,458,110,36805,28878,409,245,38263,27484
223,26,1,1,2,1,2,1,128,43,36806,28879,162,264,38264,27485
224,26,4,0,0,3,1,0,346,193,36810,28879,320,158,38267,27485
225,26,3,0,0,3,1,0,159,255,36813,28879,121,106,38270,27485
226,26,1,0,0,3,1,0,320,195,36814,28879,293,182,38273,27485
227,26,1,3,1,0,0,3,292,254,36815,28882,253,342,38273,27488
228,26,5,1,0,3,1,0,317,210,36820,28883,308,130,38276,27488
229,26,4,2,0,3,1,0,311,244,36824,28885,270,77,38279,27488
230,26,2,0,0,3,1,0,390,153,36826,28885,378,215,38282,27488
231,26,0,1,1,0,0,3,268,196,36826,28886,287,311,38282,27491
0,1,2,0,0,3,1,0,294,254,36828,28886,256,215,38285,27491
1,1,0,2,1,0,0,3,229,202,36828,28888,196,260,38285,27494
2,1,2,0,0,3,1,0,290,191,36830,28888,265,12,38288,27494
3,1,3,5,1,0,0,3,162,260,36833,28893,121,109,38288,27497
4,1,2,0,0,3,1,0,313,244,36835,28893,273,158,38291,27497
5,1,0,1,1,0,0,3,185,153,36835,28894,206,345,38291,27500
6,1,1,3,1,0,0,3,269,199,36836,28897,287,314,38291,27503
7,1,0,1,1,0,0,3,87,89,36836,28898,86,215,38291,27506
8,1,2,2,2,1,2,1,319,212,36838,28900,309,246,38292,27507
9,2,1,1,2,1,2,1,130,178,36839,28901,116,191,38293,27508
10,2,1,1,2,1,2,1,347,194,36840,28902,321,265,38294,27509
11,2,2,0,0,3,1,0,322,195,36842,28902,296,130,38297,27509
12,2,2,1,0,3,1,0,451,136,36844,28903,421,21,38300,27509
13,2,1,3,1,0,0,3,129,46,36845,28906,162,209,38300,27512
14,2,0,1,1,0,0,3,254,252,36845,28907,240,161,38300,27515
15,2,1,1,2,1,2,1,391,154,36846,28908,379,183,38301,27516
16,2,4,0,0,3,1,0,266,300,36850,28908,202,151,38304,27516
17,2,3,0,0,3,1,0,461,110,36853,28908,412,77,38307,27516
18,3,3,1,0,3,1,0,293,192,36856,28909,268,161,38310,27516
19,3,4,0,0,3,1,0,233,202,36860,28909,199,130,38313,27516
20,3,3,3,2,1,2,1,132,49,36863,28912,163,247,38314,27517
21,3,1,0,0,3,1,0,295,254,36864,28912,259,109,38317,27517
22,3,2,1,0,3,1,0,463,111,36866,28913,415,215,38320,27517
23,3,4,2,0,3,1,0,395,156,36870,28915,382,158,38323,27517
24,3,3,1,0,3,1,0,322,213,36873,28916,312,77,38326,27517
25,3,1,1,2,1,2,1,314,245,36874,28917,274,315,38327,27518
26,3,1,1,2,1,2,1,163,261,36875,28918,122,216,38328,27519
27,4,1,1,2,1,2,1,323,214,36876,28919,313,210,38329,27520
28,4,3,0,0,3,1,0,325,195,36879,28919,299,151,38332,27520
29,4,1,2,1,0,0,3,131,180,36880,28921,116,161,38332,27523
30,4,1,1,2,1,2,1,294,193,36881,28922,269,22,38333,27524
31,4,1,0,0,3,1,0,270,199,36882,28922,290,345,38336,27524
32,4,4,4,2,1,2,1,189,157,36886,28926,207,248,38337,27525
33,4,1,4,1,0,0,3,267,304,36887,28930,202,263,38337,27528
34,4,2,0,0,3,1,0,453,136,36889,28930,424,12,38340,27528
35,4,1,1,2,1,2,1,88,90,36890,28931,87,266,38341,27529
36,5,0,1,1,0,0,3,314,246,36890,28932,274,80,38341,27532
37,5,2,2,2,1,2,1,349,196,36892,28934,322,110,38342,27533
38,5,0,3,1,0,0,3,267,307,36892,28937,202,186,38342,27536
39,5,1,1,2,1,2,1,396,157,36893,28938,383,131,38343,27537
40,5,5,1,0,3,1,0,468,112,36898,28939,418,210,38346,27537
41,5,0,2,1,0,0,3,254,254,36898,28941,240,218,38346,27540
42,5,0,0,2,1,2,1,270,199,36898,28941,291,192,38347,27541
43,5,0,3,1,0,0,3,233,205,36898,28944,199,318,38347,27544
44,5,2,2,2,1,2,1,165,263,36900,28946,123,13,38348,27545
45,6,0,1,1,0,0,3,131,181,36900,28947,116,348,38348,27548
46,6,2,1,0,3,1,0,325,215,36902,28948,316,186,38351,27548
47,6,0,0,2,1,2,1,233,205,36902,28948,200,217,38352,27549
48,6,4,0,0,3,1,0,299,254,36906,28948,262,22,38355,27549
49,6,1,3,1,0,0,3,133,52,36907,28951,163,164,38355,27552
50,6,2,1,0,3,1,0,327,196,36909,28952,302,318,38358,27552
51,6,1,1,2,1,2,1,190,158,36910,28953,208,152,38359,27553
52,6,2,2,2,1,2,1,90,92,36912,28955,88,264,38360,27554
53,6,2,2,2,1,2,1,256,256,36914,28957,241,249,38361,27555
54,7,5,1,0,3,1,0,299,194,36919,28958,272,266,38364,27555
55,7,5,2,0,3,1,0,473,114,36924,28960,421,13,38367,27555
56,7,2,1,0,3,1,0,272,200,36926,28961,294,110,38370,27555
57,7,1,3,1,0,0,3,268,310,36927,28964,202,221,38370,27558
58,7,4,1,0,3,1,0,318,247,36931,28965,277,192,38373,27558
59,7,1,4,1,0,0,3,191,162,36932,28969,208,213,38373,27561
60,7,2,3,1,0,0,3,167,266,36934,28972,123,267,38373,27564
61,7,4,0,0,3,1,0,457,136,36938,28972,427,161,38376,27564
62,7,3,0,0,3,1,0,352,196,36941,28972,325,80,38379,27564
63,8,2,2,2,1,2,1,135,54,36943,28974,164,267,38380,27565
64,8,2,4,1,0,0,3,258,260,36945,28978,241,189,38380,27568
65,8,3,2,0,3,1,0,134,183,36948,28980,119,152,38383,27568
66,8,0,2,1,0,0,3,90,94,36948,28982,88,134,38383,27571
67,8,0,3,1,0,0,3,325,218,36948,28985,316,351,38383,27574
68,8,3,1,0,3,1,0,330,197,36951,28986,305,22,38386,27574
69,8,2,0,0,3,1,0,398,157,36953,28986,386,164,38389,27574
70,8,0,3,1,0,0,3,299,257,36953,28989,262,252,38389,27577
71,8,3,0,0,3,1,0,460,136,36956,28989,430,217,38392,27577
72,9,2,1,0,3,1,0,270,311,36958,28990,205,110,38395,27577
73,9,1,1,2,1,2,1,273,201,36959,28991,295,222,38396,27578
74,9,1,1,2,1,2,1,234,206,36960,28992,201,193,38397,27579
75,9,5,0,0,3,1,0,478,114,36965,28992,424,152,38400,27579
76,9,6,0,0,3,1,0,197,162,36971,28992,211,161,38403,27579
77,9,1,3,1,0,0,3,136,57,36972,28995,164,270,38403,27582
78,9,1,1,2,1,2,1,300,195,36973,28996,273,319,38404,27583
79,9,1,1,2,1,2,1,91,95,36974,28997,89,214,38405,27584
80,9,1,0,0,3,1,0,353,196,36975,28997,328,22,38408,27584
81,10,0,2,1,0,0,3,300,197,36975,28999,273,83,38408,27587
82,10,0,5,1,0,0,3,167,271,36975,29004,123,354,38408,27590
83,10,1,1,2,1,2,1,259,261,36976,29005,242,215,38409,27591
84,10,2,2,2,1,2,1,136,185,36978,29007,120,268,38410,27592
85,10,2,0,0,3,1,0,332,197,36980,29007,308,13,38413,27592
86,10,1,0,0,3,1,0,274,201,36981,29007,298,217,38416,27592
87,10,1,1,2,1,2,1,399,158,36982,29008,387,194,38417,27593
88,10,1,2,1,0,0,3,319,249,36983,29010,277,255,38417,27596
89,10,1,0,0,3,1,0,461,136,36984,29010,433,134,38420,27596
90,11,2,1,0,3,1,0,199,163,36986,29011,214,22,38423,27596
91,11,3,2,0,3,1,0,94,97,36989,29013,92,110,38426,27596
92,11,3,2,0,3,1,0,139,59,36992,29015,167,217,38429,27596
93,11,1,2,1,0,0,3,479,116,36993,29017,424,192,38429,27599
94,11,2,1,0,3,1,0,236,207,36995,29018,204,222,38432,27599
95,11,0,0,2,1,2,1,399,158,36995,29018,388,153,38433,27600
96,11,1,2,1,0,0,3,354,198,36996,29020,328,167,38433,27603
97,11,1,1,2,1,2,1,326,219,36997,29021,317,162,38434,27604
98,11,2,2,2,1,2,1,301,259,36999,29023,263,320,38435,27605
99,12,1,2,1,0,0,3,320,251,37000,29025,277,16,38435,27608
100,12,2,0,0,3,1,0,276,201,37002,29025,301,83,38438,27608
101,12,1,1,2,1,2,1,168,272,37003,29026,124,163,38439,27609
102,12,4,0,0,3,1,0,483,116,37007,29026,427,268,38442,27609
103,12,1,1,2,1,2,1,333,198,37008,29027,309,216,38443,27610
104,12,0,3,1,0,0,3,136,188,37008,29030,120,273,38443,27613
105,12,1,3,1,0,0,3,271,314,37009,29033,205,137,38443,27616
106,12,2,1,0,3,1,0,463,137,37011,29034,436,194,38446,27616
107,12,1,3,1,0,0,3,301,200,37012,29037,273,258,38446,27619
108,13,0,0,2,1,2,1,236,207,37012,29037,205,23,38447,27620
109,13,2,3,1,0,0,3,201,166,37014,29040,214,170,38447,27623
110,13,1,2,1,0,0,3,137,190,37015,29042,120,195,38447,27626
111,13,1,4,1,0,0,3,95,101,37016,29046,92,323,38447,27629
112,13,1,1,2,1,2,1,327,220,37017,29047,318,17,38448,27630
113,13,1,0,0,3,1,0,334,198,37018,29047,312,273,38451,27630
114,13,2,4,1,0,0,3,261,265,37020,29051,242,357,38451,27633
115,13,1,2,1,0,0,3,302,261,37021,29053,263,156,38451,27636
116,13,5,3,0,3,1,0,359,201,37026,29056,331,217,38454,27636
117,14,2,1,0,3,1,0,141,60,37028,29057,170,83,38457,27636
118,14,2,3,1,0,0,3,170,275,37030,29060,124,197,38457,27639
119,14,4,1,0,3,1,0,467,138,37034,29061,439,110,38460,27639
120,14,0,2,1,0,0,3,301,202,37034,29063,273,140,38460,27642
121,14,3,1,0,3,1,0,362,202,37037,29064,334,222,38463,27642
122,14,1,1,2,1,2,1,272,315,37038,29065,206,358,38464,27643
123,14,0,1,1,0,0,3,276,202,37038,29066,301,159,38464,27646
124,14,0,2,1,0,0,3,261,267,37038,29068,242,271,38464,27649
125,14,3,0,0,3,1,0,402,158,37041,29068,391,216,38467,27649
126,15,0,1,1,0,0,3,95,102,37041,29069,92,166,38467,27652
127,15,1,4,1,0,0,3,171,279,37042,29073,124,198,38467,27655
128,15,0,2,1,0,0,3,320,253,37042,29075,277,225,38467,27658
129,15,1,1,2,1,2,1,237,208,37043,29076,206,259,38468,27659
130,15,2,2,2,1,2,1,329,222,37045,29078,319,171,38469,27660
131,15,0,2,1,0,0,3,201,168,37045,29080,214,276,38469,27663
132,15,1,3,1,0,0,3,303,264,37046,29083,263,20,38469,27666
133,15,2,1,0,3,1,0,139,191,37048,29084,123,217,38472,27666
134,15,2,2,2,1,2,1,485,118,37050,29086,428,324,38473,27667
135,16,1,0,0,3,1,0,335,198,37051,29086,315,197,38476,27667
136,16,4,0,0,3,1,0,324,253,37055,29086,280,23,38479,27667
137,16,1,3,1,0,0,3,468,141,37056,29089,439,262,38479,27670
138,16,0,1,1,0,0,3,141,61,37056,29090,170,143,38479,27673
139,16,1,4,1,0,0,3,262,271,37057,29094,242,113,38479,27676
140,16,1,0,0,3,1,0,403,158,37058,29094,394,271,38482,27676
141,16,1,1,2,1,2,1,304,265,37059,29095,264,84,38483,27677
142,16,1,3,1,0,0,3,302,205,37060,29098,273,361,38483,27680
143,16,2,3,1,0,0,3,274,318,37062,29101,206,174,38483,27683
144,17,1,4,1,0,0,3,172,283,37063,29105,124,228,38483,27686
145,17,3,5,1,0,0,3,204,173,37066,29110,214,327,38483,27689
146,17,2,0,0,3,1,0,331,222,37068,29110,322,159,38486,27689
147,17,0,2,1,0,0,3,237,210,37068,29112,206,23,38486,27692
148,17,2,1,0,3,1,0,364,203,37070,29113,337,166,38489,27692
149,17,1,1,2,1,2,1,96,103,37071,29114,93,218,38490,27693
150,17,2,2,2,1,2,1,278,204,37073,29116,302,199,38491,27694
151,17,1,1,2,1,2,1,140,192,37074,29117,124,217,38492,27695
152,17,1,0,0,3,1,0,486,118,37075,29117,431,276,38495,27695
153,18,1,3,1,0,0,3,275,321,37076,29120,206,274,38495,27698
154,18,0,0,2,1,2,1,262,271,37076,29120,243,24,38496,27699
155,18,1,0,0,3,1,0,336,198,37077,29120,318,174,38499,27699
156,18,2,0,0,3,1,0,470,141,37079,29120,442,84,38502,27699
157,18,1,0,0,3,1,0,325,253,37080,29120,283,217,38505,27699
158,18,1,2,1,0,0,3,142,63,37081,29122,170,364,38505,27702
159,18,0,1,1,0,0,3,302,206,37081,29123,273,116,38505,27705
160,18,1,0,0,3,1,0,332,222,37082,29123,325,143,38508,27705
161,18,2,3,1,0,0,3,405,161,37084,29126,394,265,38508,27708
162,19,2,2,2,1,2,1,239,212,37086,29128,207,160,38509,27709
163,19,0,2,1,0,0,3,172,285,37086,29130,124,330,38509,27712
164,19,3,0,0,3,1,0,281,204,37089,29130,305,166,38512,27712
165,19,0,1,1,0,0,3,364,204,37089,29131,337,200,38512,27715
166,19,1,2,1,0,0,3,97,105,37090,29133,93,26,38512,27718
167,19,4,1,0,3,1,0,144,193,37094,29134,127,228,38515,27718
168,19,3,0,0,3,1,0,307,265,37097,29134,267,276,38518,27718
169,19,0,0,2,1,2,1,204,173,37097,29134,215,200,38519,27719
170,19,3,1,0,3,1,0,489,119,37100,29135,434,218,38522,27719
171,20,1,0,0,3,1,0,326,253,37101,29135,286,174,38525,27719
172,20,3,3,2,1,2,1,335,225,37104,29138,326,275,38526,27720
173,20,3,2,0,3,1,0,145,65,37107,29140,173,116,38529,27720
174,20,1,1,2,1,2,1,337,199,37108,29141,319,85,38530,27721
175,20,0,0,2,1,2,1,302,206,37108,29141,274,218,38531,27722
176,20,3,1,0,3,1,0,408,162,37111,29142,397,330,38534,27722
177,20,2,0,0,3,1,0,277,321,37113,29142,209,24,38537,27722
178,20,0,3,1,0,0,3,364,207,37113,29145,337,367,38537,27725
179,20,1,1,2,1,2,1,263,272,37114,29146,244,144,38538,27726
180,21,0,1,1,0,0,3,145,66,37114,29147,173,163,38538,27729
181,21,1,1,2,1,2,1,240,213,37115,29148,208,86,38539,27730
182,21,0,1,1,0,0,3,172,286,37115,29149,124,268,38539,27733
183,21,3,0,0,3,1,0,473,141,37118,29149,445,200,38542,27733
184,21,1,0,0,3,1,0,308,265,37119,29149,270,228,38545,27733
185,21,1,1,2,1,2,1,278,322,37120,29150,210,167,38546,27734
186,21,0,0,2,1,2,1,281,204,37120,29150,306,277,38547,27735
187,21,0,1,1,0,0,3,144,194,37120,29151,127,147,38547,27738
188,22,1,0,0,3,1,0,98,105,37121,29151,96,24,38550,27738
189,22,1,0,0,3,1,0,282,204,37122,29151,309,275,38553,27738
190,22,1,2,1,0,0,3,205,175,37123,29153,215,29,38553,27741
191,22,2,2,2,1,2,1,265,274,37125,29155,245,331,38554,27742
192,22,0,2,1,0,0,3,326,255,37125,29157,286,370,38554,27745
193,22,3,1,0,3,1,0,367,208,37128,29158,340,218,38557,27745
194,22,3,1,0,3,1,0,338,226,37131,29159,329,116,38560,27745
195,22,5,0,0,3,1,0,413,162,37136,29159,400,218,38563,27745
196,22,0,2,1,0,0,3,337,201,37136,29161,319,203,38563,27748
197,23,0,6,1,0,0,3,278,328,37136,29167,210,203,38563,27751
198,23,3,2,0,3,1,0,175,288,37139,29169,127,275,38566,27751
199,23,1,4,1,0,0,3,145,198,37140,29173,127,271,38566,27754
200,23,2,0,0,3,1,0,147,66,37142,29173,176,167,38569,27754
201,23,2,2,2,1,2,1,304,208,37144,29175,275,278,38570,27755
202,23,3,0,0,3,1,0,101,105,37147,29175,99,163,38573,27755
203,23,1,1,2,1,2,1,309,266,37148,29176,271,175,38574,27756
204,23,3,1,0,3,1,0,476,142,37151,29177,448,228,38577,27756
205,23,4,2,0,3,1,0,493,121,37155,29179,437,147,38580,27756
206,24,4,1,0,3,1,0,244,214,37159,29180,211,218,38583,27756
207,24,0,1,1,0,0,3,338,227,37159,29181,329,27,38583,27759
208,24,0,0,2,1,2,1,265,274,37159,29181,246,87,38584,27760
209,24,4,1,0,3,1,0,341,202,37163,29182,322,116,38587,27760
210,24,2,2,2,1,2,1,328,257,37165,29184,287,204,38588,27761
211,24,0,2,1,0,0,3,205,177,37165,29186,215,221,38588,27764
212,24,1,0,0,3,1,0,283,204,37166,29186,312,29,38591,27764
213,24,1,1,2,1,2,1,477,143,37167,29187,449,371,38592,27765
214,24,4,2,0,3,1,0,371,210,37171,29189,343,278,38595,27765
215,25,1,1,2,1,2,1,176,289,37172,29190,128,148,38596,27766
216,25,6,0,0,3,1,0,419,162,37178,29190,403,116,38599,27766
217,25,1,1,2,1,2,1,305,209,37179,29191,276,222,38600,27767
218,25,3,0,0,3,1,0,312,266,37182,29191,274,167,38603,27767
219,25,1,2,1,0,0,3,102,107,37183,29193,99,206,38603,27770
220,25,3,1,0,3,1,0,496,122,37186,29194,440,175,38606,27770
221,25,1,3,1,0,0,3,148,69,37187,29197,176,334,38606,27773
222,25,2,1,0,3,1,0,330,258,37189,29198,290,275,38609,27773
223,25,2,1,0,3,1,0,343,203,37191,29199,325,271,38612,27773
224,26,3,1,0,3,1,0,281,329,37194,29200,213,218,38615,27773
225,26,1,2,1,0,0,3,266,276,37195,29202,246,166,38615,27776
226,26,4,1,0,3,1,0,375,211,37199,29203,346,204,38618,27776
227,26,1,1,2,1,2,1,284,205,37200,29204,313,28,38619,27777
228,26,2,0,0,3,1,0,207,177,37202,29204,218,87,38622,27777
229,26,1,3,1,0,0,3,146,201,37203,29207,127,32,38622,27780
230,26,1,3,1,0,0,3,339,230,37204,29210,329,231,38622,27783
231,26,1,1,2,1,2,1,478,144,37205,29211,450,279,38623,27784
232,26,0,2,1,0,0,3,244,216,37205,29213,211,374,38623,27787
233,27,0,0,2,1,2,1,312,266,37205,29213,275,205,38624,27788
234,27,0,1,1,0,0,3,148,70,37205,29214,176,209,38624,27791
235,27,1,1,2,1,2,1,420,163,37206,29215,404,29,38625,27792
236,27,3,1,0,3,1,0,105,108,37209,29216,102,175,38628,27792
237,27,2,1,0,3,1,0,246,217,37211,29217,214,116,38631,27792
238,27,2,0,0,3,1,0,377,211,37213,29217,349,334,38634,27792
239,27,0,0,2,1,2,1,343,203,37213,29217,326,223,38635,27793
240,27,1,1,2,1,2,1,331,259,37214,29218,291,149,38636,27794
241,27,5,0,0,3,1,0,501,122,37219,29218,443,167,38639,27794
242,28,0,1,1,0,0,3,146,202,37219,29219,127,178,38639,27797
243,28,1,2,1,0,0,3,306,211,37220,29221,276,234,38639,27800
244,28,0,1,1,0,0,3,281,330,37220,29222,213,274,38639,27803
245,28,3,2,0,3,1,0,210,179,37223,29224,221,275,38642,27803
246,28,2,0,0,3,1,0,422,163,37225,29224,407,32,38645,27803
247,28,1,4,1,0,0,3,267,280,37226,29228,246,212,38645,27806
248,28,3,0,0,3,1,0,481,144,37229,29228,453,166,38648,27806
249,28,3,1,0,3,1,0,179,290,37232,29229,131,87,38651,27806
250,28,1,2,1,0,0,3,313,268,37233,29231,275,377,38651,27809
251,29,0,0,2,1,2,1,343,203,37233,29231,327,168,38652,27810
252,29,4,0,0,3,1,0,335,259,37237,29231,294,223,38655,27810
253,29,2,0,0,3,1,0,379,211,37239,29231,352,149,38658,27810
254,29,1,3,1,0,0,3,149,73,37240,29234,176,32,38658,27813
255,29,1,0,0,3,1,0,247,217,37241,29234,217,205,38661,27813
256,29,1,2,1,0,0,3,340,232,37242,29236,329,282,38661,27816
257,29,0,2,1,0,0,3,284,207,37242,29238,313,221,38661,27819
258,29,0,2,1,0,0,3,146,204,37242,29240,127,337,38661,27822
259,29,0,1,1,0,0,3,105,109,37242,29241,102,380,38661,27825
0,1,3,1,0,3,1,0,3,1,37245,29242,3,0,38664,27825
1,1,0,1,1,0,0,3,0,1,37245,29243,0,3,38664,27828
2,1,0,1,1,0,0,3,0,1,37245,29244,0,3,38664,27831
3,1,1,0,0,3,1,0,1,0,37246,29244,3,0,38667,27831
4,1,0,1,1,0,0,3,0,1,37246,29245,0,3,38667,27834
5,1,0,0,2,1,2,1,0,0,37246,29245,1,1,38668,27835
6,1,1,2,1,0,0,3,1,2,37247,29247,0,3,38668,27838
7,1,0,0,2,1,2,1,0,0,37247,29247,1,1,38669,27839
8,2,1,1,2,1,2,1,1,1,37248,29248,1,1,38670,27840
9,2,0,0,2,1,2,1,0,0,37248,29248,1,1,38671,27841
10,2,2,1,0,3,1,0,2,1,37250,29249,3,0,38674,27841
11,2,0,1,1,0,0,3,0,1,37250,29250,0,3,38674,27844
12,2,0,0,2,1,2,1,0,0,37250,29250,1,1,38675,27845
13,2,1,0,0,3,1,0,1,0,37251,29250,3,0,38678,27845
14,2,3,0,0,3,1,0,3,0,37254,29250,3,0,38681,27845
15,2,0,0,2,1,2,1,0,0,37254,29250,1,1,38682,27846
16,3,1,3,1,0,0,3,3,4,37255,29253,3,4,38682,27849
17,3,3,0,0,3,1,0,4,2,37258,29253,3,3,38685,27849
18,3,2,2,2,1,2,1,3,2,37260,29255,4,1,38686,27850
19,3,2,1,0,3,1,0,2,1,37262,29256,4,3,38689,27850
20,3,1,0,0,3,1,0,4,1,37263,29256,6,0,38692,27850
21,3,1,0,0,3,1,0,1,0,37264,29256,4,1,38695,27850
22,3,0,2,1,0,0,3,0,3,37264,29258,0,6,38695,27853
23,3,1,3,1,0,0,3,1,4,37265,29261,0,3,38695,27856
24,4,2,1,0,3,1,0,2,1,37267,29262,4,0,38698,27856
25,4,0,0,2,1,2,1,1,0,37267,29262,4,2,38699,27857
26,4,3,2,0,3,1,0,6,2,37270,29264,6,1,38702,27857
27,4,1,1,2,1,2,1,1,2,37271,29265,1,2,38703,27858
28,4,3,1,0,3,1,0,3,2,37274,29266,3,1,38706,27858
29,4,2,1,0,3,1,0,2,1,37276,29267,4,3,38709,27858
30,4,3,0,0,3,1,0,4,1,37279,29267,4,3,38712,27858
31,4,0,0,2,1,2,1,0,0,37279,29267,2,1,38713,27859
32,5,2,0,0,3,1,0,3,0,37281,29267,7,1,38716,27859
33,5,1,1,2,1,2,1,3,2,37282,29268,5,1,38717,27860
34,5,1,0,0,3,1,0,3,1,37283,29268,7,1,38720,27860
35,5,2,2,2,1,2,1,2,5,37285,29270,1,4,38721,27861
36,5,0,0,2,1,2,1,1,4,37285,29270,1,4,38722,27862
37,5,2,2,2,1,2,1,5,4,37287,29272,5,2,38723,27863
38,5,2,0,0,3,1,0,6,2,37289,29272,6,3,38726,27863
39,5,0,2,1,0,0,3,3,6,37289,29274,3,9,38726,27866
40,6,3,1,0,3,1,0,7,2,37292,29275,9,3,38729,27866
41,6,3,1,0,3,1,0,7,2,37295,29276,7,4,38732,27866
42,6,0,1,1,0,0,3,1,3,37295,29277,1,3,38732,27869
43,6,2,0,0,3,1,0,8,2,37297,29277,9,2,38735,27869
44,6,1,0,0,3,1,0,3,1,37298,29277,7,1,38738,27869
45,6,1,0,0,3,1,0,4,2,37299,29277,6,1,38741,27869
46,6,1,1,2,1,2,1,2,1,37300,29278,5,4,38742,27870
47,6,1,0,0,3,1,0,1,0,37301,29278,5,2,38745,27870
48,7,2,1,0,3,1,0,5,2,37303,29279,10,4,38748,27870
49,7,3,1,0,3,1,0,6,1,37306,29280,10,4,38751,27870
50,7,0,0,2,1,2,1,2,5,37306,29280,2,2,38752,27871
51,7,3,1,0,3,1,0,6,7,37309,29281,6,1,38755,27871
52,7,1,2,1,0,0,3,2,6,37310,29283,1,5,38755,27874
53,7,1,0,0,3,1,0,7,2,37311,29283,9,2,38758,27874
54,7,1,1,2,1,2,1,4,3,37312,29284,6,4,38759,27875
55,7,1,1,2,1,2,1,4,2,37313,29285,8,10,38760,27876
56,8,2,1,0,3,1,0,9,3,37315,29286,10,4,38763,27876
57,8,1,1,2,1,2,1,6,5,37316,29287,6,2,38764,27877
58,8,2,1,0,3,1,0,3,1,37318,29288,8,4,38767,27877
59,8,3,1,0,3,1,0,10,3,37321,29289,12,2,38770,27877
60,8,1,0,0,3,1,0,2,3,37322,29289,4,3,38773,27877
61,8,1,0,0,3,1,0,3,1,37323,29289,8,1,38776,27877
62,8,0,1,1,0,0,3,4,3,37323,29290,6,6,38776,27880
63,8,5,1,0,3,1,0,13,3,37328,29291,12,1,38779,27880
64,9,2,0,0,3,1,0,9,2,37330,29291,12,5,38782,27880
65,9,2,0,0,3,1,0,4,5,37332,29291,5,2,38785,27880
66,9,0,1,1,0,0,3,9,4,37332,29292,10,13,38785,27883
67,9,1,0,0,3,1,0,7,7,37333,29292,9,4,38788,27883
68,9,3,1,0,3,1,0,7,4,37336,29293,9,3,38791,27883
69,9,1,1,2,1,2,1,7,2,37337,29294,11,3,38792,27884
70,9,1,2,1,0,0,3,6,4,37338,29296,10,7,38792,27887
71,9,2,0,0,3,1,0,6,2,37340,29296,11,1,38795,27887
72,10,3,3,2,1,2,1,6,4,37343,29299,9,2,38796,27888
73,10,0,1,1,0,0,3,6,6,37343,29300,6,7,38796,27891
74,10,2,2,2,1,2,1,6,5,37345,29302,7,5,38797,27892
75,10,1,1,2,1,2,1,3,4,37346,29303,5,2,38798,27893
76,10,1,1,2,1,2,1,3,7,37347,29304,2,3,38799,27894
77,10,2,3,1,0,0,3,12,6,37349,29307,12,5,38799,27897
78,10,5,0,0,3,1,0,18,3,37354,29307,15,6,38802,27897
79,10,2,3,1,0,0,3,5,4,37356,29310,8,7,38802,27900
80,11,0,0,2,1,2,1,7,7,37356,29310,10,4,38803,27901
81,11,2,1,0,3,1,0,8,3,37358,29311,14,2,38806,27901
82,11,1,2,1,0,0,3,10,6,37359,29313,10,10,38806,27904
83,11,3,1,0,3,1,0,7,6,37362,29314,8,5,38809,27904
84,11,1,0,0,3,1,0,7,4,37363,29314,13,4,38812,27904
85,11,1,1,2,1,2,1,8,3,37364,29315,12,6,38813,27905
86,11,4,0,0,3,1,0,13,2,37368,29315,15,3,38816,27905
87,11,2,0,0,3,1,0,20,3,37370,29315,18,1,38819,27905
88,12,0,1,1,0,0,3,6,5,37370,29316,9,8,38819,27908
89,12,1,0,0,3,1,0,7,6,37371,29316,9,3,38822,27908
90,12,2,0,0,3,1,0,5,4,37373,29316,8,7,38825,27908
91,12,1,1,2,1,2,1,6,5,37374,29317,9,14,38826,27909
92,12,0,1,1,0,0,3,3,8,37374,29318,2,5,38826,27912
93,12,1,2,1,0,0,3,7,7,37375,29320,7,5,38826,27915
94,12,1,3,1,0,0,3,8,7,37376,29323,9,9,38826,27918
95,12,2,0,0,3,1,0,14,6,37378,29323,15,7,38829,27918
96,13,2,0,0,3,1,0,15,2,37380,29323,18,3,38832,27918
97,13,1,1,2,1,2,1,9,4,37381,29324,15,6,38833,27919
98,13,3,1,0,3,1,0,10,5,37384,29325,16,2,38836,27919
99,13,1,1,2,1,2,1,8,7,37385,29326,9,7,38837,27920
100,13,1,3,1,0,0,3,8,10,37386,29329,7,13,38837,27923
101,13,2,1,0,3,1,0,9,8,37388,29330,13,3,38840,27923
102,13,1,0,0,3,1,0,21,3,37389,29330,21,4,38843,27923
103,13,1,5,1,0,0,3,11,11,37390,29335,10,7,38843,27926
104,14,5,0,0,3,1,0,19,6,37395,29335,18,8,38846,27926
105,14,5,2,0,3,1,0,20,4,37400,29337,21,5,38849,27926
106,14,3,2,0,3,1,0,11,9,37403,29339,12,7,38852,27926
107,14,1,1,2,1,2,1,6,5,37404,29340,9,2,38853,27927
108,14,0,3,1,0,0,3,3,11,37404,29343,2,8,38853,27930
109,14,0,0,2,1,2,1,8,3,37404,29343,13,8,38854,27931
110,14,0,3,1,0,0,3,7,9,37404,29346,9,17,38854,27934
111,14,0,3,1,0,0,3,6,8,37404,29349,9,16,38854,27937
112,15,3,4,1,0,0,3,11,14,37407,29353,7,7,38854,27940
113,15,4,1,0,3,1,0,25,4,37411,29354,24,7,38857,27940
114,15,2,1,0,3,1,0,8,6,37413,29355,12,2,38860,27940
115,15,0,1,1,0,0,3,8,8,37413,29356,9,6,38860,27943
116,15,0,0,2,1,2,1,9,8,37413,29356,14,8,38861,27944
117,15,0,0,2,1,2,1,11,11,37413,29356,11,7,38862,27945
118,15,1,2,1,0,0,3,10,6,37414,29358,15,6,38862,27948
119,15,0,3,1,0,0,3,10,8,37414,29361,16,12,38862,27951
120,16,0,3,1,0,0,3,11,17,37414,29364,7,5,38862,27954
121,16,1,0,0,3,1,0,11,6,37415,29364,18,6,38865,27954
122,16,2,3,1,0,0,3,10,9,37417,29367,12,10,38865,27957
123,16,1,0,0,3,1,0,10,8,37418,29367,17,5,38868,27957
124,16,2,4,1,0,0,3,8,12,37420,29371,9,10,38868,27960
125,16,0,3,1,0,0,3,10,11,37420,29374,16,11,38868,27963
126,16,3,1,0,3,1,0,28,5,37423,29375,27,6,38871,27963
127,16,0,1,1,0,0,3,11,12,37423,29376,11,15,38871,27966
128,17,1,1,2,1,2,1,8,10,37424,29377,10,9,38872,27967
129,17,2,1,0,3,1,0,10,4,37426,29378,16,8,38875,27967
130,17,2,2,2,1,2,1,21,8,37428,29380,19,8,38876,27968
131,17,2,3,1,0,0,3,10,11,37430,29383,9,10,38876,27971
132,17,0,1,1,0,0,3,11,10,37430,29384,12,20,38876,27974
133,17,1,1,2,1,2,1,4,12,37431,29385,3,3,38877,27975
134,17,4,2,0,3,1,0,24,6,37435,29387,24,8,38880,27975
135,17,0,3,1,0,0,3,6,8,37435,29390,9,19,38880,27978
136,18,3,3,2,1,2,1,13,12,37438,29393,13,7,38881,27979
137,18,1,2,1,0,0,3,7,10,37439,29395,9,8,38881,27982
138,18,0,0,2,1,2,1,11,6,37439,29395,19,9,38882,27983
139,18,0,1,1,0,0,3,11,18,37439,29396,7,13,38882,27986
140,18,3,3,2,1,2,1,14,15,37442,29399,12,12,38883,27987
141,18,0,2,1,0,0,3,10,13,37442,29401,16,9,38883,27990
142,18,1,0,0,3,1,0,29,5,37443,29401,30,5,38886,27990
143,18,0,2,1,0,0,3,8,14,37443,29403,9,18,38886,27993
144,19,0,1,1,0,0,3,10,9,37443,29404,17,12,38886,27996
145,19,2,2,2,1,2,1,12,6,37445,29406,17,20,38887,27997
146,19,1,0,0,3,1,0,9,10,37446,29406,13,10,38890,27997
147,19,3,1,0,3,1,0,7,13,37449,29407,6,8,38893,27997
148,19,2,0,0,3,1,0,12,11,37451,29407,12,3,38896,27997
149,19,3,0,0,3,1,0,27,6,37454,29407,27,10,38899,27997
150,19,0,2,1,0,0,3,21,10,37454,29409,19,23,38899,28000
151,19,0,0,2,1,2,1,11,10,37454,29409,13,9,38900,28001
152,20,3,0,0,3,1,0,32,5,37457,29409,33,9,38903,28001
153,20,0,1,1,0,0,3,10,14,37457,29410,16,13,38903,28004
154,20,1,1,2,1,2,1,12,19,37458,29411,8,10,38904,28005
155,20,0,1,1,0,0,3,14,16,37458,29412,12,8,38904,28008
156,20,1,1,2,1,2,1,9,15,37459,29413,10,8,38905,28009
157,20,1,0,0,3,1,0,8,10,37460,29413,12,12,38908,28009
158,20,1,2,1,0,0,3,22,12,37461,29415,19,16,38908,28012
159,20,0,2,1,0,0,3,13,14,37461,29417,13,21,38908,28015
160,21,0,2,1,0,0,3,11,8,37461,29419,19,11,38908,28018
161,21,2,0,0,3,1,0,11,10,37463,29419,16,9,38911,28018
162,21,0,3,1,0,0,3,12,9,37463,29422,17,26,38911,28021
163,21,1,0,0,3,1,0,13,11,37464,29422,15,12,38914,28021
164,21,0,1,1,0,0,3,11,11,37464,29423,13,6,38914,28024
165,21,2,1,0,3,1,0,29,7,37466,29424,30,10,38917,28024
166,21,1,0,0,3,1,0,11,9,37467,29424,20,20,38920,28024
167,21,0,0,2,1,2,1,7,13,37467,29424,7,9,38921,28025
168,22,0,0,2,1,2,1,14,16,37467,29424,13,13,38922,28026
169,22,2,0,0,3,1,0,34,5,37469,29424,36,13,38925,28026
170,22,0,1,1,0,0,3,8,11,37469,29425,12,11,38925,28029
171,22,0,0,2,1,2,1,9,15,37469,29425,11,11,38926,28030
172,22,1,0,0,3,1,0,14,14,37470,29425,16,12,38929,28030
173,22,2,1,0,3,1,0,24,13,37472,29426,22,21,38932,28030
174,22,0,0,2,1,2,1,11,10,37472,29426,17,9,38933,28031
175,22,1,1,2,1,2,1,13,20,37473,29427,9,10,38934,28032
176,23,3,1,0,3,1,0,14,12,37476,29428,16,16,38937,28032
177,23,0,0,2,1,2,1,13,11,37476,29428,16,21,38938,28033
178,23,1,1,2,1,2,1,12,9,37477,29429,20,10,38939,28034
179,23,0,3,1,0,0,3,7,16,37477,29432,7,13,38939,28037
180,23,1,1,2,1,2,1,12,10,37478,29433,21,12,38940,28038
181,23,1,1,2,1,2,1,30,8,37479,29434,31,7,38941,28039
182,23,0,2,1,0,0,3,10,16,37479,29436,16,29,38941,28042
183,23,0,2,1,0,0,3,12,11,37479,29438,17,12,38941,28045
184,24,2,1,0,3,1,0,15,21,37481,29439,12,13,38944,28045
185,24,0,0,2,1,2,1,14,14,37481,29439,17,14,38945,28046
186,24,2,1,0,3,1,0,11,16,37483,29440,14,10,38948,28046
187,24,2,2,2,1,2,1,9,18,37485,29442,8,13,38949,28047
188,24,4,0,0,3,1,0,12,11,37489,29442,15,11,38952,28047
189,24,3,1,0,3,1,0,37,6,37492,29443,39,12,38955,28047
190,24,1,0,0,3,1,0,25,13,37493,29443,25,11,38958,28047
191,24,1,5,1,0,0,3,12,15,37494,29448,17,24,38958,28050
192,25,1,3,1,0,0,3,11,19,37495,29451,16,16,38958,28053
193,25,1,0,0,3,1,0,15,16,37496,29451,16,7,38961,28053
194,25,1,2,1,0,0,3,15,14,37497,29453,16,15,38961,28056
195,25,2,0,0,3,1,0,15,11,37499,29453,19,10,38964,28056
196,25,1,3,1,0,0,3,13,14,37500,29456,17,12,38964,28059
197,25,1,1,2,1,2,1,13,10,37501,29457,21,22,38965,28060
198,25,1,2,1,0,0,3,31,10,37502,29459,31,32,38965,28063
199,25,1,0,0,3,1,0,13,10,37503,29459,24,16,38968,28063
200,26,1,1,2,1,2,1,13,12,37504,29460,16,11,38969,28064
201,26,2,0,0,3,1,0,16,14,37506,29460,20,12,38972,28064
202,26,1,6,1,0,0,3,13,21,37507,29466,17,14,38972,28067
203,26,4,1,0,3,1,0,15,17,37511,29467,17,14,38975,28067
204,26,1,0,0,3,1,0,16,14,37512,29467,19,11,38978,28067
205,26,2,3,1,0,0,3,17,24,37514,29470,12,35,38978,28070
206,26,2,1,0,3,1,0,11,19,37516,29471,11,24,38981,28070
207,26,3,1,0,3,1,0,28,14,37519,29472,28,13,38984,28070
208,27,1,1,2,1,2,1,16,17,37520,29473,17,11,38985,28071
209,27,0,0,2,1,2,1,13,14,37520,29473,18,17,38986,28072
210,27,2,0,0,3,1,0,15,10,37522,29473,24,16,38989,28072
211,27,1,0,0,3,1,0,16,11,37523,29473,22,12,38992,28072
212,27,0,1,1,0,0,3,11,20,37523,29474,16,10,38992,28075
213,27,2,1,0,3,1,0,33,11,37525,29475,34,13,38995,28075
214,27,3,2,0,3,1,0,40,8,37528,29477,42,22,38998,28075
215,27,1,1,2,1,2,1,14,11,37529,29478,25,16,38999,28076
216,28,2,1,0,3,1,0,15,22,37531,29479,20,13,39002,28076
217,28,2,1,0,3,1,0,18,15,37533,29480,23,10,39005,28076
218,28,1,1,2,1,2,1,17,15,37534,29481,20,15,39006,28077
219,28,1,2,1,0,0,3,12,21,37535,29483,11,14,39006,28080
220,28,0,0,2,1,2,1,28,14,37535,29483,29,15,39007,28081
221,28,1,0,0,3,1,0,14,12,37536,29483,19,12,39010,28081
222,28,1,1,2,1,2,1,14,15,37537,29484,19,25,39011,28082
223,28,0,4,1,0,0,3,15,21,37537,29488,17,38,39011,28085
224,29,0,1,1,0,0,3,18,16,37537,29489,23,14,39011,28088
225,29,1,0,0,3,1,0,18,24,37538,29489,15,16,39014,28088
226,29,0,0,2,1,2,1,16,17,37538,29489,18,17,39015,28089
227,29,3,3,2,1,2,1,43,11,37541,29492,43,18,39016,28090
228,29,1,0,0,3,1,0,12,20,37542,29492,19,12,39019,28090
229,29,1,0,0,3,1,0,16,10,37543,29492,27,13,39022,28090
230,29,0,1,1,0,0,3,14,12,37543,29493,25,14,39022,28093
231,29,1,2,1,0,0,3,17,13,37544,29495,22,28,39022,28096
232,30,2,2,2,1,2,1,16,17,37546,29497,20,16,39023,28097
233,30,0,2,1,0,0,3,17,17,37546,29499,20,17,39023,28100
234,30,0,3,1,0,0,3,12,24,37546,29502,11,16,39023,28103
235,30,3,3,2,1,2,1,36,14,37549,29505,35,16,39024,28104
236,30,5,1,0,3,1,0,20,23,37554,29506,23,12,39027,28104
237,30,0,2,1,0,0,3,14,14,37554,29508,19,41,39027,28107
238,30,3,1,0,3,1,0,18,22,37557,29509,20,10,39030,28107
239,30,0,1,1,0,0,3,28,15,37557,29510,29,25,39030,28110
0,1,2,2,2,1,2,1,2,2,37559,29512,1,29,39031,28111
1,1,0,0,2,1,2,1,17,13,37559,29512,23,18,39032,28112
2,1,1,1,2,1,2,1,19,17,37560,29513,24,15,39033,28113
3,1,0,0,2,1,2,1,14,14,37560,29513,20,14,39034,28114
4,1,0,0,2,1,2,1,0,0,37560,29513,1,18,39035,28115
5,1,2,1,0,3,1,0,20,23,37562,29514,23,18,39038,28115
6,1,0,1,1,0,0,3,16,11,37562,29515,27,44,39038,28118
7,1,1,2,1,0,0,3,13,22,37563,29517,19,15,39038,28121
8,2,3,1,0,3,1,0,46,12,37566,29518,46,0,39041,28121
9,2,3,1,0,3,1,0,39,15,37569,29519,38,0,39044,28121
10,2,1,0,0,3,1,0,17,17,37570,29519,21,16,39047,28121
11,2,2,1,0,3,1,0,22,24,37572,29520,26,16,39050,28121
12,2,0,0,2,1,2,1,17,17,37572,29520,21,26,39051,28122
13,2,2,0,0,3,1,0,30,15,37574,29520,32,16,39054,28122
14,2,2,2,2,1,2,1,18,19,37576,29522,21,15,39055,28123
15,2,1,4,1,0,0,3,15,16,37577,29526,25,19,39055,28126
16,3,2,0,0,3,1,0,4,2,37579,29526,4,15,39058,28126
17,3,0,1,1,0,0,3,17,14,37579,29527,23,18,39058,28129
18,3,0,0,2,1,2,1,0,0,37579,29527,2,19,39059,28130
19,3,0,3,1,0,0,3,16,14,37579,29530,27,17,39059,28133
20,3,2,3,1,0,0,3,21,20,37581,29533,24,19,39059,28136
21,3,0,1,1,0,0,3,20,24,37581,29534,23,21,39059,28139
22,3,0,2,1,0,0,3,15,18,37581,29536,25,32,39059,28142
23,3,2,5,1,0,0,3,15,27,37583,29541,19,47,39059,28145
24,4,3,0,0,3,1,0,49,12,37586,29541,49,15,39062,28145
25,4,2,1,0,3,1,0,41,16,37588,29542,41,19,39065,28145
26,4,2,3,1,0,0,3,24,27,37590,29545,26,29,39065,28148
27,4,0,1,1,0,0,3,17,18,37590,29546,21,19,39065,28151
28,4,1,2,1,0,0,3,19,21,37591,29548,21,3,39065,28154
29,4,3,1,0,3,1,0,33,16,37594,29549,35,0,39068,28154
30,4,2,1,0,3,1,0,16,15,37596,29550,23,16,39071,28154
31,4,4,0,0,3,1,0,21,17,37600,29550,24,18,39074,28154
32,5,1,1,2,1,2,1,5,3,37601,29551,5,19,39075,28155
33,5,1,0,0,3,1,0,16,18,37602,29551,28,19,39078,28155
34,5,1,3,1,0,0,3,16,30,37603,29554,19,22,39078,28158
35,5,1,0,0,3,1,0,21,24,37604,29554,26,17,39081,28158
36,5,0,0,2,1,2,1,0,0,37604,29554,3,48,39082,28159
37,5,4,1,0,3,1,0,45,17,37608,29555,44,15,39085,28159
38,5,1,1,2,1,2,1,17,15,37609,29556,28,22,39086,28160
39,5,2,3,1,0,0,3,19,17,37611,29559,23,32,39086,28163
40,6,2,2,2,1,2,1,51,14,37613,29561,50,33,39087,28164
41,6,2,0,0,3,1,0,35,16,37615,29561,38,18,39090,28164
42,6,3,0,0,3,1,0,24,20,37618,29561,27,15,39093,28164
43,6,0,0,2,1,2,1,17,18,37618,29561,22,17,39094,28165
44,6,1,2,1,0,0,3,25,29,37619,29563,26,3,39094,28168
45,6,2,1,0,3,1,0,21,22,37621,29564,24,19,39097,28168
46,6,2,1,0,3,1,0,18,16,37623,29565,26,19,39100,28168
47,6,4,0,0,3,1,0,25,17,37627,29565,27,3,39103,28168
48,7,2,1,0,3,1,0,23,25,37629,29566,29,17,39106,28168
49,7,4,1,0,3,1,0,49,18,37633,29567,47,19,39109,28168
50,7,2,2,2,1,2,1,2,2,37635,29569,4,23,39110,28169
51,7,1,0,0,3,1,0,17,18,37636,29569,31,19,39113,28169
52,7,1,0,0,3,1,0,17,30,37637,29569,22,22,39116,28169
53,7,0,1,1,0,0,3,17,16,37637,29570,28,35,39116,28172
54,7,0,3,1,0,0,3,25,20,37637,29573,27,51,39116,28175
55,7,0,0,2,1,2,1,5,3,37637,29573,6,18,39117,28176
56,8,2,0,0,3,1,0,27,29,37639,29573,29,15,39120,28176
57,8,1,0,0,3,1,0,22,22,37640,29573,27,19,39123,28176
58,8,0,1,1,0,0,3,17,19,37640,29574,22,36,39123,28179
59,8,1,0,0,3,1,0,19,16,37641,29574,29,15,39126,28179
60,8,2,0,0,3,1,0,21,17,37643,29574,26,19,39129,28179
61,8,5,0,0,3,1,0,56,14,37648,29574,53,18,39132,28179
62,8,3,0,0,3,1,0,38,16,37651,29574,41,3,39135,28179
63,8,6,1,0,3,1,0,30,21,37657,29575,30,3,39138,28179
64,9,3,0,0,3,1,0,59,14,37660,29575,56,19,39141,28179
65,9,0,0,2,1,2,1,25,20,37660,29575,28,23,39142,28180
66,9,2,1,0,3,1,0,51,19,37662,29576,50,19,39145,28180
67,9,2,1,0,3,1,0,19,19,37664,29577,34,18,39148,28180
68,9,2,0,0,3,1,0,19,30,37666,29577,25,15,39151,28180
69,9,2,1,0,3,1,0,19,17,37668,29578,31,17,39154,28180
70,9,0,2,1,0,0,3,2,4,37668,29580,4,38,39154,28183
71,9,0,0,2,1,2,1,5,3,37668,29580,7,24,39155,28184
72,10,1,5,1,0,0,3,28,34,37669,29585,29,22,39155,28187
73,10,3,2,0,3,1,0,22,18,37672,29587,32,15,39158,28187
74,10,0,0,2,1,2,1,22,22,37672,29587,28,52,39159,28188
75,10,2,1,0,3,1,0,19,20,37674,29588,25,3,39162,28188
76,10,2,1,0,3,1,0,23,18,37676,29589,29,18,39165,28188
77,10,0,0,2,1,2,1,23,25,37676,29589,30,4,39166,28189
78,10,1,1,2,1,2,1,39,17,37677,29590,42,37,39167,28190
79,10,3,1,0,3,1,0,33,22,37680,29591,33,19,39170,28190
80,11,0,1,1,0,0,3,25,21,37680,29592,28,21,39170,28193
81,11,2,2,2,1,2,1,21,21,37682,29594,35,25,39171,28194
82,11,1,0,0,3,1,0,52,19,37683,29594,53,38,39174,28194
83,11,2,0,0,3,1,0,4,4,37685,29594,7,17,39177,28194
84,11,2,1,0,3,1,0,7,4,37687,29595,10,19,39180,28194
85,11,3,2,0,3,1,0,62,16,37690,29597,59,23,39183,28194
86,11,1,1,2,1,2,1,29,35,37691,29598,30,20,39184,28195
87,11,3,0,0,3,1,0,22,17,37694,29598,34,15,39187,28195
88,12,5,2,0,3,1,0,44,19,37699,29600,45,19,39190,28195
89,12,1,2,1,0,0,3,20,22,37700,29602,25,55,39190,28198
90,12,1,0,0,3,1,0,34,22,37701,29602,36,18,39193,28198
91,12,2,0,0,3,1,0,25,18,37703,29602,32,4,39196,28198
92,12,1,1,2,1,2,1,24,26,37704,29603,31,4,39197,28199
93,12,1,0,0,3,1,0,20,30,37705,29603,28,22,39200,28199
94,12,0,1,1,0,0,3,22,19,37705,29604,32,40,39200,28202
95,12,0,2,1,0,0,3,22,24,37705,29606,28,18,39200,28205
96,13,5,1,0,3,1,0,57,20,37710,29607,56,17,39203,28205
97,13,1,1,2,1,2,1,23,18,37711,29608,35,5,39204,28206
98,13,2,0,0,3,1,0,64,16,37713,29608,62,25,39207,28206
99,13,2,1,0,3,1,0,6,5,37715,29609,10,19,39210,28206
100,13,1,1,2,1,2,1,22,22,37716,29610,36,16,39211,28207
101,13,0,3,1,0,0,3,29,38,37716,29613,30,24,39211,28210
102,13,1,1,2,1,2,1,26,22,37717,29614,29,39,39212,28211
103,13,3,4,1,0,0,3,25,28,37720,29618,28,26,39212,28214
104,14,1,1,2,1,2,1,25,27,37721,29619,32,19,39213,28215
105,14,0,0,2,1,2,1,34,22,37721,29619,37,56,39214,28216
106,14,2,1,0,3,1,0,24,20,37723,29620,35,20,39217,28216
107,14,1,0,0,3,1,0,26,18,37724,29620,35,19,39220,28216
108,14,0,3,1,0,0,3,7,7,37724,29623,10,21,39220,28219
109,14,0,4,1,0,0,3,20,34,37724,29627,28,43,39220,28222
110,14,1,0,0,3,1,0,24,18,37725,29627,38,4,39223,28222
111,14,1,2,1,0,0,3,21,24,37726,29629,25,29,39223,28225
112,15,1,1,2,1,2,1,30,39,37727,29630,31,26,39224,28226
113,15,0,0,2,1,2,1,6,5,37727,29630,11,6,39225,28227
114,15,4,1,0,3,1,0,61,21,37731,29631,59,16,39228,28227
115,15,2,0,0,3,1,0,66,16,37733,29631,65,17,39231,28227
116,15,2,2,2,1,2,1,24,24,37735,29633,37,20,39232,28228
117,15,2,1,0,3,1,0,27,29,37737,29634,31,24,39235,28228
118,15,0,2,1,0,0,3,26,24,37737,29636,29,25,39235,28231
119,15,2,1,0,3,1,0,46,20,37739,29637,48,39,39238,28231
120,16,0,0,2,1,2,1,26,24,37739,29637,30,21,39239,28232
121,16,1,2,1,0,0,3,22,26,37740,29639,25,29,39239,28235
122,16,2,0,0,3,1,0,26,24,37742,29639,40,4,39242,28235
123,16,2,1,0,3,1,0,32,40,37744,29640,34,16,39245,28235
124,16,2,1,0,3,1,0,48,21,37746,29641,51,17,39248,28235
125,16,3,1,0,3,1,0,69,17,37749,29642,68,25,39251,28235
126,16,3,1,0,3,1,0,64,22,37752,29643,62,6,39254,28235
127,16,0,0,2,1,2,1,27,29,37752,29643,32,40,39255,28236
128,17,1,0,0,3,1,0,25,18,37753,29643,41,21,39258,28236
129,17,0,0,2,1,2,1,26,18,37753,29643,36,20,39259,28237
130,17,1,2,1,0,0,3,7,7,37754,29645,11,46,39259,28240
131,17,2,4,1,0,0,3,22,38,37756,29649,28,22,39259,28243
132,17,2,3,1,0,0,3,27,30,37758,29652,32,23,39259,28246
133,17,2,0,0,3,1,0,36,22,37760,29652,40,24,39262,28246
134,17,3,1,0,3,1,0,10,8,37763,29653,13,56,39265,28246
135,17,1,2,1,0,0,3,25,22,37764,29655,35,32,39265,28249
136,18,3,0,0,3,1,0,51,21,37767,29655,54,16,39268,28249
137,18,2,0,0,3,1,0,27,22,37769,29655,38,40,39271,28249
138,18,4,1,0,3,1,0,68,23,37773,29656,65,21,39274,28249
139,18,3,1,0,3,1,0,35,41,37776,29657,37,4,39277,28249
140,18,0,2,1,0,0,3,27,31,37776,29659,32,20,39277,28252
141,18,0,1,1,0,0,3,22,27,37776,29660,25,28,39277,28255
142,18,4,0,0,3,1,0,73,17,37780,29660,71,21,39280,28255
143,18,0,2,1,0,0,3,26,26,37780,29662,30,9,39280,28258
144,19,1,3,1,0,0,3,27,21,37781,29665,36,32,39280,28261
145,19,0,3,1,0,0,3,10,11,37781,29668,13,35,39280,28264
146,19,0,0,2,1,2,1,22,38,37781,29668,29,25,39281,28265
147,19,4,1,0,3,1,0,30,25,37785,29669,43,20,39284,28265
148,19,1,1,2,1,2,1,8,8,37786,29670,12,24,39285,28266
149,19,1,3,1,0,0,3,28,33,37787,29673,32,59,39285,28269
150,19,1,0,0,3,1,0,37,22,37788,29673,43,22,39288,28269
151,19,1,0,0,3,1,0,26,18,37789,29673,44,46,39291,28269
152,20,1,0,0,3,1,0,28,22,37790,29673,41,21,39294,28269
153,20,0,0,2,1,2,1,26,26,37790,29673,31,47,39295,28270
154,20,0,2,1,0,0,3,35,43,37790,29675,37,24,39295,28273
155,20,2,3,1,0,0,3,24,30,37792,29678,25,19,39295,28276
156,20,0,0,2,1,2,1,27,31,37792,29678,33,10,39296,28277
157,20,1,0,0,3,1,0,38,22,37793,29678,46,20,39299,28277
158,20,2,0,0,3,1,0,75,17,37795,29678,74,4,39302,28277
159,20,4,0,0,3,1,0,55,21,37799,29678,57,28,39305,28277
160,21,2,3,1,0,0,3,70,26,37801,29681,65,62,39305,28280
161,21,1,3,1,0,0,3,31,28,37802,29684,43,38,39305,28283
162,21,1,0,0,3,1,0,29,33,37803,29684,35,40,39308,28283
163,21,4,0,0,3,1,0,31,21,37807,29684,39,25,39311,28283
164,21,1,1,2,1,2,1,9,9,37808,29685,13,21,39312,28284
165,21,1,2,1,0,0,3,11,13,37809,29687,13,25,39312,28287
166,21,1,0,0,3,1,0,27,18,37810,29687,47,32,39315,28287
167,21,1,3,1,0,0,3,23,41,37811,29690,29,27,39315,28290
168,22,2,1,0,3,1,0,30,23,37813,29691,44,4,39318,28290
169,22,2,1,0,3,1,0,57,22,37815,29692,60,21,39321,28290
170,22,1,1,2,1,2,1,76,18,37816,29693,75,22,39322,28291
171,22,4,4,2,1,2,1,31,35,37820,29697,34,25,39323,28292
172,22,3,0,0,3,1,0,34,21,37823,29697,42,19,39326,28292
173,22,1,0,0,3,1,0,25,30,37824,29697,28,10,39329,28292
174,22,1,2,1,0,0,3,36,45,37825,29699,37,50,39329,28295
175,22,5,0,0,3,1,0,43,22,37830,29699,49,28,39332,28295
176,23,0,2,1,0,0,3,31,30,37830,29701,43,65,39332,28298
177,23,3,1,0,3,1,0,73,27,37833,29702,68,25,39335,28298
178,23,1,0,0,3,1,0,24,41,37834,29702,32,20,39338,28298
179,23,1,4,1,0,0,3,10,13,37835,29706,13,41,39338,28301
180,23,0,1,1,0,0,3,26,27,37835,29707,31,28,39338,28304
181,23,1,1,2,1,2,1,30,34,37836,29708,36,33,39339,28305
182,23,2,2,2,1,2,1,29,20,37838,29710,48,28,39340,28306
183,23,2,0,0,3,1,0,13,13,37840,29710,16,40,39343,28306
184,24,0,0,2,1,2,1,31,35,37840,29710,35,51,39344,28307
185,24,1,0,0,3,1,0,44,22,37841,29710,52,4,39347,28307
186,24,0,3,1,0,0,3,25,33,37841,29713,28,28,39347,28310
187,24,1,0,0,3,1,0,31,34,37842,29713,39,21,39350,28310
188,24,0,1,1,0,0,3,34,22,37842,29714,42,31,39350,28313
189,24,1,1,2,1,2,1,37,46,37843,29715,38,66,39351,28314
190,24,3,2,0,3,1,0,33,25,37846,29717,47,10,39354,28314
191,24,2,1,0,3,1,0,59,23,37848,29718,63,22,39357,28314
192,25,0,1,1,0,0,3,26,28,37848,29719,31,36,39357,28317
193,25,2,0,0,3,1,0,78,18,37850,29719,78,28,39360,28317
194,25,2,1,0,3,1,0,75,28,37852,29720,71,41,39363,28317
195,25,1,3,1,0,0,3,11,16,37853,29723,13,28,39363,28320
196,25,2,1,0,3,1,0,33,31,37855,29724,46,20,39366,28320
197,25,0,1,1,0,0,3,13,14,37855,29725,16,22,39366,28323
198,25,0,1,1,0,0,3,24,42,37855,29726,32,43,39366,28326
199,25,3,1,0,3,1,0,32,21,37858,29727,51,28,39369,28326
200,26,0,0,2,1,2,1,24,42,37858,29727,33,11,39370,28327
201,26,2,1,0,3,1,0,27,34,37860,29728,31,22,39373,28327
202,26,1,0,0,3,1,0,32,34,37861,29728,42,31,39376,28327
203,26,2,2,2,1,2,1,36,24,37863,29730,43,5,39377,28328
204,26,1,2,1,0,0,3,32,37,37864,29732,35,31,39377,28331
205,26,2,4,1,0,0,3,35,29,37866,29736,47,31,39377,28334
206,26,0,1,1,0,0,3,59,24,37866,29737,63,69,39377,28337
207,26,1,0,0,3,1,0,45,22,37867,29737,55,51,39380,28337
208,27,1,1,2,1,2,1,38,47,37868,29738,39,42,39381,28338
209,27,4,1,0,3,1,0,79,29,37872,29739,74,36,39384,28338
210,27,3,2,0,3,1,0,35,23,37875,29741,54,21,39387,28338
211,27,3,0,0,3,1,0,81,18,37878,29741,81,28,39390,28338
212,27,0,0,2,1,2,1,13,14,37878,29741,17,21,39391,28339
213,27,1,0,0,3,1,0,12,16,37879,29741,16,22,39394,28339
214,27,2,3,1,0,0,3,35,34,37881,29744,46,46,39394,28342
215,27,0,1,1,0,0,3,26,29,37881,29745,31,31,39394,28345
216,28,1,2,1,0,0,3,60,26,37882,29747,63,34,39394,28348
217,28,3,1,0,3,1,0,16,15,37885,29748,20,31,39397,28348
218,28,0,2,1,0,0,3,35,31,37885,29750,47,72,39397,28351
219,28,0,4,1,0,0,3,24,46,37885,29754,33,8,39397,28354
220,28,0,3,1,0,0,3,32,37,37885,29757,42,34,39397,28357
221,28,2,0,0,3,1,0,29,34,37887,29757,34,31,39400,28357
222,28,2,2,2,1,2,1,38,26,37889,29759,44,52,39401,28358
223,28,2,1,0,3,1,0,47,23,37891,29760,58,22,39404,28358
224,29,1,0,0,3,1,0,61,26,37892,29760,66,28,39407,28358
225,29,0,0,2,1,2,1,32,37,37892,29760,36,37,39408,28359
226,29,2,0,0,3,1,0,83,18,37894,29760,84,46,39411,28359
227,29,2,2,2,1,2,1,40,49,37896,29762,40,22,39412,28360
228,29,1,0,0,3,1,0,27,29,37897,29762,34,22,39415,28360
229,29,1,0,0,3,1,0,80,29,37898,29762,77,21,39418,28360
230,29,3,1,0,3,1,0,38,35,37901,29763,49,11,39421,28360
231,29,1,3,1,0,0,3,13,19,37902,29766,16,34,39421,28363
232,30,3,1,0,3,1,0,19,16,37905,29767,23,8,39424,28363
233,30,2,3,1,0,0,3,26,49,37907,29770,33,37,39424,28366
234,30,1,3,1,0,0,3,33,40,37908,29773,42,55,39424,28369
235,30,1,2,1,0,0,3,36,25,37909,29775,54,25,39424,28372
236,30,2,5,1,0,0,3,40,31,37911,29780,44,75,39424,28375
237,30,1,1,2,1,2,1,36,32,37912,29781,48,32,39425,28376
238,30,1,2,1,0,0,3,30,36,37913,29783,34,37,39425,28379
239,30,3,2,0,3,1,0,50,25,37916,29785,61,42,39428,28379
0,1,2,1,0,3,1,0,34,38,37918,29786,39,0,39431,28379
1,1,0,1,1,0,0,3,40,32,37918,29787,44,40,39431,28382
2,1,2,2,2,1,2,1,82,31,37920,29789,78,43,39432,28383
3,1,2,2,2,1,2,1,40,37,37922,29791,50,23,39433,28384
4,1,1,1,2,1,2,1,41,50,37923,29792,41,1,39434,28385
5,1,0,0,2,1,2,1,19,16,37923,29792,24,76,39435,28386
6,1,0,0,2,1,2,1,36,25,37923,29792,55,47,39436,28387
7,1,3,3,2,1,2,1,33,39,37926,29795,35,26,39437,28388
8,2,1,1,2,1,2,1,28,30,37927,29796,35,38,39438,28389
9,2,3,1,0,3,1,0,64,27,37930,29797,69,28,39441,28389
10,2,4,0,0,3,1,0,87,18,37934,29797,87,34,39444,28389
11,2,3,1,0,3,1,0,3,1,37937,29798,3,37,39447,28389
12,2,1,1,2,1,2,1,1,1,37938,29799,1,33,39448,28390
13,2,0,0,2,1,2,1,36,32,37938,29799,49,12,39449,28391
14,2,0,5,1,0,0,3,33,45,37938,29804,42,58,39449,28394
15,2,0,1,1,0,0,3,50,26,37938,29805,61,25,39449,28397
16,3,2,2,2,1,2,1,38,27,37940,29807,56,1,39450,28398
17,3,2,3,1,0,0,3,36,41,37942,29810,39,79,39450,28401
18,3,1,1,2,1,2,1,34,40,37943,29811,36,2,39451,28402
19,3,0,0,2,1,2,1,19,16,37943,29811,25,24,39452,28403
20,3,0,0,2,1,2,1,40,32,37943,29811,45,27,39453,28404
21,3,2,0,0,3,1,0,43,50,37945,29811,44,43,39456,28404
22,3,3,0,0,3,1,0,85,31,37948,29811,81,37,39459,28404
23,3,1,1,2,1,2,1,37,33,37949,29812,50,48,39460,28405
24,4,0,1,1,0,0,3,3,2,37949,29813,3,37,39460,28408
25,4,4,0,0,3,1,0,91,18,37953,29813,90,28,39463,28408
26,4,1,0,0,3,1,0,34,45,37954,29813,45,38,39466,28408
27,4,3,3,2,1,2,1,43,40,37957,29816,51,34,39467,28409
28,4,4,1,0,3,1,0,68,28,37961,29817,72,25,39470,28409
29,4,2,2,2,1,2,1,30,32,37963,29819,36,59,39471,28410
30,4,3,1,0,3,1,0,4,2,37966,29820,4,40,39474,28410
31,4,2,1,0,3,1,0,52,27,37968,29821,64,12,39477,28410
32,5,1,2,1,0,0,3,44,52,37969,29823,44,62,39477,28413
33,5,0,2,1,0,0,3,38,29,37969,29825,56,46,39477,28416
34,5,2,2,2,1,2,1,54,29,37971,29827,65,2,39478,28417
35,5,2,2,2,1,2,1,42,34,37973,29829,46,80,39479,28418
36,5,1,1,2,1,2,1,35,41,37974,29830,37,25,39480,28419
37,5,1,2,1,0,0,3,37,43,37975,29832,39,40,39480,28422
38,5,4,3,0,3,1,0,23,19,37979,29835,28,2,39483,28422
39,5,0,2,1,0,0,3,37,35,37979,29837,50,30,39483,28425
40,6,2,1,0,3,1,0,87,32,37981,29838,84,28,39486,28425
41,6,0,0,2,1,2,1,34,45,37981,29838,46,35,39487,28426
42,6,0,1,1,0,0,3,43,41,37981,29839,51,15,39487,28429
43,6,4,4,2,1,2,1,72,32,37985,29843,73,39,39488,28430
44,6,1,3,1,0,0,3,5,5,37986,29846,4,28,39488,28433
45,6,1,2,1,0,0,3,31,34,37987,29848,36,40,39488,28436
46,6,2,0,0,3,1,0,93,18,37989,29848,93,48,39491,28436
47,6,0,1,1,0,0,3,3,3,37989,29849,3,43,39491,28439
48,7,2,1,0,3,1,0,40,30,37991,29850,59,25,39494,28439
49,7,0,2,1,0,0,3,35,43,37991,29852,37,38,39494,28442
50,7,2,2,2,1,2,1,39,45,37993,29854,40,3,39495,28443
51,7,0,3,1,0,0,3,23,22,37993,29857,28,65,39495,28446
52,7,2,1,0,3,1,0,44,35,37995,29858,49,40,39498,28446
53,7,0,2,1,0,0,3,37,37,37995,29860,50,49,39498,28449
54,7,1,2,1,0,0,3,6,7,37996,29862,4,83,39498,28452
55,7,0,0,2,1,2,1,54,29,37996,29862,66,31,39499,28453
56,8,5,0,0,3,1,0,98,18,38001,29862,96,43,39502,28453
57,8,3,1,0,3,1,0,75,33,38004,29863,76,15,39505,28453
58,8,3,0,0,3,1,0,90,32,38007,29863,87,40,39508,28453
59,8,2,4,1,0,0,3,45,45,38009,29867,51,31,39508,28456
60,8,0,0,2,1,2,1,44,52,38009,29867,45,40,39509,28457
61,8,0,1,1,0,0,3,3,4,38009,29868,3,31,39509,28460
62,8,0,2,1,0,0,3,31,36,38009,29870,36,5,39509,28463
63,8,2,1,0,3,1,0,36,46,38011,29871,49,48,39512,28463
64,9,0,1,1,0,0,3,23,23,38011,29872,28,41,39512,28466
65,9,1,3,1,0,0,3,41,33,38012,29875,59,43,39512,28469
66,9,2,0,0,3,1,0,8,7,38014,29875,7,3,39515,28469
67,9,1,0,0,3,1,0,40,45,38015,29875,43,31,39518,28469
68,9,2,1,0,3,1,0,100,19,38017,29876,99,31,39521,28469
69,9,0,1,1,0,0,3,44,36,38017,29877,49,68,39521,28472
70,9,1,0,0,3,1,0,55,29,38018,29877,69,49,39524,28472
71,9,1,1,2,1,2,1,38,38,38019,29878,51,26,39525,28473
72,10,2,2,2,1,2,1,37,45,38021,29880,38,41,39526,28474
73,10,2,0,0,3,1,0,92,32,38023,29880,90,40,39529,28474
74,10,3,5,1,0,0,3,39,51,38026,29885,49,34,39529,28477
75,10,1,0,0,3,1,0,46,45,38027,29885,54,5,39532,28477
76,10,2,2,2,1,2,1,33,38,38029,29887,37,16,39533,28478
77,10,0,2,1,0,0,3,75,35,38029,29889,76,86,39533,28481
78,10,2,2,2,1,2,1,5,6,38031,29891,4,49,39534,28482
79,10,2,2,2,1,2,1,46,54,38033,29893,46,44,39535,28483
80,11,3,0,0,3,1,0,11,7,38036,29893,10,26,39538,28483
81,11,1,0,0,3,1,0,101,19,38037,29893,102,3,39541,28483
82,11,0,0,2,1,2,1,44,36,38037,29893,50,42,39542,28484
83,11,2,0,0,3,1,0,40,38,38039,29893,54,43,39545,28484
84,11,1,2,1,0,0,3,24,25,38040,29895,28,34,39545,28487
85,11,2,0,0,3,1,0,43,33,38042,29895,62,40,39548,28487
86,11,1,4,1,0,0,3,34,42,38043,29899,37,52,39548,28490
87,11,1,3,1,0,0,3,56,32,38044,29902,69,71,39548,28493
88,12,3,1,0,3,1,0,40,46,38047,29903,41,34,39551,28493
89,12,2,2,2,1,2,1,42,47,38049,29905,44,17,39552,28494
90,12,1,1,2,1,2,1,47,46,38050,29906,55,50,39553,28495
91,12,4,1,0,3,1,0,96,33,38054,29907,93,44,39556,28495
92,12,2,2,2,1,2,1,7,8,38056,29909,5,32,39557,28496
93,12,3,0,0,3,1,0,78,35,38059,29909,79,5,39560,28496
94,12,2,1,0,3,1,0,48,55,38061,29910,49,41,39563,28496
95,12,0,3,1,0,0,3,39,54,38061,29913,49,89,39563,28499
96,13,0,1,1,0,0,3,44,37,38061,29914,50,43,39563,28502
97,13,0,0,2,1,2,1,24,25,38061,29914,29,42,39564,28503
98,13,0,1,1,0,0,3,56,33,38061,29915,69,45,39564,28506
99,13,4,2,0,3,1,0,38,44,38065,29917,40,26,39567,28506
100,13,1,0,0,3,1,0,102,19,38066,29917,105,43,39570,28506
101,13,1,1,2,1,2,1,41,39,38067,29918,55,35,39571,28507
102,13,1,0,0,3,1,0,79,35,38068,29918,82,3,39574,28507
103,13,1,3,1,0,0,3,12,10,38069,29921,10,74,39574,28510
104,14,1,1,2,1,2,1,44,34,38070,29922,63,45,39575,28511
105,14,3,2,0,3,1,0,50,48,38073,29924,58,52,39578,28511
106,14,5,0,0,3,1,0,44,54,38078,29924,52,3,39581,28511
107,14,1,0,0,3,1,0,49,55,38079,29924,52,32,39584,28511
108,14,0,1,1,0,0,3,24,26,38079,29925,29,37,39584,28514
109,14,0,2,1,0,0,3,42,49,38079,29927,44,53,39584,28517
110,14,2,2,2,1,2,1,98,35,38081,29929,94,90,39585,28518
111,14,0,1,1,0,0,3,40,47,38081,29930,41,8,39585,28521
112,15,1,0,0,3,1,0,57,33,38082,29930,72,35,39588,28521
113,15,2,0,0,3,1,0,104,19,38084,29930,108,45,39591,28521
114,15,1,0,0,3,1,0,42,39,38085,29930,58,43,39594,28521
115,15,1,2,1,0,0,3,13,12,38086,29932,10,20,39594,28524
116,15,4,1,0,3,1,0,83,36,38090,29933,85,26,39597,28524
117,15,1,3,1,0,0,3,45,40,38091,29936,50,45,39597,28527
118,15,2,1,0,3,1,0,40,45,38093,29937,43,43,39600,28527
119,15,0,2,1,0,0,3,7,10,38093,29939,5,77,39600,28530
120,16,3,1,0,3,1,0,43,46,38096,29940,46,35,39603,28530
121,16,1,2,1,0,0,3,84,38,38097,29942,85,80,39603,28533
122,16,1,1,2,1,2,1,43,40,38098,29943,59,38,39604,28534
123,16,0,2,1,0,0,3,44,56,38098,29945,52,46,39604,28537
124,16,0,5,1,0,0,3,7,15,38098,29950,5,48,39604,28540
125,16,1,1,2,1,2,1,58,34,38099,29951,73,46,39605,28541
126,16,3,3,2,1,2,1,16,15,38102,29954,11,44,39606,28542
127,16,5,0,0,3,1,0,109,19,38107,29954,111,20,39609,28542
128,17,2,1,0,3,1,0,47,41,38109,29955,53,53,39612,28542
129,17,0,4,1,0,0,3,44,38,38109,29959,63,93,39612,28545
130,17,4,2,0,3,1,0,28,28,38113,29961,32,45,39615,28545
131,17,0,0,2,1,2,1,42,49,38113,29961,45,33,39616,28546
132,17,1,2,1,0,0,3,51,50,38114,29963,58,6,39616,28549
133,17,3,3,2,1,2,1,43,50,38117,29966,42,53,39617,28550
134,17,3,0,0,3,1,0,101,35,38120,29966,97,26,39620,28550
135,17,1,0,0,3,1,0,50,55,38121,29966,55,8,39623,28550
136,18,2,0,0,3,1,0,18,15,38123,29966,14,46,39626,28550
137,18,1,2,1,0,0,3,44,48,38124,29968,46,41,39626,28553
138,18,0,1,1,0,0,3,58,35,38124,29969,73,48,39626,28556
139,18,3,0,0,3,1,0,10,15,38127,29969,8,35,39629,28556
140,18,1,0,0,3,1,0,45,56,38128,29969,55,20,39632,28556
141,18,2,2,2,1,2,1,53,52,38130,29971,59,81,39633,28557
142,18,1,1,2,1,2,1,110,20,38131,29972,112,45,39634,28558
143,18,2,3,1,0,0,3,86,41,38133,29975,85,51,39634,28561
144,19,0,2,1,0,0,3,43,52,38133,29977,42,96,39634,28564
145,19,2,3,1,0,0,3,30,31,38135,29980,32,56,39634,28567
146,19,0,1,1,0,0,3,42,50,38135,29981,45,29,39634,28570
147,19,1,1,2,1,2,1,51,56,38136,29982,56,47,39635,28571
148,19,2,1,0,3,1,0,45,41,38138,29983,62,8,39638,28571
149,19,1,0,0,3,1,0,45,38,38139,29983,66,6,39641,28571
150,19,1,0,0,3,1,0,102,35,38140,29983,100,33,39644,28571
151,19,1,1,2,1,2,1,48,42,38141,29984,54,54,39645,28572
152,20,3,1,0,3,1,0,21,16,38144,29985,17,56,39648,28572
153,20,1,0,0,3,1,0,46,56,38145,29985,58,35,39651,28572
154,20,3,2,0,3,1,0,89,43,38148,29987,88,46,39654,28572
155,20,2,1,0,3,1,0,112,21,38150,29988,115,41,39657,28572
156,20,3,1,0,3,1,0,56,53,38153,29989,62,45,39660,28572
157,20,0,0,2,1,2,1,10,15,38153,29989,9,21,39661,28573
158,20,3,0,0,3,1,0,105,35,38156,29989,103,51,39664,28573
159,20,2,3,1,0,0,3,46,51,38158,29992,46,51,39664,28576
160,21,2,0,0,3,1,0,53,56,38160,29992,59,29,39667,28576
161,21,0,0,2,1,2,1,58,35,38160,29992,74,97,39668,28577
162,21,1,2,1,0,0,3,31,33,38161,29994,32,50,39668,28580
163,21,0,2,1,0,0,3,48,44,38161,29996,54,11,39668,28583
164,21,1,1,2,1,2,1,46,42,38162,29997,63,7,39669,28584
165,21,0,1,1,0,0,3,43,53,38162,29998,42,84,39669,28587
166,21,2,0,0,3,1,0,47,38,38164,29998,69,33,39672,28587
167,21,0,1,1,0,0,3,42,51,38164,29999,45,57,39672,28590
168,22,2,0,0,3,1,0,114,21,38166,29999,118,11,39675,28590
169,22,2,0,0,3,1,0,91,43,38168,29999,91,51,39678,28590
170,22,1,1,2,1,2,1,47,52,38169,30000,47,57,39679,28591
171,22,1,1,2,1,2,1,57,54,38170,30001,63,42,39680,28592
172,22,1,1,2,1,2,1,11,16,38171,30002,10,46,39681,28593
173,22,1,1,2,1,2,1,54,57,38172,30003,60,36,39682,28594
174,22,5,0,0,3,1,0,110,35,38177,30003,106,21,39685,28594
175,22,2,3,1,0,0,3,48,59,38179,30006,58,49,39685,28597
176,23,1,3,1,0,0,3,32,36,38180,30009,32,60,39685,28600
177,23,1,2,1,0,0,3,43,53,38181,30011,45,54,39685,28603
178,23,2,1,0,3,1,0,60,36,38183,30012,77,29,39688,28603
179,23,2,2,2,1,2,1,45,55,38185,30014,43,51,39689,28604
180,23,2,0,0,3,1,0,23,16,38187,30014,20,33,39692,28604
181,23,0,1,1,0,0,3,48,45,38187,30015,54,10,39692,28607
182,23,1,1,2,1,2,1,47,43,38188,30016,64,98,39693,28608
183,23,0,4,1,0,0,3,47,42,38188,30020,69,87,39693,28611
184,24,3,2,0,3,1,0,57,59,38191,30022,63,21,39696,28611
185,24,2,4,1,0,0,3,50,63,38193,30026,58,54,39696,28614
186,24,1,1,2,1,2,1,12,17,38194,30027,11,12,39697,28615
187,24,0,1,1,0,0,3,45,56,38194,30028,43,49,39697,28618
188,24,0,3,1,0,0,3,47,55,38194,30031,47,101,39697,28621
189,24,6,1,0,3,1,0,116,36,38200,30032,109,42,39700,28621
190,24,2,1,0,3,1,0,59,55,38202,30033,66,49,39703,28621
191,24,2,3,1,0,0,3,93,46,38204,30036,91,60,39703,28624
192,25,1,1,2,1,2,1,48,44,38205,30037,65,55,39704,28625
193,25,3,2,0,3,1,0,63,38,38208,30039,80,10,39707,28625
194,25,4,0,0,3,1,0,27,16,38212,30039,23,51,39710,28625
195,25,2,1,0,3,1,0,34,37,38214,30040,35,33,39713,28625
196,25,2,1,0,3,1,0,50,46,38216,30041,57,29,39716,28625
197,25,2,1,0,3,1,0,49,43,38218,30042,72,36,39719,28625
198,25,0,2,1,0,0,3,43,55,38218,30044,45,90,39719,28628
199,25,3,1,0,3,1,0,117,22,38221,30045,121,60,39722,28628
200,26,1,0,0,3,1,0,94,46,38222,30045,94,33,39725,28628
201,26,2,1,0,3,1,0,59,60,38224,30046,66,42,39728,28628
202,26,0,3,1,0,0,3,12,20,38224,30049,11,104,39728,28631
203,26,2,1,0,3,1,0,61,56,38226,30050,69,54,39731,28631
204,26,1,0,0,3,1,0,51,63,38227,30050,61,12,39734,28631
205,26,1,0,0,3,1,0,46,56,38228,30050,46,21,39737,28631
206,26,2,0,0,3,1,0,118,36,38230,30050,112,60,39740,28631
207,26,1,2,1,0,0,3,44,57,38231,30052,45,52,39740,28634
208,27,2,1,0,3,1,0,29,17,38233,30053,26,60,39743,28634
209,27,2,0,0,3,1,0,119,22,38235,30053,124,29,39746,28634
210,27,2,2,2,1,2,1,51,45,38237,30055,73,56,39747,28635
211,27,2,1,0,3,1,0,52,47,38239,30056,60,36,39750,28635
212,27,2,0,0,3,1,0,36,37,38241,30056,38,49,39753,28635
213,27,2,1,0,3,1,0,65,39,38243,30057,83,51,39756,28635
214,27,1,0,0,3,1,0,48,55,38244,30057,50,10,39759,28635
215,27,1,2,1,0,0,3,49,46,38245,30059,65,93,39759,28638
216,28,2,3,1,0,0,3,14,23,38247,30062,11,63,39759,28641
217,28,1,3,1,0,0,3,62,59,38248,30065,69,107,39759,28644
218,28,1,0,0,3,1,0,45,57,38249,30065,48,42,39762,28644
219,28,4,2,0,3,1,0,50,58,38253,30067,49,54,39765,28644
220,28,0,1,1,0,0,3,51,64,38253,30068,61,36,39765,28647
221,28,3,1,0,3,1,0,54,46,38256,30069,76,21,39768,28647
222,28,1,0,0,3,1,0,60,60,38257,30069,69,60,39771,28647
223,28,1,1,2,1,2,1,119,37,38258,30070,113,13,39772,28648
224,29,2,1,0,3,1,0,16,24,38260,30071,14,29,39775,28648
225,29,1,3,1,0,0,3,95,49,38261,30074,94,54,39775,28651
226,29,1,1,2,1,2,1,49,56,38262,30075,51,57,39776,28652
227,29,2,1,0,3,1,0,31,18,38264,30076,29,36,39779,28652
228,29,1,0,0,3,1,0,66,39,38265,30076,86,49,39782,28652
229,29,1,0,0,3,1,0,50,46,38266,30076,68,52,39785,28652
230,29,2,1,0,3,1,0,54,48,38268,30077,63,21,39788,28652
231,29,2,1,0,3,1,0,121,23,38270,30078,127,93,39791,28652
232,30,0,1,1,0,0,3,54,47,38270,30079,76,45,39791,28655
233,30,0,0,2,1,2,1,45,57,38270,30079,49,55,39792,28656
234,30,1,4,1,0,0,3,51,62,38271,30083,49,63,39792,28659
235,30,1,3,1,0,0,3,37,40,38272,30086,38,16,39792,28662
236,30,0,2,1,0,0,3,60,62,38272,30088,69,110,39792,28665
237,30,2,1,0,3,1,0,64,60,38274,30089,72,36,39795,28665
238,30,0,1,1,0,0,3,51,65,38274,30090,61,66,39795,28668
239,30,3,1,0,3,1,0,122,38,38277,30091,116,10,39798,28668
0,1,0,2,1,0,0,3,60,64,38277,30093,69,69,39798,28671
1,1,3,1,0,3,1,0,34,19,38280,30094,32,54,39801,28671
2,1,2,0,0,3,1,0,56,47,38282,30094,79,49,39804,28671
3,1,5,1,0,3,1,0,71,40,38287,30095,89,0,39807,28671
4,1,0,3,1,0,0,3,0,3,38287,30098,0,48,39807,28674
5,1,2,0,0,3,1,0,39,40,38289,30098,41,36,39810,28674
6,1,2,1,0,3,1,0,52,47,38291,30099,71,93,39813,28674
7,1,1,3,1,0,0,3,52,68,38292,30102,61,113,39813,28677
8,2,1,0,0,3,1,0,46,57,38293,30102,52,57,39816,28677
9,2,0,4,1,0,0,3,49,60,38293,30106,51,66,39816,28680
10,2,2,0,0,3,1,0,56,48,38295,30106,66,29,39819,28680
11,2,1,1,2,1,2,1,65,61,38296,30107,73,53,39820,28681
12,2,2,1,0,3,1,0,124,39,38298,30108,119,21,39823,28681
13,2,1,2,1,0,0,3,1,2,38299,30110,0,19,39823,28684
14,2,3,0,0,3,1,0,124,23,38302,30110,130,55,39826,28684
15,2,2,1,0,3,1,0,97,50,38304,30111,97,0,39829,28684
16,3,1,4,1,0,0,3,57,51,38305,30115,79,32,39829,28687
17,3,1,1,2,1,2,1,72,41,38306,30116,90,94,39830,28688
18,3,1,0,0,3,1,0,2,2,38307,30116,3,48,39833,28688
19,3,1,1,2,1,2,1,53,48,38308,30117,72,50,39834,28689
20,3,2,3,1,0,0,3,2,6,38310,30120,0,57,39834,28692
21,3,0,1,1,0,0,3,60,65,38310,30121,69,116,39834,28695
22,3,1,0,0,3,1,0,40,40,38311,30121,44,69,39837,28695
23,3,1,1,2,1,2,1,35,20,38312,30122,33,37,39838,28696
24,4,0,1,1,0,0,3,56,49,38312,30123,66,56,39838,28699
25,4,3,1,0,3,1,0,127,40,38315,30124,122,57,39841,28699
26,4,2,0,0,3,1,0,126,23,38317,30124,133,21,39844,28699
27,4,2,1,0,3,1,0,51,61,38319,30125,54,0,39847,28699
28,4,2,4,1,0,0,3,54,72,38321,30129,61,58,39847,28702
29,4,0,1,1,0,0,3,65,62,38321,30130,73,3,39847,28705
30,4,0,2,1,0,0,3,46,59,38321,30132,52,69,39847,28708
31,4,3,2,0,3,1,0,100,52,38324,30134,100,19,39850,28708
32,5,0,1,1,0,0,3,2,3,38324,30135,3,72,39850,28711
33,5,1,1,2,1,2,1,41,41,38325,30136,45,51,39851,28712
34,5,1,0,0,3,1,0,3,6,38326,30136,3,58,39854,28712
35,5,1,1,2,1,2,1,73,42,38327,30137,91,49,39855,28713
36,5,1,0,0,3,1,0,66,62,38328,30137,76,37,39858,28713
37,5,0,1,1,0,0,3,57,52,38328,30138,79,97,39858,28716
38,5,2,2,2,1,2,1,37,22,38330,30140,34,117,39859,28717
39,5,1,1,2,1,2,1,61,66,38331,30141,70,33,39860,28718
40,6,1,0,0,3,1,0,127,23,38332,30141,136,56,39863,28718
41,6,0,0,2,1,2,1,51,61,38332,30141,55,4,39864,28719
42,6,0,3,1,0,0,3,56,52,38332,30144,66,60,39864,28722
43,6,3,4,1,0,0,3,56,52,38335,30148,72,60,39864,28725
44,6,1,2,1,0,0,3,47,61,38336,30150,52,22,39864,28728
45,6,1,1,2,1,2,1,128,41,38337,30151,123,1,39865,28729
46,6,1,2,1,0,0,3,101,54,38338,30153,100,72,39865,28732
47,6,2,2,2,1,2,1,56,74,38340,30155,62,22,39866,28733
48,7,0,1,1,0,0,3,51,62,38340,30156,55,52,39866,28736
49,7,2,0,0,3,1,0,5,6,38342,30156,6,51,39869,28736
50,7,4,0,0,3,1,0,77,42,38346,30156,94,33,39872,28736
51,7,2,1,0,3,1,0,43,42,38348,30157,48,60,39875,28736
52,7,3,0,0,3,1,0,69,62,38351,30157,79,72,39878,28736
53,7,1,3,1,0,0,3,3,6,38352,30160,3,120,39878,28739
54,7,1,2,1,0,0,3,38,24,38353,30162,34,100,39878,28742
55,7,1,0,0,3,1,0,58,52,38354,30162,82,58,39881,28742
56,8,0,1,1,0,0,3,101,55,38354,30163,100,40,39881,28745
57,8,1,0,0,3,1,0,48,61,38355,30163,55,4,39884,28745
58,8,0,1,1,0,0,3,56,53,38355,30164,66,25,39884,28748
59,8,0,0,2,1,2,1,56,74,38355,30164,63,2,39885,28749
60,8,2,0,0,3,1,0,130,41,38357,30164,126,60,39888,28749
61,8,3,1,0,3,1,0,130,24,38360,30165,139,72,39891,28749
62,8,1,3,1,0,0,3,57,55,38361,30168,72,25,39891,28752
63,8,1,3,1,0,0,3,62,69,38362,30171,70,59,39891,28755
64,9,0,3,1,0,0,3,51,65,38362,30174,55,103,39891,28758
65,9,1,1,2,1,2,1,6,7,38363,30175,7,121,39892,28759
66,9,3,2,0,3,1,0,80,44,38366,30177,97,58,39895,28759
67,9,0,0,2,1,2,1,3,6,38366,30177,4,61,39896,28760
68,9,0,0,2,1,2,1,69,62,38366,30177,80,52,39897,28761
69,9,0,2,1,0,0,3,38,26,38366,30179,34,36,39897,28764
70,9,1,0,0,3,1,0,44,42,38367,30179,51,59,39900,28764
71,9,0,1,1,0,0,3,101,56,38367,30180,100,55,39900,28767
72,10,1,0,0,3,1,0,131,41,38368,30180,129,72,39903,28767
73,10,1,1,2,1,2,1,131,25,38369,30181,140,61,39904,28768
74,10,0,2,1,0,0,3,56,55,38369,30183,66,28,39904,28771
75,10,1,0,0,3,1,0,57,74,38370,30183,66,4,39907,28771
76,10,3,2,0,3,1,0,60,57,38373,30185,75,25,39910,28771
77,10,1,0,0,3,1,0,63,69,38374,30185,73,2,39913,28771
78,10,0,1,1,0,0,3,58,53,38374,30186,82,75,39913,28774
79,10,0,1,1,0,0,3,48,62,38374,30187,55,43,39913,28777
80,11,4,1,0,3,1,0,105,57,38378,30188,103,52,39916,28777
81,11,1,0,0,3,1,0,52,65,38379,30188,58,121,39919,28777
82,11,1,2,1,0,0,3,4,8,38380,30190,4,61,39919,28780
83,11,0,0,2,1,2,1,6,7,38380,30190,8,26,39920,28781
84,11,2,2,2,1,2,1,71,64,38382,30192,81,37,39921,28782
85,11,1,3,1,0,0,3,57,58,38383,30195,66,106,39921,28785
86,11,4,0,0,3,1,0,84,44,38387,30195,100,61,39924,28785
87,11,0,2,1,0,0,3,38,28,38387,30197,34,62,39924,28788
88,12,2,2,2,1,2,1,133,43,38389,30199,130,5,39925,28789
89,12,0,3,1,0,0,3,63,72,38389,30202,73,31,39925,28792
90,12,0,0,2,1,2,1,58,53,38389,30202,83,3,39926,28793
91,12,2,0,0,3,1,0,133,25,38391,30202,143,72,39929,28793
92,12,2,2,2,1,2,1,62,59,38393,30204,76,62,39930,28794
93,12,0,1,1,0,0,3,48,63,38393,30205,55,58,39930,28797
94,12,0,2,1,0,0,3,44,44,38393,30207,51,78,39930,28800
95,12,1,0,0,3,1,0,58,74,38394,30207,69,43,39933,28800
96,13,1,1,2,1,2,1,53,66,38395,30208,59,62,39934,28801
97,13,2,0,0,3,1,0,107,57,38397,30208,106,37,39937,28801
98,13,3,0,0,3,1,0,87,44,38400,30208,103,3,39940,28801
99,13,0,2,1,0,0,3,4,10,38400,30210,4,65,39940,28804
100,13,2,3,1,0,0,3,50,66,38402,30213,55,109,39940,28807
101,13,1,3,1,0,0,3,58,61,38403,30216,66,124,39940,28810
102,13,2,1,0,3,1,0,73,65,38405,30217,84,61,39943,28810
103,13,2,0,0,3,1,0,40,28,38407,30217,37,26,39946,28810
104,14,2,2,2,1,2,1,64,61,38409,30219,77,73,39947,28811
105,14,4,0,0,3,1,0,137,25,38413,30219,146,52,39950,28811
106,14,0,2,1,0,0,3,58,76,38413,30221,69,112,39950,28814
107,14,0,0,2,1,2,1,63,72,38413,30221,74,59,39951,28815
108,14,3,0,0,3,1,0,61,53,38416,30221,86,43,39954,28815
109,14,0,0,2,1,2,1,87,44,38416,30221,104,63,39955,28816
110,14,0,3,1,0,0,3,44,47,38416,30224,51,8,39955,28819
111,14,0,0,2,1,2,1,6,7,38416,30224,9,32,39956,28820
112,15,3,0,0,3,1,0,110,57,38419,30224,109,65,39959,28820
113,15,1,1,2,1,2,1,59,62,38420,30225,67,63,39960,28821
114,15,0,0,2,1,2,1,40,28,38420,30225,38,79,39961,28822
115,15,2,0,0,3,1,0,6,10,38422,30225,7,3,39964,28822
116,15,4,2,0,3,1,0,57,68,38426,30227,62,61,39967,28822
117,15,2,0,0,3,1,0,135,43,38428,30227,133,124,39970,28822
118,15,2,1,0,3,1,0,52,67,38430,30228,58,37,39973,28822
119,15,2,0,0,3,1,0,75,65,38432,30228,87,26,39976,28822
120,16,0,1,1,0,0,3,52,68,38432,30229,58,68,39976,28825
121,16,1,2,1,0,0,3,7,12,38433,30231,7,82,39976,28828
122,16,1,0,0,3,1,0,60,62,38434,30231,70,3,39979,28828
123,16,1,0,0,3,1,0,58,68,38435,30231,65,26,39982,28828
124,16,1,1,2,1,2,1,111,58,38436,30232,110,62,39983,28829
125,16,2,0,0,3,1,0,137,43,38438,30232,136,63,39986,28829
126,16,3,0,0,3,1,0,140,25,38441,30232,149,37,39989,28829
127,16,2,2,2,1,2,1,77,67,38443,30234,88,33,39990,28830
128,17,1,1,2,1,2,1,41,29,38444,30235,39,9,39991,28831
129,17,1,0,0,3,1,0,65,61,38445,30235,80,124,39994,28831
130,17,2,0,0,3,1,0,60,76,38447,30235,72,59,39997,28831
131,17,1,1,2,1,2,1,45,48,38448,30236,52,113,39998,28832
132,17,2,1,0,3,1,0,8,8,38450,30237,12,73,40001,28832
133,17,0,0,2,1,2,1,87,44,38450,30237,105,44,40002,28833
134,17,1,2,1,0,0,3,62,55,38451,30239,86,66,40002,28836
135,17,3,1,0,3,1,0,66,73,38454,30240,77,52,40005,28836
136,18,2,0,0,3,1,0,79,67,38456,30240,91,3,40008,28836
137,18,3,2,0,3,1,0,63,78,38459,30242,75,68,40011,28836
138,18,1,1,2,1,2,1,61,63,38460,30243,71,10,40012,28837
139,18,1,1,2,1,2,1,53,69,38461,30244,59,64,40013,28838
140,18,3,0,0,3,1,0,143,25,38464,30244,152,62,40016,28838
141,18,4,1,0,3,1,0,115,59,38468,30245,113,26,40019,28838
142,18,0,1,1,0,0,3,58,69,38468,30246,65,36,40019,28841
143,18,2,0,0,3,1,0,139,43,38470,30246,139,82,40022,28841
144,19,0,0,2,1,2,1,8,8,38470,30246,13,45,40023,28842
145,19,1,0,0,3,1,0,88,44,38471,30246,108,52,40026,28842
146,19,1,0,0,3,1,0,66,61,38472,30246,83,37,40029,28842
147,19,1,1,2,1,2,1,8,13,38473,30247,8,67,40030,28843
148,19,1,0,0,3,1,0,63,55,38474,30247,89,59,40033,28843
149,19,0,2,1,0,0,3,66,75,38474,30249,77,116,40033,28846
150,19,1,2,1,0,0,3,46,50,38475,30251,52,127,40033,28849
151,19,2,1,0,3,1,0,43,30,38477,30252,42,73,40036,28849
152,20,0,0,2,1,2,1,58,69,38477,30252,66,68,40037,28850
153,20,2,2,2,1,2,1,117,61,38479,30254,114,11,40038,28851
154,20,1,2,1,0,0,3,62,65,38480,30256,71,85,40038,28854
155,20,2,1,0,3,1,0,55,70,38482,30257,62,26,40041,28854
156,20,4,0,0,3,1,0,67,78,38486,30257,78,62,40044,28854
157,20,2,0,0,3,1,0,68,61,38488,30257,86,3,40047,28854
158,20,0,1,1,0,0,3,143,26,38488,30258,152,39,40047,28857
159,20,1,0,0,3,1,0,140,43,38489,30258,142,68,40050,28857
160,21,4,0,0,3,1,0,47,30,38493,30258,45,52,40053,28857
161,21,2,1,0,3,1,0,90,45,38495,30259,111,73,40056,28857
162,21,1,0,0,3,1,0,47,50,38496,30259,55,37,40059,28857
163,21,3,1,0,3,1,0,69,76,38499,30260,80,64,40062,28857
164,21,1,1,2,1,2,1,80,68,38500,30261,92,60,40063,28858
165,21,0,1,1,0,0,3,8,9,38500,30262,13,119,40063,28861
166,21,2,2,2,1,2,1,65,57,38502,30264,90,128,40064,28862
167,21,0,3,1,0,0,3,8,16,38502,30267,8,48,40064,28865
168,22,0,0,2,1,2,1,62,65,38502,30267,72,49,40065,28866
169,22,2,1,0,3,1,0,119,62,38504,30268,117,68,40068,28866
170,22,0,0,2,1,2,1,55,70,38504,30268,63,4,40069,28867
171,22,0,2,1,0,0,3,69,78,38504,30270,80,29,40069,28870
172,22,2,0,0,3,1,0,142,43,38506,30270,145,39,40072,28870
173,22,2,2,2,1,2,1,69,80,38508,30272,79,86,40073,28871
174,22,4,1,0,3,1,0,147,27,38512,30273,155,11,40076,28871
175,22,2,1,0,3,1,0,70,62,38514,30274,89,68,40079,28871
176,23,1,1,2,1,2,1,59,70,38515,30275,67,74,40080,28872
177,23,1,2,1,0,0,3,48,52,38516,30277,55,63,40080,28875
178,23,1,0,0,3,1,0,48,30,38517,30277,48,64,40083,28875
179,23,1,2,1,0,0,3,66,59,38518,30279,90,65,40083,28878
180,23,1,3,1,0,0,3,9,12,38519,30282,13,40,40083,28881
181,23,2,0,0,3,1,0,10,16,38521,30282,11,52,40086,28881
182,23,1,0,0,3,1,0,91,45,38522,30282,114,128,40089,28881
183,23,2,4,1,0,0,3,82,72,38524,30286,92,122,40089,28884
184,24,1,1,2,1,2,1,63,66,38525,30287,73,75,40090,28885
185,24,0,0,2,1,2,1,66,59,38525,30287,91,30,40091,28886
186,24,1,3,1,0,0,3,71,65,38526,30290,89,89,40091,28889
187,24,1,1,2,1,2,1,56,71,38527,30291,64,69,40092,28890
188,24,3,1,0,3,1,0,72,79,38530,30292,83,11,40095,28890
189,24,3,0,0,3,1,0,145,43,38533,30292,148,49,40098,28890
190,24,1,0,0,3,1,0,148,27,38534,30292,158,4,40101,28890
191,24,1,1,2,1,2,1,70,81,38535,30293,80,40,40102,28891
192,25,1,1,2,1,2,1,10,13,38536,30294,14,66,40103,28892
193,25,1,0,0,3,1,0,92,45,38537,30294,117,68,40106,28892
194,25,1,0,0,3,1,0,11,16,38538,30294,14,40,40109,28892
195,25,2,1,0,3,1,0,61,71,38540,30295,70,52,40112,28892
196,25,0,1,1,0,0,3,48,31,38540,30296,48,66,40112,28895
197,25,1,1,2,1,2,1,49,53,38541,30297,56,65,40113,28896
198,25,0,1,1,0,0,3,119,63,38541,30298,117,125,40113,28899
199,25,2,1,0,3,1,0,84,73,38543,30299,95,128,40116,28899
200,26,1,3,1,0,0,3,67,62,38544,30302,91,43,40116,28902
201,26,0,2,1,0,0,3,56,73,38544,30304,64,78,40116,28905
202,26,1,3,1,0,0,3,73,82,38545,30307,83,92,40116,28908
203,26,1,0,0,3,1,0,72,65,38546,30307,92,11,40119,28908
204,26,0,1,1,0,0,3,49,54,38546,30308,56,7,40119,28911
205,26,3,0,0,3,1,0,73,81,38549,30308,83,69,40122,28911
206,26,3,1,0,3,1,0,151,28,38552,30309,161,49,40125,28911
207,26,4,0,0,3,1,0,149,43,38556,30309,151,66,40128,28911
208,27,1,1,2,1,2,1,62,72,38557,30310,71,41,40129,28912
209,27,2,0,0,3,1,0,86,73,38559,30310,98,65,40132,28912
210,27,3,1,0,3,1,0,13,14,38562,30311,17,68,40135,28912
211,27,1,2,1,0,0,3,64,68,38563,30313,73,55,40135,28915
212,27,2,0,0,3,1,0,94,45,38565,30313,120,30,40138,28915
213,27,0,2,1,0,0,3,11,18,38565,30315,14,128,40138,28918
214,27,1,3,1,0,0,3,120,66,38566,30318,117,131,40138,28921
215,27,1,0,0,3,1,0,49,31,38567,30318,51,66,40141,28921
216,28,2,3,1,0,0,3,69,65,38569,30321,91,14,40141,28924
217,28,3,1,0,3,1,0,75,66,38572,30322,95,49,40144,28924
218,28,0,5,1,0,0,3,73,87,38572,30327,83,72,40144,28927
219,28,0,0,2,1,2,1,49,54,38572,30327,57,44,40145,28928
220,28,0,1,1,0,0,3,13,15,38572,30328,17,95,40145,28931
221,28,2,0,0,3,1,0,151,43,38574,30328,154,55,40148,28931
222,28,1,1,2,1,2,1,74,82,38575,30329,84,79,40149,28932
223,28,3,0,0,3,1,0,154,28,38578,30329,164,66,40152,28932
224,29,1,1,2,1,2,1,87,74,38579,30330,99,96,40153,28933
225,29,1,1,2,1,2,1,152,44,38580,30331,155,42,40154,28934
226,29,0,0,2,1,2,1,64,68,38580,30331,74,67,40155,28935
227,29,2,1,0,3,1,0,58,74,38582,30332,67,131,40158,28935
228,29,1,0,0,3,1,0,12,18,38583,30332,17,30,40161,28935
229,29,0,0,2,1,2,1,62,72,38583,30332,72,69,40162,28936
230,29,1,1,2,1,2,1,50,32,38584,30333,52,8,40163,28937
231,29,1,1,2,1,2,1,121,67,38585,30334,118,66,40164,28938
232,30,1,0,0,3,1,0,14,15,38586,30334,20,14,40167,28938
233,30,2,4,1,0,0,3,75,91,38588,30338,83,52,40167,28941
234,30,3,1,0,3,1,0,77,83,38591,30339,87,55,40170,28941
235,30,1,0,0,3,1,0,70,65,38592,30339,94,79,40173,28941
236,30,2,1,0,3,1,0,156,29,38594,30340,167,128,40176,28941
237,30,0,1,1,0,0,3,94,46,38594,30341,120,47,40176,28944
238,30,1,0,0,3,1,0,50,54,38595,30341,60,72,40179,28944
239,30,1,0,0,3,1,0,76,66,38596,30341,98,66,40182,28944
0,1,2,0,0,3,1,0,158,29,38598,30341,170,66,40185,28944
1,1,1,3,1,0,0,3,51,57,38599,30344,60,72,40185,28947
2,1,1,1,2,1,2,1,63,73,38600,30345,73,97,40186,28948
3,1,0,1,1,0,0,3,87,75,38600,30346,99,13,40186,28951
4,1,2,0,0,3,1,0,66,68,38602,30346,77,42,40189,28951
5,1,1,3,1,0,0,3,1,3,38603,30349,0,11,40189,28954
6,1,3,0,0,3,1,0,124,67,38606,30349,121,0,40192,28954
7,1,2,0,0,3,1,0,154,44,38608,30349,158,67,40195,28954
8,1,1,1,2,1,2,1,13,19,38609,30350,18,48,40196,28955
9,2,3,0,0,3,1,0,73,65,38612,30350,97,0,40199,28955
10,2,2,1,0,3,1,0,78,67,38614,30351,101,52,40202,28955
11,2,0,1,1,0,0,3,75,92,38614,30352,83,134,40202,28958
12,2,1,0,0,3,1,0,95,46,38615,30352,123,14,40205,28958
13,2,3,1,0,3,1,0,17,16,38618,30353,23,72,40208,28958
14,2,1,5,1,0,0,3,51,37,38619,30358,52,69,40208,28961
15,2,2,0,0,3,1,0,79,83,38621,30358,90,30,40211,28961
16,2,0,1,1,0,0,3,0,1,38621,30359,0,131,40211,28964
17,2,0,0,2,1,2,1,16,24,38621,30359,15,80,40212,28965
18,3,1,1,2,1,2,1,64,74,38622,30360,74,43,40213,28966
19,3,0,3,1,0,0,3,17,19,38622,30363,23,75,40213,28969
20,3,2,1,0,3,1,0,126,68,38624,30364,124,48,40216,28969
21,3,1,2,1,0,0,3,52,59,38625,30366,60,69,40216,28972
22,3,0,1,1,0,0,3,1,4,38625,30367,0,70,40216,28975
23,3,2,0,0,3,1,0,89,75,38627,30367,102,14,40219,28975
24,3,3,0,0,3,1,0,161,29,38630,30367,173,13,40222,28975
25,3,1,1,2,1,2,1,155,45,38631,30368,159,98,40223,28976
26,3,4,0,0,3,1,0,70,68,38635,30368,80,0,40226,28976
27,4,0,5,1,0,0,3,79,88,38635,30373,90,134,40226,28979
28,4,1,1,2,1,2,1,17,25,38636,30374,16,70,40227,28980
29,4,1,0,0,3,1,0,14,19,38637,30374,21,80,40230,28980
30,4,1,1,2,1,2,1,96,47,38638,30375,124,12,40231,28981
31,4,1,0,0,3,1,0,1,1,38639,30375,3,52,40234,28981
32,4,2,0,0,3,1,0,80,67,38641,30375,104,0,40237,28981
33,4,1,1,2,1,2,1,76,93,38642,30376,84,31,40238,28982
34,4,1,1,2,1,2,1,74,66,38643,30377,98,135,40239,28983
35,4,2,1,0,3,1,0,53,38,38645,30378,55,72,40242,28983
36,5,1,1,2,1,2,1,75,67,38646,30379,99,71,40243,28984
37,5,2,0,0,3,1,0,3,4,38648,30379,3,43,40246,28984
38,5,1,1,2,1,2,1,90,76,38649,30380,103,81,40247,28985
39,5,1,2,1,0,0,3,71,70,38650,30382,80,17,40247,28988
40,5,1,0,0,3,1,0,18,19,38651,30382,26,69,40250,28988
41,5,3,1,0,3,1,0,158,46,38654,30383,162,13,40253,28988
42,5,0,4,1,0,0,3,52,63,38654,30387,60,101,40253,28991
43,5,0,0,2,1,2,1,161,29,38654,30387,174,1,40254,28992
44,5,2,2,2,1,2,1,66,76,38656,30389,75,49,40255,28993
45,6,1,1,2,1,2,1,97,48,38657,30390,125,136,40256,28994
46,6,2,3,1,0,0,3,55,41,38659,30393,55,137,40256,28997
47,6,3,0,0,3,1,0,129,68,38662,30393,127,70,40259,28997
48,6,4,0,0,3,1,0,84,67,38666,30393,107,75,40262,28997
49,6,3,2,0,3,1,0,4,3,38669,30395,6,31,40265,28997
50,6,0,1,1,0,0,3,14,20,38669,30396,21,55,40265,29000
51,6,0,0,2,1,2,1,17,25,38669,30396,17,1,40266,29001
52,6,2,0,0,3,1,0,81,88,38671,30396,93,72,40269,29001
53,6,2,0,0,3,1,0,78,93,38673,30396,87,12,40272,29001
54,7,3,0,0,3,1,0,78,67,38676,30396,102,1,40275,29001
55,7,0,4,1,0,0,3,3,8,38676,30400,3,104,40275,29004
56,7,1,1,2,1,2,1,53,64,38677,30401,61,50,40276,29005
57,7,3,2,0,3,1,0,81,95,38680,30403,90,69,40279,29005
58,7,0,0,2,1,2,1,66,76,38680,30403,76,14,40280,29006
59,7,2,1,0,3,1,0,163,30,38682,30404,177,81,40283,29006
60,7,4,0,0,3,1,0,162,46,38686,30404,165,17,40286,29006
61,7,0,0,2,1,2,1,90,76,38686,30404,104,71,40287,29007
62,7,1,1,2,1,2,1,19,20,38687,30405,27,44,40288,29008
63,8,0,1,1,0,0,3,81,89,38687,30406,93,78,40288,29011
64,8,1,2,1,0,0,3,5,5,38688,30408,6,74,40288,29014
65,8,2,0,0,3,1,0,19,25,38690,30408,20,31,40291,29014
66,8,0,5,1,0,0,3,14,25,38690,30413,21,139,40291,29017
67,8,1,0,0,3,1,0,91,76,38691,30413,107,55,40294,29017
68,8,1,2,1,0,0,3,56,43,38692,30415,55,15,40294,29020
69,8,4,2,0,3,1,0,101,50,38696,30417,128,69,40297,29020
70,8,2,1,0,3,1,0,131,69,38698,30418,130,137,40300,29020
71,8,3,2,0,3,1,0,74,72,38701,30420,83,1,40303,29020
72,9,1,0,0,3,1,0,163,46,38702,30420,168,71,40306,29020
73,9,1,2,1,0,0,3,4,10,38703,30422,3,53,40306,29023
74,9,3,0,0,3,1,0,81,67,38706,30422,105,104,40309,29023
75,9,2,0,0,3,1,0,165,30,38708,30422,180,72,40312,29023
76,9,1,1,2,1,2,1,54,65,38709,30423,62,18,40313,29024
77,9,4,1,0,3,1,0,85,96,38713,30424,93,44,40316,29024
78,9,1,2,1,0,0,3,85,69,38714,30426,107,17,40316,29027
79,9,1,1,2,1,2,1,67,77,38715,30427,77,82,40317,29028
80,9,3,1,0,3,1,0,22,21,38718,30428,30,1,40320,29028
81,10,1,2,1,0,0,3,15,27,38719,30430,21,81,40320,29031
82,10,2,0,0,3,1,0,133,69,38721,30430,133,31,40323,29031
83,10,1,0,0,3,1,0,82,89,38722,30430,96,69,40326,29031
84,10,1,2,1,0,0,3,92,78,38723,30432,107,140,40326,29034
85,10,0,1,1,0,0,3,19,26,38723,30433,20,18,40326,29037
86,10,1,0,0,3,1,0,6,5,38724,30433,9,1,40329,29037
87,10,1,1,2,1,2,1,102,51,38725,30434,129,75,40330,29038
88,10,2,2,2,1,2,1,58,45,38727,30436,56,140,40331,29039
89,10,3,0,0,3,1,0,77,72,38730,30436,86,55,40334,29039
90,11,2,1,0,3,1,0,83,68,38732,30437,108,17,40337,29039
91,11,0,0,2,1,2,1,22,21,38732,30437,31,19,40338,29040
92,11,1,6,1,0,0,3,5,16,38733,30443,3,85,40338,29043
93,11,3,0,0,3,1,0,105,51,38736,30443,132,44,40341,29043
94,11,4,0,0,3,1,0,89,69,38740,30443,110,1,40344,29043
95,11,0,0,2,1,2,1,54,65,38740,30443,63,73,40345,29044
96,11,0,2,1,0,0,3,67,79,38740,30445,77,143,40345,29047
97,11,5,0,0,3,1,0,170,30,38745,30445,183,71,40348,29047
98,11,1,1,2,1,2,1,86,97,38746,30446,94,54,40349,29048
99,12,1,3,1,0,0,3,7,8,38747,30449,9,107,40349,29051
100,12,0,0,2,1,2,1,77,72,38747,30449,87,32,40350,29052
101,12,3,0,0,3,1,0,166,46,38750,30449,171,18,40353,29052
102,12,1,0,0,3,1,0,59,45,38751,30449,59,44,40356,29052
103,12,0,3,1,0,0,3,67,82,38751,30452,77,143,40356,29055
104,12,2,0,0,3,1,0,21,26,38753,30452,23,75,40359,29055
105,12,0,1,1,0,0,3,15,28,38753,30453,21,4,40359,29058
106,12,0,0,2,1,2,1,133,69,38753,30453,134,82,40360,29059
107,12,3,0,0,3,1,0,95,78,38756,30453,110,69,40363,29059
108,13,0,1,1,0,0,3,82,90,38756,30454,96,4,40363,29062
109,13,2,1,0,3,1,0,88,98,38758,30455,97,19,40366,29062
110,13,1,1,2,1,2,1,55,66,38759,30456,64,56,40367,29063
111,13,2,1,0,3,1,0,7,17,38761,30457,6,73,40370,29063
112,13,0,1,1,0,0,3,22,22,38761,30458,31,88,40370,29066
113,13,0,0,2,1,2,1,83,68,38761,30458,109,72,40371,29067
114,13,1,1,2,1,2,1,106,52,38762,30459,133,18,40372,29068
115,13,0,2,1,0,0,3,170,32,38762,30461,183,146,40372,29071
116,13,0,0,2,1,2,1,89,69,38762,30461,111,55,40373,29072
117,14,4,0,0,3,1,0,174,32,38766,30461,186,44,40376,29072
118,14,1,0,0,3,1,0,60,45,38767,30461,62,82,40379,29072
119,14,1,1,2,1,2,1,68,83,38768,30462,78,5,40380,29073
120,14,1,0,0,3,1,0,16,28,38769,30462,24,69,40383,29073
121,14,1,0,0,3,1,0,22,26,38770,30462,26,4,40386,29073
122,14,1,0,0,3,1,0,167,46,38771,30462,174,32,40389,29073
123,14,0,1,1,0,0,3,95,79,38771,30463,110,110,40389,29076
124,14,3,0,0,3,1,0,136,69,38774,30463,137,75,40392,29076
125,14,0,0,2,1,2,1,77,72,38774,30463,88,19,40393,29077
126,15,0,0,2,1,2,1,22,22,38774,30463,32,57,40394,29078
127,15,2,1,0,3,1,0,91,70,38776,30464,114,88,40397,29078
128,15,1,2,1,0,0,3,89,100,38777,30466,97,75,40397,29081
129,15,3,0,0,3,1,0,109,52,38780,30466,136,55,40400,29081
130,15,1,5,1,0,0,3,56,71,38781,30471,64,146,40400,29084
131,15,3,1,0,3,1,0,10,9,38784,30472,12,19,40403,29084
132,15,2,1,0,3,1,0,84,91,38786,30473,99,18,40406,29084
133,15,4,0,0,3,1,0,87,68,38790,30473,112,73,40409,29084
134,15,0,3,1,0,0,3,7,20,38790,30476,6,149,40409,29087
135,16,1,1,2,1,2,1,61,46,38791,30477,63,19,40410,29088
136,16,3,0,0,3,1,0,170,46,38794,30477,177,82,40413,29088
137,16,2,2,2,1,2,1,70,85,38796,30479,79,76,40414,29089
138,16,3,0,0,3,1,0,177,32,38799,30479,189,19,40417,29089
139,16,1,0,0,3,1,0,17,28,38800,30479,27,44,40420,29089
140,16,0,0,2,1,2,1,77,72,38800,30479,89,70,40421,29090
141,16,2,1,0,3,1,0,58,72,38802,30480,67,5,40424,29090
142,16,2,1,0,3,1,0,97,80,38804,30481,113,4,40427,29090
143,16,0,1,1,0,0,3,136,70,38804,30482,137,113,40427,29093
144,17,4,0,0,3,1,0,91,68,38808,30482,115,57,40430,29093
145,17,1,3,1,0,0,3,8,23,38809,30485,6,149,40430,29096
146,17,2,3,1,0,0,3,91,103,38811,30488,97,76,40430,29099
147,17,1,0,0,3,1,0,23,26,38812,30488,29,19,40433,29099
148,17,1,3,1,0,0,3,85,94,38813,30491,99,91,40433,29102
149,17,1,2,1,0,0,3,11,11,38814,30493,12,58,40433,29105
150,17,2,0,0,3,1,0,24,22,38816,30493,35,32,40436,29105
151,17,0,4,1,0,0,3,91,74,38816,30497,114,152,40436,29108
152,17,4,2,0,3,1,0,113,54,38820,30499,139,75,40439,29108
153,18,2,2,2,1,2,1,93,70,38822,30501,116,33,40440,29109
154,18,2,3,1,0,0,3,25,29,38824,30504,29,79,40440,29112
155,18,0,0,2,1,2,1,24,22,38824,30504,36,6,40441,29113
156,18,1,0,0,3,1,0,114,54,38825,30504,142,57,40444,29113
157,18,4,1,0,3,1,0,89,95,38829,30505,102,75,40447,29113
158,18,1,0,0,3,1,0,62,46,38830,30505,66,19,40450,29113
159,18,1,0,0,3,1,0,92,74,38831,30505,117,149,40453,29113
160,18,1,0,0,3,1,0,12,11,38832,30505,15,91,40456,29113
161,18,1,0,0,3,1,0,92,103,38833,30505,100,152,40459,29113
162,19,1,0,0,3,1,0,137,70,38834,30505,140,19,40462,29113
163,19,3,0,0,3,1,0,173,46,38837,30505,180,4,40465,29113
164,19,2,1,0,3,1,0,99,81,38839,30506,116,19,40468,29113
165,19,1,1,2,1,2,1,9,24,38840,30507,7,83,40469,29114
166,19,1,1,2,1,2,1,71,86,38841,30508,80,71,40470,29115
167,19,1,1,2,1,2,1,59,73,38842,30509,68,45,40471,29116
168,19,2,1,0,3,1,0,79,73,38844,30510,92,58,40474,29116
169,19,1,3,1,0,0,3,18,31,38845,30513,27,116,40474,29119
170,19,5,0,0,3,1,0,182,32,38850,30513,192,76,40477,29119
171,20,0,2,1,0,0,3,25,31,38850,30515,29,152,40477,29122
172,20,3,3,2,1,2,1,21,34,38853,30518,28,80,40478,29123
173,20,2,1,0,3,1,0,94,104,38855,30519,103,6,40481,29123
174,20,1,2,1,0,0,3,93,76,38856,30521,117,36,40481,29126
175,20,0,1,1,0,0,3,93,71,38856,30522,116,22,40481,29129
176,20,0,0,2,1,2,1,89,95,38856,30522,103,58,40482,29130
177,20,0,2,1,0,0,3,62,48,38856,30524,66,94,40482,29133
178,20,1,1,2,1,2,1,115,55,38857,30525,143,153,40483,29134
179,20,1,1,2,1,2,1,13,12,38858,30526,16,76,40484,29135
180,21,1,0,0,3,1,0,183,32,38859,30526,195,83,40487,29135
181,21,1,0,0,3,1,0,60,73,38860,30526,71,76,40490,29135
182,21,1,1,2,1,2,1,25,23,38861,30527,37,117,40491,29136
183,21,3,4,1,0,0,3,12,28,38864,30531,7,74,40491,29139
184,21,1,1,2,1,2,1,80,74,38865,30532,93,20,40492,29140
185,21,3,0,0,3,1,0,176,46,38868,30532,183,45,40495,29140
186,21,0,0,2,1,2,1,71,86,38868,30532,81,5,40496,29141
187,21,2,0,0,3,1,0,139,70,38870,30532,143,19,40499,29141
188,21,1,0,0,3,1,0,100,81,38871,30532,119,58,40502,29141
189,22,2,2,2,1,2,1,96,106,38873,30534,104,84,40503,29142
190,22,3,1,0,3,1,0,142,71,38876,30535,146,80,40506,29142
191,22,0,1,1,0,0,3,89,96,38876,30536,103,9,40506,29145
192,22,1,3,1,0,0,3,26,34,38877,30539,29,156,40506,29148
193,22,1,0,0,3,1,0,22,34,38878,30539,31,76,40509,29148
194,22,1,2,1,0,0,3,94,78,38879,30541,117,25,40509,29151
195,22,1,2,1,0,0,3,63,50,38880,30543,66,61,40509,29154
196,22,2,0,0,3,1,0,117,55,38882,30543,146,36,40512,29154
197,22,0,2,1,0,0,3,13,14,38882,30545,16,155,40512,29157
198,23,1,0,0,3,1,0,94,71,38883,30545,119,74,40515,29157
199,23,1,1,2,1,2,1,61,74,38884,30546,72,6,40516,29158
200,23,6,0,0,3,1,0,182,46,38890,30546,186,58,40519,29158
201,23,0,2,1,0,0,3,80,76,38890,30548,93,97,40519,29161
202,23,1,1,2,1,2,1,72,87,38891,30549,82,20,40520,29162
203,23,1,2,1,0,0,3,13,30,38892,30551,7,23,40520,29165
204,23,3,0,0,3,1,0,103,81,38895,30551,122,45,40523,29165
205,23,3,0,0,3,1,0,186,32,38898,30551,198,117,40526,29165
206,23,0,1,1,0,0,3,25,24,38898,30552,37,79,40526,29168
207,24,0,1,1,0,0,3,142,72,38898,30553,146,158,40526,29171
208,24,1,1,2,1,2,1,90,97,38899,30554,104,26,40527,29172
209,24,1,3,1,0,0,3,23,37,38900,30557,31,159,40527,29175
210,24,2,1,0,3,1,0,96,79,38902,30558,120,79,40530,29175
211,24,0,2,1,0,0,3,26,36,38902,30560,29,64,40530,29178
212,24,1,1,2,1,2,1,64,51,38903,30561,67,37,40531,29179
213,24,3,1,0,3,1,0,16,15,38906,30562,19,84,40534,29179
214,24,1,1,2,1,2,1,81,77,38907,30563,94,81,40535,29180
215,24,3,2,0,3,1,0,120,57,38910,30565,149,9,40538,29180
216,25,1,0,0,3,1,0,97,106,38911,30565,107,6,40541,29180
217,25,2,0,0,3,1,0,184,46,38913,30565,189,97,40544,29180
218,25,0,1,1,0,0,3,94,72,38913,30566,119,48,40544,29183
219,25,2,2,2,1,2,1,27,26,38915,30568,38,59,40545,29184
220,25,0,2,1,0,0,3,13,32,38915,30570,7,79,40545,29187
221,25,0,1,1,0,0,3,61,75,38915,30571,72,26,40545,29190
222,25,2,1,0,3,1,0,74,88,38917,30572,85,81,40548,29190
223,25,0,1,1,0,0,3,96,80,38917,30573,120,120,40548,29193
224,25,1,0,0,3,1,0,187,32,38918,30573,201,20,40551,29193
225,26,0,0,2,1,2,1,142,72,38918,30573,147,65,40552,29194
226,26,3,3,2,1,2,1,67,54,38921,30576,68,10,40553,29195
227,26,2,1,0,3,1,0,83,78,38923,30577,97,159,40556,29195
228,26,1,1,2,1,2,1,104,82,38924,30578,123,159,40557,29196
229,26,3,1,0,3,1,0,26,38,38927,30579,34,37,40560,29196
230,26,1,1,2,1,2,1,27,37,38928,30580,30,75,40561,29197
231,26,1,0,0,3,1,0,17,15,38929,30580,22,26,40564,29197
232,26,4,1,0,3,1,0,124,58,38933,30581,152,84,40567,29197
233,26,0,0,2,1,2,1,90,97,38933,30581,105,80,40568,29198
234,27,0,0,2,1,2,1,74,88,38933,30581,86,80,40569,29199
235,27,1,0,0,3,1,0,95,72,38934,30581,122,20,40572,29199
236,27,0,2,1,0,0,3,61,77,38934,30583,72,100,40572,29202
237,27,2,2,2,1,2,1,15,34,38936,30585,8,7,40573,29203
238,27,3,1,0,3,1,0,187,47,38939,30586,192,81,40576,29203
239,27,2,0,0,3,1,0,29,26,38941,30586,41,26,40579,29203
240,27,1,1,2,1,2,1,98,107,38942,30587,108,121,40580,29204
241,27,1,1,2,1,2,1,97,81,38943,30588,121,49,40581,29205
242,27,5,0,0,3,1,0,192,32,38948,30588,204,59,40584,29205
243,28,0,1,1,0,0,3,26,39,38948,30589,34,29,40584,29208
244,28,0,2,1,0,0,3,17,17,38948,30591,22,78,40584,29211
245,28,5,1,0,3,1,0,192,48,38953,30592,195,65,40587,29211
246,28,1,3,1,0,0,3,84,81,38954,30595,97,162,40587,29214
247,28,2,1,0,3,1,0,29,38,38956,30596,33,84,40590,29214
248,28,3,2,0,3,1,0,107,84,38959,30598,126,37,40593,29214
249,28,4,0,0,3,1,0,146,72,38963,30598,150,10,40596,29214
250,28,1,2,1,0,0,3,91,99,38964,30600,105,124,40596,29217
251,28,1,0,0,3,1,0,68,54,38965,30600,71,80,40599,29217
252,29,1,0,0,3,1,0,96,72,38966,30600,125,100,40602,29217
253,29,0,2,1,0,0,3,29,28,38966,30602,41,162,40602,29220
254,29,1,0,0,3,1,0,193,32,38967,30602,207,65,40605,29220
255,29,0,0,2,1,2,1,61,77,38967,30602,73,81,40606,29221
256,29,0,2,1,0,0,3,15,36,38967,30604,8,23,40606,29224
257,29,0,0,2,1,2,1,98,107,38967,30604,109,27,40607,29225
258,29,1,2,1,0,0,3,92,101,38968,30606,105,62,40607,29228
259,29,2,1,0,3,1,0,126,59,38970,30607,155,7,40610,29228
260,29,1,1,2,1,2,1,98,82,38971,30608,122,82,40611,29229
261,30,1,1,2,1,2,1,147,73,38972,30609,151,30,40612,29230
262,30,1,2,1,0,0,3,75,90,38973,30611,86,40,40612,29233
263,30,1,1,2,1,2,1,69,55,38974,30612,72,79,40613,29234
264,30,1,1,2,1,2,1,85,82,38975,30613,98,85,40614,29235
265,30,1,3,1,0,0,3,27,42,38976,30616,34,83,40614,29238
266,30,2,0,0,3,1,0,109,84,38978,30616,129,10,40617,29238
267,30,0,0,2,1,2,1,192,48,38978,30616,196,163,40618,29239
268,30,0,0,2,1,2,1,17,17,38978,30616,23,50,40619,29240
269,30,1,4,1,0,0,3,30,42,38979,30620,33,127,40619,29243
270,31,2,0,0,3,1,0,98,72,38981,30620,128,62,40622,29243
271,31,0,5,1,0,0,3,61,82,38981,30625,73,165,40622,29246
272,31,2,0,0,3,1,0,128,59,38983,30625,158,82,40625,29246
273,31,3,1,0,3,1,0,20,18,38986,30626,26,27,40628,29246
274,31,0,0,2,1,2,1,15,36,38986,30626,9,66,40629,29247
275,31,1,1,2,1,2,1,99,83,38987,30627,123,24,40630,29248
276,31,0,2,1,0,0,3,92,103,38987,30629,105,166,40630,29251
277,31,1,3,1,0,0,3,30,31,38988,30632,41,84,40630,29254
278,31,2,2,2,1,2,1,100,109,38990,30634,110,101,40631,29255
279,32,0,0,2,1,2,1,85,82,38990,30634,99,84,40632,29256
280,32,4,0,0,3,1,0,196,48,38994,30634,199,10,40635,29256
281,32,1,1,2,1,2,1,76,91,38995,30635,87,31,40636,29257
282,32,1,3,1,0,0,3,148,76,38996,30638,151,82,40636,29260
283,32,0,0,2,1,2,1,27,42,38996,30638,35,8,40637,29261
284,32,3,1,0,3,1,0,33,43,38999,30639,36,50,40640,29261
285,32,1,1,2,1,2,1,70,56,39000,30640,73,128,40641,29262
286,32,2,0,0,3,1,0,195,32,39002,30640,210,40,40644,29262
287,32,2,2,2,1,2,1,111,86,39004,30642,130,86,40645,29263
288,33,4,0,0,3,1,0,103,83,39008,30642,126,84,40648,29263
289,33,0,0,2,1,2,1,98,72,39008,30642,129,166,40649,29264
290,33,4,1,0,3,1,0,132,60,39012,30643,161,101,40652,29264
291,33,2,1,0,3,1,0,94,104,39014,30644,108,24,40655,29264
292,33,2,1,0,3,1,0,17,37,39016,30645,12,40,40658,29264
293,33,1,1,2,1,2,1,31,32,39017,30646,42,167,40659,29265
294,33,3,2,0,3,1,0,103,111,39020,30648,113,66,40662,29265
295,33,1,1,2,1,2,1,34,44,39021,30649,37,63,40663,29266
296,33,0,1,1,0,0,3,20,19,39021,30650,26,85,40663,29269
297,34,2,0,0,3,1,0,197,32,39023,30650,213,10,40666,29269
298,34,2,0,0,3,1,0,72,56,39025,30650,76,8,40669,29269
299,34,0,2,1,0,0,3,61,84,39025,30652,73,34,40669,29272
300,34,3,0,0,3,1,0,114,86,39028,30652,133,84,40672,29272
301,34,4,1,0,3,1,0,200,49,39032,30653,202,82,40675,29272
302,34,0,1,1,0,0,3,85,83,39032,30654,99,131,40675,29275
303,34,1,2,1,0,0,3,28,44,39033,30656,35,30,40675,29278
304,34,5,0,0,3,1,0,153,76,39038,30656,154,50,40678,29278
305,34,2,4,1,0,0,3,78,95,39040,30660,87,89,40678,29281
0,1,1,2,1,0,0,3,1,2,39041,30662,0,134,40678,29284
1,1,3,3,2,1,2,1,34,35,39044,30665,43,85,40679,29285
2,1,3,0,0,3,1,0,200,32,39047,30665,216,89,40682,29285
3,1,2,2,2,1,2,1,96,106,39049,30667,109,9,40683,29286
4,1,2,1,0,3,1,0,2,1,39051,30668,3,82,40686,29286
5,1,0,2,1,0,0,3,34,46,39051,30670,37,27,40686,29289
6,1,4,0,0,3,1,0,204,49,39055,30670,205,63,40689,29289
7,1,2,1,0,3,1,0,155,77,39057,30671,157,85,40692,29289
8,1,1,0,0,3,1,0,104,111,39058,30671,116,66,40695,29289
9,2,1,0,0,3,1,0,86,83,39059,30671,102,101,40698,29289
10,2,1,1,2,1,2,1,133,61,39060,30672,162,85,40699,29290
11,2,1,1,2,1,2,1,104,84,39061,30673,127,168,40700,29291
12,2,1,0,0,3,1,0,21,19,39062,30673,29,0,40703,29291
13,2,2,0,0,3,1,0,74,56,39064,30673,79,30,40706,29291
14,2,1,0,0,3,1,0,115,86,39065,30673,136,0,40709,29291
15,2,1,1,2,1,2,1,99,73,39066,30674,130,35,40710,29292
16,2,1,0,0,3,1,0,29,44,39067,30674,38,166,40713,29292
17,2,0,4,1,0,0,3,78,99,39067,30678,87,53,40713,29295
18,3,2,2,2,1,2,1,98,108,39069,30680,110,86,40714,29296
19,3,2,0,0,3,1,0,202,32,39071,30680,219,63,40717,29296
20,3,3,2,0,3,1,0,207,51,39074,30682,208,30,40720,29296
21,3,1,0,0,3,1,0,2,2,39075,30682,3,85,40723,29296
22,3,1,1,2,1,2,1,105,112,39076,30683,117,28,40724,29297
23,3,4,0,0,3,1,0,159,77,39080,30683,160,9,40727,29297
24,3,1,3,1,0,0,3,79,102,39081,30686,87,137,40727,29300
25,3,1,1,2,1,2,1,35,36,39082,30687,44,83,40728,29301
26,3,0,0,2,1,2,1,2,1,39082,30687,4,90,40729,29302
27,4,6,0,0,3,1,0,213,51,39088,30687,211,35,40732,29302
28,4,1,0,0,3,1,0,75,56,39089,30687,82,101,40735,29302
29,4,1,3,1,0,0,3,30,47,39090,30690,38,171,40735,29305
30,4,5,2,0,3,1,0,109,86,39095,30692,130,53,40738,29305
31,4,0,0,2,1,2,1,34,46,39095,30692,38,1,40739,29306
32,4,2,0,0,3,1,0,117,86,39097,30692,139,66,40742,29306
33,4,1,0,0,3,1,0,100,73,39098,30692,133,0,40745,29306
34,4,1,2,1,0,0,3,87,85,39099,30694,102,140,40745,29309
35,4,0,1,1,0,0,3,21,20,39099,30695,29,88,40745,29312
36,5,2,2,2,1,2,1,100,110,39101,30697,111,91,40746,29313
37,5,0,1,1,0,0,3,2,3,39101,30698,3,66,40746,29316
38,5,0,3,1,0,0,3,105,115,39101,30701,117,89,40746,29319
39,5,0,2,1,0,0,3,79,104,39101,30703,87,12,40746,29322
40,5,0,0,2,1,2,1,2,1,39101,30703,5,29,40747,29323
41,5,1,0,0,3,1,0,203,32,39102,30703,222,166,40750,29323
42,5,2,0,0,3,1,0,37,36,39104,30703,47,30,40753,29323
43,5,5,1,0,3,1,0,164,78,39109,30704,163,83,40756,29323
44,5,1,0,0,3,1,0,134,61,39110,30704,165,85,40759,29323
45,6,2,2,2,1,2,1,36,48,39112,30706,39,172,40760,29324
46,6,3,0,0,3,1,0,216,51,39115,30706,214,88,40763,29324
47,6,0,0,2,1,2,1,21,20,39115,30706,30,141,40764,29325
48,6,1,0,0,3,1,0,110,86,39116,30706,133,0,40767,29325
49,6,1,1,2,1,2,1,118,87,39117,30707,140,54,40768,29326
50,6,2,2,2,1,2,1,32,49,39119,30709,39,36,40769,29327
51,6,2,1,0,3,1,0,77,57,39121,30710,85,1,40772,29327
52,6,0,1,1,0,0,3,100,74,39121,30711,133,104,40772,29330
53,6,1,0,0,3,1,0,88,85,39122,30711,105,66,40775,29330
54,7,1,0,0,3,1,0,101,110,39123,30711,114,66,40778,29330
55,7,3,1,0,3,1,0,108,116,39126,30712,120,85,40781,29330
56,7,1,1,2,1,2,1,3,4,39127,30713,4,31,40782,29331
57,7,1,0,0,3,1,0,80,104,39128,30713,90,83,40785,29331
58,7,1,0,0,3,1,0,89,85,39129,30713,108,12,40788,29331
59,7,0,0,2,1,2,1,164,78,39129,30713,164,30,40789,29332
60,7,4,0,0,3,1,0,207,32,39133,30713,225,36,40792,29332
61,7,5,1,0,3,1,0,139,62,39138,30714,168,91,40795,29332
62,7,0,0,2,1,2,1,2,1,39138,30714,6,167,40796,29333
63,8,0,0,2,1,2,1,118,87,39138,30714,141,13,40797,29334
64,8,0,2,1,0,0,3,110,88,39138,30716,133,91,40797,29337
65,8,2,2,2,1,2,1,79,59,39140,30718,86,90,40798,29338
66,8,1,1,2,1,2,1,101,75,39141,30719,134,67,40799,29339
67,8,1,1,2,1,2,1,33,50,39142,30720,40,1,40800,29340
68,8,0,2,1,0,0,3,36,50,39142,30722,39,57,40800,29343
69,8,0,3,1,0,0,3,216,54,39142,30725,214,144,40800,29346
70,8,0,0,2,1,2,1,207,32,39142,30725,226,105,40801,29347
71,8,1,0,0,3,1,0,38,36,39143,30725,50,1,40804,29347
72,9,0,4,1,0,0,3,3,8,39143,30729,4,170,40804,29350
73,9,4,0,0,3,1,0,168,78,39147,30729,167,36,40807,29350
74,9,1,0,0,3,1,0,140,62,39148,30729,171,66,40810,29350
75,9,1,1,2,1,2,1,81,105,39149,30730,91,32,40811,29351
76,9,0,0,2,1,2,1,101,110,39149,30730,115,31,40812,29352
77,9,1,0,0,3,1,0,90,85,39150,30730,111,85,40815,29352
78,9,0,1,1,0,0,3,21,21,39150,30731,30,86,40815,29355
79,9,0,1,1,0,0,3,108,117,39150,30732,120,94,40815,29358
80,9,0,4,1,0,0,3,2,5,39150,30736,6,175,40815,29361
81,10,1,1,2,1,2,1,80,60,39151,30737,87,68,40816,29362
82,10,0,1,1,0,0,3,101,76,39151,30738,134,88,40816,29365
83,10,2,0,0,3,1,0,218,54,39153,30738,217,13,40819,29365
84,10,3,2,0,3,1,0,113,90,39156,30740,136,90,40822,29365
85,10,2,0,0,3,1,0,38,50,39158,30740,42,91,40825,29365
86,10,2,0,0,3,1,0,209,32,39160,30740,229,57,40828,29365
87,10,0,1,1,0,0,3,33,51,39160,30741,40,147,40828,29368
88,10,2,1,0,3,1,0,40,37,39162,30742,53,1,40831,29368
89,10,0,1,1,0,0,3,2,6,39162,30743,6,108,40831,29371
90,11,3,1,0,3,1,0,121,88,39165,30744,144,86,40834,29371
91,11,2,2,2,1,2,1,103,112,39167,30746,116,2,40835,29372
92,11,1,2,1,0,0,3,22,23,39168,30748,30,97,40835,29375
93,11,0,1,1,0,0,3,3,9,39168,30749,4,178,40835,29378
94,11,1,1,2,1,2,1,82,106,39169,30750,92,32,40836,29379
95,11,0,1,1,0,0,3,90,86,39169,30751,111,35,40836,29382
96,11,2,0,0,3,1,0,110,117,39171,30751,123,66,40839,29382
97,11,1,0,0,3,1,0,141,62,39172,30751,174,36,40842,29382
98,11,0,2,1,0,0,3,168,80,39172,30753,167,173,40842,29385
99,12,3,0,0,3,1,0,221,54,39175,30753,220,68,40845,29385
100,12,0,3,1,0,0,3,40,40,39175,30756,53,60,40845,29388
101,12,2,1,0,3,1,0,211,33,39177,30757,232,91,40848,29388
102,12,0,1,1,0,0,3,113,91,39177,30758,136,150,40848,29391
103,12,3,2,0,3,1,0,36,53,39180,30760,43,13,40851,29391
104,12,1,1,2,1,2,1,81,61,39181,30761,88,89,40852,29392
105,12,2,0,0,3,1,0,4,6,39183,30761,9,1,40855,29392
106,12,0,0,2,1,2,1,38,50,39183,30761,43,109,40856,29393
107,12,3,1,0,3,1,0,104,77,39186,30762,137,90,40859,29393
108,13,1,1,2,1,2,1,23,24,39187,30763,31,67,40860,29394
109,13,3,1,0,3,1,0,93,87,39190,30764,114,32,40863,29394
110,13,6,0,0,3,1,0,116,117,39196,30764,126,2,40866,29394
111,13,3,4,1,0,0,3,107,81,39199,30768,137,89,40866,29397
112,13,2,4,1,0,0,3,105,116,39201,30772,116,176,40866,29400
113,13,3,1,0,3,1,0,144,63,39204,30773,177,35,40869,29400
114,13,0,1,1,0,0,3,3,10,39204,30774,4,112,40869,29403
115,13,1,2,1,0,0,3,122,90,39205,30776,144,181,40869,29406
116,13,4,3,0,3,1,0,86,109,39209,30779,95,36,40872,29406
117,14,4,1,0,3,1,0,40,54,39213,30780,46,89,40875,29406
118,14,0,1,1,0,0,3,81,62,39213,30781,88,100,40875,29409
119,14,3,1,0,3,1,0,224,55,39216,30782,223,90,40878,29409
120,14,2,0,0,3,1,0,40,50,39218,30782,46,89,40881,29409
121,14,1,3,1,0,0,3,4,13,39219,30785,4,63,40881,29412
122,14,1,0,0,3,1,0,5,6,39220,30785,12,150,40884,29412
123,14,3,1,0,3,1,0,214,34,39223,30786,235,68,40887,29412
124,14,1,0,0,3,1,0,41,40,39224,30786,56,13,40890,29412
125,14,1,1,2,1,2,1,169,81,39225,30787,168,92,40891,29413
126,15,3,1,0,3,1,0,89,110,39228,30788,98,2,40894,29413
127,15,0,3,1,0,0,3,23,27,39228,30791,31,38,40894,29416
128,15,2,2,2,1,2,1,124,92,39230,30793,145,33,40895,29417
129,15,1,1,2,1,2,1,114,92,39231,30794,137,68,40896,29418
130,15,1,1,2,1,2,1,106,117,39232,30795,117,113,40897,29419
131,15,2,2,2,1,2,1,118,119,39234,30797,127,37,40898,29420
132,15,0,1,1,0,0,3,107,82,39234,30798,137,179,40898,29423
133,15,2,0,0,3,1,0,146,63,39236,30798,180,181,40901,29423
134,15,2,3,1,0,0,3,95,90,39238,30801,114,4,40901,29426
135,16,1,0,0,3,1,0,6,6,39239,30801,15,13,40904,29426
136,16,1,0,0,3,1,0,41,54,39240,30801,49,68,40907,29426
137,16,0,2,1,0,0,3,4,15,39240,30803,4,95,40907,29429
138,16,3,4,1,0,0,3,43,54,39243,30807,46,103,40907,29432
139,16,2,2,2,1,2,1,43,42,39245,30809,57,90,40908,29433
140,16,3,0,0,3,1,0,172,81,39248,30809,171,68,40911,29433
141,16,6,0,0,3,1,0,230,55,39254,30809,226,89,40914,29433
142,16,1,1,2,1,2,1,215,35,39255,30810,236,91,40915,29434
143,16,0,6,1,0,0,3,106,123,39255,30816,117,153,40915,29437
144,17,2,2,2,1,2,1,109,84,39257,30818,138,34,40916,29438
145,17,2,1,0,3,1,0,91,111,39259,30819,101,4,40919,29438
146,17,5,1,0,3,1,0,119,93,39264,30820,140,38,40922,29438
147,17,1,0,0,3,1,0,96,90,39265,30820,117,2,40925,29438
148,17,2,0,0,3,1,0,83,62,39267,30820,91,37,40928,29438
149,17,3,2,0,3,1,0,149,65,39270,30822,183,113,40931,29438
150,17,0,5,1,0,0,3,23,32,39270,30827,31,184,40931,29441
151,17,1,4,1,0,0,3,125,96,39271,30831,145,182,40931,29444
152,17,2,1,0,3,1,0,120,120,39273,30832,130,63,40934,29444
153,18,2,2,2,1,2,1,151,67,39275,30834,184,5,40935,29445
154,18,1,1,2,1,2,1,92,112,39276,30835,102,96,40936,29446
155,18,0,1,1,0,0,3,119,94,39276,30836,140,5,40936,29449
156,18,1,2,1,0,0,3,84,64,39277,30838,91,185,40936,29452
157,18,1,2,1,0,0,3,97,92,39278,30840,117,40,40936,29455
158,18,1,2,1,0,0,3,42,56,39279,30842,49,41,40936,29458
159,18,2,3,1,0,0,3,127,99,39281,30845,145,116,40936,29461
160,18,1,0,0,3,1,0,110,84,39282,30845,141,184,40939,29461
161,18,4,0,0,3,1,0,27,32,39286,30845,34,63,40942,29461
162,19,2,1,0,3,1,0,108,124,39288,30846,120,68,40945,29461
163,19,1,3,1,0,0,3,44,57,39289,30849,46,71,40945,29464
164,19,3,0,0,3,1,0,9,6,39292,30849,18,90,40948,29464
165,19,3,1,0,3,1,0,233,56,39295,30850,229,34,40951,29464
166,19,1,3,1,0,0,3,121,123,39296,30853,130,156,40951,29467
167,19,3,3,2,1,2,1,46,45,39299,30856,58,104,40952,29468
168,19,5,1,0,3,1,0,177,82,39304,30857,174,91,40955,29468
169,19,1,0,0,3,1,0,216,35,39305,30857,239,89,40958,29468
170,19,1,2,1,0,0,3,5,17,39306,30859,4,16,40958,29471
171,20,3,1,0,3,1,0,113,85,39309,30860,144,5,40961,29471
172,20,1,3,1,0,0,3,85,67,39310,30863,91,187,40961,29474
173,20,3,2,0,3,1,0,154,69,39313,30865,187,68,40964,29474
174,20,2,2,2,1,2,1,44,58,39315,30867,50,97,40965,29475
175,20,3,1,0,3,1,0,130,100,39318,30868,148,5,40968,29475
176,20,2,1,0,3,1,0,99,93,39320,30869,120,63,40971,29475
177,20,0,0,2,1,2,1,27,32,39320,30869,35,117,40972,29476
178,20,1,4,1,0,0,3,45,61,39321,30873,46,188,40972,29479
179,20,1,2,1,0,0,3,120,96,39322,30875,140,43,40972,29482
180,21,0,5,1,0,0,3,46,50,39322,30880,58,191,40972,29485
181,21,1,1,2,1,2,1,109,125,39323,30881,121,90,40973,29486
182,21,1,1,2,1,2,1,6,18,39324,30882,5,105,40974,29487
183,21,0,1,1,0,0,3,121,124,39324,30883,130,19,40974,29490
184,21,0,1,1,0,0,3,9,7,39324,30884,18,44,40974,29493
185,21,2,2,2,1,2,1,94,114,39326,30886,103,91,40975,29494
186,21,1,2,1,0,0,3,217,37,39327,30888,239,37,40975,29497
187,21,0,0,2,1,2,1,154,69,39327,30888,188,92,40976,29498
188,21,2,0,0,3,1,0,179,82,39329,30888,177,71,40979,29498
189,22,1,2,1,0,0,3,234,58,39330,30890,229,190,40979,29501
190,22,2,3,1,0,0,3,47,64,39332,30893,46,46,40979,29504
191,22,0,4,1,0,0,3,130,104,39332,30897,148,159,40979,29507
192,22,2,2,2,1,2,1,115,87,39334,30899,145,64,40980,29508
193,22,3,0,0,3,1,0,47,58,39337,30899,53,5,40983,29508
194,22,2,1,0,3,1,0,87,68,39339,30900,94,5,40986,29508
195,22,0,0,2,1,2,1,27,32,39339,30900,36,69,40987,29509
196,22,1,3,1,0,0,3,121,99,39340,30903,140,120,40987,29512
197,22,1,1,2,1,2,1,100,94,39341,30904,121,98,40988,29513
198,23,1,1,2,1,2,1,10,8,39342,30905,19,72,40989,29514
199,23,1,3,1,0,0,3,122,127,39343,30908,130,194,40989,29517
200,23,0,2,1,0,0,3,94,116,39343,30910,103,95,40989,29520
201,23,0,2,1,0,0,3,46,52,39343,30912,58,40,40989,29523
202,23,3,4,1,0,0,3,9,22,39346,30916,5,93,40989,29526
203,23,1,1,2,1,2,1,110,126,39347,30917,122,92,40990,29527
204,23,3,2,0,3,1,0,220,39,39350,30919,242,44,40993,29527
205,23,3,3,2,1,2,1,182,85,39353,30922,178,106,40994,29528
206,23,2,0,0,3,1,0,156,69,39355,30922,191,19,40997,29528
207,24,3,0,0,3,1,0,133,104,39358,30922,151,98,41000,29528
208,24,1,2,1,0,0,3,28,34,39359,30924,36,98,41000,29531
209,24,0,0,2,1,2,1,47,58,39359,30924,54,121,41001,29532
210,24,3,0,0,3,1,0,90,68,39362,30924,97,64,41004,29532
211,24,1,0,0,3,1,0,122,99,39363,30924,143,69,41007,29532
212,24,1,2,1,0,0,3,48,66,39364,30926,46,8,41007,29535
213,24,1,2,1,0,0,3,47,54,39365,30928,58,193,41007,29538
214,24,2,0,0,3,1,0,236,58,39367,30928,232,5,41010,29538
215,24,0,0,2,1,2,1,115,87,39367,30928,146,160,41011,29539
216,25,2,2,2,1,2,1,124,129,39369,30930,131,94,41012,29540
217,25,0,1,1,0,0,3,156,70,39369,30931,191,197,41012,29543
218,25,0,1,1,0,0,3,9,23,39369,30932,5,43,41012,29546
219,25,0,0,2,1,2,1,10,8,39369,30932,20,47,41013,29547
220,25,0,1,1,0,0,3,110,127,39369,30933,122,47,41013,29550
221,25,0,1,1,0,0,3,28,35,39369,30934,36,95,41013,29553
222,25,2,0,0,3,1,0,96,116,39371,30934,106,106,41016,29553
223,25,3,1,0,3,1,0,185,86,39374,30935,181,193,41019,29553
224,25,1,3,1,0,0,3,101,97,39375,30938,121,75,41019,29556
225,26,0,3,1,0,0,3,122,102,39375,30941,143,22,41019,29559
226,26,1,2,1,0,0,3,91,70,39376,30943,97,163,41019,29562
227,26,3,2,0,3,1,0,223,41,39379,30945,245,5,41022,29562
228,26,2,2,2,1,2,1,50,68,39381,30947,47,70,41023,29563
229,26,1,0,0,3,1,0,48,58,39382,30947,57,64,41026,29563
230,26,1,0,0,3,1,0,134,104,39383,30947,154,98,41029,29563
231,26,0,1,1,0,0,3,115,88,39383,30948,146,101,41029,29566
232,26,3,0,0,3,1,0,50,54,39386,30948,61,121,41032,29566
233,26,4,1,0,3,1,0,240,59,39390,30949,235,8,41035,29566
234,27,1,0,0,3,1,0,102,97,39391,30949,124,94,41038,29566
235,27,5,1,0,3,1,0,161,71,39396,30950,194,43,41041,29566
236,27,0,1,1,0,0,3,110,128,39396,30951,122,196,41041,29569
237,27,2,2,2,1,2,1,11,25,39398,30953,6,48,41042,29570
238,27,3,2,0,3,1,0,137,106,39401,30955,157,106,41045,29570
239,27,0,3,1,0,0,3,96,119,39401,30958,106,78,41045,29573
240,27,0,0,2,1,2,1,124,129,39401,30958,132,48,41046,29574
241,27,0,1,1,0,0,3,28,36,39401,30959,36,200,41046,29577
242,27,2,0,0,3,1,0,187,86,39403,30959,184,5,41049,29577
243,28,5,1,0,3,1,0,245,60,39408,30960,238,121,41052,29577
244,28,3,2,0,3,1,0,51,60,39411,30962,60,70,41055,29577
245,28,2,0,0,3,1,0,124,102,39413,30962,146,95,41058,29577
246,28,1,1,2,1,2,1,116,89,39414,30963,147,23,41059,29578
247,28,2,2,2,1,2,1,12,10,39416,30965,21,65,41060,29579
248,28,1,0,0,3,1,0,92,70,39417,30965,100,101,41063,29579
249,28,0,1,1,0,0,3,50,69,39417,30966,47,101,41063,29582
250,28,0,1,1,0,0,3,223,42,39417,30967,245,11,41063,29585
251,28,2,5,1,0,0,3,52,59,39419,30972,61,166,41063,29588
252,29,0,0,2,1,2,1,28,36,39419,30972,37,44,41064,29589
253,29,1,2,1,0,0,3,97,121,39420,30974,106,203,41064,29592
254,29,3,1,0,3,1,0,164,72,39423,30975,197,94,41067,29592
255,29,0,1,1,0,0,3,110,129,39423,30976,122,51,41067,29595
256,29,4,1,0,3,1,0,141,107,39427,30977,160,78,41070,29595
257,29,1,0,0,3,1,0,12,25,39428,30977,9,5,41073,29595
258,29,1,0,0,3,1,0,125,129,39429,30977,135,196,41076,29595
259,29,1,1,2,1,2,1,188,87,39430,30978,185,49,41077,29596
260,29,2,0,0,3,1,0,104,97,39432,30978,127,106,41080,29596
261,30,0,0,2,1,2,1,51,60,39432,30978,61,102,41081,29597
262,30,1,0,0,3,1,0,93,70,39433,30978,103,23,41084,29597
263,30,0,1,1,0,0,3,50,70,39433,30979,47,169,41084,29600
264,30,1,1,2,1,2,1,53,60,39434,30980,62,71,41085,29601
265,30,3,4,1,0,0,3,15,14,39437,30984,21,104,41085,29604
266,30,3,0,0,3,1,0,127,102,39440,30984,149,106,41088,29604
267,30,4,0,0,3,1,0,227,42,39444,30984,248,95,41091,29604
268,30,3,0,0,3,1,0,191,87,39447,30984,188,11,41094,29604
269,30,2,1,0,3,1,0,247,61,39449,30985,241,65,41097,29604
270,31,1,0,0,3,1,0,29,36,39450,30985,40,51,41100,29604
271,31,1,2,1,0,0,3,98,123,39451,30987,106,199,41100,29607
272,31,2,0,0,3,1,0,166,72,39453,30987,200,5,41103,29607
273,31,1,0,0,3,1,0,126,129,39454,30987,138,121,41106,29607
274,31,1,2,1,0,0,3,128,104,39455,30989,149,47,41106,29610
275,31,0,1,1,0,0,3,141,108,39455,30990,160,52,41106,29613
276,31,0,1,1,0,0,3,110,130,39455,30991,122,14,41106,29616
277,31,1,1,2,1,2,1,117,90,39456,30992,148,79,41107,29617
278,31,0,1,1,0,0,3,104,98,39456,30993,127,206,41107,29620
279,32,1,0,0,3,1,0,248,61,39457,30993,244,106,41110,29620
280,32,3,2,0,3,1,0,194,89,39460,30995,191,65,41113,29620
281,32,1,1,2,1,2,1,13,26,39461,30996,10,103,41114,29621
282,32,0,2,1,0,0,3,53,62,39461,30998,62,107,41114,29624
283,32,1,3,1,0,0,3,228,45,39462,31001,248,172,41114,29627
284,32,1,1,2,1,2,1,51,71,39463,31002,48,24,41115,29628
285,32,2,1,0,3,1,0,95,71,39465,31003,106,94,41118,29628
286,32,3,0,0,3,1,0,54,60,39468,31003,64,95,41121,29628
287,32,3,1,0,3,1,0,18,15,39471,31004,24,71,41124,29628
288,33,1,4,1,0,0,3,127,133,39472,31008,138,17,41124,29631
289,33,1,3,1,0,0,3,105,101,39473,31011,127,202,41124,29634
290,33,0,0,2,1,2,1,98,123,39473,31011,107,122,41125,29635
291,33,5,0,0,3,1,0,171,72,39478,31011,203,65,41128,29635
292,33,2,2,2,1,2,1,143,110,39480,31013,161,52,41129,29636
293,33,1,0,0,3,1,0,30,36,39481,31013,43,5,41132,29636
294,33,4,1,0,3,1,0,121,91,39485,31014,151,52,41135,29636
295,33,0,2,1,0,0,3,128,106,39485,31016,149,209,41135,29639
296,33,1,1,2,1,2,1,96,72,39486,31017,107,48,41136,29640
297,34,4,0,0,3,1,0,232,45,39490,31017,251,24,41139,29640
298,34,2,2,2,1,2,1,56,62,39492,31019,65,107,41140,29641
299,34,2,0,0,3,1,0,15,26,39494,31019,13,71,41143,29641
300,34,0,0,2,1,2,1,110,130,39494,31019,123,108,41144,29642
301,34,1,2,1,0,0,3,19,17,39495,31021,24,106,41144,29645
302,34,2,1,0,3,1,0,55,63,39497,31022,65,79,41147,29645
303,34,2,1,0,3,1,0,53,72,39499,31023,51,94,41150,29645
304,34,4,1,0,3,1,0,252,62,39503,31024,247,95,41153,29645
305,34,0,4,1,0,0,3,194,93,39503,31028,191,175,41153,29648
0,1,1,3,1,0,0,3,106,104,39504,31031,127,205,41153,29651
1,1,1,1,2,1,2,1,54,73,39505,31032,52,109,41154,29652
2,1,2,0,0,3,1,0,173,72,39507,31032,206,94,41157,29652
3,1,0,2,1,0,0,3,15,28,39507,31034,13,212,41157,29655
4,1,2,0,0,3,1,0,32,36,39509,31034,46,48,41160,29655
5,1,2,0,0,3,1,0,112,130,39511,31034,126,52,41163,29655
6,1,0,1,1,0,0,3,121,92,39511,31035,151,125,41163,29658
7,1,0,2,1,0,0,3,96,74,39511,31037,107,11,41163,29661
8,1,0,1,1,0,0,3,143,111,39511,31038,161,3,41163,29664
9,2,0,0,2,1,2,1,55,63,39511,31038,66,25,41164,29665
10,2,0,2,1,0,0,3,128,108,39511,31040,149,110,41164,29668
11,2,1,1,2,1,2,1,1,1,39512,31041,1,18,41165,29669
12,2,0,1,1,0,0,3,127,134,39512,31042,138,178,41165,29672
13,2,1,0,0,3,1,0,233,45,39513,31042,254,79,41168,29672
14,2,0,3,1,0,0,3,13,22,39513,31045,16,55,41168,29675
15,2,2,0,0,3,1,0,58,62,39515,31045,68,95,41171,29675
16,2,1,1,2,1,2,1,253,63,39516,31046,248,66,41172,29676
17,2,1,1,2,1,2,1,195,94,39517,31047,192,107,41173,29677
18,3,5,3,0,3,1,0,126,95,39522,31050,154,109,41176,29677
19,3,0,1,1,0,0,3,15,29,39522,31051,13,55,41176,29680
20,3,1,3,1,0,0,3,97,77,39523,31054,107,128,41176,29683
21,3,1,3,1,0,0,3,144,114,39524,31057,161,215,41176,29686
22,3,2,2,2,1,2,1,34,38,39526,31059,47,4,41177,29687
23,3,0,1,1,0,0,3,54,74,39526,31060,52,97,41177,29690
24,3,2,1,0,3,1,0,175,73,39528,31061,209,205,41180,29690
25,3,1,0,0,3,1,0,107,104,39529,31061,130,11,41183,29690
26,3,2,0,0,3,1,0,114,130,39531,31061,129,48,41186,29690
27,4,1,2,1,0,0,3,59,64,39532,31063,68,218,41186,29693
28,4,2,1,0,3,1,0,57,64,39534,31064,69,95,41189,29693
29,4,3,0,0,3,1,0,178,73,39537,31064,212,55,41192,29693
30,4,3,0,0,3,1,0,236,45,39540,31064,257,110,41195,29693
31,4,0,0,2,1,2,1,127,134,39540,31064,139,80,41196,29694
32,4,0,1,1,0,0,3,128,109,39540,31065,149,110,41196,29697
33,4,3,0,0,3,1,0,198,94,39543,31065,195,25,41199,29697
34,4,0,0,2,1,2,1,1,1,39543,31065,2,67,41200,29698
35,4,2,1,0,3,1,0,15,23,39545,31066,19,18,41203,29698
36,5,2,0,0,3,1,0,146,114,39547,31066,164,97,41206,29698
37,5,2,0,0,3,1,0,99,77,39549,31066,110,55,41209,29698
38,5,1,4,1,0,0,3,115,134,39550,31070,129,112,41209,29701
39,5,1,1,2,1,2,1,127,96,39551,31071,155,56,41210,29702
40,5,0,1,1,0,0,3,59,65,39551,31072,68,7,41210,29705
41,5,1,2,1,0,0,3,35,40,39552,31074,47,14,41210,29708
42,5,0,0,2,1,2,1,15,29,39552,31074,14,206,41211,29709
43,5,3,1,0,3,1,0,110,105,39555,31075,133,178,41214,29709
44,5,3,1,0,3,1,0,256,64,39558,31076,251,128,41217,29709
45,6,3,1,0,3,1,0,239,46,39561,31077,260,25,41220,29709
46,6,4,2,0,3,1,0,182,75,39565,31079,215,80,41223,29709
47,6,0,3,1,0,0,3,15,26,39565,31082,19,98,41223,29712
48,6,0,2,1,0,0,3,1,3,39565,31084,2,221,41223,29715
49,6,2,1,0,3,1,0,200,95,39567,31085,198,67,41226,29715
50,6,2,0,0,3,1,0,130,109,39569,31085,152,18,41229,29715
51,6,2,1,0,3,1,0,129,135,39571,31086,142,110,41232,29715
52,6,0,1,1,0,0,3,54,75,39571,31087,52,113,41232,29718
53,6,1,1,2,1,2,1,58,65,39572,31088,70,49,41233,29719
54,7,2,1,0,3,1,0,17,30,39574,31089,17,112,41236,29719
55,7,1,2,1,0,0,3,111,107,39575,31091,133,83,41236,29722
56,7,3,1,0,3,1,0,4,4,39578,31092,5,56,41239,29722
57,7,3,3,2,1,2,1,130,99,39581,31095,156,179,41240,29723
58,7,0,4,1,0,0,3,146,118,39581,31099,164,209,41240,29726
59,7,4,0,0,3,1,0,260,64,39585,31099,254,14,41243,29726
60,7,0,1,1,0,0,3,115,135,39585,31100,129,100,41243,29729
61,7,2,0,0,3,1,0,37,40,39587,31100,50,55,41246,29729
62,7,1,1,2,1,2,1,60,66,39588,31101,69,129,41247,29730
63,8,1,1,2,1,2,1,130,136,39589,31102,143,99,41248,29731
64,8,1,1,2,1,2,1,131,110,39590,31103,153,26,41249,29732
65,8,1,1,2,1,2,1,16,27,39591,31104,20,68,41250,29733
66,8,1,1,2,1,2,1,183,76,39592,31105,216,19,41251,29734
67,8,3,0,0,3,1,0,242,46,39595,31105,263,49,41254,29734
68,8,1,1,2,1,2,1,55,76,39596,31106,53,111,41255,29735
69,8,0,2,1,0,0,3,99,79,39596,31108,110,116,41255,29738
70,8,0,2,1,0,0,3,58,67,39596,31110,70,224,41255,29741
71,8,1,0,0,3,1,0,201,95,39597,31110,201,7,41258,29741
72,9,3,0,0,3,1,0,263,64,39600,31110,257,112,41261,29741
73,9,0,0,2,1,2,1,146,118,39600,31110,165,180,41262,29742
74,9,1,2,1,0,0,3,18,32,39601,31112,17,58,41262,29745
75,9,0,0,2,1,2,1,115,135,39601,31112,130,210,41263,29746
76,9,0,0,2,1,2,1,37,40,39601,31112,51,84,41264,29747
77,9,1,0,0,3,1,0,61,66,39602,31112,72,100,41267,29747
78,9,0,3,1,0,0,3,111,110,39602,31115,133,119,41267,29750
79,9,2,1,0,3,1,0,203,96,39604,31116,204,56,41270,29750
80,9,1,1,2,1,2,1,5,5,39605,31117,6,15,41271,29751
81,10,2,1,0,3,1,0,132,100,39607,31118,159,99,41274,29751
82,10,2,0,0,3,1,0,101,79,39609,31118,113,19,41277,29751
83,10,1,1,2,1,2,1,131,137,39610,31119,144,8,41278,29752
84,10,0,1,1,0,0,3,16,28,39610,31120,20,59,41278,29755
85,10,1,2,1,0,0,3,112,112,39611,31122,133,29,41278,29758
86,10,1,2,1,0,0,3,56,78,39612,31124,53,71,41278,29761
87,10,1,1,2,1,2,1,243,47,39613,31125,264,225,41279,29762
88,10,3,0,0,3,1,0,186,76,39616,31125,219,49,41282,29762
89,10,1,0,0,3,1,0,132,110,39617,31125,156,129,41285,29762
90,11,0,1,1,0,0,3,115,136,39617,31126,130,114,41285,29765
91,11,0,0,2,1,2,1,5,5,39617,31126,7,101,41286,29766
92,11,0,1,1,0,0,3,146,119,39617,31127,165,87,41286,29769
93,11,0,1,1,0,0,3,37,41,39617,31128,51,183,41286,29772
94,11,0,0,2,1,2,1,58,67,39617,31128,71,211,41287,29773
95,11,1,0,0,3,1,0,62,66,39618,31128,75,112,41290,29773
96,11,3,0,0,3,1,0,266,64,39621,31128,260,58,41293,29773
97,11,2,1,0,3,1,0,20,33,39623,31129,20,119,41296,29773
98,11,6,2,0,3,1,0,209,98,39629,31131,207,15,41299,29773
99,12,2,1,0,3,1,0,134,111,39631,31132,159,225,41302,29773
100,12,3,1,0,3,1,0,115,113,39634,31133,136,19,41305,29773
101,12,2,0,0,3,1,0,188,76,39636,31133,222,71,41308,29773
102,12,1,0,0,3,1,0,244,47,39637,31133,267,129,41311,29773
103,12,0,2,1,0,0,3,16,30,39637,31135,20,52,41311,29776
104,12,3,1,0,3,1,0,59,79,39640,31136,56,99,41314,29776
105,12,1,1,2,1,2,1,102,80,39641,31137,114,60,41315,29777
106,12,1,1,2,1,2,1,133,101,39642,31138,160,9,41316,29778
107,12,2,1,0,3,1,0,133,138,39644,31139,147,29,41319,29778
108,13,2,0,0,3,1,0,117,136,39646,31139,133,87,41322,29778
109,13,1,0,0,3,1,0,59,67,39647,31139,74,101,41325,29778
110,13,2,1,0,3,1,0,7,6,39649,31140,10,58,41328,29778
111,13,1,2,1,0,0,3,38,43,39650,31142,51,122,41328,29781
112,13,0,4,1,0,0,3,16,34,39650,31146,20,214,41328,29784
113,13,3,2,0,3,1,0,149,121,39653,31148,168,19,41331,29784
114,13,2,1,0,3,1,0,268,65,39655,31149,263,183,41334,29784
115,13,3,0,0,3,1,0,212,98,39658,31149,210,112,41337,29784
116,13,0,2,1,0,0,3,62,68,39658,31151,75,117,41337,29787
117,14,1,0,0,3,1,0,134,138,39659,31151,150,60,41340,29787
118,14,1,4,1,0,0,3,60,83,39660,31155,56,55,41340,29790
119,14,0,1,1,0,0,3,102,81,39660,31156,114,228,41340,29793
120,14,2,1,0,3,1,0,117,114,39662,31157,139,99,41343,29793
121,14,1,1,2,1,2,1,21,34,39663,31158,21,30,41344,29794
122,14,3,1,0,3,1,0,136,102,39666,31159,163,71,41347,29794
123,14,0,1,1,0,0,3,188,77,39666,31160,222,132,41347,29797
124,14,2,0,0,3,1,0,136,111,39668,31160,162,15,41350,29797
125,14,2,1,0,3,1,0,246,48,39670,31161,270,9,41353,29797
126,15,2,1,0,3,1,0,248,49,39672,31162,273,101,41356,29797
127,15,2,0,0,3,1,0,270,65,39674,31162,266,117,41359,29797
128,15,0,2,1,0,0,3,149,123,39674,31164,168,33,41359,29800
129,15,2,1,0,3,1,0,214,99,39676,31165,213,58,41362,29800
130,15,2,0,0,3,1,0,18,34,39678,31165,23,112,41365,29800
131,15,0,1,1,0,0,3,59,68,39678,31166,74,186,41365,29803
132,15,1,0,0,3,1,0,8,6,39679,31166,13,87,41368,29803
133,15,3,0,0,3,1,0,120,136,39682,31166,136,19,41371,29803
134,15,0,1,1,0,0,3,62,69,39682,31167,75,125,41371,29806
135,16,0,0,2,1,2,1,149,123,39682,31167,169,133,41372,29807
136,16,0,1,1,0,0,3,102,82,39682,31168,114,104,41372,29810
137,16,0,2,1,0,0,3,136,104,39682,31170,163,231,41372,29813
138,16,0,0,2,1,2,1,134,138,39682,31170,151,215,41373,29814
139,16,2,2,2,1,2,1,119,116,39684,31172,140,10,41374,29815
140,16,1,2,1,0,0,3,22,36,39685,31174,21,58,41374,29818
141,16,1,0,0,3,1,0,39,43,39686,31174,54,71,41377,29818
142,16,2,1,0,3,1,0,190,78,39688,31175,225,15,41380,29818
143,16,1,0,0,3,1,0,61,83,39689,31175,59,60,41383,29818
144,17,2,1,0,3,1,0,64,70,39691,31176,78,87,41386,29818
145,17,3,3,2,1,2,1,273,68,39694,31179,267,34,41387,29819
146,17,1,0,0,3,1,0,121,136,39695,31179,139,99,41390,29819
147,17,2,2,2,1,2,1,10,8,39697,31181,14,187,41391,29820
148,17,0,0,2,1,2,1,18,34,39697,31181,24,126,41392,29821
149,17,3,1,0,3,1,0,139,112,39700,31182,165,112,41395,29821
150,17,3,0,0,3,1,0,251,49,39703,31182,276,58,41398,29821
151,17,1,0,0,3,1,0,60,68,39704,31182,77,117,41401,29821
152,17,2,0,0,3,1,0,216,99,39706,31182,216,19,41404,29821
153,18,0,2,1,0,0,3,134,140,39706,31184,151,61,41404,29824
154,18,4,2,0,3,1,0,255,51,39710,31186,279,117,41407,29824
155,18,2,2,2,1,2,1,141,114,39712,31188,166,188,41408,29825
156,18,1,2,1,0,0,3,65,72,39713,31190,78,37,41408,29828
157,18,4,0,0,3,1,0,277,68,39717,31190,270,19,41411,29828
158,18,1,0,0,3,1,0,19,34,39718,31190,27,87,41414,29828
159,18,1,2,1,0,0,3,61,70,39719,31192,77,74,41414,29831
160,18,1,2,1,0,0,3,217,101,39720,31194,216,129,41414,29834
161,18,2,0,0,3,1,0,12,8,39722,31194,17,99,41417,29834
162,19,0,1,1,0,0,3,39,44,39722,31195,54,63,41417,29837
163,19,2,0,0,3,1,0,24,36,39724,31195,24,10,41420,29837
164,19,0,0,2,1,2,1,136,104,39724,31195,164,105,41421,29838
165,19,1,1,2,1,2,1,150,124,39725,31196,170,59,41422,29839
166,19,1,2,1,0,0,3,103,84,39726,31198,114,218,41422,29842
167,19,4,2,0,3,1,0,194,80,39730,31200,228,112,41425,29842
168,19,1,0,0,3,1,0,122,136,39731,31200,142,231,41428,29842
169,19,1,1,2,1,2,1,62,84,39732,31201,60,16,41429,29843
170,19,1,0,0,3,1,0,120,116,39733,31201,143,133,41432,29843
171,20,2,0,0,3,1,0,136,140,39735,31201,154,129,41435,29843
172,20,0,0,2,1,2,1,12,8,39735,31201,18,38,41436,29844
173,20,2,1,0,3,1,0,257,52,39737,31202,282,188,41439,29844
174,20,2,1,0,3,1,0,67,73,39739,31203,81,74,41442,29844
175,20,3,0,0,3,1,0,280,68,39742,31203,273,99,41445,29844
176,20,0,0,2,1,2,1,61,70,39742,31203,78,20,41446,29845
177,20,1,0,0,3,1,0,142,114,39743,31203,169,61,41449,29845
178,20,1,1,2,1,2,1,218,102,39744,31204,217,88,41450,29846
179,20,2,1,0,3,1,0,21,35,39746,31205,30,117,41453,29846
180,21,3,0,0,3,1,0,283,68,39749,31205,276,59,41456,29846
181,21,0,1,1,0,0,3,24,37,39749,31206,24,19,41456,29849
182,21,0,0,2,1,2,1,122,136,39749,31206,143,11,41457,29850
183,21,2,1,0,3,1,0,105,85,39751,31207,117,112,41460,29850
184,21,0,2,1,0,0,3,136,106,39751,31209,164,221,41460,29853
185,21,1,1,2,1,2,1,151,125,39752,31210,171,64,41461,29854
186,21,2,3,1,0,0,3,64,87,39754,31213,60,191,41461,29857
187,21,1,1,2,1,2,1,40,45,39755,31214,55,134,41462,29858
188,21,0,0,2,1,2,1,120,116,39755,31214,144,106,41463,29859
189,22,4,0,0,3,1,0,261,52,39759,31214,285,20,41466,29859
190,22,2,0,0,3,1,0,14,8,39761,31214,21,59,41469,29859
191,22,1,1,2,1,2,1,65,88,39762,31215,61,89,41470,29860
192,22,0,1,1,0,0,3,21,36,39762,31216,30,41,41470,29863
193,22,1,0,0,3,1,0,195,80,39763,31216,231,117,41473,29863
194,22,2,1,0,3,1,0,138,141,39765,31217,157,74,41476,29863
195,22,1,1,2,1,2,1,62,71,39766,31218,79,130,41477,29864
196,22,0,1,1,0,0,3,218,103,39766,31219,217,234,41477,29867
197,22,0,0,2,1,2,1,142,114,39766,31219,170,100,41478,29868
198,23,1,0,0,3,1,0,137,106,39767,31219,167,61,41481,29868
199,23,3,1,0,3,1,0,286,69,39770,31220,279,11,41484,29868
200,23,1,1,2,1,2,1,25,38,39771,31221,25,107,41485,29869
201,23,0,2,1,0,0,3,105,87,39771,31223,117,194,41485,29872
202,23,0,0,2,1,2,1,120,116,39771,31223,145,113,41486,29873
203,23,0,0,2,1,2,1,151,125,39771,31223,172,20,41487,29874
204,23,1,1,2,1,2,1,123,137,39772,31224,144,135,41488,29875
205,23,0,1,1,0,0,3,40,46,39772,31225,55,224,41488,29878
206,23,1,2,1,0,0,3,68,75,39773,31227,81,67,41488,29881
207,24,0,0,2,1,2,1,65,88,39773,31227,62,42,41489,29882
208,24,3,1,0,3,1,0,221,104,39776,31228,220,59,41492,29882
209,24,7,0,0,3,1,0,268,52,39783,31228,288,100,41495,29882
210,24,0,1,1,0,0,3,21,37,39783,31229,30,237,41495,29885
211,24,0,0,2,1,2,1,138,141,39783,31229,158,21,41496,29886
212,24,1,0,0,3,1,0,143,114,39784,31229,173,74,41499,29886
213,24,2,1,0,3,1,0,64,72,39786,31230,82,11,41502,29886
214,24,1,1,2,1,2,1,196,81,39787,31231,232,131,41503,29887
215,24,0,2,1,0,0,3,105,89,39787,31233,117,120,41503,29890
216,25,0,4,1,0,0,3,68,79,39787,31237,81,227,41503,29893
217,25,1,2,1,0,0,3,124,139,39788,31239,144,23,41503,29896
218,25,0,0,2,1,2,1,14,8,39788,31239,22,136,41504,29897
219,25,1,4,1,0,0,3,26,42,39789,31243,25,197,41504,29900
220,25,3,0,0,3,1,0,43,46,39792,31243,58,107,41507,29900
221,25,3,2,0,3,1,0,123,118,39795,31245,148,61,41510,29900
222,25,3,3,2,1,2,1,140,109,39798,31248,168,90,41511,29901
223,25,1,1,2,1,2,1,152,126,39799,31249,173,114,41512,29902
224,25,4,0,0,3,1,0,290,69,39803,31249,282,67,41515,29902
225,26,0,0,2,1,2,1,105,89,39803,31249,118,43,41516,29903
226,26,1,2,1,0,0,3,65,74,39804,31251,82,139,41516,29906
227,26,1,1,2,1,2,1,66,89,39805,31252,63,22,41517,29907
228,26,2,0,0,3,1,0,198,81,39807,31252,235,100,41520,29907
229,26,0,0,2,1,2,1,138,141,39807,31252,159,238,41521,29908
230,26,3,2,0,3,1,0,24,39,39810,31254,33,11,41524,29908
231,26,3,1,0,3,1,0,146,115,39813,31255,176,59,41527,29908
232,26,1,1,2,1,2,1,269,53,39814,31256,289,75,41528,29909
233,26,3,0,0,3,1,0,143,109,39817,31256,171,120,41531,29909
234,27,1,0,0,3,1,0,15,8,39818,31256,25,114,41534,29909
235,27,1,2,1,0,0,3,153,128,39819,31258,173,134,41534,29912
236,27,0,2,1,0,0,3,26,44,39819,31260,25,93,41534,29915
237,27,0,1,1,0,0,3,43,47,39819,31261,58,123,41534,29918
238,27,1,1,2,1,2,1,291,70,39820,31262,283,228,41535,29919
239,27,1,2,1,0,0,3,66,76,39821,31264,82,26,41535,29922
240,27,2,0,0,3,1,0,126,139,39823,31264,147,61,41538,29922
241,27,1,2,1,0,0,3,69,81,39824,31266,81,200,41538,29925
242,27,3,3,2,1,2,1,224,107,39827,31269,221,108,41539,29926
243,28,0,1,1,0,0,3,24,40,39827,31270,33,142,41539,29929
244,28,1,1,2,1,2,1,139,142,39828,31271,160,60,41540,29930
245,28,3,0,0,3,1,0,272,53,39831,31271,292,67,41543,29930
246,28,4,0,0,3,1,0,202,81,39835,31271,238,43,41546,29930
247,28,0,1,1,0,0,3,105,90,39835,31272,118,103,41546,29933
248,28,0,0,2,1,2,1,123,118,39835,31272,149,76,41547,29934
249,28,2,1,0,3,1,0,145,110,39837,31273,174,22,41550,29934
250,28,0,1,1,0,0,3,66,90,39837,31274,63,241,41550,29937
251,28,2,1,0,3,1,0,148,116,39839,31275,179,11,41553,29937
252,29,1,3,1,0,0,3,67,79,39840,31278,82,96,41553,29940
253,29,0,0,2,1,2,1,43,47,39840,31278,59,115,41554,29941
254,29,3,0,0,3,1,0,294,70,39843,31278,286,108,41557,29941
255,29,0,3,1,0,0,3,126,142,39843,31281,147,203,41557,29944
256,29,2,0,0,3,1,0,71,81,39845,31281,84,26,41560,29944
257,29,2,3,1,0,0,3,17,11,39847,31284,25,137,41560,29947
258,29,2,1,0,3,1,0,28,45,39849,31285,28,123,41563,29947
259,29,1,1,2,1,2,1,225,108,39850,31286,222,229,41564,29948
260,29,0,1,1,0,0,3,153,129,39850,31287,173,64,41564,29951
261,30,3,0,0,3,1,0,126,118,39853,31287,152,60,41567,29951
262,30,3,0,0,3,1,0,151,116,39856,31287,182,67,41570,29951
263,30,2,0,0,3,1,0,30,45,39858,31287,31,103,41573,29951
264,30,3,0,0,3,1,0,108,90,39861,31287,121,76,41576,29951
265,30,1,1,2,1,2,1,203,82,39862,31288,239,242,41577,29952
266,30,3,1,0,3,1,0,142,143,39865,31289,163,142,41580,29952
267,30,2,0,0,3,1,0,147,110,39867,31289,177,43,41583,29952
268,30,0,0,2,1,2,1,272,53,39867,31289,293,27,41584,29953
269,30,0,0,2,1,2,1,66,90,39867,31289,64,12,41585,29954
270,31,0,2,1,0,0,3,126,144,39867,31291,147,140,41585,29957
271,31,1,0,0,3,1,0,44,47,39868,31291,62,22,41588,29957
272,31,0,2,1,0,0,3,153,131,39868,31293,173,126,41588,29960
273,31,2,1,0,3,1,0,296,71,39870,31294,289,96,41591,29960
274,31,0,2,1,0,0,3,17,13,39870,31296,25,232,41591,29963
275,31,2,2,2,1,2,1,73,83,39872,31298,85,65,41592,29964
276,31,2,1,0,3,1,0,26,41,39874,31299,36,108,41595,29964
277,31,2,3,1,0,0,3,227,111,39876,31302,222,206,41595,29967
278,31,1,2,1,0,0,3,68,81,39877,31304,82,118,41595,29970
279,32,2,1,0,3,1,0,68,91,39879,31305,67,142,41598,29970
280,32,2,2,2,1,2,1,46,49,39881,31307,63,104,41599,29971
281,32,0,1,1,0,0,3,142,144,39881,31308,163,30,41599,29974
282,32,1,1,2,1,2,1,152,117,39882,31309,183,233,41600,29975
283,32,1,3,1,0,0,3,204,85,39883,31312,239,70,41600,29978
284,32,2,1,0,3,1,0,32,46,39885,31313,34,76,41603,29978
285,32,1,0,0,3,1,0,148,110,39886,31313,180,60,41606,29978
286,32,0,1,1,0,0,3,126,119,39886,31314,152,245,41606,29981
287,32,2,1,0,3,1,0,110,91,39888,31315,124,12,41609,29981
288,33,1,1,2,1,2,1,69,82,39889,31316,83,66,41610,29982
289,33,1,2,1,0,0,3,74,85,39890,31318,85,25,41610,29985
290,33,5,0,0,3,1,0,301,71,39895,31318,292,140,41613,29985
291,33,2,1,0,3,1,0,28,42,39897,31319,39,206,41616,29985
292,33,2,2,2,1,2,1,19,15,39899,31321,26,127,41617,29986
293,33,1,1,2,1,2,1,153,118,39900,31322,184,97,41618,29987
294,33,4,1,0,3,1,0,276,54,39904,31323,296,118,41621,29987
295,33,4,0,0,3,1,0,231,111,39908,31323,225,104,41624,29987
296,33,0,1,1,0,0,3,126,145,39908,31324,147,46,41624,29990
297,34,0,0,2,1,2,1,142,144,39908,31324,164,109,41625,29991
298,34,1,2,1,0,0,3,154,133,39909,31326,173,79,41625,29994
299,34,2,0,0,3,1,0,128,119,39911,31326,155,70,41628,29994
300,34,0,1,1,0,0,3,148,111,39911,31327,180,33,41628,29997
301,34,2,2,2,1,2,1,48,51,39913,31329,64,246,41629,29998
302,34,4,2,0,3,1,0,114,93,39917,31331,127,60,41632,29998
303,34,3,1,0,3,1,0,71,92,39920,31332,70,233,41635,29998
304,34,2,0,0,3,1,0,34,46,39922,31332,37,142,41638,29998
305,34,4,1,0,3,1,0,208,86,39926,31333,242,12,41641,29998
0,1,0,2,1,0,0,3,0,2,39926,31335,0,209,41641,30001
1,1,1,1,2,1,2,1,127,146,39927,31336,148,67,41642,30002
2,1,2,1,0,3,1,0,20,25,39929,31337,18,46,41645,30002
3,1,1,1,2,1,2,1,29,43,39930,31338,40,26,41646,30003
4,1,1,0,0,3,1,0,129,119,39931,31338,158,70,41649,30003
5,1,1,0,0,3,1,0,154,118,39932,31338,187,118,41652,30003
6,1,4,0,0,3,1,0,280,54,39936,31338,299,97,41655,30003
7,1,3,1,0,3,1,0,304,72,39939,31339,295,142,41658,30003
8,1,3,2,0,3,1,0,151,113,39942,31341,183,12,41661,30003
9,2,1,0,0,3,1,0,209,86,39943,31341,245,79,41664,30003
10,2,0,0,2,1,2,1,71,92,39943,31341,71,34,41665,30004
11,2,1,0,0,3,1,0,70,82,39944,31341,86,109,41668,30004
12,2,1,2,1,0,0,3,49,53,39945,31343,64,130,41668,30007
13,2,2,2,2,1,2,1,144,146,39947,31345,165,1,41669,30008
14,2,2,1,0,3,1,0,233,112,39949,31346,228,10,41672,30008
15,2,0,1,1,0,0,3,34,47,39949,31347,37,236,41672,30011
16,2,3,0,0,3,1,0,117,93,39952,31347,130,140,41675,30011
17,2,0,1,1,0,0,3,19,16,39952,31348,26,249,41675,30014
18,3,2,0,0,3,1,0,131,119,39954,31348,161,10,41678,30014
19,3,2,3,1,0,0,3,36,50,39956,31351,37,100,41678,30017
20,3,0,5,1,0,0,3,151,118,39956,31356,183,212,41678,30020
21,3,5,0,0,3,1,0,309,72,39961,31356,298,70,41681,30020
22,3,1,1,2,1,2,1,128,147,39962,31357,149,13,41682,30021
23,3,3,0,0,3,1,0,283,54,39965,31357,302,67,41685,30021
24,3,0,2,1,0,0,3,0,4,39965,31359,0,145,41685,30024
25,3,1,0,0,3,1,0,155,118,39966,31359,190,46,41688,30024
26,3,2,1,0,3,1,0,31,44,39968,31360,43,118,41691,30024
27,4,1,1,2,1,2,1,71,83,39969,31361,87,80,41692,30025
28,4,0,0,2,1,2,1,144,146,39969,31361,166,141,41693,30026
29,4,0,3,1,0,0,3,71,95,39969,31364,71,29,41693,30029
30,4,0,2,1,0,0,3,19,18,39969,31366,26,37,41693,30032
31,4,1,1,2,1,2,1,132,120,39970,31367,162,250,41694,30033
32,4,1,0,0,3,1,0,50,53,39971,31367,67,1,41697,30033
33,4,2,1,0,3,1,0,211,87,39973,31368,248,100,41700,30033
34,4,0,1,1,0,0,3,233,113,39973,31369,228,239,41700,30036
35,4,1,2,1,0,0,3,21,27,39974,31371,18,112,41700,30039
36,5,2,3,1,0,0,3,33,47,39976,31374,43,215,41700,30042
37,5,2,1,0,3,1,0,311,73,39978,31375,301,10,41703,30042
38,5,2,2,2,1,2,1,38,52,39980,31377,38,119,41704,30043
39,5,1,0,0,3,1,0,156,118,39981,31377,193,130,41707,30043
40,5,3,0,0,3,1,0,286,54,39984,31377,305,13,41710,30043
41,5,2,0,0,3,1,0,130,147,39986,31377,152,145,41713,30043
42,5,1,0,0,3,1,0,152,118,39987,31377,186,46,41716,30043
43,5,0,2,1,0,0,3,117,95,39987,31379,130,70,41716,30046
44,5,2,1,0,3,1,0,2,5,39989,31380,3,70,41719,30046
45,6,1,0,0,3,1,0,145,146,39990,31380,169,80,41722,30046
46,6,2,1,0,3,1,0,158,119,39992,31381,196,1,41725,30046
47,6,2,1,0,3,1,0,52,54,39994,31382,70,250,41728,30046
48,6,2,0,0,3,1,0,213,87,39996,31382,251,29,41731,30046
49,6,2,1,0,3,1,0,73,84,39998,31383,90,100,41734,30046
50,6,1,2,1,0,0,3,133,122,39999,31385,162,242,41734,30049
51,6,2,1,0,3,1,0,235,114,40001,31386,231,141,41737,30049
52,6,2,1,0,3,1,0,23,28,40003,31387,21,37,41740,30049
53,6,3,0,0,3,1,0,22,18,40006,31387,29,70,41743,30049
54,7,5,2,0,3,1,0,291,56,40011,31389,308,10,41746,30049
55,7,0,2,1,0,0,3,117,97,40011,31391,130,16,41746,30052
56,7,1,1,2,1,2,1,72,96,40012,31392,72,216,41747,30053
57,7,2,0,0,3,1,0,313,73,40014,31392,304,119,41750,30053
58,7,2,1,0,3,1,0,154,119,40016,31393,189,112,41753,30053
59,7,1,4,1,0,0,3,34,51,40017,31397,43,73,41753,30056
60,7,1,2,1,0,0,3,39,54,40018,31399,38,148,41753,30059
61,7,0,0,2,1,2,1,2,5,40018,31399,4,131,41754,30060
62,7,1,1,2,1,2,1,131,148,40019,31400,153,47,41755,30061
63,8,1,1,2,1,2,1,23,19,40020,31401,30,30,41756,30062
64,8,3,2,0,3,1,0,148,148,40023,31403,172,70,41759,30062
65,8,2,2,2,1,2,1,25,30,40025,31405,22,2,41760,30063
66,8,1,0,0,3,1,0,53,54,40026,31405,73,37,41763,30063
67,8,2,1,0,3,1,0,135,123,40028,31406,165,80,41766,30063
68,8,6,0,0,3,1,0,241,114,40034,31406,234,100,41769,30063
69,8,0,0,2,1,2,1,213,87,40034,31406,252,243,41770,30064
70,8,1,0,0,3,1,0,74,84,40035,31406,93,141,41773,30064
71,8,1,1,2,1,2,1,159,120,40036,31407,197,251,41774,30065
72,9,0,3,1,0,0,3,117,100,40036,31410,130,50,41774,30068
73,9,1,0,0,3,1,0,35,51,40037,31410,46,131,41777,30068
74,9,3,1,0,3,1,0,134,149,40040,31411,156,112,41780,30068
75,9,6,1,0,3,1,0,297,57,40046,31412,311,119,41783,30068
76,9,2,0,0,3,1,0,41,54,40048,31412,41,73,41786,30068
77,9,1,3,1,0,0,3,3,8,40049,31415,4,254,41786,30071
78,9,5,1,0,3,1,0,218,88,40054,31416,255,16,41789,30071
79,9,0,1,1,0,0,3,72,97,40054,31417,72,151,41789,30074
80,9,3,3,2,1,2,1,157,122,40057,31420,190,11,41790,30075
81,10,1,0,0,3,1,0,314,73,40058,31420,307,37,41793,30075
82,10,0,1,1,0,0,3,135,124,40058,31421,165,219,41793,30078
83,10,2,0,0,3,1,0,161,120,40060,31421,200,30,41796,30078
84,10,3,0,0,3,1,0,77,84,40063,31421,96,70,41799,30078
85,10,0,3,1,0,0,3,53,57,40063,31424,73,246,41799,30081
86,10,1,0,0,3,1,0,242,114,40064,31424,237,16,41802,30081
87,10,1,0,0,3,1,0,149,148,40065,31424,175,100,41805,30081
88,10,1,3,1,0,0,3,4,11,40066,31427,4,144,41805,30084
89,10,5,2,0,3,1,0,30,32,40071,31429,25,80,41808,30084
90,11,0,1,1,0,0,3,134,150,40071,31430,156,5,41808,30087
91,11,1,1,2,1,2,1,73,98,40072,31431,73,12,41809,30088
92,11,3,2,0,3,1,0,44,56,40075,31433,44,50,41812,30088
93,11,0,2,1,0,0,3,117,102,40075,31435,130,134,41812,30091
94,11,2,0,0,3,1,0,299,57,40077,31435,314,73,41815,30091
95,11,4,2,0,3,1,0,27,21,40081,31437,33,119,41818,30091
96,11,0,1,1,0,0,3,35,52,40081,31438,46,115,41818,30094
97,11,1,3,1,0,0,3,158,125,40082,31441,190,257,41818,30097
98,11,2,2,2,1,2,1,220,90,40084,31443,256,152,41819,30098
99,12,0,1,1,0,0,3,77,85,40084,31444,96,19,41819,30101
100,12,2,0,0,3,1,0,32,32,40086,31444,28,30,41822,30101
101,12,1,0,0,3,1,0,54,57,40087,31444,76,70,41825,30101
102,12,1,1,2,1,2,1,5,12,40088,31445,5,247,41826,30102
103,12,0,0,2,1,2,1,161,120,40088,31445,201,101,41827,30103
104,12,1,2,1,0,0,3,150,150,40089,31447,175,222,41827,30106
105,12,6,0,0,3,1,0,320,73,40095,31447,310,80,41830,30106
106,12,3,1,0,3,1,0,245,115,40098,31448,240,37,41833,30106
107,12,0,1,1,0,0,3,135,125,40098,31449,165,147,41833,30109
108,13,1,0,0,3,1,0,221,90,40099,31449,259,73,41836,30109
109,13,0,0,2,1,2,1,299,57,40099,31449,315,258,41837,30110
110,13,1,1,2,1,2,1,74,99,40100,31450,74,116,41838,30111
111,13,1,3,1,0,0,3,45,59,40101,31453,44,137,41838,30114
112,13,0,0,2,1,2,1,27,21,40101,31453,34,51,41839,30115
113,13,0,1,1,0,0,3,35,53,40101,31454,46,8,41839,30118
114,13,3,0,0,3,1,0,248,115,40104,31454,243,119,41842,30118
115,13,1,2,1,0,0,3,135,152,40105,31456,156,150,41842,30121
116,13,0,0,2,1,2,1,117,102,40105,31456,131,13,41843,30122
117,14,2,1,0,3,1,0,137,126,40107,31457,168,70,41846,30122
118,14,0,1,1,0,0,3,5,13,40107,31458,5,33,41846,30125
119,14,3,1,0,3,1,0,323,74,40110,31459,313,101,41849,30125
120,14,1,3,1,0,0,3,55,60,40111,31462,76,225,41849,30128
121,14,0,1,1,0,0,3,32,33,40111,31463,28,22,41849,30131
122,14,1,1,2,1,2,1,78,86,40112,31464,97,120,41850,30132
123,14,0,5,1,0,0,3,135,157,40112,31469,156,250,41850,30135
124,14,1,0,0,3,1,0,159,125,40113,31469,193,37,41853,30135
125,14,1,0,0,3,1,0,162,120,40114,31469,204,152,41856,30135
126,15,1,2,1,0,0,3,151,152,40115,31471,175,54,41856,30138
127,15,3,2,0,3,1,0,120,104,40118,31473,134,8,41859,30138
128,15,4,0,0,3,1,0,252,115,40122,31473,246,73,41862,30138
129,15,1,1,2,1,2,1,28,22,40123,31474,35,138,41863,30139
130,15,1,0,0,3,1,0,36,53,40124,31474,49,80,41866,30139
131,15,2,0,0,3,1,0,223,90,40126,31474,262,13,41869,30139
132,15,1,5,1,0,0,3,46,64,40127,31479,44,261,41869,30142
133,15,2,1,0,3,1,0,76,100,40129,31480,77,150,41872,30142
134,15,3,1,0,3,1,0,302,58,40132,31481,318,116,41875,30142
135,16,0,1,1,0,0,3,159,126,40132,31482,193,36,41875,30145
136,16,1,2,1,0,0,3,6,15,40133,31484,5,73,41875,30148
137,16,1,3,1,0,0,3,56,63,40134,31487,76,155,41875,30151
138,16,1,2,1,0,0,3,163,122,40135,31489,204,25,41875,30154
139,16,1,2,1,0,0,3,37,55,40136,31491,49,253,41875,30157
140,16,4,2,0,3,1,0,141,128,40140,31493,171,120,41878,30157
141,16,1,1,2,1,2,1,324,75,40141,31494,314,226,41879,30158
142,16,2,2,2,1,2,1,137,159,40143,31496,157,102,41880,30159
143,16,0,0,2,1,2,1,32,33,40143,31496,29,74,41881,30160
144,17,2,1,0,3,1,0,254,116,40145,31497,249,138,41884,30160
145,17,1,1,2,1,2,1,29,23,40146,31498,36,9,41885,30161
146,17,0,2,1,0,0,3,76,102,40146,31500,77,264,41885,30164
147,17,5,0,0,3,1,0,228,90,40151,31500,265,116,41888,30164
148,17,4,2,0,3,1,0,306,60,40155,31502,321,150,41891,30164
149,17,1,1,2,1,2,1,152,153,40156,31503,176,14,41892,30165
150,17,0,2,1,0,0,3,120,106,40156,31505,134,40,41892,30168
151,17,1,1,2,1,2,1,47,65,40157,31506,45,81,41893,30169
152,17,1,1,2,1,2,1,79,87,40158,31507,98,55,41894,30170
153,18,4,3,0,3,1,0,33,26,40162,31510,39,150,41897,30170
154,18,0,0,2,1,2,1,152,153,40162,31510,177,117,41898,30171
155,18,1,3,1,0,0,3,255,119,40163,31513,249,267,41898,30174
156,18,3,1,0,3,1,0,50,66,40166,31514,48,40,41901,30174
157,18,2,0,0,3,1,0,58,63,40168,31514,79,14,41904,30174
158,18,1,2,1,0,0,3,80,89,40169,31516,98,141,41904,30177
159,18,3,0,0,3,1,0,231,90,40172,31516,268,9,41907,30177
160,18,2,2,2,1,2,1,78,104,40174,31518,78,82,41908,30178
161,18,1,3,1,0,0,3,121,109,40175,31521,134,256,41908,30181
162,19,1,1,2,1,2,1,138,160,40176,31522,158,227,41909,30182
163,19,1,0,0,3,1,0,307,60,40177,31522,324,36,41912,30182
164,19,0,0,2,1,2,1,163,122,40177,31522,205,75,41913,30183
165,19,3,0,0,3,1,0,327,75,40180,31522,317,25,41916,30183
166,19,1,2,1,0,0,3,33,35,40181,31524,29,158,41916,30186
167,19,0,2,1,0,0,3,6,17,40181,31526,5,123,41916,30189
168,19,1,0,0,3,1,0,38,55,40182,31526,52,73,41919,30189
169,19,2,0,0,3,1,0,143,128,40184,31526,174,55,41922,30189
170,19,3,1,0,3,1,0,162,127,40187,31527,196,102,41925,30189
171,20,4,1,0,3,1,0,37,36,40191,31528,32,141,41928,30189
172,20,2,1,0,3,1,0,154,154,40193,31529,180,40,41931,30189
173,20,1,1,2,1,2,1,81,90,40194,31530,99,268,41932,30190
174,20,2,0,0,3,1,0,257,119,40196,31530,252,9,41935,30190
175,20,3,0,0,3,1,0,124,109,40199,31530,137,36,41938,30190
176,20,0,0,2,1,2,1,78,104,40199,31530,79,257,41939,30191
177,20,2,1,0,3,1,0,60,64,40201,31531,82,117,41942,30191
178,20,2,2,2,1,2,1,35,28,40203,31533,40,83,41943,30192
179,20,1,0,0,3,1,0,232,90,40204,31533,271,150,41946,30192
180,21,5,1,0,3,1,0,332,76,40209,31534,320,141,41949,30192
181,21,3,1,0,3,1,0,310,61,40212,31535,327,158,41952,30192
182,21,1,2,1,0,0,3,39,57,40213,31537,52,28,41952,30195
183,21,1,2,1,0,0,3,51,68,40214,31539,48,76,41952,30198
184,21,2,0,0,3,1,0,126,109,40216,31539,140,227,41955,30198
185,21,3,2,0,3,1,0,165,129,40219,31541,199,123,41958,30198
186,21,0,3,1,0,0,3,163,125,40219,31544,205,17,41958,30201
187,21,3,0,0,3,1,0,141,160,40222,31544,161,75,41961,30201
188,21,3,0,0,3,1,0,9,17,40225,31544,8,55,41964,30201
189,22,0,2,1,0,0,3,154,156,40225,31546,180,39,41964,30204
190,22,3,0,0,3,1,0,146,128,40228,31546,177,117,41967,30204
191,22,3,1,0,3,1,0,260,120,40231,31547,255,83,41970,30204
192,22,1,3,1,0,0,3,38,39,40232,31550,32,271,41970,30207
193,22,2,5,1,0,0,3,83,95,40234,31555,99,12,41970,30210
194,22,0,4,1,0,0,3,35,32,40234,31559,40,260,41970,30213
195,22,2,0,0,3,1,0,234,90,40236,31559,274,40,41973,30213
196,22,1,0,0,3,1,0,61,64,40237,31559,85,150,41976,30213
197,22,1,2,1,0,0,3,79,106,40238,31561,79,105,41976,30216
198,23,1,3,1,0,0,3,40,60,40239,31564,52,20,41976,30219
199,23,0,0,2,1,2,1,9,17,40239,31564,9,118,41977,30220
200,23,4,0,0,3,1,0,336,76,40243,31564,323,55,41980,30220
201,23,0,2,1,0,0,3,126,111,40243,31566,140,78,41980,30223
202,23,0,1,1,0,0,3,79,107,40243,31567,79,31,41980,30226
203,23,1,0,0,3,1,0,142,160,40244,31567,164,123,41983,30226
204,23,5,0,0,3,1,0,315,61,40249,31567,330,141,41986,30226
205,23,0,5,1,0,0,3,165,134,40249,31572,199,161,41986,30229
206,23,1,2,1,0,0,3,52,70,40250,31574,48,230,41986,30232
207,24,0,0,2,1,2,1,146,128,40250,31574,178,13,41987,30233
208,24,1,0,0,3,1,0,84,95,40251,31574,102,40,41990,30233
209,24,3,2,0,3,1,0,166,127,40254,31576,208,150,41993,30233
210,24,1,3,1,0,0,3,155,159,40255,31579,180,274,41993,30236
211,24,2,0,0,3,1,0,37,32,40257,31579,43,105,41996,30236
212,24,4,0,0,3,1,0,65,64,40261,31579,88,83,41999,30236
213,24,1,5,1,0,0,3,39,44,40262,31584,32,263,41999,30239
214,24,1,0,0,3,1,0,261,120,40263,31584,258,39,42002,30239
215,24,1,0,0,3,1,0,235,90,40264,31584,277,76,42005,30239
216,25,2,1,0,3,1,0,317,62,40266,31585,333,230,42008,30239
217,25,3,0,0,3,1,0,43,60,40269,31585,55,55,42011,30239
218,25,5,0,0,3,1,0,341,76,40274,31585,326,118,42014,30239
219,25,0,6,1,0,0,3,126,117,40274,31591,140,164,42014,30242
220,25,2,0,0,3,1,0,54,70,40276,31591,51,31,42017,30242
221,25,2,0,0,3,1,0,81,107,40278,31591,82,123,42020,30242
222,25,1,0,0,3,1,0,143,160,40279,31591,167,141,42023,30242
223,25,0,0,2,1,2,1,165,134,40279,31591,200,79,42024,30243
224,25,3,0,0,3,1,0,12,17,40282,31591,12,20,42027,30243
225,26,3,0,0,3,1,0,264,120,40285,31591,261,76,42030,30243
226,26,2,1,0,3,1,0,148,129,40287,31592,181,40,42033,30243
227,26,2,0,0,3,1,0,343,76,40289,31592,329,13,42036,30243
228,26,1,0,0,3,1,0,66,64,40290,31592,91,105,42039,30243
229,26,2,1,0,3,1,0,41,45,40292,31593,35,150,42042,30243
230,26,4,2,0,3,1,0,170,129,40296,31595,211,83,42045,30243
231,26,0,0,2,1,2,1,84,95,40296,31595,103,40,42046,30244
232,26,1,0,0,3,1,0,156,159,40297,31595,183,263,42049,30244
233,26,1,2,1,0,0,3,38,34,40298,31597,43,233,42049,30247
234,27,1,1,2,1,2,1,144,161,40299,31598,168,21,42050,30248
235,27,1,2,1,0,0,3,55,72,40300,31600,51,121,42050,30251
236,27,1,1,2,1,2,1,127,118,40301,31601,141,124,42051,30252
237,27,0,2,1,0,0,3,43,62,40301,31603,55,277,42051,30255
238,27,2,0,0,3,1,0,319,62,40303,31603,336,55,42054,30255
239,27,2,1,0,3,1,0,167,135,40305,31604,203,13,42057,30255
240,27,2,1,0,3,1,0,83,108,40307,31605,85,79,42060,30255
241,27,1,4,1,0,0,3,39,38,40308,31609,43,167,42060,30258
242,27,2,0,0,3,1,0,237,90,40310,31609,280,141,42063,30258
243,28,1,4,1,0,0,3,13,21,40311,31613,12,86,42063,30261
244,28,4,1,0,3,1,0,174,130,40315,31614,214,40,42066,30261
245,28,2,0,0,3,1,0,150,129,40317,31614,184,105,42069,30261
246,28,1,1,2,1,2,1,67,65,40318,31615,92,41,42070,30262
247,28,2,0,0,3,1,0,158,159,40320,31615,186,31,42073,30262
248,28,4,3,0,3,1,0,45,48,40324,31618,38,76,42076,30262
249,28,2,0,0,3,1,0,345,76,40326,31618,332,150,42079,30262
250,28,1,0,0,3,1,0,265,120,40327,31618,264,233,42082,30262
251,28,2,0,0,3,1,0,86,95,40329,31618,106,263,42085,30262
252,29,3,0,0,3,1,0,170,135,40332,31618,206,141,42088,30262
253,29,2,2,2,1,2,1,57,74,40334,31620,52,22,42089,30263
254,29,1,1,2,1,2,1,128,119,40335,31621,142,122,42090,30264
255,29,2,2,2,1,2,1,45,64,40337,31623,56,168,42091,30265
256,29,1,2,1,0,0,3,145,163,40338,31625,168,280,42091,30268
257,29,1,1,2,1,2,1,40,39,40339,31626,44,80,42092,30269
258,29,2,0,0,3,1,0,321,62,40341,31626,339,13,42095,30269
259,29,2,0,0,3,1,0,239,90,40343,31626,283,124,42098,30269
260,29,1,0,0,3,1,0,84,108,40344,31626,88,55,42101,30269
261,30,1,5,1,0,0,3,159,164,40345,31631,186,171,42101,30272
262,30,0,1,1,0,0,3,45,49,40345,31632,38,108,42101,30275
263,30,1,0,0,3,1,0,14,21,40346,31632,15,40,42104,30275
264,30,3,3,2,1,2,1,70,68,40349,31635,93,32,42105,30276
265,30,1,1,2,1,2,1,171,136,40350,31636,207,87,42106,30277
266,30,1,1,2,1,2,1,175,131,40351,31637,215,77,42107,30278
267,30,0,1,1,0,0,3,345,77,40351,31638,332,266,42107,30281
268,30,3,4,1,0,0,3,89,99,40354,31642,106,236,42107,30284
269,30,1,1,2,1,2,1,151,130,40355,31643,185,42,42108,30285
270,31,2,0,0,3,1,0,267,120,40357,31643,267,122,42111,30285
271,31,1,1,2,1,2,1,160,165,40358,31644,187,81,42112,30286
272,31,2,1,0,3,1,0,47,65,40360,31645,59,150,42115,30286
273,31,1,2,1,0,0,3,129,121,40361,31647,142,283,42115,30289
274,31,3,0,0,3,1,0,60,74,40364,31647,55,13,42118,30289
275,31,2,1,0,3,1,0,42,40,40366,31648,47,22,42121,30289
276,31,2,1,0,3,1,0,86,109,40368,31649,91,141,42124,30289
277,31,1,0,0,3,1,0,240,90,40369,31649,286,55,42127,30289
278,31,5,1,0,3,1,0,326,63,40374,31650,342,87,42130,30289
279,32,1,0,0,3,1,0,172,136,40375,31650,210,77,42133,30289
280,32,0,2,1,0,0,3,145,165,40375,31652,168,43,42133,30292
281,32,2,3,1,0,0,3,347,80,40377,31655,332,45,42133,30295
282,32,1,2,1,0,0,3,46,51,40378,31657,38,239,42133,30298
283,32,2,1,0,3,1,0,153,131,40380,31658,188,32,42136,30298
284,32,1,0,0,3,1,0,71,68,40381,31658,96,124,42139,30298
285,32,0,1,1,0,0,3,175,132,40381,31659,215,269,42139,30301
286,32,0,1,1,0,0,3,89,100,40381,31660,106,174,42139,30304
287,32,1,0,0,3,1,0,15,21,40382,31660,18,108,42142,30304
288,33,1,1,2,1,2,1,268,121,40383,31661,268,56,42143,30305
289,33,3,2,0,3,1,0,92,102,40386,31663,109,22,42146,30305
290,33,1,4,1,0,0,3,61,78,40387,31667,55,153,42146,30308
291,33,0,0,2,1,2,1,240,90,40387,31667,287,284,42147,30309
292,33,0,3,1,0,0,3,86,112,40387,31670,91,16,42147,30312
293,33,2,1,0,3,1,0,131,122,40389,31671,145,87,42150,30312
294,33,4,1,0,3,1,0,46,41,40393,31672,50,122,42153,30312
295,33,2,1,0,3,1,0,328,64,40395,31673,345,43,42156,30312
296,33,0,0,2,1,2,1,160,165,40395,31673,188,142,42157,30313
297,34,2,3,1,0,0,3,17,24,40397,31676,18,35,42157,30316
298,34,0,1,1,0,0,3,172,137,40397,31677,210,272,42157,30319
299,34,1,0,0,3,1,0,72,68,40398,31677,99,81,42160,30319
300,34,1,0,0,3,1,0,154,131,40399,31677,191,174,42163,30319
301,34,0,0,2,1,2,1,47,65,40399,31677,60,109,42164,30320
302,34,3,1,0,3,1,0,49,52,40402,31678,41,124,42167,30320
303,34,1,0,0,3,1,0,348,80,40403,31678,335,77,42170,30320
304,34,2,1,0,3,1,0,177,133,40405,31679,218,239,42173,30320
305,34,1,0,0,3,1,0,146,165,40406,31679,171,45,42176,30320
0,1,3,2,0,3,1,0,351,82,40409,31681,338,153,42179,30320
1,1,2,0,0,3,1,0,148,165,40411,31681,174,16,42182,30320
2,1,0,1,1,0,0,3,61,79,40411,31682,55,84,42182,30323
3,1,5,0,0,3,1,0,333,64,40416,31682,348,35,42185,30323
4,1,1,0,0,3,1,0,178,133,40417,31682,221,0,42188,30323
5,1,2,0,0,3,1,0,49,65,40419,31682,63,142,42191,30323
6,1,1,3,1,0,0,3,87,115,40420,31685,91,242,42191,30326
7,1,4,2,0,3,1,0,272,123,40424,31687,271,104,42194,30326
8,1,0,2,1,0,0,3,49,54,40424,31689,41,59,42194,30329
9,2,2,2,2,1,2,1,19,26,40426,31691,19,46,42195,30330
10,2,2,0,0,3,1,0,48,41,40428,31691,53,22,42198,30330
11,2,0,2,1,0,0,3,72,70,40428,31693,99,287,42198,30333
12,2,2,1,0,3,1,0,242,91,40430,31694,290,87,42201,30333
13,2,3,1,0,3,1,0,157,132,40433,31695,194,122,42204,30333
14,2,1,2,1,0,0,3,155,135,40434,31697,173,80,42204,30336
15,2,2,3,1,0,0,3,94,105,40436,31700,109,275,42204,30339
16,2,3,3,2,1,2,1,3,3,40439,31703,1,175,42205,30340
17,2,0,1,1,0,0,3,172,138,40439,31704,210,46,42205,30343
18,3,2,1,0,3,1,0,180,134,40441,31705,224,35,42208,30343
19,3,2,2,2,1,2,1,51,56,40443,31707,42,1,42209,30344
20,3,1,1,2,1,2,1,352,83,40444,31708,339,243,42210,30345
21,3,2,3,1,0,0,3,335,67,40446,31711,348,156,42210,30348
22,3,1,2,1,0,0,3,149,167,40447,31713,174,107,42210,30351
23,3,1,1,2,1,2,1,50,66,40448,31714,64,60,42211,30352
24,3,1,1,2,1,2,1,62,80,40449,31715,56,143,42212,30353
25,3,3,1,0,3,1,0,275,124,40452,31716,274,16,42215,30353
26,3,1,1,2,1,2,1,88,116,40453,31717,92,85,42216,30354
27,4,0,1,1,0,0,3,48,42,40453,31718,53,178,42216,30357
28,4,1,0,0,3,1,0,173,138,40454,31718,213,46,42219,30357
29,4,0,0,2,1,2,1,94,105,40454,31718,110,88,42220,30358
30,4,4,2,0,3,1,0,7,5,40458,31720,4,60,42223,30358
31,4,1,0,0,3,1,0,243,91,40459,31720,293,46,42226,30358
32,4,2,1,0,3,1,0,159,133,40461,31721,197,22,42229,30358
33,4,0,1,1,0,0,3,19,27,40461,31722,19,125,42229,30361
34,4,0,4,1,0,0,3,155,139,40461,31726,173,290,42229,30364
35,4,3,0,0,3,1,0,338,67,40464,31726,351,80,42232,30364
36,5,1,2,1,0,0,3,73,72,40465,31728,99,38,42232,30367
37,5,1,3,1,0,0,3,8,8,40466,31731,4,146,42232,30370
38,5,0,0,2,1,2,1,180,134,40466,31731,225,86,42233,30371
39,5,0,2,1,0,0,3,149,169,40466,31733,174,278,42233,30374
40,5,2,0,0,3,1,0,64,80,40468,31733,59,80,42236,30374
41,5,0,0,2,1,2,1,50,66,40468,31733,65,108,42237,30375
42,5,2,0,0,3,1,0,354,83,40470,31733,342,16,42240,30375
43,5,3,2,0,3,1,0,54,58,40473,31735,45,156,42243,30375
44,5,1,0,0,3,1,0,276,124,40474,31735,277,243,42246,30375
45,6,2,2,2,1,2,1,50,44,40476,31737,54,291,42247,30376
46,6,1,0,0,3,1,0,339,67,40477,31737,354,46,42250,30376
47,6,1,0,0,3,1,0,89,116,40478,31737,95,46,42253,30376
48,6,2,1,0,3,1,0,161,134,40480,31738,200,60,42256,30376
49,6,2,0,0,3,1,0,245,91,40482,31738,296,125,42259,30376
50,6,0,3,1,0,0,3,155,142,40482,31741,173,4,42259,30379
51,6,1,1,2,1,2,1,174,139,40483,31742,214,89,42260,30380
52,6,0,3,1,0,0,3,94,108,40483,31745,110,181,42260,30383
53,6,3,0,0,3,1,0,22,27,40486,31745,22,22,42263,30383
54,7,1,1,2,1,2,1,65,81,40487,31746,60,109,42264,30384
55,7,1,0,0,3,1,0,9,8,40488,31746,7,38,42267,30384
56,7,0,0,2,1,2,1,50,66,40488,31746,66,87,42268,30385
57,7,3,0,0,3,1,0,152,169,40491,31746,177,80,42271,30385
58,7,1,3,1,0,0,3,181,137,40492,31749,225,159,42271,30388
59,7,1,1,2,1,2,1,277,125,40493,31750,278,147,42272,30389
60,7,1,0,0,3,1,0,74,72,40494,31750,102,16,42275,30389
61,7,1,0,0,3,1,0,355,83,40495,31750,345,278,42278,30389
62,7,4,2,0,3,1,0,58,60,40499,31752,48,243,42281,30389
63,8,0,1,1,0,0,3,155,143,40499,31753,173,25,42281,30392
64,8,1,1,2,1,2,1,175,140,40500,31754,215,182,42282,30393
65,8,1,2,1,0,0,3,23,29,40501,31756,22,7,42282,30396
66,8,1,0,0,3,1,0,162,134,40502,31756,203,38,42285,30396
67,8,2,0,0,3,1,0,96,108,40504,31756,113,291,42288,30396
68,8,1,0,0,3,1,0,90,116,40505,31756,98,125,42291,30396
69,8,1,2,1,0,0,3,66,83,40506,31758,60,92,42291,30399
70,8,2,0,0,3,1,0,341,67,40508,31758,357,46,42294,30399
71,8,3,0,0,3,1,0,248,91,40511,31758,299,60,42297,30399
72,9,1,3,1,0,0,3,356,86,40512,31761,345,83,42297,30402
73,9,1,1,2,1,2,1,59,61,40513,31762,49,88,42298,30403
74,9,0,2,1,0,0,3,181,139,40513,31764,225,281,42298,30406
75,9,0,0,2,1,2,1,74,72,40513,31764,103,160,42299,30407
76,9,2,4,1,0,0,3,52,70,40515,31768,66,49,42299,30410
77,9,1,2,1,0,0,3,10,10,40516,31770,7,246,42299,30413
78,9,2,1,0,3,1,0,279,126,40518,31771,281,92,42302,30413
79,9,3,3,2,1,2,1,165,137,40521,31774,204,110,42303,30414
80,9,1,2,1,0,0,3,51,46,40522,31776,54,19,42303,30417
81,10,2,0,0,3,1,0,92,116,40524,31776,101,25,42306,30417
82,10,2,1,0,3,1,0,154,170,40526,31777,180,46,42309,30417
83,10,0,0,2,1,2,1,96,108,40526,31777,114,61,42310,30418
84,10,2,1,0,3,1,0,25,30,40528,31778,25,147,42313,30418
85,10,1,0,0,3,1,0,156,143,40529,31778,176,125,42316,30418
86,10,1,0,0,3,1,0,342,67,40530,31778,360,182,42319,30418
87,10,2,0,0,3,1,0,177,140,40532,31778,218,7,42322,30418
88,10,1,3,1,0,0,3,67,86,40533,31781,60,294,42322,30421
89,10,2,1,0,3,1,0,250,92,40535,31782,302,38,42325,30421
90,11,2,3,1,0,0,3,12,13,40537,31785,7,91,42325,30424
91,11,0,1,1,0,0,3,181,140,40537,31786,225,95,42325,30427
92,11,4,0,0,3,1,0,360,86,40541,31786,348,46,42328,30427
93,11,2,0,0,3,1,0,281,126,40543,31786,284,83,42331,30427
94,11,3,2,0,3,1,0,62,63,40546,31788,52,49,42334,30427
95,11,2,3,1,0,0,3,27,33,40548,31791,25,113,42334,30430
96,11,0,1,1,0,0,3,51,47,40548,31792,54,163,42334,30433
97,11,0,1,1,0,0,3,74,73,40548,31793,103,284,42334,30436
98,11,1,3,1,0,0,3,166,140,40549,31796,204,249,42334,30439
99,12,4,1,0,3,1,0,346,68,40553,31797,363,25,42337,30439
100,12,1,0,0,3,1,0,97,108,40554,31797,117,38,42340,30439
101,12,0,1,1,0,0,3,67,87,40554,31798,60,185,42340,30442
102,12,0,1,1,0,0,3,154,171,40554,31799,180,297,42340,30445
103,12,0,0,2,1,2,1,156,143,40554,31799,177,62,42341,30446
104,12,0,1,1,0,0,3,92,117,40554,31800,101,10,42341,30449
105,12,3,2,0,3,1,0,180,142,40557,31802,221,147,42344,30449
106,12,4,1,0,3,1,0,254,93,40561,31803,305,19,42347,30449
107,12,1,1,2,1,2,1,53,71,40562,31804,67,126,42348,30450
108,13,3,1,0,3,1,0,65,64,40565,31805,55,95,42351,30450
109,13,4,0,0,3,1,0,285,126,40569,31805,287,46,42354,30450
110,13,1,2,1,0,0,3,52,49,40570,31807,54,86,42354,30453
111,13,2,0,0,3,1,0,76,73,40572,31807,106,49,42357,30453
112,13,1,1,2,1,2,1,28,34,40573,31808,26,164,42358,30454
113,13,1,2,1,0,0,3,13,15,40574,31810,7,287,42358,30457
114,13,2,2,2,1,2,1,168,142,40576,31812,205,92,42359,30458
115,13,0,1,1,0,0,3,181,141,40576,31813,225,300,42359,30461
116,13,5,2,0,3,1,0,259,95,40581,31815,308,113,42362,30461
117,14,0,2,1,0,0,3,154,173,40581,31817,180,13,42362,30464
118,14,2,1,0,3,1,0,69,88,40583,31818,63,126,42365,30464
119,14,0,1,1,0,0,3,53,72,40583,31819,67,28,42365,30467
120,14,5,2,0,3,1,0,102,110,40588,31821,120,19,42368,30467
121,14,2,1,0,3,1,0,94,118,40590,31822,104,62,42371,30467
122,14,2,0,0,3,1,0,158,143,40592,31822,180,38,42374,30467
123,14,2,1,0,3,1,0,348,69,40594,31823,366,147,42377,30467
124,14,6,2,0,3,1,0,366,88,40600,31825,351,185,42380,30467
125,14,1,0,0,3,1,0,181,142,40601,31825,224,249,42383,30467
126,15,1,2,1,0,0,3,14,17,40602,31827,7,52,42383,30470
127,15,1,0,0,3,1,0,159,143,40603,31827,183,164,42386,30470
128,15,1,0,0,3,1,0,77,73,40604,31827,109,95,42389,30470
129,15,2,0,0,3,1,0,287,126,40606,31827,290,126,42392,30470
130,15,2,0,0,3,1,0,67,64,40608,31827,58,300,42395,30470
131,15,1,2,1,0,0,3,169,144,40609,31829,205,89,42395,30473
132,15,0,0,2,1,2,1,52,49,40609,31829,55,47,42396,30474
133,15,2,1,0,3,1,0,261,96,40611,31830,311,92,42399,30474
134,15,0,1,1,0,0,3,28,35,40611,31831,26,290,42399,30477
135,16,2,1,0,3,1,0,183,142,40613,31832,228,28,42402,30477
136,16,0,0,2,1,2,1,154,173,40613,31832,181,39,42403,30478
137,16,2,2,2,1,2,1,55,74,40615,31834,68,14,42404,30479
138,16,1,0,0,3,1,0,103,110,40616,31834,123,164,42407,30479
139,16,4,2,0,3,1,0,370,90,40620,31836,354,147,42410,30479
140,16,1,0,0,3,1,0,288,126,40621,31836,293,62,42413,30479
141,16,1,0,0,3,1,0,95,118,40622,31836,107,19,42416,30479
142,16,2,1,0,3,1,0,71,89,40624,31837,66,249,42419,30479
143,16,3,1,0,3,1,0,351,70,40627,31838,369,113,42422,30479
144,17,1,1,2,1,2,1,68,65,40628,31839,59,186,42423,30480
145,17,0,2,1,0,0,3,14,19,40628,31841,7,303,42423,30483
146,17,1,1,2,1,2,1,29,36,40629,31842,27,48,42424,30484
147,17,1,0,0,3,1,0,182,142,40630,31842,227,89,42427,30484
148,17,0,0,2,1,2,1,261,96,40630,31842,312,291,42428,30485
149,17,0,1,1,0,0,3,77,74,40630,31843,109,129,42428,30488
150,17,0,1,1,0,0,3,159,144,40630,31844,183,95,42428,30491
151,17,2,1,0,3,1,0,54,50,40632,31845,58,52,42431,30491
152,17,1,1,2,1,2,1,170,145,40633,31846,206,96,42432,30492
153,18,0,3,1,0,0,3,159,147,40633,31849,183,189,42432,30495
154,18,1,4,1,0,0,3,55,54,40634,31853,58,294,42432,30498
155,18,0,1,1,0,0,3,182,143,40634,31854,227,306,42432,30501
156,18,2,2,2,1,2,1,105,112,40636,31856,124,53,42433,30502
157,18,2,1,0,3,1,0,263,97,40638,31857,315,89,42436,30502
158,18,0,1,1,0,0,3,14,20,40638,31858,7,132,42436,30505
159,18,2,1,0,3,1,0,31,37,40640,31859,30,96,42439,30505
160,18,0,2,1,0,0,3,77,76,40640,31861,109,31,42439,30508
161,18,0,0,2,1,2,1,170,145,40640,31861,207,49,42440,30509
162,19,0,2,1,0,0,3,183,144,40640,31863,228,150,42440,30512
163,19,2,1,0,3,1,0,97,119,40642,31864,110,113,42443,30512
164,19,0,2,1,0,0,3,71,91,40642,31866,66,22,42443,30515
165,19,1,2,1,0,0,3,56,76,40643,31868,68,167,42443,30518
166,19,0,1,1,0,0,3,68,66,40643,31869,59,42,42443,30521
167,19,5,1,0,3,1,0,375,91,40648,31870,357,62,42446,30521
168,19,1,0,0,3,1,0,289,126,40649,31870,296,14,42449,30521
169,19,1,1,2,1,2,1,155,174,40650,31871,182,250,42450,30522
170,19,3,0,0,3,1,0,354,70,40653,31871,372,95,42453,30522
171,20,2,2,2,1,2,1,172,147,40655,31873,208,54,42454,30523
172,20,1,0,0,3,1,0,56,54,40656,31873,61,132,42457,30523
173,20,2,0,0,3,1,0,79,76,40658,31873,112,49,42460,30523
174,20,0,2,1,0,0,3,31,39,40658,31875,30,192,42460,30526
175,20,2,1,0,3,1,0,16,21,40660,31876,10,31,42463,30526
176,20,0,0,2,1,2,1,159,147,40660,31876,184,97,42464,30527
177,20,2,4,1,0,0,3,265,101,40662,31880,315,309,42464,30530
178,20,0,0,2,1,2,1,182,143,40662,31880,228,295,42465,30531
179,20,0,1,1,0,0,3,105,113,40662,31881,124,92,42465,30534
180,21,1,1,2,1,2,1,98,120,40663,31882,111,296,42466,30535
181,21,0,1,1,0,0,3,183,145,40663,31883,228,25,42466,30538
182,21,0,1,1,0,0,3,68,67,40663,31884,59,153,42466,30541
183,21,1,0,0,3,1,0,72,91,40664,31884,69,167,42469,30541
184,21,2,1,0,3,1,0,291,127,40666,31885,299,42,42472,30541
185,21,1,0,0,3,1,0,80,76,40667,31885,115,14,42475,30541
186,21,1,0,0,3,1,0,376,91,40668,31885,360,113,42478,30541
187,21,1,3,1,0,0,3,57,79,40669,31888,68,253,42478,30544
188,21,0,0,2,1,2,1,155,174,40669,31888,183,96,42479,30545
189,22,1,2,1,0,0,3,173,149,40670,31890,208,17,42479,30548
190,22,4,0,0,3,1,0,163,147,40674,31890,187,49,42482,30548
191,22,2,0,0,3,1,0,184,143,40676,31890,231,31,42485,30548
192,22,2,0,0,3,1,0,356,70,40678,31890,375,97,42488,30548
193,22,2,0,0,3,1,0,100,120,40680,31890,114,54,42491,30548
194,22,0,1,1,0,0,3,105,114,40680,31891,124,135,42491,30551
195,22,1,1,2,1,2,1,57,55,40681,31892,62,63,42492,30552
196,22,3,0,0,3,1,0,268,101,40684,31892,318,192,42495,30552
197,22,0,3,1,0,0,3,31,42,40684,31895,30,312,42495,30555
198,23,0,2,1,0,0,3,291,129,40684,31897,299,99,42495,30558
199,23,0,3,1,0,0,3,72,94,40684,31900,69,299,42495,30561
200,23,1,3,1,0,0,3,58,82,40685,31903,68,95,42495,30564
201,23,1,1,2,1,2,1,69,68,40686,31904,60,26,42496,30565
202,23,1,1,2,1,2,1,156,175,40687,31905,184,168,42497,30566
203,23,2,0,0,3,1,0,18,21,40689,31905,13,113,42500,30566
204,23,1,0,0,3,1,0,81,76,40690,31905,118,153,42503,30566
205,23,0,0,2,1,2,1,183,145,40690,31905,229,254,42504,30567
206,23,4,0,0,3,1,0,380,91,40694,31905,363,42,42507,30567
207,24,2,0,0,3,1,0,33,42,40696,31905,33,63,42510,30567
208,24,3,2,0,3,1,0,166,149,40699,31907,190,54,42513,30567
209,24,1,1,2,1,2,1,101,121,40700,31908,115,98,42514,30568
210,24,1,2,1,0,0,3,357,72,40701,31910,375,315,42514,30571
211,24,0,0,2,1,2,1,57,55,40701,31910,63,18,42515,30572
212,24,4,0,0,3,1,0,109,114,40705,31910,127,49,42518,30572
213,24,1,2,1,0,0,3,174,151,40706,31912,208,195,42518,30575
214,24,3,1,0,3,1,0,271,102,40709,31913,321,31,42521,30575
215,24,1,0,0,3,1,0,185,143,40710,31913,234,135,42524,30575
216,25,1,1,2,1,2,1,58,56,40711,31914,64,154,42525,30576
217,25,3,2,0,3,1,0,186,147,40714,31916,232,95,42528,30576
218,25,1,0,0,3,1,0,292,129,40715,31916,302,168,42531,30576
219,25,1,2,1,0,0,3,82,78,40716,31918,118,257,42531,30579
220,25,0,0,2,1,2,1,18,21,40716,31918,14,27,42532,30580
221,25,5,1,0,3,1,0,74,69,40721,31919,63,113,42535,30580
222,25,0,0,2,1,2,1,156,175,40721,31919,185,55,42536,30581
223,25,1,2,1,0,0,3,59,84,40722,31921,68,302,42536,30584
224,25,2,2,2,1,2,1,382,93,40724,31923,364,100,42537,30585
225,26,1,0,0,3,1,0,272,102,40725,31923,324,18,42540,30585
226,26,2,2,2,1,2,1,111,116,40727,31925,128,32,42541,30586
227,26,0,1,1,0,0,3,156,176,40727,31926,185,198,42541,30589
228,26,3,1,0,3,1,0,188,144,40730,31927,237,63,42544,30589
229,26,3,0,0,3,1,0,360,72,40733,31927,378,135,42547,30589
230,26,0,1,1,0,0,3,33,43,40733,31928,33,45,42547,30592
231,26,0,1,1,0,0,3,166,150,40733,31929,190,157,42547,30595
232,26,0,4,1,0,0,3,101,125,40733,31933,115,318,42547,30598
233,26,1,1,2,1,2,1,73,95,40734,31934,70,50,42548,30599
234,27,0,2,1,0,0,3,74,71,40734,31936,63,98,42548,30602
235,27,2,3,1,0,0,3,294,132,40736,31939,302,305,42548,30605
236,27,1,3,1,0,0,3,59,59,40737,31942,64,260,42548,30608
237,27,1,0,0,3,1,0,19,21,40738,31942,17,168,42551,30608
238,27,1,0,0,3,1,0,383,93,40739,31942,367,55,42554,30608
239,27,3,2,0,3,1,0,189,149,40742,31944,235,113,42557,30608
240,27,0,2,1,0,0,3,174,153,40742,31946,208,30,42557,30611
241,27,2,0,0,3,1,0,84,78,40744,31946,121,100,42560,30611
242,27,0,1,1,0,0,3,59,85,40744,31947,68,101,42560,30614
243,28,2,0,0,3,1,0,362,72,40746,31947,381,63,42563,30614
244,28,1,1,2,1,2,1,112,117,40747,31948,129,19,42564,30615
245,28,0,0,2,1,2,1,166,150,40747,31948,191,31,42565,30616
246,28,4,0,0,3,1,0,192,144,40751,31948,240,45,42568,30616
247,28,1,0,0,3,1,0,102,125,40752,31948,118,198,42571,30616
248,28,1,0,0,3,1,0,157,176,40753,31948,188,135,42574,30616
249,28,1,4,1,0,0,3,60,89,40754,31952,68,321,42574,30619
250,28,3,0,0,3,1,0,275,102,40757,31952,327,157,42577,30619
251,28,3,2,0,3,1,0,76,97,40760,31954,73,32,42580,30619
252,29,2,2,2,1,2,1,61,61,40762,31956,65,101,42581,30620
253,29,1,1,2,1,2,1,20,22,40763,31957,18,99,42582,30621
254,29,0,3,1,0,0,3,74,74,40763,31960,63,308,42582,30624
255,29,1,3,1,0,0,3,34,46,40764,31963,33,263,42582,30627
256,29,2,1,0,3,1,0,176,154,40766,31964,211,168,42585,30627
257,29,2,0,0,3,1,0,191,149,40768,31964,238,50,42588,30627
258,29,1,0,0,3,1,0,85,78,40769,31964,124,113,42591,30627
259,29,3,0,0,3,1,0,297,132,40772,31964,305,55,42594,30627
260,29,4,2,0,3,1,0,387,95,40776,31966,370,101,42597,30627
261,30,1,0,0,3,1,0,77,97,40777,31966,76,63,42600,30627
262,30,1,1,2,1,2,1,158,177,40778,31967,189,33,42601,30628
263,30,0,1,1,0,0,3,166,151,40778,31968,191,266,42601,30631
264,30,0,2,1,0,0,3,192,146,40778,31970,240,34,42601,30634
265,30,1,3,1,0,0,3,113,120,40779,31973,129,160,42601,30637
266,30,0,1,1,0,0,3,102,126,40779,31974,118,48,42601,30640
267,30,0,2,1,0,0,3,60,91,40779,31976,68,201,42601,30643
268,30,1,0,0,3,1,0,363,72,40780,31976,384,19,42604,30643
269,30,6,0,0,3,1,0,393,95,40786,31976,373,135,42607,30643
270,31,2,2,2,1,2,1,178,156,40788,31978,212,309,42608,30644
271,31,0,0,2,1,2,1,20,22,40788,31978,19,102,42609,30645
272,31,1,0,0,3,1,0,75,74,40789,31978,66,50,42612,30645
273,31,2,0,0,3,1,0,277,102,40791,31978,330,168,42615,30645
274,31,3,0,0,3,1,0,37,46,40794,31978,36,101,42618,30645
275,31,4,1,0,3,1,0,65,62,40798,31979,68,113,42621,30645
276,31,2,0,0,3,1,0,193,149,40800,31979,241,55,42624,30645
277,31,1,4,1,0,0,3,298,136,40801,31983,305,324,42624,30648
278,31,3,1,0,3,1,0,88,79,40804,31984,127,99,42627,30648
279,32,1,2,1,0,0,3,103,128,40805,31986,118,163,42627,30651
280,32,4,4,2,1,2,1,64,95,40809,31990,69,49,42628,30652
281,32,1,0,0,3,1,0,194,149,40810,31990,244,201,42631,30652
282,32,5,1,0,3,1,0,398,96,40815,31991,376,33,42634,30652
283,32,4,0,0,3,1,0,367,72,40819,31991,387,34,42637,30652
284,32,1,3,1,0,0,3,78,100,40820,31994,76,22,42637,30655
285,32,1,8,1,0,0,3,114,128,40821,32002,129,269,42637,30658
286,32,2,2,2,1,2,1,194,148,40823,32004,241,114,42638,30659
287,32,0,3,1,0,0,3,158,180,40823,32007,189,66,42638,30662
288,33,0,1,1,0,0,3,37,47,40823,32008,36,102,42638,30665
289,33,4,4,2,1,2,1,24,26,40827,32012,20,51,42639,30666
290,33,3,2,0,3,1,0,78,76,40830,32014,69,135,42642,30666
291,33,4,2,0,3,1,0,92,81,40834,32016,130,201,42645,30666
292,33,1,1,2,1,2,1,278,103,40835,32017,331,56,42646,30667
293,33,1,2,1,0,0,3,66,64,40836,32019,68,105,42646,30670
294,33,5,1,0,3,1,0,199,149,40841,32020,244,101,42649,30670
295,33,0,4,1,0,0,3,166,155,40841,32024,191,312,42649,30673
296,33,2,3,1,0,0,3,180,159,40843,32027,212,327,42649,30676
297,34,3,0,0,3,1,0,117,128,40846,32027,132,114,42652,30676
298,34,2,0,0,3,1,0,300,136,40848,32027,308,33,42655,30676
299,34,2,1,0,3,1,0,66,96,40850,32028,72,34,42658,30676
300,34,0,1,1,0,0,3,194,150,40850,32029,244,69,42658,30679
301,34,1,3,1,0,0,3,159,183,40851,32032,189,166,42658,30682
302,34,4,1,0,3,1,0,402,97,40855,32033,379,22,42661,30682
303,34,2,1,0,3,1,0,369,73,40857,32034,390,269,42664,30682
304,34,5,2,0,3,1,0,83,102,40862,32036,79,49,42667,30682
305,34,1,3,1,0,0,3,104,131,40863,32039,118,171,42667,30685
0,1,0,0,2,1,2,1,78,76,40863,32039,70,102,42668,30686
1,1,0,2,1,0,0,3,24,28,40863,32041,20,3,42668,30689
2,1,2,1,0,3,1,0,63,85,40865,32042,76,312,42671,30689
3,1,5,0,0,3,1,0,407,97,40870,32042,382,124,42674,30689
4,1,2,1,0,3,1,0,94,82,40872,32043,133,34,42677,30689
5,1,1,1,2,1,2,1,195,151,40873,32044,245,270,42678,30690
6,1,3,1,0,3,1,0,303,137,40876,32045,311,102,42681,30690
7,1,0,0,2,1,2,1,159,183,40876,32045,190,57,42682,30691
8,1,1,1,2,1,2,1,181,160,40877,32046,213,172,42683,30692
9,2,1,0,0,3,1,0,1,0,40878,32046,3,166,42686,30692
10,2,3,0,0,3,1,0,107,131,40881,32046,121,40,42689,30692
11,2,0,2,1,0,0,3,117,130,40881,32048,132,330,42689,30695
12,2,4,0,0,3,1,0,373,73,40885,32048,393,105,42692,30695
13,2,0,1,1,0,0,3,160,166,40885,32049,188,25,42692,30698
14,2,3,1,0,3,1,0,40,48,40888,32050,39,135,42695,30698
15,2,1,1,2,1,2,1,200,150,40889,32051,245,70,42696,30699
16,2,2,1,0,3,1,0,280,104,40891,32052,334,201,42699,30699
17,2,1,2,1,0,0,3,84,104,40892,32054,79,36,42699,30702
18,3,0,0,2,1,2,1,159,183,40892,32054,191,103,42700,30703
19,3,5,1,0,3,1,0,186,161,40897,32055,216,34,42703,30703
20,3,0,2,1,0,0,3,407,99,40897,32057,382,315,42703,30706
21,3,1,1,2,1,2,1,95,83,40898,32058,134,125,42704,30707
22,3,0,0,2,1,2,1,24,28,40898,32058,21,103,42705,30708
23,3,2,3,1,0,0,3,197,154,40900,32061,245,60,42705,30711
24,3,1,3,1,0,0,3,79,79,40901,32064,70,273,42705,30714
25,3,1,1,2,1,2,1,64,86,40902,32065,77,202,42706,30715
26,3,1,1,2,1,2,1,201,151,40903,32066,246,4,42707,30716
27,4,1,0,0,3,1,0,108,131,40904,32066,124,36,42710,30716
28,4,0,1,1,0,0,3,117,131,40904,32067,132,73,42710,30719
29,4,0,1,1,0,0,3,160,167,40904,32068,188,138,42710,30722
30,4,2,3,1,0,0,3,42,51,40906,32071,39,7,42710,30725
31,4,2,3,1,0,0,3,282,107,40908,32074,334,169,42710,30728
32,4,0,0,2,1,2,1,64,86,40908,32074,78,106,42711,30729
33,4,0,0,2,1,2,1,84,104,40908,32074,80,26,42712,30730
34,4,3,0,0,3,1,0,376,73,40911,32074,396,172,42715,30730
35,4,0,4,1,0,0,3,303,141,40911,32078,311,333,42715,30733
36,5,1,0,0,3,1,0,160,183,40912,32078,194,202,42718,30733
37,5,4,2,0,3,1,0,5,2,40916,32080,6,125,42721,30733
38,5,2,0,0,3,1,0,409,99,40918,32080,385,40,42724,30733
39,5,5,1,0,3,1,0,206,152,40923,32081,249,34,42727,30733
40,5,2,0,0,3,1,0,26,28,40925,32081,24,103,42730,30733
41,5,2,4,1,0,0,3,188,165,40927,32085,216,63,42730,30736
42,5,1,3,1,0,0,3,198,157,40928,32088,245,106,42730,30739
43,5,2,3,1,0,0,3,81,82,40930,32091,70,318,42730,30742
44,5,1,1,2,1,2,1,96,84,40931,32092,135,274,42731,30743
45,6,2,1,0,3,1,0,162,168,40933,32093,191,34,42734,30743
46,6,0,2,1,0,0,3,117,133,40933,32095,132,172,42734,30746
47,6,1,2,1,0,0,3,109,133,40934,32097,124,336,42734,30749
48,6,0,0,2,1,2,1,64,86,40934,32097,79,74,42735,30750
49,6,1,3,1,0,0,3,85,107,40935,32100,80,175,42735,30753
50,6,0,0,2,1,2,1,160,183,40935,32100,195,37,42736,30754
51,6,2,0,0,3,1,0,378,73,40937,32100,399,26,42739,30754
52,6,2,2,2,1,2,1,305,143,40939,32102,312,139,42740,30755
53,6,1,2,1,0,0,3,283,109,40940,32104,334,10,42740,30758
54,7,0,0,2,1,2,1,96,84,40940,32104,136,64,42741,30759
55,7,2,1,0,3,1,0,200,158,40942,32105,248,103,42744,30759
56,7,1,0,0,3,1,0,410,99,40943,32105,388,106,42747,30759
57,7,3,1,0,3,1,0,8,3,40946,32106,9,106,42750,30759
58,7,1,0,0,3,1,0,27,28,40947,32106,27,40,42753,30759
59,7,1,0,0,3,1,0,207,152,40948,32106,252,125,42756,30759
60,7,0,1,1,0,0,3,81,83,40948,32107,70,205,42756,30762
61,7,0,1,1,0,0,3,188,166,40948,32108,216,321,42756,30765
62,7,0,1,1,0,0,3,42,52,40948,32109,39,277,42756,30768
63,8,0,0,2,1,2,1,162,168,40948,32109,192,173,42757,30769
64,8,1,1,2,1,2,1,65,87,40949,32110,80,38,42758,30770
65,8,3,2,0,3,1,0,120,135,40952,32112,135,34,42761,30770
66,8,0,0,2,1,2,1,160,183,40952,32112,196,140,42762,30771
67,8,1,1,2,1,2,1,110,134,40953,32113,125,75,42763,30772
68,8,0,1,1,0,0,3,85,108,40953,32114,80,339,42763,30775
69,8,3,0,0,3,1,0,381,73,40956,32114,402,10,42766,30775
70,8,3,1,0,3,1,0,286,110,40959,32115,337,175,42769,30775
71,8,2,0,0,3,1,0,307,143,40961,32115,315,26,42772,30775
72,9,0,1,1,0,0,3,42,53,40961,32116,39,67,42772,30778
73,9,1,1,2,1,2,1,189,167,40962,32117,217,104,42773,30779
74,9,1,1,2,1,2,1,201,159,40963,32118,249,322,42774,30780
75,9,5,0,0,3,1,0,212,152,40968,32118,255,106,42777,30780
76,9,4,0,0,3,1,0,414,99,40972,32118,391,38,42780,30780
77,9,2,1,0,3,1,0,10,4,40974,32119,12,40,42783,30780
78,9,1,2,1,0,0,3,163,170,40975,32121,192,280,42783,30783
79,9,1,1,2,1,2,1,28,29,40976,32122,28,107,42784,30784
80,9,2,0,0,3,1,0,98,84,40978,32122,139,205,42787,30784
81,10,2,0,0,3,1,0,416,99,40980,32122,394,173,42790,30784
82,10,1,1,2,1,2,1,111,135,40981,32123,126,176,42791,30785
83,10,2,0,0,3,1,0,67,87,40983,32123,83,140,42794,30785
84,10,1,0,0,3,1,0,86,108,40984,32123,83,280,42797,30785
85,10,1,0,0,3,1,0,382,73,40985,32123,405,34,42800,30785
86,10,2,2,2,1,2,1,309,145,40987,32125,316,11,42801,30786
87,10,1,0,0,3,1,0,121,135,40988,32125,138,125,42804,30786
88,10,1,0,0,3,1,0,161,183,40989,32125,199,75,42807,30786
89,10,1,1,2,1,2,1,82,84,40990,32126,71,27,42808,30787
90,11,1,2,1,0,0,3,43,55,40991,32128,39,43,42808,30790
91,11,1,0,0,3,1,0,190,167,40992,32128,220,107,42811,30790
92,11,1,2,1,0,0,3,29,31,40993,32130,28,342,42811,30793
93,11,3,3,2,1,2,1,13,7,40996,32133,13,105,42812,30794
94,11,1,0,0,3,1,0,164,170,40997,32133,195,67,42815,30794
95,11,1,1,2,1,2,1,202,160,40998,32134,250,39,42816,30795
96,11,2,0,0,3,1,0,288,110,41000,32134,340,106,42819,30795
97,11,0,2,1,0,0,3,212,154,41000,32136,255,208,42819,30798
98,11,0,1,1,0,0,3,98,85,41000,32137,139,325,42819,30801
99,12,1,2,1,0,0,3,30,33,41001,32139,28,78,42819,30804
100,12,3,2,0,3,1,0,114,137,41004,32141,129,34,42822,30804
101,12,4,0,0,3,1,0,420,99,41008,32141,397,140,42825,30804
102,12,2,1,0,3,1,0,84,85,41010,32142,74,11,42828,30804
103,12,0,1,1,0,0,3,86,109,41010,32143,83,109,42828,30807
104,12,1,1,2,1,2,1,162,184,41011,32144,200,177,42829,30808
105,12,3,1,0,3,1,0,70,88,41014,32145,86,280,42832,30808
106,12,2,0,0,3,1,0,311,145,41016,32145,319,173,42835,30808
107,12,2,0,0,3,1,0,384,73,41018,32145,408,125,42838,30808
108,13,1,4,1,0,0,3,99,89,41019,32149,139,345,42838,30811
109,13,2,2,2,1,2,1,204,162,41021,32151,251,28,42839,30812
110,13,2,3,1,0,0,3,15,10,41023,32154,13,70,42839,30815
111,13,1,0,0,3,1,0,44,55,41024,32154,42,208,42842,30815
112,13,2,3,1,0,0,3,166,173,41026,32157,195,110,42842,30818
113,13,2,0,0,3,1,0,214,154,41028,32157,258,39,42845,30818
114,13,1,0,0,3,1,0,289,110,41029,32157,343,105,42848,30818
115,13,1,1,2,1,2,1,122,136,41030,32158,139,326,42849,30819
116,13,1,0,0,3,1,0,191,167,41031,32158,223,43,42852,30819
117,14,1,1,2,1,2,1,85,86,41032,32159,75,174,42853,30820
118,14,1,0,0,3,1,0,205,162,41033,32159,254,78,42856,30820
119,14,4,0,0,3,1,0,424,99,41037,32159,400,11,42859,30820
120,14,1,0,0,3,1,0,163,184,41038,32159,203,34,42862,30820
121,14,2,1,0,3,1,0,116,138,41040,32160,132,109,42865,30820
122,14,2,2,2,1,2,1,72,90,41042,32162,87,178,42866,30821
123,14,0,1,1,0,0,3,311,146,41042,32163,319,128,42866,30824
124,14,0,4,1,0,0,3,30,37,41042,32167,28,283,42866,30827
125,14,3,0,0,3,1,0,387,73,41045,32167,411,70,42869,30827
126,15,0,1,1,0,0,3,44,56,41045,32168,42,31,42869,30830
127,15,1,1,2,1,2,1,100,90,41046,32169,140,40,42870,30831
128,15,1,7,1,0,0,3,123,143,41047,32176,139,211,42870,30834
129,15,0,1,1,0,0,3,214,155,41047,32177,258,348,42870,30837
130,15,1,0,0,3,1,0,167,173,41048,32177,198,105,42873,30837
131,15,0,1,1,0,0,3,191,168,41048,32178,223,143,42873,30840
132,15,1,1,2,1,2,1,87,110,41049,32179,84,44,42874,30841
133,15,1,2,1,0,0,3,290,112,41050,32181,343,329,42874,30844
134,15,3,0,0,3,1,0,18,10,41053,32181,16,110,42877,30844
135,16,2,1,0,3,1,0,426,100,41055,32182,403,34,42880,30844
136,16,0,1,1,0,0,3,30,38,41055,32183,28,177,42880,30847
137,16,2,4,1,0,0,3,118,142,41057,32187,132,332,42880,30850
138,16,0,0,2,1,2,1,85,86,41057,32187,76,129,42881,30851
139,16,0,1,1,0,0,3,100,91,41057,32188,140,14,42881,30854
140,16,1,3,1,0,0,3,164,187,41058,32191,203,286,42881,30857
141,16,2,0,0,3,1,0,74,90,41060,32191,90,109,42884,30857
142,16,0,0,2,1,2,1,205,162,41060,32191,255,179,42885,30858
143,16,2,1,0,3,1,0,313,147,41062,32192,322,70,42888,30858
144,17,1,2,1,0,0,3,388,75,41063,32194,411,214,42888,30861
145,17,0,2,1,0,0,3,290,114,41063,32196,343,351,42888,30864
146,17,3,0,0,3,1,0,47,56,41066,32196,45,40,42891,30864
147,17,1,0,0,3,1,0,215,155,41067,32196,261,31,42894,30864
148,17,1,1,2,1,2,1,88,111,41068,32197,85,106,42895,30865
149,17,0,1,1,0,0,3,123,144,41068,32198,139,113,42895,30868
150,17,0,0,2,1,2,1,167,173,41068,32198,199,45,42896,30869
151,17,1,1,2,1,2,1,19,11,41069,32199,17,144,42897,30870
152,17,2,0,0,3,1,0,193,168,41071,32199,226,78,42900,30870
153,18,2,1,0,3,1,0,125,145,41073,32200,142,40,42903,30870
154,18,0,1,1,0,0,3,19,12,41073,32201,17,34,42903,30873
155,18,0,3,1,0,0,3,88,114,41073,32204,85,116,42903,30876
156,18,0,2,1,0,0,3,167,175,41073,32206,199,354,42903,30879
157,18,0,1,1,0,0,3,47,57,41073,32207,45,81,42903,30882
158,18,1,2,1,0,0,3,216,157,41074,32209,261,180,42903,30885
159,18,1,0,0,3,1,0,291,114,41075,32209,346,144,42906,30885
160,18,2,1,0,3,1,0,390,76,41077,32210,414,45,42909,30885
161,18,1,2,1,0,0,3,119,144,41078,32212,132,217,42909,30888
162,19,3,2,0,3,1,0,429,102,41081,32214,406,109,42912,30888
163,19,2,2,2,1,2,1,195,170,41083,32216,227,15,42913,30889
164,19,0,1,1,0,0,3,85,87,41083,32217,76,73,42913,30892
165,19,0,4,1,0,0,3,164,191,41083,32221,203,335,42913,30895
166,19,1,5,1,0,0,3,75,95,41084,32226,90,109,42913,30898
167,19,1,2,1,0,0,3,206,164,41085,32228,255,37,42913,30901
168,19,1,0,0,3,1,0,314,147,41086,32228,325,286,42916,30901
169,19,2,1,0,3,1,0,32,39,41088,32229,31,129,42919,30901
170,19,2,0,0,3,1,0,102,91,41090,32229,143,179,42922,30901
171,20,0,1,1,0,0,3,167,176,41090,32230,199,84,42922,30904
172,20,0,2,1,0,0,3,125,147,41090,32232,142,37,42922,30907
173,20,0,7,1,0,0,3,19,19,41090,32239,17,182,42922,30910
174,20,2,2,2,1,2,1,316,149,41092,32241,326,46,42923,30911
175,20,3,2,0,3,1,0,393,78,41095,32243,417,354,42926,30911
176,20,1,1,2,1,2,1,120,145,41096,32244,133,117,42927,30912
177,20,0,0,2,1,2,1,88,114,41096,32244,86,145,42928,30913
178,20,2,1,0,3,1,0,293,115,41098,32245,349,40,42931,30913
179,20,0,4,1,0,0,3,47,61,41098,32249,45,183,42931,30916
180,21,1,2,1,0,0,3,165,193,41099,32251,203,49,42931,30919
181,21,1,1,2,1,2,1,86,88,41100,32252,77,110,42932,30920
182,21,1,0,0,3,1,0,33,39,41101,32252,34,73,42935,30920
183,21,0,1,1,0,0,3,429,103,41101,32253,406,220,42935,30923
184,21,1,1,2,1,2,1,196,171,41102,32254,228,287,42936,30924
185,21,1,2,1,0,0,3,103,93,41103,32256,143,112,42936,30927
186,21,3,0,0,3,1,0,209,164,41106,32256,258,129,42939,30927
187,21,1,2,1,0,0,3,217,159,41107,32258,261,338,42939,30930
188,21,1,1,2,1,2,1,20,20,41108,32259,18,38,42940,30931
189,22,0,2,1,0,0,3,47,63,41108,32261,45,185,42940,30934
190,22,1,2,1,0,0,3,89,116,41109,32263,86,186,42940,30937
191,22,1,0,0,3,1,0,126,147,41110,32263,145,145,42943,30937
192,22,2,1,0,3,1,0,169,177,41112,32264,202,15,42946,30937
193,22,2,1,0,3,1,0,122,146,41114,32265,136,37,42949,30937
194,22,2,0,0,3,1,0,295,115,41116,32265,352,84,42952,30937
195,22,3,1,0,3,1,0,319,150,41119,32266,329,117,42955,30937
196,22,1,0,0,3,1,0,394,78,41120,32266,420,40,42958,30937
197,22,0,1,1,0,0,3,75,96,41120,32267,90,357,42958,30940
198,23,0,0,2,1,2,1,86,88,41120,32267,78,118,42959,30941
199,23,0,0,2,1,2,1,196,171,41120,32267,229,113,42960,30942
200,23,0,1,1,0,0,3,103,94,41120,32268,143,52,42960,30945
201,23,1,3,1,0,0,3,48,66,41121,32271,45,132,42960,30948
202,23,1,2,1,0,0,3,210,166,41122,32273,258,223,42960,30951
203,23,2,0,0,3,1,0,219,159,41124,32273,264,73,42963,30951
204,23,0,2,1,0,0,3,33,41,41124,32275,34,341,42963,30954
205,23,1,1,2,1,2,1,430,104,41125,32276,407,111,42964,30955
206,23,3,1,0,3,1,0,23,21,41128,32277,21,287,42967,30955
207,24,3,1,0,3,1,0,322,151,41131,32278,332,40,42970,30955
208,24,1,1,2,1,2,1,90,117,41132,32279,87,85,42971,30956
209,24,1,1,2,1,2,1,166,194,41133,32280,204,358,42972,30957
210,24,1,1,2,1,2,1,395,79,41134,32281,421,187,42973,30958
211,24,0,0,2,1,2,1,126,147,41134,32281,146,16,42974,30959
212,24,2,0,0,3,1,0,124,146,41136,32281,139,145,42977,30959
213,24,1,1,2,1,2,1,76,97,41137,32282,91,38,42978,30960
214,24,2,0,0,3,1,0,297,115,41139,32282,355,38,42981,30960
215,24,1,2,1,0,0,3,170,179,41140,32284,202,188,42981,30963
216,25,1,0,0,3,1,0,87,88,41141,32284,81,52,42984,30963
217,25,2,1,0,3,1,0,25,22,41143,32285,24,341,42987,30963
218,25,1,1,2,1,2,1,211,167,41144,32286,259,119,42988,30964
219,25,0,0,2,1,2,1,430,104,41144,32286,408,74,42989,30965
220,25,2,2,2,1,2,1,221,161,41146,32288,265,288,42990,30966
221,25,3,2,0,3,1,0,36,43,41149,32290,37,223,42993,30966
222,25,0,2,1,0,0,3,48,68,41149,32292,45,116,42993,30969
223,25,0,1,1,0,0,3,103,95,41149,32293,143,114,42993,30972
224,25,2,3,1,0,0,3,198,174,41151,32296,229,135,42993,30975
225,26,1,3,1,0,0,3,77,100,41152,32299,91,19,42993,30978
226,26,2,2,2,1,2,1,168,196,41154,32301,205,39,42994,30979
227,26,2,2,2,1,2,1,89,90,41156,32303,82,359,42995,30980
228,26,1,0,0,3,1,0,396,79,41157,32303,424,145,42998,30980
229,26,1,1,2,1,2,1,127,148,41158,32304,147,189,42999,30981
230,26,2,0,0,3,1,0,92,117,41160,32304,90,38,43002,30981
231,26,0,1,1,0,0,3,124,147,41160,32305,139,190,43002,30984
232,26,1,0,0,3,1,0,298,115,41161,32305,358,135,43005,30984
233,26,0,1,1,0,0,3,322,152,41161,32306,332,88,43005,30987
234,27,2,1,0,3,1,0,213,168,41163,32307,262,52,43008,30987
235,27,1,1,2,1,2,1,37,44,41164,32308,38,41,43009,30988
236,27,0,0,2,1,2,1,48,68,41164,32308,46,342,43010,30989
237,27,2,1,0,3,1,0,172,180,41166,32309,205,116,43013,30989
238,27,1,2,1,0,0,3,199,176,41167,32311,229,362,43013,30992
239,27,3,1,0,3,1,0,106,96,41170,32312,146,119,43016,30992
240,27,2,0,0,3,1,0,300,115,41172,32312,361,74,43019,30992
241,27,1,1,2,1,2,1,222,162,41173,32313,266,115,43020,30993
242,27,0,0,2,1,2,1,25,22,41173,32313,25,224,43021,30994
243,28,3,0,0,3,1,0,80,100,41176,32313,94,38,43024,30994
244,28,3,2,0,3,1,0,92,92,41179,32315,85,145,43027,30994
245,28,1,2,1,0,0,3,169,198,41180,32317,205,193,43027,30997
246,28,3,4,1,0,0,3,433,108,41183,32321,408,42,43027,31000
247,28,4,0,0,3,1,0,400,79,41187,32321,427,88,43030,31000
248,28,1,3,1,0,0,3,93,120,41188,32324,90,138,43030,31003
249,28,1,1,2,1,2,1,125,148,41189,32325,140,20,43031,31004
250,28,3,2,0,3,1,0,325,154,41192,32327,335,189,43034,31004
251,28,1,3,1,0,0,3,128,151,41193,32330,147,291,43034,31007
252,29,1,0,0,3,1,0,107,96,41194,32330,149,42,43037,31007
253,29,0,1,1,0,0,3,48,69,41194,32331,46,118,43037,31010
254,29,2,0,0,3,1,0,215,168,41196,32331,265,362,43040,31010
255,29,0,1,1,0,0,3,172,181,41196,32332,205,345,43040,31013
256,29,0,1,1,0,0,3,25,23,41196,32333,25,44,43040,31016
257,29,2,0,0,3,1,0,224,162,41198,32333,269,119,43043,31016
258,29,4,3,0,3,1,0,203,179,41202,32336,232,224,43046,31016
259,29,1,1,2,1,2,1,129,152,41203,32337,148,75,43047,31017
260,29,2,1,0,3,1,0,302,116,41205,32338,364,52,43050,31017
261,30,0,1,1,0,0,3,37,45,41205,32339,38,148,43050,31020
262,30,2,3,1,0,0,3,171,201,41207,32342,205,141,43050,31023
263,30,0,1,1,0,0,3,92,93,41207,32343,85,192,43050,31026
264,30,3,1,0,3,1,0,436,109,41210,32344,411,88,43053,31026
265,30,4,0,0,3,1,0,329,154,41214,32344,338,38,43056,31026
266,30,1,0,0,3,1,0,81,100,41215,32344,97,193,43059,31026
267,30,0,1,1,0,0,3,93,121,41215,32345,90,23,43059,31029
268,30,5,0,0,3,1,0,405,79,41220,32345,430,116,43062,31029
269,30,0,0,2,1,2,1,125,148,41220,32345,141,292,43063,31030
270,31,0,1,1,0,0,3,107,97,41220,32346,149,151,43063,31033
271,31,1,0,0,3,1,0,49,69,41221,32346,49,119,43066,31033
272,31,2,1,0,3,1,0,205,180,41223,32347,235,44,43069,31033
273,31,1,3,1,0,0,3,94,124,41224,32350,90,348,43069,31036
274,31,1,1,2,1,2,1,26,24,41225,32351,26,363,43070,31037
275,31,1,2,1,0,0,3,225,164,41226,32353,269,55,43070,31040
276,31,1,0,0,3,1,0,303,116,41227,32353,367,42,43073,31040
277,31,1,5,1,0,0,3,173,186,41228,32358,205,227,43073,31043
278,31,0,1,1,0,0,3,129,153,41228,32359,148,121,43073,31046
279,32,0,0,2,1,2,1,215,168,41228,32359,266,194,43074,31047
280,32,1,2,1,0,0,3,172,203,41229,32361,205,26,43074,31050
281,32,3,0,0,3,1,0,40,45,41232,32361,41,38,43077,31050
282,32,2,1,0,3,1,0,94,94,41234,32362,88,88,43080,31050
283,32,2,0,0,3,1,0,438,109,41236,32362,414,192,43083,31050
284,32,3,2,0,3,1,0,84,102,41239,32364,100,75,43086,31050
285,32,1,1,2,1,2,1,126,149,41240,32365,142,142,43087,31051
286,32,1,1,2,1,2,1,330,155,41241,32366,339,117,43088,31052
287,32,2,0,0,3,1,0,407,79,41243,32366,433,292,43091,31052
288,33,2,2,2,1,2,1,207,182,41245,32368,236,43,43092,31053
289,33,2,2,2,1,2,1,28,26,41247,32370,27,89,43093,31054
290,33,1,0,0,3,1,0,130,153,41248,32370,151,55,43096,31054
291,33,1,0,0,3,1,0,226,164,41249,32370,272,151,43099,31054
292,33,2,1,0,3,1,0,175,187,41251,32371,208,44,43102,31054
293,33,1,0,0,3,1,0,95,124,41252,32371,93,227,43105,31054
294,33,6,1,0,3,1,0,413,80,41258,32372,436,121,43108,31054
295,33,0,0,2,1,2,1,303,116,41258,32372,368,120,43109,31055
296,33,0,4,1,0,0,3,49,73,41258,32376,49,366,43109,31058
297,34,2,2,2,1,2,1,42,47,41260,32378,42,193,43110,31059
298,34,3,3,2,1,2,1,87,105,41263,32381,101,143,43111,31060
299,34,0,2,1,0,0,3,107,99,41263,32383,149,197,43111,31063
300,34,3,3,2,1,2,1,218,171,41266,32386,267,27,43112,31064
301,34,2,1,0,3,1,0,440,110,41268,32387,417,292,43115,31064
302,34,2,1,0,3,1,0,332,156,41270,32388,342,348,43118,31064
303,34,1,2,1,0,0,3,127,151,41271,32390,142,78,43118,31067
304,34,2,0,0,3,1,0,96,94,41273,32390,91,38,43121,31067
305,34,2,0,0,3,1,0,174,203,41275,32390,208,117,43124,31067
0,1,1,5,1,0,0,3,29,31,41276,32395,27,369,43124,31070
1,1,0,1,1,0,0,3,226,165,41276,32396,272,120,43124,31073
2,1,3,3,2,1,2,1,169,158,41279,32399,192,90,43125,31074
3,1,3,1,0,3,1,0,416,81,41282,32400,439,227,43128,31074
4,1,2,0,0,3,1,0,44,47,41284,32400,45,151,43131,31074
5,1,2,0,0,3,1,0,129,151,41286,32400,145,0,43134,31074
6,1,1,1,2,1,2,1,96,125,41287,32401,94,198,43135,31075
7,1,1,1,2,1,2,1,97,95,41288,32402,92,144,43136,31076
8,1,3,1,0,3,1,0,306,117,41291,32403,371,55,43139,31076
9,2,0,1,1,0,0,3,332,157,41291,32404,342,46,43139,31079
10,2,2,1,0,3,1,0,220,172,41293,32405,270,78,43142,31079
11,2,2,0,0,3,1,0,442,110,41295,32405,420,121,43145,31079
12,2,0,5,1,0,0,3,107,104,41295,32410,149,351,43145,31082
13,2,0,1,1,0,0,3,0,1,41295,32411,0,117,43145,31085
14,2,1,0,0,3,1,0,88,105,41296,32411,104,44,43148,31085
15,2,0,2,1,0,0,3,175,189,41296,32413,208,295,43148,31088
16,2,0,0,2,1,2,1,207,182,41296,32413,237,194,43149,31089
17,2,1,2,1,0,0,3,131,155,41297,32415,151,30,43149,31092
18,3,1,1,2,1,2,1,130,152,41298,32416,146,91,43150,31093
19,3,1,0,0,3,1,0,227,165,41299,32416,275,144,43153,31093
20,3,0,0,2,1,2,1,44,47,41299,32416,46,56,43154,31094
21,3,2,3,1,0,0,3,418,84,41301,32419,439,154,43154,31097
22,3,0,4,1,0,0,3,96,129,41301,32423,94,230,43154,31100
23,3,0,0,2,1,2,1,169,158,41301,32423,193,121,43155,31101
24,3,1,1,2,1,2,1,30,32,41302,32424,28,199,43156,31102
25,3,3,2,0,3,1,0,445,112,41305,32426,423,0,43159,31102
26,3,0,2,1,0,0,3,97,97,41305,32428,92,298,43159,31105
27,4,1,1,2,1,2,1,89,106,41306,32429,105,79,43160,31106
28,4,1,2,1,0,0,3,221,174,41307,32431,270,47,43160,31109
29,4,2,1,0,3,1,0,334,158,41309,32432,345,117,43163,31109
30,4,2,2,2,1,2,1,308,119,41311,32434,372,352,43164,31110
31,4,2,1,0,3,1,0,177,190,41313,32435,211,46,43167,31110
32,4,0,0,2,1,2,1,131,155,41313,32435,152,122,43168,31111
33,4,3,3,2,1,2,1,3,4,41316,32438,1,31,43169,31112
34,4,0,3,1,0,0,3,207,185,41316,32441,237,372,43169,31115
35,4,0,1,1,0,0,3,107,105,41316,32442,149,197,43169,31118
36,5,1,0,0,3,1,0,97,129,41317,32442,97,47,43172,31118
37,5,1,1,2,1,2,1,170,159,41318,32443,194,145,43173,31119
38,5,1,2,1,0,0,3,45,49,41319,32445,46,301,43173,31122
39,5,1,0,0,3,1,0,419,84,41320,32445,442,56,43176,31122
40,5,2,1,0,3,1,0,132,153,41322,32446,149,154,43179,31122
41,5,0,1,1,0,0,3,3,5,41322,32447,1,202,43179,31125
42,5,2,2,2,1,2,1,32,34,41324,32449,29,92,43180,31126
43,5,0,1,1,0,0,3,227,166,41324,32450,275,233,43180,31129
44,5,2,0,0,3,1,0,447,112,41326,32450,426,121,43183,31129
45,6,3,2,0,3,1,0,180,192,41329,32452,214,352,43186,31129
46,6,1,1,2,1,2,1,132,156,41330,32453,153,1,43187,31130
47,6,2,0,0,3,1,0,209,185,41332,32453,240,122,43190,31130
48,6,0,0,2,1,2,1,221,174,41332,32453,271,118,43191,31131
49,6,1,2,1,0,0,3,98,99,41333,32455,92,49,43191,31134
50,6,1,2,1,0,0,3,90,108,41334,32457,105,200,43191,31137
51,6,4,0,0,3,1,0,312,119,41338,32457,375,79,43194,31137
52,6,1,0,0,3,1,0,335,158,41339,32457,348,31,43197,31137
53,6,3,0,0,3,1,0,110,105,41342,32457,152,372,43200,31137
54,7,0,0,2,1,2,1,132,156,41342,32457,154,203,43201,31138
55,7,2,0,0,3,1,0,99,129,41344,32457,100,49,43204,31138
56,7,2,1,0,3,1,0,34,35,41346,32458,32,154,43207,31138
57,7,0,4,1,0,0,3,227,170,41346,32462,275,304,43207,31141
58,7,2,1,0,3,1,0,172,160,41348,32463,197,56,43210,31141
59,7,3,1,0,3,1,0,6,6,41351,32464,4,92,43213,31141
60,7,3,1,0,3,1,0,422,85,41354,32465,445,47,43216,31141
61,7,2,3,1,0,0,3,449,115,41356,32468,426,236,43216,31144
62,7,0,1,1,0,0,3,132,154,41356,32469,149,148,43216,31147
63,8,2,0,0,3,1,0,182,192,41358,32469,217,31,43219,31147
64,8,0,2,1,0,0,3,99,131,41358,32471,100,203,43219,31150
65,8,0,1,1,0,0,3,45,50,41358,32472,46,355,43219,31153
66,8,2,1,0,3,1,0,314,120,41360,32473,378,122,43222,31153
67,8,2,0,0,3,1,0,92,108,41362,32473,108,203,43225,31153
68,8,1,0,0,3,1,0,99,99,41363,32473,95,118,43228,31153
69,8,0,0,2,1,2,1,110,105,41363,32473,153,122,43229,31154
70,8,1,0,0,3,1,0,336,158,41364,32473,351,1,43232,31154
71,8,1,2,1,0,0,3,222,176,41365,32475,271,375,43232,31157
72,9,1,0,0,3,1,0,228,170,41366,32475,278,47,43235,31157
73,9,1,1,2,1,2,1,133,155,41367,32476,150,57,43236,31158
74,9,2,2,2,1,2,1,36,37,41369,32478,33,305,43237,31159
75,9,4,3,0,3,1,0,426,88,41373,32481,448,79,43240,31159
76,9,1,3,1,0,0,3,173,163,41374,32484,197,52,43240,31162
77,9,0,0,2,1,2,1,209,185,41374,32484,241,93,43241,31163
78,9,2,1,0,3,1,0,134,157,41376,32485,157,236,43244,31163
79,9,2,1,0,3,1,0,451,116,41378,32486,429,148,43247,31163
80,9,2,1,0,3,1,0,8,7,41380,32487,7,154,43250,31163
81,10,0,0,2,1,2,1,99,99,41380,32487,96,32,43251,31164
82,10,1,0,0,3,1,0,223,176,41381,32487,274,122,43254,31164
83,10,0,0,2,1,2,1,99,131,41381,32487,101,123,43255,31165
84,10,1,0,0,3,1,0,315,120,41382,32487,381,1,43258,31165
85,10,1,1,2,1,2,1,183,193,41383,32488,218,94,43259,31166
86,10,0,2,1,0,0,3,92,110,41383,32490,108,378,43259,31169
87,10,2,0,0,3,1,0,428,88,41385,32490,451,118,43262,31169
88,10,0,4,1,0,0,3,45,54,41385,32494,46,206,43262,31172
89,10,3,0,0,3,1,0,339,158,41388,32494,354,203,43265,31172
90,11,0,1,1,0,0,3,36,38,41388,32495,33,60,43265,31175
91,11,2,0,0,3,1,0,175,163,41390,32495,200,79,43268,31175
92,11,1,1,2,1,2,1,9,8,41391,32496,8,149,43269,31176
93,11,1,2,1,0,0,3,135,159,41392,32498,157,308,43269,31179
94,11,1,3,1,0,0,3,210,188,41393,32501,241,157,43269,31182
95,11,1,4,1,0,0,3,111,109,41394,32505,153,239,43269,31185
96,11,2,1,0,3,1,0,453,117,41396,32506,432,47,43272,31185
97,11,1,0,0,3,1,0,134,155,41397,32506,153,52,43275,31185
98,11,2,3,1,0,0,3,230,173,41399,32509,278,358,43275,31188
99,12,2,0,0,3,1,0,317,120,41401,32509,384,239,43278,31188
100,12,1,0,0,3,1,0,100,131,41402,32509,104,32,43281,31188
101,12,0,0,2,1,2,1,223,176,41402,32509,275,95,43282,31189
102,12,2,0,0,3,1,0,185,193,41404,32509,221,203,43285,31189
103,12,3,0,0,3,1,0,431,88,41407,32509,454,123,43288,31189
104,12,1,1,2,1,2,1,46,55,41408,32510,47,379,43289,31190
105,12,0,0,2,1,2,1,92,110,41408,32510,109,123,43290,31191
106,12,2,0,0,3,1,0,101,99,41410,32510,99,1,43293,31191
107,12,3,1,0,3,1,0,233,174,41413,32511,281,118,43296,31191
108,13,2,1,0,3,1,0,341,159,41415,32512,357,157,43299,31191
109,13,0,2,1,0,0,3,175,165,41415,32514,200,311,43299,31194
110,13,2,0,0,3,1,0,455,117,41417,32514,435,79,43302,31194
111,13,3,0,0,3,1,0,213,188,41420,32514,244,47,43305,31194
112,13,1,4,1,0,0,3,37,42,41421,32518,33,361,43305,31197
113,13,2,2,2,1,2,1,136,157,41423,32520,154,207,43306,31198
114,13,1,1,2,1,2,1,112,110,41424,32521,154,53,43307,31199
115,13,3,1,0,3,1,0,12,9,41427,32522,11,60,43310,31199
116,13,0,2,1,0,0,3,135,161,41427,32524,157,152,43310,31202
117,14,1,1,2,1,2,1,318,121,41428,32525,385,204,43311,31203
118,14,1,1,2,1,2,1,432,89,41429,32526,455,380,43312,31204
119,14,2,0,0,3,1,0,187,193,41431,32526,224,239,43315,31204
120,14,3,1,0,3,1,0,103,132,41434,32527,107,95,43318,31204
121,14,0,1,1,0,0,3,175,166,41434,32528,200,126,43318,31207
122,14,1,2,1,0,0,3,47,57,41435,32530,47,35,43318,31210
123,14,0,1,1,0,0,3,92,111,41435,32531,109,160,43318,31213
124,14,1,0,0,3,1,0,102,99,41436,32531,102,123,43321,31213
125,14,2,2,2,1,2,1,235,176,41438,32533,282,2,43322,31214
126,15,0,3,1,0,0,3,223,179,41438,32536,275,155,43322,31217
127,15,2,2,2,1,2,1,138,159,41440,32538,155,48,43323,31218
128,15,0,1,1,0,0,3,37,43,41440,32539,33,210,43323,31221
129,15,2,0,0,3,1,0,137,161,41442,32539,160,79,43326,31221
130,15,1,2,1,0,0,3,214,190,41443,32541,244,56,43326,31224
131,15,1,1,2,1,2,1,456,118,41444,32542,436,119,43327,31225
132,15,0,1,1,0,0,3,12,10,41444,32543,11,364,43327,31228
133,15,1,0,0,3,1,0,342,159,41445,32543,360,60,43330,31228
134,15,0,2,1,0,0,3,112,112,41445,32545,154,314,43330,31231
135,16,2,1,0,3,1,0,177,167,41447,32546,203,35,43333,31231
136,16,2,0,0,3,1,0,105,132,41449,32546,110,2,43336,31231
137,16,1,2,1,0,0,3,103,101,41450,32548,102,98,43336,31234
138,16,1,0,0,3,1,0,236,176,41451,32548,285,160,43339,31234
139,16,2,0,0,3,1,0,49,57,41453,32548,50,123,43342,31234
140,16,2,0,0,3,1,0,434,89,41455,32548,458,204,43345,31234
141,16,0,4,1,0,0,3,138,163,41455,32552,155,242,43345,31237
142,16,1,0,0,3,1,0,319,121,41456,32552,388,380,43348,31237
143,16,1,2,1,0,0,3,93,113,41457,32554,109,158,43348,31240
144,17,1,1,2,1,2,1,13,11,41458,32555,12,57,43349,31241
145,17,0,0,2,1,2,1,137,161,41458,32555,161,365,43350,31242
146,17,2,1,0,3,1,0,344,160,41460,32556,363,48,43353,31242
147,17,0,2,1,0,0,3,37,45,41460,32558,33,129,43353,31245
148,17,0,0,2,1,2,1,214,190,41460,32558,245,120,43354,31246
149,17,0,0,2,1,2,1,456,118,41460,32558,437,211,43355,31247
150,17,0,2,1,0,0,3,223,181,41460,32560,275,317,43355,31250
151,17,2,1,0,3,1,0,189,194,41462,32561,227,79,43358,31250
152,17,1,2,1,0,0,3,113,114,41463,32563,154,63,43358,31253
153,18,2,2,2,1,2,1,346,162,41465,32565,364,366,43359,31254
154,18,1,2,1,0,0,3,14,13,41466,32567,12,132,43359,31257
155,18,2,0,0,3,1,0,458,118,41468,32567,440,35,43362,31257
156,18,1,2,1,0,0,3,224,183,41469,32569,275,60,43362,31260
157,18,1,1,2,1,2,1,138,162,41470,32570,162,212,43363,31261
158,18,0,0,2,1,2,1,189,194,41470,32570,228,49,43364,31262
159,18,2,1,0,3,1,0,216,191,41472,32571,248,79,43367,31262
160,18,0,1,1,0,0,3,113,115,41472,32572,154,123,43367,31265
161,18,1,2,1,0,0,3,94,115,41473,32574,109,320,43367,31268
162,19,0,0,2,1,2,1,37,45,41473,32574,34,124,43368,31269
163,19,2,3,1,0,0,3,179,170,41475,32577,203,5,43368,31272
164,19,1,3,1,0,0,3,237,179,41476,32580,285,207,43368,31275
165,19,2,2,2,1,2,1,436,91,41478,32582,459,99,43369,31276
166,19,4,1,0,3,1,0,107,102,41482,32583,105,63,43372,31276
167,19,0,1,1,0,0,3,49,58,41482,32584,50,245,43372,31279
168,19,1,1,2,1,2,1,139,164,41483,32585,156,381,43373,31280
169,19,2,0,0,3,1,0,321,121,41485,32585,391,158,43376,31280
170,19,2,1,0,3,1,0,107,133,41487,32586,113,160,43379,31280
171,20,1,0,0,3,1,0,114,115,41488,32586,157,132,43382,31280
172,20,2,1,0,3,1,0,140,163,41490,32587,165,123,43385,31280
173,20,1,0,0,3,1,0,95,115,41491,32587,112,60,43388,31280
174,20,2,0,0,3,1,0,323,121,41493,32587,394,49,43391,31280
175,20,2,1,0,3,1,0,191,195,41495,32588,231,212,43394,31280
176,20,0,1,1,0,0,3,216,192,41495,32589,248,38,43394,31283
177,20,4,2,0,3,1,0,350,164,41499,32591,367,79,43397,31283
178,20,0,0,2,1,2,1,14,13,41499,32591,13,382,43398,31284
179,20,1,2,1,0,0,3,225,185,41500,32593,275,369,43398,31287
180,21,2,1,0,3,1,0,239,180,41502,32594,288,99,43401,31287
181,21,0,0,2,1,2,1,37,45,41502,32594,35,6,43402,31288
182,21,3,0,0,3,1,0,52,58,41505,32594,53,158,43405,31288
183,21,0,0,2,1,2,1,436,91,41505,32594,460,321,43406,31289
184,21,0,0,2,1,2,1,107,102,41505,32594,106,161,43407,31290
185,21,1,0,0,3,1,0,108,133,41506,32594,116,63,43410,31290
186,21,1,2,1,0,0,3,180,172,41507,32596,203,248,43410,31293
187,21,2,0,0,3,1,0,460,118,41509,32596,443,207,43413,31293
188,21,2,2,2,1,2,1,141,166,41511,32598,157,125,43414,31294
189,22,2,1,0,3,1,0,193,196,41513,32599,234,123,43417,31294
190,22,2,1,0,3,1,0,325,122,41515,32600,397,60,43420,31294
191,22,3,0,0,3,1,0,110,102,41518,32600,109,79,43423,31294
192,22,0,2,1,0,0,3,95,117,41518,32602,112,372,43423,31297
193,22,3,0,0,3,1,0,117,115,41521,32602,160,38,43426,31297
194,22,0,2,1,0,0,3,225,187,41521,32604,275,135,43426,31300
195,22,2,0,0,3,1,0,218,192,41523,32604,251,6,43429,31300
196,22,0,3,1,0,0,3,140,166,41523,32607,165,385,43429,31303
197,22,3,0,0,3,1,0,353,164,41526,32607,370,212,43432,31303
198,23,1,2,1,0,0,3,181,174,41527,32609,203,164,43432,31306
199,23,0,1,1,0,0,3,14,14,41527,32610,13,128,43432,31309
200,23,2,0,0,3,1,0,462,118,41529,32610,446,99,43435,31309
201,23,2,0,0,3,1,0,54,58,41531,32610,56,49,43438,31309
202,23,0,1,1,0,0,3,108,134,41531,32611,116,324,43438,31312
203,23,1,1,2,1,2,1,142,167,41532,32612,158,208,43439,31313
204,23,2,4,1,0,0,3,241,184,41534,32616,288,66,43439,31316
205,23,2,0,0,3,1,0,438,91,41536,32616,463,158,43442,31316
206,23,2,2,2,1,2,1,39,47,41538,32618,36,249,43443,31317
207,24,2,0,0,3,1,0,97,117,41540,32618,115,123,43446,31317
208,24,3,0,0,3,1,0,196,196,41543,32618,237,135,43449,31317
209,24,1,1,2,1,2,1,55,59,41544,32619,57,80,43450,31318
210,24,1,2,1,0,0,3,111,104,41545,32621,109,375,43450,31321
211,24,1,0,0,3,1,0,326,122,41546,32621,400,212,43453,31321
212,24,0,0,2,1,2,1,218,192,41546,32621,252,129,43454,31322
213,24,0,1,1,0,0,3,117,116,41546,32622,160,9,43454,31325
214,24,0,4,1,0,0,3,225,191,41546,32626,275,41,43454,31328
215,24,0,2,1,0,0,3,353,166,41546,32628,370,388,43454,31331
216,25,1,5,1,0,0,3,182,179,41547,32633,203,52,43454,31334
217,25,0,2,1,0,0,3,218,194,41547,32635,252,69,43454,31337
218,25,2,1,0,3,1,0,440,92,41549,32636,466,60,43457,31337
219,25,0,2,1,0,0,3,140,168,41549,32638,165,102,43457,31340
220,25,1,2,1,0,0,3,242,186,41550,32640,288,83,43457,31343
221,25,2,0,0,3,1,0,41,47,41552,32640,39,158,43460,31343
222,25,1,2,1,0,0,3,15,16,41553,32642,13,252,43460,31346
223,25,1,0,0,3,1,0,463,118,41554,32642,449,164,43463,31346
224,25,1,1,2,1,2,1,143,168,41555,32643,159,325,43464,31347
225,26,3,0,0,3,1,0,114,104,41558,32643,112,212,43467,31347
226,26,1,0,0,3,1,0,226,191,41559,32643,278,9,43470,31347
227,26,3,3,2,1,2,1,120,119,41562,32646,161,209,43471,31348
228,26,0,2,1,0,0,3,108,136,41562,32648,116,378,43471,31351
229,26,0,5,1,0,0,3,196,201,41562,32653,237,391,43471,31354
230,26,1,2,1,0,0,3,98,119,41563,32655,115,138,43471,31357
231,26,5,1,0,3,1,0,60,60,41568,32656,60,123,43474,31357
232,26,1,1,2,1,2,1,354,167,41569,32657,371,130,43475,31358
233,26,1,1,2,1,2,1,327,123,41570,32658,401,42,43476,31359
0,1,0,1,1,0,0,3,0,1,41570,32659,0,3,43476,31362
1,1,1,3,1,0,0,3,1,3,41571,32662,0,3,43476,31365
2,1,1,4,1,0,0,3,1,4,41572,32666,0,3,43476,31368
3,1,0,0,2,1,2,1,0,0,41572,32666,1,1,43477,31369
4,1,3,1,0,3,1,0,3,1,41575,32667,3,0,43480,31369
5,1,1,0,0,3,1,0,1,0,41576,32667,3,0,43483,31369
6,1,0,0,2,1,2,1,0,0,41576,32667,1,1,43484,31370
7,1,0,3,1,0,0,3,0,3,41576,32670,0,3,43484,31373
8,1,0,0,2,1,2,1,0,0,41576,32670,1,1,43485,31374
9,1,4,0,0,3,1,0,4,0,41580,32670,3,0,43488,31374
10,2,0,2,1,0,0,3,0,2,41580,32672,0,3,43488,31377
11,2,1,0,0,3,1,0,1,0,41581,32672,3,0,43491,31377
12,2,1,0,0,3,1,0,1,0,41582,32672,3,0,43494,31377
13,2,1,2,1,0,0,3,1,2,41583,32674,0,3,43494,31380
14,2,2,0,0,3,1,0,2,0,41585,32674,3,0,43497,31380
15,2,3,5,1,0,0,3,3,5,41588,32679,0,3,43497,31383
16,2,4,1,0,3,1,0,4,1,41592,32680,3,0,43500,31383
17,2,4,0,0,3,1,0,4,0,41596,32680,3,0,43503,31383
18,2,0,0,2,1,2,1,0,0,41596,32680,1,1,43504,31384
19,2,2,2,2,1,2,1,2,2,41598,32682,1,1,43505,31385
20,3,1,0,0,3,1,0,4,1,41599,32682,6,1,43508,31385
21,3,2,0,0,3,1,0,2,0,41601,32682,4,0,43511,31385
22,3,2,2,2,1,2,1,4,2,41603,32684,4,4,43512,31386
23,3,1,2,1,0,0,3,2,2,41604,32686,3,4,43512,31389
24,3,1,2,1,0,0,3,1,3,41605,32688,0,6,43512,31392
25,3,2,0,0,3,1,0,2,3,41607,32688,3,1,43515,31392
26,3,1,2,1,0,0,3,2,6,41608,32690,0,3,43515,31395
27,3,1,2,1,0,0,3,5,2,41609,32692,3,6,43515,31398
28,3,1,2,1,0,0,3,2,5,41610,32694,0,6,43515,31401
29,3,2,2,2,1,2,1,2,2,41612,32696,2,1,43516,31402
30,4,3,1,0,3,1,0,3,1,41615,32697,4,1,43519,31402
31,4,3,0,0,3,1,0,4,2,41618,32697,3,0,43522,31402
32,4,3,0,0,3,1,0,4,0,41621,32697,6,0,43525,31402
33,4,1,0,0,3,1,0,1,2,41622,32697,3,0,43528,31402
34,4,0,0,2,1,2,1,3,5,41622,32697,1,4,43529,31403
35,4,0,1,1,0,0,3,2,3,41622,32698,1,3,43529,31406
36,4,1,1,2,1,2,1,2,1,41623,32699,4,4,43530,31407
37,4,0,2,1,0,0,3,4,3,41623,32701,3,6,43530,31410
38,4,1,0,0,3,1,0,5,0,41624,32701,6,1,43533,31410
39,4,1,1,2,1,2,1,1,1,41625,32702,2,1,43534,31411
40,5,0,2,1,0,0,3,4,4,41625,32704,4,9,43534,31414
41,5,0,0,2,1,2,1,2,6,41625,32704,1,5,43535,31415
42,5,1,3,1,0,0,3,5,5,41626,32707,3,9,43535,31418
43,5,0,1,1,0,0,3,2,4,41626,32708,3,4,43535,31421
44,5,0,2,1,0,0,3,2,4,41626,32710,2,4,43535,31424
45,5,1,0,0,3,1,0,5,1,41627,32710,9,0,43538,31424
46,5,2,0,0,3,1,0,4,0,41629,32710,7,1,43541,31424
47,5,2,0,0,3,1,0,3,3,41631,32710,3,6,43544,31424
48,5,1,0,0,3,1,0,6,2,41632,32710,6,1,43547,31424
49,5,2,3,1,0,0,3,4,8,41634,32713,0,6,43547,31427
50,6,2,2,2,1,2,1,5,7,41636,32715,2,1,43548,31428
51,6,1,0,0,3,1,0,3,2,41637,32715,6,0,43551,31428
52,6,2,1,0,3,1,0,4,2,41639,32716,7,4,43554,31428
53,6,3,1,0,3,1,0,4,2,41642,32717,5,4,43557,31428
54,6,3,0,0,3,1,0,7,3,41645,32717,6,4,43560,31428
55,6,2,0,0,3,1,0,7,0,41647,32717,9,1,43563,31428
56,6,1,1,2,1,2,1,3,4,41648,32718,2,7,43564,31429
57,6,1,1,2,1,2,1,4,2,41649,32719,5,4,43565,31430
58,6,1,1,2,1,2,1,2,3,41650,32720,4,1,43566,31431
59,6,6,1,0,3,1,0,10,1,41656,32721,9,1,43569,31431
60,7,2,0,0,3,1,0,8,2,41658,32721,9,4,43572,31431
61,7,2,1,0,3,1,0,4,4,41660,32722,7,9,43575,31431
62,7,1,4,1,0,0,3,5,12,41661,32726,0,8,43575,31434
63,7,1,0,0,3,1,0,3,4,41662,32726,6,4,43578,31434
64,7,0,0,2,1,2,1,2,4,41662,32726,3,1,43579,31435
65,7,2,1,0,3,1,0,4,7,41664,32727,4,1,43582,31435
66,7,0,1,1,0,0,3,4,1,41664,32728,7,3,43582,31438
67,7,2,1,0,3,1,0,7,6,41666,32729,6,1,43585,31438
68,7,2,0,0,3,1,0,6,4,41668,32729,7,6,43588,31438
69,7,2,2,2,1,2,1,5,5,41670,32731,4,7,43589,31439
70,8,0,2,1,0,0,3,5,9,41670,32733,2,12,43589,31442
71,8,6,1,0,3,1,0,16,2,41676,32734,12,1,43592,31442
72,8,1,2,1,0,0,3,5,4,41677,32736,7,4,43592,31445
73,8,3,0,0,3,1,0,10,3,41680,32736,9,1,43595,31445
74,8,1,1,2,1,2,1,4,5,41681,32737,3,5,43596,31446
75,8,3,0,0,3,1,0,7,2,41684,32737,8,7,43599,31446
76,8,2,1,0,3,1,0,7,2,41686,32738,12,4,43602,31446
77,8,4,3,0,3,1,0,8,5,41690,32741,8,4,43605,31446
78,8,2,0,0,3,1,0,9,0,41692,32741,12,4,43608,31446
79,8,3,0,0,3,1,0,6,2,41695,32741,9,1,43611,31446
80,9,1,1,2,1,2,1,6,5,41696,32742,8,2,43612,31447
81,9,1,3,1,0,0,3,6,8,41697,32745,4,11,43612,31450
82,9,5,0,0,3,1,0,9,4,41702,32745,10,6,43615,31450
83,9,1,1,2,1,2,1,7,5,41703,32746,8,8,43616,31451
84,9,4,1,0,3,1,0,7,5,41707,32747,9,1,43619,31451
85,9,1,2,1,0,0,3,6,14,41708,32749,0,4,43619,31454
86,9,3,0,0,3,1,0,5,4,41711,32749,6,3,43622,31454
87,9,1,1,2,1,2,1,9,3,41712,32750,10,5,43623,31455
88,9,3,0,0,3,1,0,10,6,41715,32750,9,4,43626,31455
89,9,2,1,0,3,1,0,6,2,41717,32751,10,4,43629,31455
90,10,1,0,0,3,1,0,7,2,41718,32751,12,1,43632,31455
91,10,1,0,0,3,1,0,8,2,41719,32751,15,7,43635,31455
92,10,3,2,0,3,1,0,8,11,41722,32753,5,4,43638,31455
93,10,4,1,0,3,1,0,13,1,41726,32754,15,4,43641,31455
94,10,1,1,2,1,2,1,5,6,41727,32755,4,2,43642,31456
95,10,3,0,0,3,1,0,10,2,41730,32755,11,5,43645,31456
96,10,1,2,1,0,0,3,5,9,41731,32757,4,4,43645,31459
97,10,1,3,1,0,0,3,11,6,41732,32760,9,15,43645,31462
98,10,2,0,0,3,1,0,18,2,41734,32760,15,4,43648,31462
99,10,2,0,0,3,1,0,10,5,41736,32760,11,9,43651,31462
100,11,1,0,0,3,1,0,11,6,41737,32760,12,5,43654,31462
101,11,3,0,0,3,1,0,12,3,41740,32760,13,1,43657,31462
102,11,3,1,0,3,1,0,12,5,41743,32761,13,8,43660,31462
103,11,2,1,0,3,1,0,8,9,41745,32762,7,4,43663,31462
104,11,0,0,2,1,2,1,7,5,41745,32762,10,4,43664,31463
105,11,1,0,0,3,1,0,7,14,41746,32762,3,4,43667,31463
106,11,0,0,2,1,2,1,6,2,41746,32762,11,5,43668,31464
107,11,1,2,1,0,0,3,9,13,41747,32764,5,9,43668,31467
108,11,0,1,1,0,0,3,7,6,41747,32765,8,14,43668,31470
109,11,2,0,0,3,1,0,8,5,41749,32765,11,4,43671,31470
110,12,1,1,2,1,2,1,14,2,41750,32766,16,10,43672,31471
111,12,0,8,1,0,0,3,5,14,41750,32774,4,18,43672,31474
112,12,5,1,0,3,1,0,23,3,41755,32775,18,4,43675,31474
113,12,1,0,0,3,1,0,11,2,41756,32775,14,2,43678,31474
114,12,3,0,0,3,1,0,11,2,41759,32775,18,5,43681,31474
115,12,3,1,0,3,1,0,8,10,41762,32776,7,1,43684,31474
116,12,3,0,0,3,1,0,8,4,41765,32776,9,7,43687,31474
117,12,1,2,1,0,0,3,11,7,41766,32778,11,7,43687,31477
118,12,2,4,1,0,0,3,9,6,41768,32782,12,7,43687,31480
119,12,1,1,2,1,2,1,12,7,41769,32783,10,3,43688,31481
120,13,0,3,1,0,0,3,9,16,41769,32786,5,11,43688,31484
121,13,1,3,1,0,0,3,12,10,41770,32789,11,7,43688,31487
122,13,2,3,1,0,0,3,14,6,41772,32792,13,7,43688,31490
123,13,1,3,1,0,0,3,8,9,41773,32795,8,7,43688,31493
124,13,3,1,0,3,1,0,11,10,41776,32796,10,4,43691,31493
125,13,1,0,0,3,1,0,8,5,41777,32796,13,5,43694,31493
126,13,2,0,0,3,1,0,8,2,41779,32796,14,7,43697,31493
127,13,1,0,0,3,1,0,12,6,41780,32796,15,1,43700,31493
128,13,2,1,0,3,1,0,10,6,41782,32797,14,5,43703,31493
129,13,5,0,0,3,1,0,17,5,41787,32797,16,14,43706,31493
130,14,2,0,0,3,1,0,10,10,41789,32797,10,7,43709,31493
131,14,0,3,1,0,0,3,11,5,41789,32800,14,21,43709,31496
132,14,2,0,0,3,1,0,25,3,41791,32800,21,10,43712,31496
133,14,3,0,0,3,1,0,15,7,41794,32800,13,7,43715,31496
134,14,1,1,2,1,2,1,6,15,41795,32801,5,4,43716,31497
135,14,1,0,0,3,1,0,12,2,41796,32801,21,2,43719,31497
136,14,4,1,0,3,1,0,11,15,41800,32802,6,1,43722,31497
137,14,1,0,0,3,1,0,15,2,41801,32802,19,9,43725,31497
138,14,2,0,0,3,1,0,11,6,41803,32802,15,4,43728,31497
139,14,1,0,0,3,1,0,9,4,41804,32802,12,5,43731,31497
140,15,1,0,0,3,1,0,16,7,41805,32802,16,11,43734,31497
141,15,1,3,1,0,0,3,13,13,41806,32805,11,8,43734,31500
142,15,2,0,0,3,1,0,16,6,41808,32805,16,5,43737,31500
143,15,2,1,0,3,1,0,14,7,41810,32806,18,7,43740,31500
144,15,1,1,2,1,2,1,9,10,41811,32807,9,5,43741,31501
145,15,4,1,0,3,1,0,15,11,41815,32808,13,7,43744,31501
146,15,0,1,1,0,0,3,8,3,41815,32809,14,4,43744,31504
147,15,1,3,1,0,0,3,10,19,41816,32812,5,17,43744,31507
148,15,5,0,0,3,1,0,22,5,41821,32812,19,7,43747,31507
149,15,3,3,2,1,2,1,13,9,41824,32815,15,2,43748,31508
150,16,1,2,1,0,0,3,11,12,41825,32817,10,7,43748,31511
151,16,3,1,0,3,1,0,18,3,41828,32818,22,7,43751,31511
152,16,1,1,2,1,2,1,10,5,41829,32819,13,3,43752,31512
153,16,1,5,1,0,0,3,13,7,41830,32824,21,24,43752,31515
154,16,1,2,1,0,0,3,12,8,41831,32826,15,13,43752,31518
155,16,2,3,1,0,0,3,8,18,41833,32829,5,10,43752,31521
156,16,0,0,2,1,2,1,11,5,41833,32829,15,5,43753,31522
157,16,0,3,1,0,0,3,11,18,41833,32832,6,10,43753,31525
158,16,1,0,0,3,1,0,26,3,41834,32832,24,9,43756,31525
159,16,0,0,2,1,2,1,8,5,41834,32832,14,6,43757,31526
160,17,1,2,1,0,0,3,15,9,41835,32834,18,8,43757,31529
161,17,2,1,0,3,1,0,24,6,41837,32835,22,5,43760,31529
162,17,1,2,1,0,0,3,10,12,41838,32837,9,10,43760,31532
163,17,1,0,0,3,1,0,14,13,41839,32837,14,2,43763,31532
164,17,2,1,0,3,1,0,15,10,41841,32838,18,7,43766,31532
165,17,2,0,0,3,1,0,20,3,41843,32838,25,8,43769,31532
166,17,2,1,0,3,1,0,12,20,41845,32839,8,7,43772,31532
167,17,0,0,2,1,2,1,16,6,41845,32839,17,5,43773,31533
168,17,3,0,0,3,1,0,11,3,41848,32839,17,6,43776,31533
169,17,2,3,1,0,0,3,18,10,41850,32842,16,20,43776,31536
170,18,1,1,2,1,2,1,12,19,41851,32843,7,8,43777,31537
171,18,2,3,1,0,0,3,14,11,41853,32846,15,12,43777,31540
172,18,0,4,1,0,0,3,10,9,41853,32850,13,27,43777,31543
173,18,4,1,0,3,1,0,15,4,41857,32851,20,8,43780,31543
174,18,0,0,2,1,2,1,11,5,41857,32851,16,11,43781,31544
175,18,4,0,0,3,1,0,17,7,41861,32851,24,5,43784,31544
176,18,1,1,2,1,2,1,9,6,41862,32852,15,4,43785,31545
177,18,4,2,0,3,1,0,30,5,41866,32854,27,11,43788,31545
178,18,0,1,1,0,0,3,11,13,41866,32855,10,16,43788,31548
179,18,4,1,0,3,1,0,19,12,41870,32856,16,10,43791,31548
180,19,2,0,0,3,1,0,12,12,41872,32856,12,6,43794,31548
181,19,4,2,0,3,1,0,24,5,41876,32858,28,2,43797,31548
182,19,0,4,1,0,0,3,18,14,41876,32862,16,10,43797,31551
183,19,1,0,0,3,1,0,13,20,41877,32862,11,5,43800,31551
184,19,2,1,0,3,1,0,17,10,41879,32863,21,5,43803,31551
185,19,1,2,1,0,0,3,15,15,41880,32865,14,10,43803,31554
186,19,2,0,0,3,1,0,17,10,41882,32865,21,8,43806,31554
187,19,1,1,2,1,2,1,9,19,41883,32866,6,21,43807,31555
188,19,4,1,0,3,1,0,28,7,41887,32867,25,10,43810,31555
189,19,3,0,0,3,1,0,19,6,41890,32867,20,7,43813,31555
190,20,4,1,0,3,1,0,19,16,41894,32868,17,5,43816,31555
191,20,3,0,0,3,1,0,31,7,41897,32868,28,5,43819,31555
192,20,4,3,0,3,1,0,21,13,41901,32871,24,10,43822,31555
193,20,1,0,0,3,1,0,13,12,41902,32871,15,10,43825,31555
194,20,1,0,0,3,1,0,14,20,41903,32871,14,8,43828,31555
195,20,1,3,1,0,0,3,19,17,41904,32874,16,13,43828,31558
196,20,3,2,0,3,1,0,12,21,41907,32876,9,2,43831,31558
197,20,1,0,0,3,1,0,31,5,41908,32876,30,7,43834,31558
198,20,2,1,0,3,1,0,26,6,41910,32877,31,10,43837,31558
199,20,3,0,0,3,1,0,20,10,41913,32877,24,6,43840,31558
200,21,0,4,1,0,0,3,15,8,41913,32881,20,7,43840,31561
201,21,1,2,1,0,0,3,13,21,41914,32883,7,8,43840,31564
202,21,2,0,0,3,1,0,13,13,41916,32883,13,11,43843,31564
203,21,2,0,0,3,1,0,16,11,41918,32883,18,8,43846,31564
204,21,0,3,1,0,0,3,19,15,41918,32886,16,30,43846,31567
205,21,3,3,2,1,2,1,13,12,41921,32889,14,13,43847,31568
206,21,0,2,1,0,0,3,19,8,41921,32891,20,11,43847,31571
207,21,1,0,0,3,1,0,12,5,41922,32891,19,21,43850,31571
208,21,0,1,1,0,0,3,17,8,41922,32892,24,14,43850,31574
209,21,1,1,2,1,2,1,10,7,41923,32893,16,17,43851,31575
210,22,3,0,0,3,1,0,23,10,41926,32893,27,7,43854,31575
211,22,1,1,2,1,2,1,15,21,41927,32894,15,6,43855,31576
212,22,4,1,0,3,1,0,23,18,41931,32895,19,8,43858,31576
213,22,3,2,0,3,1,0,15,23,41934,32897,12,13,43861,31576
214,22,1,1,2,1,2,1,13,6,41935,32898,20,8,43862,31577
215,22,0,1,1,0,0,3,26,7,41935,32899,31,8,43862,31580
216,22,3,0,0,3,1,0,34,7,41938,32899,31,10,43865,31580
217,22,0,0,2,1,2,1,19,16,41938,32899,18,11,43866,31581
218,22,4,1,0,3,1,0,35,6,41942,32900,33,10,43869,31581
219,22,2,0,0,3,1,0,23,13,41944,32900,27,6,43872,31581
220,23,1,2,1,0,0,3,20,10,41945,32902,20,20,43872,31584
221,23,1,1,2,1,2,1,14,13,41946,32903,16,31,43873,31585
222,23,3,2,0,3,1,0,13,9,41949,32905,19,13,43876,31585
223,23,1,0,0,3,1,0,17,11,41950,32905,21,2,43879,31585
224,23,2,1,0,3,1,0,21,16,41952,32906,19,8,43882,31585
225,23,2,2,2,1,2,1,15,23,41954,32908,8,12,43883,31586
226,23,1,0,0,3,1,0,14,13,41955,32908,16,8,43886,31586
227,23,1,0,0,3,1,0,14,12,41956,32908,17,14,43889,31586
228,23,0,1,1,0,0,3,17,9,41956,32909,24,24,43889,31589
229,23,1,0,0,3,1,0,16,8,41957,32909,23,11,43892,31589
230,24,0,0,2,1,2,1,23,13,41957,32909,28,8,43893,31590
231,24,2,0,0,3,1,0,37,6,41959,32909,36,8,43896,31590
232,24,0,1,1,0,0,3,15,22,41959,32910,15,13,43896,31593
233,24,0,1,1,0,0,3,23,19,41959,32911,19,9,43896,31596
234,24,1,1,2,1,2,1,27,8,41960,32912,32,12,43897,31597
235,24,1,1,2,1,2,1,16,24,41961,32913,13,9,43898,31598
236,24,4,0,0,3,1,0,17,6,41965,32913,23,13,43901,31598
237,24,1,0,0,3,1,0,20,16,41966,32913,21,6,43904,31598
238,24,2,1,0,3,1,0,36,8,41968,32914,34,11,43907,31598
239,24,1,0,0,3,1,0,18,11,41969,32914,24,8,43910,31598
240,25,0,0,2,1,2,1,14,13,41969,32914,17,9,43911,31599
241,25,4,1,0,3,1,0,21,10,41973,32915,27,10,43914,31599
242,25,2,2,2,1,2,1,22,12,41975,32917,21,14,43915,31600
243,25,0,3,1,0,0,3,16,11,41975,32920,23,34,43915,31603
244,25,0,0,2,1,2,1,14,12,41975,32920,18,25,43916,31604
245,25,0,0,2,1,2,1,21,16,41975,32920,20,13,43917,31605
246,25,2,1,0,3,1,0,16,14,41977,32921,19,2,43920,31605
247,25,2,2,2,1,2,1,15,11,41979,32923,20,15,43921,31606
248,25,1,2,1,0,0,3,24,12,41980,32925,27,23,43921,31609
249,25,3,1,0,3,1,0,18,24,41983,32926,11,8,43924,31609
250,26,1,2,1,0,0,3,22,12,41984,32928,27,11,43924,31612
251,26,3,0,0,3,1,0,23,16,41987,32928,24,8,43927,31612
252,26,2,1,0,3,1,0,17,23,41989,32929,18,11,43930,31612
253,26,1,1,2,1,2,1,24,20,41990,32930,20,14,43931,31613
254,26,1,0,0,3,1,0,28,8,41991,32930,35,6,43934,31613
255,26,0,0,2,1,2,1,17,6,41991,32930,24,10,43935,31614
256,26,1,1,2,1,2,1,19,12,41992,32931,25,9,43936,31615
257,26,0,1,1,0,0,3,23,14,41992,32932,28,37,43936,31618
258,26,1,1,2,1,2,1,17,25,41993,32933,14,10,43937,31619
259,26,7,0,0,3,1,0,44,6,42000,32933,39,12,43940,31619
260,27,1,2,1,0,0,3,17,13,42001,32935,23,26,43940,31622
261,27,1,0,0,3,1,0,37,8,42002,32935,37,9,43943,31622
262,27,3,1,0,3,1,0,25,13,42005,32936,24,15,43946,31622
263,27,2,0,0,3,1,0,16,13,42007,32936,20,13,43949,31622
264,27,1,2,1,0,0,3,22,18,42008,32938,20,11,43949,31625
265,27,0,1,1,0,0,3,18,25,42008,32939,11,5,43949,31628
266,27,1,0,0,3,1,0,17,14,42009,32939,22,13,43952,31628
267,27,2,0,0,3,1,0,26,12,42011,32939,30,14,43955,31628
268,27,1,3,1,0,0,3,16,14,42012,32942,20,28,43955,31631
269,27,2,1,0,3,1,0,16,13,42014,32943,21,10,43958,31631
270,28,2,2,2,1,2,1,19,27,42016,32945,15,15,43959,31632
271,28,2,0,0,3,1,0,46,6,42018,32945,42,6,43962,31632
272,28,4,0,0,3,1,0,21,23,42022,32945,21,26,43965,31632
273,28,3,1,0,3,1,0,20,7,42025,32946,27,10,43968,31632
274,28,0,2,1,0,0,3,19,14,42025,32948,25,15,43968,31635
275,28,2,0,0,3,1,0,24,12,42027,32948,30,10,43971,31635
276,28,1,1,2,1,2,1,18,15,42028,32949,23,12,43972,31636
277,28,1,1,2,1,2,1,29,9,42029,32950,36,9,43973,31637
278,28,1,1,2,1,2,1,24,17,42030,32951,25,38,43974,31638
279,28,2,2,2,1,2,1,26,22,42032,32953,21,12,43975,31639
280,29,1,0,0,3,1,0,18,13,42033,32953,26,9,43978,31639
281,29,2,1,0,3,1,0,39,9,42035,32954,40,13,43981,31639
282,29,1,2,1,0,0,3,26,15,42036,32956,24,31,43981,31642
283,29,1,0,0,3,1,0,17,13,42037,32956,23,11,43984,31642
284,29,0,4,1,0,0,3,22,22,42037,32960,20,8,43984,31645
285,29,2,1,0,3,1,0,18,15,42039,32961,23,10,43987,31645
286,29,2,0,0,3,1,0,20,25,42041,32961,14,13,43990,31645
287,29,0,1,1,0,0,3,16,14,42041,32962,21,12,43990,31648
288,29,0,1,1,0,0,3,26,13,42041,32963,30,18,43990,31651
289,29,0,1,1,0,0,3,23,15,42041,32964,28,17,43990,31654
290,30,0,1,1,0,0,3,46,7,42041,32965,42,12,43990,31657
291,30,2,4,1,0,0,3,28,26,42043,32969,21,29,43990,31660
292,30,0,1,1,0,0,3,29,10,42043,32970,36,41,43990,31663
293,30,1,3,1,0,0,3,20,17,42044,32973,25,9,43990,31666
294,30,1,2,1,0,0,3,25,14,42045,32975,30,13,43990,31669
295,30,3,1,0,3,1,0,21,16,42048,32976,26,15,43993,31669
296,30,2,1,0,3,1,0,18,15,42050,32977,24,12,43996,31669
297,30,3,1,0,3,1,0,27,18,42053,32978,28,9,43999,31669
298,30,2,3,1,0,0,3,22,10,42055,32981,27,18,43999,31672
299,30,1,3,1,0,0,3,20,30,42056,32984,15,15,43999,31675
300,31,0,3,1,0,0,3,26,16,42056,32987,30,34,43999,31678
301,31,3,1,0,3,1,0,42,10,42059,32988,43,11,44002,31678
302,31,2,2,2,1,2,1,20,15,42061,32990,27,18,44003,31679
303,31,1,0,0,3,1,0,18,13,42062,32990,26,8,44006,31679
304,31,0,0,2,1,2,1,22,22,42062,32990,21,14,44007,31680
305,31,1,1,2,1,2,1,19,16,42063,32991,24,13,44008,31681
306,31,0,0,2,1,2,1,20,25,42063,32991,15,11,44009,31682
307,31,3,0,0,3,1,0,29,15,42066,32991,27,10,44012,31682
308,31,5,0,0,3,1,0,28,15,42071,32991,31,18,44015,31682
309,31,2,1,0,3,1,0,23,24,42073,32992,24,13,44018,31682
310,32,1,0,0,3,1,0,29,26,42074,32992,24,18,44021,31682
311,32,3,0,0,3,1,0,23,25,42077,32992,18,12,44024,31682
312,32,0,3,1,0,0,3,20,33,42077,32995,15,32,44024,31685
313,32,1,1,2,1,2,1,47,8,42078,32996,43,42,44025,31686
314,32,2,1,0,3,1,0,22,18,42080,32997,28,12,44028,31686
315,32,2,1,0,3,1,0,23,17,42082,32998,29,9,44031,31686
316,32,2,0,0,3,1,0,20,15,42084,32998,27,13,44034,31686
317,32,1,2,1,0,0,3,23,12,42085,33000,27,18,44034,31689
318,32,2,2,2,1,2,1,27,16,42087,33002,31,19,44035,31690
319,32,1,0,0,3,1,0,30,10,42088,33002,39,9,44038,31690
320,33,3,6,1,0,0,3,31,21,42091,33008,31,37,44038,31693
321,33,2,0,0,3,1,0,44,10,42093,33008,46,8,44041,31693
322,33,2,1,0,3,1,0,28,17,42095,33009,33,10,44044,31693
323,33,2,0,0,3,1,0,22,15,42097,33009,30,13,44047,31693
324,33,1,0,0,3,1,0,19,13,42098,33009,29,14,44050,31693
325,33,1,0,0,3,1,0,23,22,42099,33009,24,11,44053,31693
326,33,1,2,1,0,0,3,20,18,42100,33011,24,18,44053,31696
327,33,4,1,0,3,1,0,33,16,42104,33012,30,13,44056,31696
328,33,3,2,0,3,1,0,30,20,42107,33014,31,18,44059,31696
329,33,1,0,0,3,1,0,24,24,42108,33014,27,11,44062,31696
330,34,2,3,1,0,0,3,49,11,42110,33017,43,12,44062,31699
331,34,2,1,0,3,1,0,24,19,42112,33018,31,42,44065,31699
332,34,0,1,1,0,0,3,20,16,42112,33019,27,22,44065,31702
333,34,0,0,2,1,2,1,23,17,42112,33019,30,13,44066,31703
334,34,3,1,0,3,1,0,26,26,42115,33020,21,9,44069,31703
335,34,2,0,0,3,1,0,22,18,42117,33020,27,12,44072,31703
336,34,0,1,1,0,0,3,20,34,42117,33021,15,21,44072,31706
337,34,2,1,0,3,1,0,32,11,42119,33022,42,13,44075,31706
338,34,1,0,0,3,1,0,24,12,42120,33022,30,32,44078,31706
339,34,2,1,0,3,1,0,29,17,42122,33023,34,18,44081,31706
340,35,2,0,0,3,1,0,31,26,42124,33023,27,11,44084,31706
341,35,3,0,0,3,1,0,34,21,42127,33023,34,10,44087,31706
342,35,3,2,0,3,1,0,31,19,42130,33025,36,13,44090,31706
343,35,2,2,2,1,2,1,21,15,42132,33027,30,12,44091,31707
344,35,2,3,1,0,0,3,25,25,42134,33030,24,16,44091,31710
345,35,0,3,1,0,0,3,33,19,42134,33033,30,21,44091,31713
346,35,2,6,1,0,0,3,32,26,42136,33039,31,40,44091,31716
347,35,0,0,2,1,2,1,22,15,42136,33039,31,19,44092,31717
348,35,2,0,0,3,1,0,46,10,42138,33039,49,14,44095,31717
349,35,1,3,1,0,0,3,25,27,42139,33042,27,11,44095,31720
350,36,2,1,0,3,1,0,22,17,42141,33043,30,18,44098,31720
351,36,2,0,0,3,1,0,28,26,42143,33043,24,13,44101,31720
352,36,2,1,0,3,1,0,24,19,42145,33044,30,22,44104,31720
353,36,4,0,0,3,1,0,53,11,42149,33044,46,13,44107,31720
354,36,0,0,2,1,2,1,20,34,42149,33044,16,20,44108,31721
355,36,2,1,0,3,1,0,26,20,42151,33045,34,12,44111,31721
356,36,1,1,2,1,2,1,24,18,42152,33046,31,43,44112,31722
357,36,2,2,2,1,2,1,31,19,42154,33048,35,33,44113,31723
358,36,2,2,2,1,2,1,27,27,42156,33050,25,13,44114,31724
359,36,3,2,0,3,1,0,27,14,42159,33052,33,21,44117,31724
360,37,3,1,0,3,1,0,23,35,42162,33053,19,13,44120,31724
361,37,1,3,1,0,0,3,33,14,42163,33056,42,43,44120,31727
362,37,2,0,0,3,1,0,33,26,42165,33056,30,11,44123,31727
363,37,3,1,0,3,1,0,35,27,42168,33057,34,10,44126,31727
364,37,1,0,0,3,1,0,26,27,42169,33057,30,14,44129,31727
365,37,0,0,2,1,2,1,34,21,42169,33057,35,14,44130,31728
366,37,0,0,2,1,2,1,46,10,42169,33057,50,13,44131,31729
367,37,1,1,2,1,2,1,32,20,42170,33058,37,22,44132,31730
368,37,2,1,0,3,1,0,23,16,42172,33059,33,16,44135,31730
369,37,2,1,0,3,1,0,35,20,42174,33060,33,9,44138,31730
370,38,1,3,1,0,0,3,29,29,42175,33063,24,46,44138,31733
371,38,0,0,2,1,2,1,27,27,42175,33063,26,14,44139,31734
372,38,8,1,0,3,1,0,61,12,42183,33064,49,11,44142,31734
373,38,0,2,1,0,0,3,22,19,42183,33066,30,36,44142,31737
374,38,1,2,1,0,0,3,25,21,42184,33068,30,21,44142,31740
375,38,1,0,0,3,1,0,28,14,42185,33068,36,20,44145,31740
376,38,1,1,2,1,2,1,27,21,42186,33069,35,14,44146,31741
377,38,2,3,1,0,0,3,33,22,42188,33072,35,24,44146,31744
378,38,1,2,1,0,0,3,25,20,42189,33074,31,15,44146,31747
379,38,3,4,1,0,0,3,25,19,42192,33078,31,25,44146,31750
0,1,1,2,1,0,0,3,26,23,42193,33080,30,17,44146,31753
1,1,3,0,0,3,1,0,36,22,42196,33080,38,0,44149,31753
2,1,0,4,1,0,0,3,27,25,42196,33084,35,28,44149,31756
3,1,1,1,2,1,2,1,1,1,42197,33085,1,25,44150,31757
4,1,1,1,2,1,2,1,29,15,42198,33086,37,37,44151,31758
5,1,0,1,1,0,0,3,0,1,42198,33087,0,16,44151,31761
6,1,1,4,1,0,0,3,30,33,42199,33091,24,49,44151,31764
7,1,0,0,2,1,2,1,25,20,42199,33091,32,16,44152,31765
8,1,4,1,0,3,1,0,65,13,42203,33092,52,21,44155,31765
9,1,3,0,0,3,1,0,36,14,42206,33092,45,14,44158,31765
10,2,1,2,1,0,0,3,24,18,42207,33094,33,13,44158,31768
11,2,4,3,0,3,1,0,38,24,42211,33097,38,16,44161,31768
12,2,0,1,1,0,0,3,0,1,42211,33098,0,3,44161,31771
13,2,0,0,2,1,2,1,35,20,42211,33098,34,12,44162,31772
14,2,1,1,2,1,2,1,33,21,42212,33099,38,1,44163,31773
15,2,1,0,0,3,1,0,26,19,42213,33099,34,14,44166,31773
16,2,1,1,2,1,2,1,34,27,42214,33100,31,15,44167,31774
17,2,0,6,1,0,0,3,26,33,42214,33106,30,46,44167,31777
18,2,2,1,0,3,1,0,37,28,42216,33107,37,22,44170,31777
19,2,5,0,0,3,1,0,51,10,42221,33107,53,20,44173,31777
20,3,2,2,2,1,2,1,29,27,42223,33109,36,50,44174,31778
21,3,2,2,2,1,2,1,38,16,42225,33111,46,26,44175,31779
22,3,4,2,0,3,1,0,69,15,42229,33113,55,17,44178,31779
23,3,1,0,0,3,1,0,39,24,42230,33113,41,28,44181,31779
24,3,1,0,0,3,1,0,2,1,42231,33113,4,16,44184,31779
25,3,0,0,2,1,2,1,26,23,42231,33113,31,16,44185,31780
26,3,2,1,0,3,1,0,31,16,42233,33114,40,14,44188,31780
27,3,0,0,2,1,2,1,0,1,42233,33114,1,17,44189,31781
28,3,2,1,0,3,1,0,38,23,42235,33115,41,21,44192,31781
29,3,4,0,0,3,1,0,34,33,42239,33115,27,0,44195,31781
30,4,0,1,1,0,0,3,24,19,42239,33116,33,40,44195,31784
31,4,1,0,0,3,1,0,1,1,42240,33116,3,20,44198,31784
32,4,0,1,1,0,0,3,26,20,42240,33117,34,25,44198,31787
33,4,8,0,0,3,1,0,59,10,42248,33117,56,12,44201,31787
34,4,1,0,0,3,1,0,38,28,42249,33117,40,13,44204,31787
35,4,0,1,1,0,0,3,34,28,42249,33118,31,4,44204,31790
36,4,2,1,0,3,1,0,28,34,42251,33119,33,14,44207,31790
37,4,4,0,0,3,1,0,39,20,42255,33119,37,16,44210,31790
38,4,1,0,0,3,1,0,26,20,42256,33119,35,46,44213,31790
39,4,2,3,1,0,0,3,35,24,42258,33122,38,6,44213,31793
40,5,0,0,2,1,2,1,31,16,42258,33122,41,27,44214,31794
41,5,1,0,0,3,1,0,30,27,42259,33122,39,0,44217,31794
42,5,2,0,0,3,1,0,40,16,42261,33122,49,16,44220,31794
43,5,4,0,0,3,1,0,43,20,42265,33122,40,14,44223,31794
44,5,1,0,0,3,1,0,35,33,42266,33122,30,21,44226,31794
45,5,1,2,1,0,0,3,1,3,42267,33124,1,19,44226,31797
46,5,0,0,2,1,2,1,26,23,42267,33124,32,47,44227,31798
47,5,2,2,2,1,2,1,41,26,42269,33126,42,51,44228,31799
48,5,1,0,0,3,1,0,39,23,42270,33126,44,17,44231,31799
49,5,4,3,0,3,1,0,6,4,42274,33129,7,17,44234,31799
50,6,1,0,0,3,1,0,39,28,42275,33129,43,40,44237,31799
51,6,1,1,2,1,2,1,36,25,42276,33130,39,21,44238,31800
52,6,6,2,0,3,1,0,75,17,42282,33132,58,4,44241,31800
53,6,5,0,0,3,1,0,64,10,42287,33132,59,28,44244,31800
54,6,2,1,0,3,1,0,28,21,42289,33133,37,13,44247,31800
55,6,3,1,0,3,1,0,29,21,42292,33134,38,14,44250,31800
56,6,1,1,2,1,2,1,2,2,42293,33135,4,13,44251,31801
57,6,0,0,2,1,2,1,24,19,42293,33135,34,17,44252,31802
58,6,0,0,2,1,2,1,28,34,42293,33135,34,26,44253,31803
59,6,1,0,0,3,1,0,35,28,42294,33135,34,6,44256,31803
60,7,2,2,2,1,2,1,33,18,42296,33137,42,17,44257,31804
61,7,2,2,2,1,2,1,42,18,42298,33139,50,18,44258,31805
62,7,1,1,2,1,2,1,27,24,42299,33140,33,5,44259,31806
63,7,1,0,0,3,1,0,42,26,42300,33140,45,0,44262,31806
64,7,3,2,0,3,1,0,38,35,42303,33142,33,17,44265,31806
65,7,1,2,1,0,0,3,31,29,42304,33144,39,24,44265,31809
66,7,0,1,1,0,0,3,6,5,42304,33145,7,22,44265,31812
67,7,0,0,2,1,2,1,43,20,42304,33145,41,28,44266,31813
68,7,0,1,1,0,0,3,24,20,42304,33146,34,54,44266,31816
69,7,0,4,1,0,0,3,39,27,42304,33150,44,50,44266,31819
70,8,1,1,2,1,2,1,29,22,42305,33151,38,41,44267,31820
71,8,4,1,0,3,1,0,79,18,42309,33152,61,6,44270,31820
72,8,0,0,2,1,2,1,35,28,42309,33152,35,22,44271,31821
73,8,3,0,0,3,1,0,67,10,42312,33152,62,17,44274,31821
74,8,0,0,2,1,2,1,2,2,42312,33152,5,29,44275,31822
75,8,0,1,1,0,0,3,1,4,42312,33153,1,17,44275,31825
76,8,2,0,0,3,1,0,30,34,42314,33153,37,13,44278,31825
77,8,3,0,0,3,1,0,32,21,42317,33153,41,26,44281,31825
78,8,2,1,0,3,1,0,41,29,42319,33154,46,14,44284,31825
79,8,3,1,0,3,1,0,39,26,42322,33155,42,13,44287,31825
80,9,2,0,0,3,1,0,26,20,42324,33155,37,0,44290,31825
81,9,0,1,1,0,0,3,27,25,42324,33156,33,20,44290,31828
82,9,0,4,1,0,0,3,38,39,42324,33160,33,53,44290,31831
83,9,0,0,2,1,2,1,67,10,42324,33160,63,29,44291,31832
84,9,0,2,1,0,0,3,6,7,42324,33162,7,8,44291,31835
85,9,0,0,2,1,2,1,31,29,42324,33162,40,18,44292,31836
86,9,1,1,2,1,2,1,44,21,42325,33163,42,18,44293,31837
87,9,3,0,0,3,1,0,36,18,42328,33163,45,18,44296,31837
88,9,1,1,2,1,2,1,43,27,42329,33164,46,25,44297,31838
89,9,0,3,1,0,0,3,42,21,42329,33167,50,25,44297,31841
90,10,0,1,1,0,0,3,2,3,42329,33168,5,57,44297,31844
91,10,2,2,2,1,2,1,43,31,42331,33170,47,18,44298,31845
92,10,0,1,1,0,0,3,30,35,42331,33171,37,44,44298,31848
93,10,2,2,2,1,2,1,37,30,42333,33173,36,14,44299,31849
94,10,3,2,0,3,1,0,35,23,42336,33175,44,13,44302,31849
95,10,2,0,0,3,1,0,3,4,42338,33175,4,26,44305,31849
96,10,1,2,1,0,0,3,30,24,42339,33177,38,17,44305,31852
97,10,3,0,0,3,1,0,82,18,42342,33177,64,22,44308,31852
98,10,1,0,0,3,1,0,40,27,42343,33177,47,6,44311,31852
99,10,3,0,0,3,1,0,42,26,42346,33177,45,29,44314,31852
100,11,3,1,0,3,1,0,46,28,42349,33178,49,18,44317,31852
101,11,2,0,0,3,1,0,44,21,42351,33178,53,8,44320,31852
102,11,5,0,0,3,1,0,72,10,42356,33178,66,18,44323,31852
103,11,0,1,1,0,0,3,31,30,42356,33179,40,56,44323,31855
104,11,1,1,2,1,2,1,27,21,42357,33180,38,26,44324,31856
105,11,2,0,0,3,1,0,38,18,42359,33180,48,25,44327,31856
106,11,1,0,0,3,1,0,28,25,42360,33180,36,6,44330,31856
107,11,3,1,0,3,1,0,47,22,42363,33181,45,18,44333,31856
108,11,2,1,0,3,1,0,40,40,42365,33182,36,20,44336,31856
109,11,1,2,1,0,0,3,44,33,42366,33184,47,3,44336,31859
110,12,0,0,2,1,2,1,30,24,42366,33184,39,30,44337,31860
111,12,0,0,2,1,2,1,6,7,42366,33184,8,27,44338,31861
112,12,0,2,1,0,0,3,35,25,42366,33186,44,47,44338,31864
113,12,7,1,0,3,1,0,89,19,42373,33187,67,14,44341,31864
114,12,0,0,2,1,2,1,2,3,42373,33187,6,19,44342,31865
115,12,2,2,2,1,2,1,32,37,42375,33189,38,18,44343,31866
116,12,4,0,0,3,1,0,7,4,42379,33189,7,13,44346,31866
117,12,0,0,2,1,2,1,40,27,42379,33189,48,23,44347,31867
118,12,2,2,2,1,2,1,44,28,42381,33191,46,58,44348,31868
119,12,3,2,0,3,1,0,40,32,42384,33193,39,29,44351,31868
120,13,1,0,0,3,1,0,45,21,42385,33193,56,6,44354,31868
121,13,4,0,0,3,1,0,76,10,42389,33193,69,18,44357,31868
122,13,2,3,1,0,0,3,48,31,42391,33196,49,59,44357,31871
123,13,0,0,2,1,2,1,31,30,42391,33196,41,21,44358,31872
124,13,2,1,0,3,1,0,29,22,42393,33197,41,18,44361,31872
125,13,0,0,2,1,2,1,38,18,42393,33197,49,9,44362,31873
126,13,1,2,1,0,0,3,45,35,42394,33199,47,29,44362,31876
127,13,3,2,0,3,1,0,50,24,42397,33201,48,25,44365,31876
128,13,1,3,1,0,0,3,29,28,42398,33204,36,30,44365,31879
129,13,2,2,2,1,2,1,4,5,42400,33206,7,19,44366,31880
130,14,1,2,1,0,0,3,8,6,42401,33208,7,50,44366,31883
131,14,4,1,0,3,1,0,93,20,42405,33209,70,29,44369,31883
132,14,1,0,0,3,1,0,41,32,42406,33209,42,58,44372,31883
133,14,2,3,1,0,0,3,8,10,42408,33212,8,16,44372,31886
134,14,4,0,0,3,1,0,39,25,42412,33212,47,18,44375,31886
135,14,2,1,0,3,1,0,32,25,42414,33213,42,19,44378,31886
136,14,1,2,1,0,0,3,41,29,42415,33215,48,17,44378,31889
137,14,0,1,1,0,0,3,44,29,42415,33216,46,6,44378,31892
138,14,0,1,1,0,0,3,32,38,42415,33217,38,33,44378,31895
139,14,2,1,0,3,1,0,42,41,42417,33218,39,23,44381,31895
140,15,0,3,1,0,0,3,29,25,42417,33221,41,62,44381,31898
141,15,1,0,0,3,1,0,30,28,42418,33221,39,23,44384,31898
142,15,5,0,0,3,1,0,81,10,42423,33221,72,25,44387,31898
143,15,2,1,0,3,1,0,50,32,42425,33222,52,21,44390,31898
144,15,3,1,0,3,1,0,53,25,42428,33223,51,9,44393,31898
145,15,3,2,0,3,1,0,34,32,42431,33225,44,30,44396,31898
146,15,2,1,0,3,1,0,40,19,42433,33226,52,6,44399,31898
147,15,1,1,2,1,2,1,33,26,42434,33227,43,30,44400,31899
148,15,1,0,0,3,1,0,5,5,42435,33227,10,18,44403,31899
149,15,3,0,0,3,1,0,48,35,42438,33227,50,18,44406,31899
150,16,1,0,0,3,1,0,40,25,42439,33227,50,33,44409,31899
151,16,2,1,0,3,1,0,10,11,42441,33228,11,50,44412,31899
152,16,1,3,1,0,0,3,94,23,42442,33231,70,61,44412,31902
153,16,1,3,1,0,0,3,9,9,42443,33234,7,21,44412,31905
154,16,1,0,0,3,1,0,42,32,42444,33234,45,6,44415,31905
155,16,1,1,2,1,2,1,46,22,42445,33235,57,17,44416,31906
156,16,0,1,1,0,0,3,32,39,42445,33236,38,22,44416,31909
157,16,1,1,2,1,2,1,43,42,42446,33237,40,18,44417,31910
158,16,1,1,2,1,2,1,45,30,42447,33238,47,20,44418,31911
159,16,4,2,0,3,1,0,45,31,42451,33240,51,29,44421,31911
160,17,4,0,0,3,1,0,85,10,42455,33240,75,9,44424,31911
161,17,1,2,1,0,0,3,34,28,42456,33242,43,21,44424,31914
162,17,1,2,1,0,0,3,30,27,42457,33244,41,24,44424,31917
163,17,2,1,0,3,1,0,47,31,42459,33245,50,18,44427,31917
164,17,2,6,1,0,0,3,50,41,42461,33251,50,65,44427,31920
165,17,0,2,1,0,0,3,53,27,42461,33253,51,9,44427,31923
166,17,2,1,0,3,1,0,7,6,42463,33254,13,25,44430,31923
167,17,2,1,0,3,1,0,42,20,42465,33255,55,23,44433,31923
168,17,0,0,2,1,2,1,30,28,42465,33255,40,18,44434,31924
169,17,2,0,0,3,1,0,52,32,42467,33255,55,30,44437,31924
170,18,1,0,0,3,1,0,31,28,42468,33255,43,18,44440,31924
171,18,0,0,2,1,2,1,40,25,42468,33255,51,23,44441,31925
172,18,0,0,2,1,2,1,34,32,42468,33255,45,19,44442,31926
173,18,5,1,0,3,1,0,99,24,42473,33256,73,6,44445,31926
174,18,0,0,2,1,2,1,43,42,42473,33256,41,30,44446,31927
175,18,2,1,0,3,1,0,11,10,42475,33257,10,33,44449,31927
176,18,0,0,2,1,2,1,42,32,42475,33257,46,31,44450,31928
177,18,2,2,2,1,2,1,48,24,42477,33259,58,51,44451,31929
178,18,2,0,0,3,1,0,12,11,42479,33259,14,21,44454,31929
179,18,1,1,2,1,2,1,46,32,42480,33260,52,62,44455,31930
180,19,1,1,2,1,2,1,33,40,42481,33261,39,22,44456,31931
181,19,1,2,1,0,0,3,8,8,42482,33263,13,12,44456,31934
182,19,0,0,2,1,2,1,50,41,42482,33263,51,25,44457,31935
183,19,1,2,1,0,0,3,35,30,42483,33265,43,68,44457,31938
184,19,0,1,1,0,0,3,52,33,42483,33266,55,21,44457,31941
185,19,3,0,0,3,1,0,56,27,42486,33266,54,23,44460,31941
186,19,0,2,1,0,0,3,42,22,42486,33268,55,23,44460,31944
187,19,3,0,0,3,1,0,50,31,42489,33268,53,25,44463,31944
188,19,2,1,0,3,1,0,32,28,42491,33269,44,30,44466,31944
189,19,4,2,0,3,1,0,89,12,42495,33271,78,9,44469,31944
190,20,1,1,2,1,2,1,43,33,42496,33272,47,24,44470,31945
191,20,2,1,0,3,1,0,10,9,42498,33273,16,25,44473,31945
192,20,2,3,1,0,0,3,34,31,42500,33276,44,26,44473,31948
193,20,1,1,2,1,2,1,57,28,42501,33277,55,22,44474,31949
194,20,4,1,0,3,1,0,93,13,42505,33278,81,30,44477,31949
195,20,1,2,1,0,0,3,51,43,42506,33280,51,12,44477,31952
196,20,1,0,0,3,1,0,34,40,42507,33280,42,25,44480,31952
197,20,1,0,0,3,1,0,36,30,42508,33280,46,12,44483,31952
198,20,0,3,1,0,0,3,50,34,42508,33283,53,71,44483,31955
199,20,4,0,0,3,1,0,56,33,42512,33283,58,19,44486,31955
200,21,1,0,0,3,1,0,47,32,42513,33283,55,23,44489,31955
201,21,2,3,1,0,0,3,13,13,42515,33286,10,34,44489,31958
202,21,3,1,0,3,1,0,102,25,42518,33287,76,18,44492,31958
203,21,0,0,2,1,2,1,48,24,42518,33287,59,63,44493,31959
204,21,1,2,1,0,0,3,13,13,42519,33289,14,9,44493,31962
205,21,5,1,0,3,1,0,39,33,42524,33290,48,21,44496,31962
206,21,1,2,1,0,0,3,41,27,42525,33292,51,25,44496,31965
207,21,2,2,2,1,2,1,33,30,42527,33294,44,52,44497,31966
208,21,2,1,0,3,1,0,45,43,42529,33295,44,33,44500,31966
209,21,0,1,1,0,0,3,42,23,42529,33296,55,33,44500,31969
210,22,3,3,2,1,2,1,53,37,42532,33299,54,26,44501,31970
211,22,1,0,0,3,1,0,37,30,42533,33299,49,12,44504,31970
212,22,1,1,2,1,2,1,42,28,42534,33300,52,25,44505,31971
213,22,0,1,1,0,0,3,43,34,42534,33301,47,74,44505,31974
214,22,2,1,0,3,1,0,95,14,42536,33302,84,22,44508,31974
215,22,1,1,2,1,2,1,35,32,42537,33303,45,20,44509,31975
216,22,1,2,1,0,0,3,52,45,42538,33305,51,29,44509,31978
217,22,1,2,1,0,0,3,35,42,42539,33307,42,15,44509,31981
218,22,0,0,2,1,2,1,57,28,42539,33307,56,53,44510,31982
219,22,2,1,0,3,1,0,12,10,42541,33308,19,30,44513,31982
220,23,0,0,2,1,2,1,33,30,42541,33308,45,34,44514,31983
221,23,3,2,0,3,1,0,45,25,42544,33310,58,63,44517,31983
222,23,2,1,0,3,1,0,15,14,42546,33311,17,34,44520,31983
223,23,0,2,1,0,0,3,47,34,42546,33313,55,21,44520,31986
224,23,3,1,0,3,1,0,48,44,42549,33314,47,23,44523,31986
225,23,2,0,0,3,1,0,15,13,42551,33314,13,25,44526,31986
226,23,4,0,0,3,1,0,60,33,42555,33314,61,21,44529,31986
227,23,3,1,0,3,1,0,51,25,42558,33315,62,9,44532,31986
228,23,4,2,0,3,1,0,106,27,42562,33317,79,25,44535,31986
229,23,2,0,0,3,1,0,41,33,42564,33317,51,33,44538,31986
230,24,1,1,2,1,2,1,44,35,42565,33318,48,27,44539,31987
231,24,4,0,0,3,1,0,110,27,42569,33318,82,25,44542,31987
232,24,2,0,0,3,1,0,54,45,42571,33318,54,20,44545,31987
233,24,4,1,0,3,1,0,16,11,42575,33319,22,22,44548,31987
234,24,3,0,0,3,1,0,56,37,42578,33319,57,30,44551,31987
235,24,1,1,2,1,2,1,36,33,42579,33320,46,35,44552,31988
236,24,4,0,0,3,1,0,41,30,42583,33320,52,29,44555,31988
237,24,3,5,1,0,0,3,45,33,42586,33325,52,18,44555,31991
238,24,5,1,0,3,1,0,100,15,42591,33326,87,53,44558,31991
239,24,0,2,1,0,0,3,35,44,42591,33328,42,15,44558,31994
240,25,1,1,2,1,2,1,34,31,42592,33329,46,22,44559,31995
241,25,1,1,2,1,2,1,16,15,42593,33330,18,26,44560,31996
242,25,5,1,0,3,1,0,53,45,42598,33331,50,21,44563,31996
243,25,1,2,1,0,0,3,48,36,42599,33333,55,28,44563,31999
244,25,2,2,2,1,2,1,53,27,42601,33335,63,35,44564,32000
245,25,0,1,1,0,0,3,15,14,42601,33336,13,77,44564,32003
246,25,1,2,1,0,0,3,61,35,42602,33338,61,36,44564,32006
247,25,2,1,0,3,1,0,47,26,42604,33339,61,9,44567,32006
248,25,1,0,0,3,1,0,42,33,42605,33339,54,23,44570,32006
249,25,1,2,1,0,0,3,58,30,42606,33341,56,66,44570,32009
250,26,1,3,1,0,0,3,45,38,42607,33344,48,33,44570,32012
251,26,1,1,2,1,2,1,42,31,42608,33345,53,21,44571,32013
252,26,4,2,0,3,1,0,19,16,42612,33347,16,25,44574,32013
253,26,3,1,0,3,1,0,103,16,42615,33348,90,22,44577,32013
254,26,1,1,2,1,2,1,55,46,42616,33349,55,36,44578,32014
255,26,2,1,0,3,1,0,37,45,42618,33350,45,29,44581,32014
256,26,2,0,0,3,1,0,58,37,42620,33350,60,22,44584,32014
257,26,0,1,1,0,0,3,16,12,42620,33351,22,56,44584,32017
258,26,5,0,0,3,1,0,115,27,42625,33351,85,27,44587,32017
259,26,3,1,0,3,1,0,48,34,42628,33352,55,15,44590,32017
260,27,3,0,0,3,1,0,45,33,42631,33352,57,21,44593,32017
261,27,1,0,0,3,1,0,54,45,42632,33352,53,28,44596,32017
262,27,1,0,0,3,1,0,37,33,42633,33352,49,36,44599,32017
263,27,2,3,1,0,0,3,18,18,42635,33355,18,80,44599,32020
264,27,5,1,0,3,1,0,53,37,42640,33356,58,18,44602,32020
265,27,2,0,0,3,1,0,60,30,42642,33356,59,9,44605,32020
266,27,2,2,2,1,2,1,63,37,42644,33358,62,24,44606,32021
267,27,0,2,1,0,0,3,34,33,42644,33360,46,69,44606,32024
268,27,2,1,0,3,1,0,49,27,42646,33361,64,35,44609,32024
269,27,1,2,1,0,0,3,54,29,42647,33363,63,29,44609,32027
270,28,2,1,0,3,1,0,18,13,42649,33364,25,22,44612,32027
271,28,1,1,2,1,2,1,38,46,42650,33365,46,22,44613,32028
272,28,1,0,0,3,1,0,46,38,42651,33365,51,22,44616,32028
273,28,0,2,1,0,0,3,55,48,42651,33367,55,72,44616,32031
274,28,3,0,0,3,1,0,22,16,42654,33367,19,15,44619,32031
275,28,1,0,0,3,1,0,49,34,42655,33367,58,29,44622,32031
276,28,2,1,0,3,1,0,44,32,42657,33368,56,36,44625,32031
277,28,0,3,1,0,0,3,58,40,42657,33371,60,59,44625,32034
278,28,1,1,2,1,2,1,116,28,42658,33372,86,34,44626,32035
279,28,3,1,0,3,1,0,56,38,42661,33373,61,25,44629,32035
280,29,0,0,2,1,2,1,49,27,42661,33373,65,30,44630,32036
281,29,5,3,0,3,1,0,108,19,42666,33376,93,9,44633,32036
282,29,2,3,1,0,0,3,39,36,42668,33379,49,27,44633,32039
283,29,2,1,0,3,1,0,62,31,42670,33380,62,35,44636,32039
284,29,1,2,1,0,0,3,64,39,42671,33382,62,24,44636,32042
285,29,1,3,1,0,0,3,46,36,42672,33385,57,31,44636,32045
286,29,1,1,2,1,2,1,55,30,42673,33386,64,81,44637,32046
287,29,0,3,1,0,0,3,34,36,42673,33389,46,39,44637,32049
288,29,1,1,2,1,2,1,19,19,42674,33390,19,28,44638,32050
289,29,4,2,0,3,1,0,58,47,42678,33392,56,18,44641,32050
290,30,0,2,1,0,0,3,44,34,42678,33394,56,75,44641,32053
291,30,5,1,0,3,1,0,121,29,42683,33395,89,22,44644,32053
292,30,3,1,0,3,1,0,49,39,42686,33396,54,59,44647,32053
293,30,1,0,0,3,1,0,39,46,42687,33396,49,36,44650,32053
294,30,0,2,1,0,0,3,49,36,42687,33398,58,25,44650,32056
295,30,1,2,1,0,0,3,57,40,42688,33400,61,37,44650,32059
296,30,1,1,2,1,2,1,59,41,42689,33401,61,23,44651,32060
297,30,0,2,1,0,0,3,22,18,42689,33403,19,32,44651,32063
298,30,1,1,2,1,2,1,20,20,42690,33404,20,26,44652,32064
299,30,0,3,1,0,0,3,18,16,42690,33407,25,42,44652,32067
300,31,0,1,1,0,0,3,34,37,42690,33408,46,12,44652,32070
301,31,1,2,1,0,0,3,40,38,42691,33410,49,27,44652,32073
302,31,1,5,1,0,0,3,50,32,42692,33415,65,84,44652,32076
303,31,2,0,0,3,1,0,110,19,42694,33415,96,35,44655,32076
304,31,0,2,1,0,0,3,58,49,42694,33417,56,18,44655,32079
305,31,3,0,0,3,1,0,65,31,42697,33417,65,30,44658,32079
306,31,1,1,2,1,2,1,65,40,42698,33418,63,32,44659,32080
307,31,4,0,0,3,1,0,50,36,42702,33418,60,18,44662,32080
308,31,0,0,2,1,2,1,55,30,42702,33418,65,29,44663,32081
309,31,3,1,0,3,1,0,58,49,42705,33419,58,27,44666,32081
310,32,6,0,0,3,1,0,28,18,42711,33419,22,25,44669,32081
311,32,2,0,0,3,1,0,51,39,42713,33419,57,23,44672,32081
312,32,2,2,2,1,2,1,59,42,42715,33421,62,23,44673,32082
313,32,1,4,1,0,0,3,40,50,42716,33425,49,78,44673,32085
314,32,3,1,0,3,1,0,23,21,42719,33426,23,32,44676,32085
315,32,2,0,0,3,1,0,51,36,42721,33426,61,36,44679,32085
316,32,0,0,2,1,2,1,44,34,42721,33426,57,13,44680,32086
317,32,1,0,0,3,1,0,60,41,42722,33426,64,42,44683,32086
318,32,0,0,2,1,2,1,121,29,42722,33426,90,60,44684,32087
319,32,3,0,0,3,1,0,61,49,42725,33426,59,26,44687,32087
320,33,1,1,2,1,2,1,51,37,42726,33427,61,19,44688,32088
321,33,2,0,0,3,1,0,52,32,42728,33427,68,29,44691,32088
322,33,4,0,0,3,1,0,114,19,42732,33427,99,30,44694,32088
323,33,2,2,2,1,2,1,20,18,42734,33429,26,36,44695,32089
324,33,3,2,0,3,1,0,43,40,42737,33431,52,32,44698,32089
325,33,4,1,0,3,1,0,69,41,42741,33432,66,18,44701,32089
326,33,1,4,1,0,0,3,66,35,42742,33436,65,87,44701,32092
327,33,2,1,0,3,1,0,57,31,42744,33437,68,37,44704,32092
328,33,0,3,1,0,0,3,34,40,42744,33440,46,30,44704,32095
329,33,3,0,0,3,1,0,61,49,42747,33440,61,27,44707,32095
330,34,3,1,0,3,1,0,124,30,42750,33441,93,23,44710,32095
331,34,1,2,1,0,0,3,52,38,42751,33443,61,81,44710,32098
332,34,4,0,0,3,1,0,63,42,42755,33443,65,60,44713,32098
333,34,1,0,0,3,1,0,41,50,42756,33443,52,13,44716,32098
334,34,1,0,0,3,1,0,24,21,42757,33443,26,25,44719,32098
335,34,1,1,2,1,2,1,62,50,42758,33444,60,24,44720,32099
336,34,1,1,2,1,2,1,58,32,42759,33445,69,27,44721,32100
337,34,1,0,0,3,1,0,61,41,42760,33445,67,30,44724,32100
338,34,0,1,1,0,0,3,28,19,42760,33446,22,39,44724,32103
339,34,5,1,0,3,1,0,56,40,42765,33447,60,42,44727,32103
340,35,1,0,0,3,1,0,45,34,42766,33447,60,27,44730,32103
341,35,2,1,0,3,1,0,45,41,42768,33448,55,18,44733,32103
342,35,1,2,1,0,0,3,115,21,42769,33450,99,90,44733,32106
343,35,1,1,2,1,2,1,62,50,42770,33451,62,33,44734,32107
344,35,1,0,0,3,1,0,21,18,42771,33451,29,30,44737,32107
345,35,1,1,2,1,2,1,52,38,42772,33452,62,33,44738,32108
346,35,0,1,1,0,0,3,34,41,42772,33453,46,39,44738,32111
347,35,3,1,0,3,1,0,69,36,42775,33454,68,29,44741,32111
348,35,4,0,0,3,1,0,73,41,42779,33454,69,19,44744,32111
349,35,1,1,2,1,2,1,53,33,42780,33455,69,38,44745,32112
350,36,1,3,1,0,0,3,57,43,42781,33458,60,33,44745,32115
351,36,3,1,0,3,1,0,55,39,42784,33459,64,13,44748,32115
352,36,0,3,1,0,0,3,63,45,42784,33462,65,26,44748,32118
353,36,3,0,0,3,1,0,55,38,42787,33462,65,27,44751,32118
354,36,1,1,2,1,2,1,59,33,42788,33463,70,26,44752,32119
355,36,3,0,0,3,1,0,127,30,42791,33463,96,42,44755,32119
356,36,2,0,0,3,1,0,43,50,42793,33463,55,39,44758,32119
357,36,1,0,0,3,1,0,63,50,42794,33463,63,60,44761,32119
358,36,2,2,2,1,2,1,26,23,42796,33465,27,40,44762,32120
359,36,0,7,1,0,0,3,28,26,42796,33472,22,84,44762,32123
360,37,2,1,0,3,1,0,45,51,42798,33473,58,27,44765,32123
361,37,0,0,2,1,2,1,61,41,42798,33473,68,31,44766,32124
362,37,1,0,0,3,1,0,46,34,42799,33473,63,33,44769,32124
363,37,1,2,1,0,0,3,22,20,42800,33475,29,93,44769,32127
364,37,5,2,0,3,1,0,67,52,42805,33477,65,18,44772,32127
365,37,4,0,0,3,1,0,119,21,42809,33477,102,29,44775,32127
366,37,2,1,0,3,1,0,47,42,42811,33478,58,19,44778,32127
367,37,2,1,0,3,1,0,71,37,42813,33479,71,38,44781,32127
368,37,1,0,0,3,1,0,74,41,42814,33479,72,33,44784,32127
369,37,1,0,0,3,1,0,54,33,42815,33479,72,24,44787,32127
370,38,1,0,0,3,1,0,56,38,42816,33479,68,60,44790,32127
371,38,2,2,2,1,2,1,28,25,42818,33481,28,85,44791,32128
372,38,0,2,1,0,0,3,57,45,42818,33483,60,30,44791,32131
373,38,3,0,0,3,1,0,58,39,42821,33483,67,39,44794,32131
374,38,4,1,0,3,1,0,131,31,42825,33484,99,33,44797,32131
375,38,1,0,0,3,1,0,29,26,42826,33484,25,13,44800,32131
376,38,1,1,2,1,2,1,64,46,42827,33485,66,43,44801,32132
377,38,1,0,0,3,1,0,64,50,42828,33485,66,26,44804,32132
378,38,0,1,1,0,0,3,59,34,42828,33486,70,43,44804,32135
379,38,2,4,1,0,0,3,36,45,42830,33490,46,29,44804,32138
0,1,0,1,1,0,0,3,0,1,42830,33491,0,41,44804,32141
1,1,2,1,0,3,1,0,69,53,42832,33492,68,31,44807,32141
2,1,2,1,0,3,1,0,48,35,42834,33493,66,29,44810,32141
3,1,3,5,1,0,0,3,64,46,42837,33498,68,22,44810,32144
4,1,1,1,2,1,2,1,132,32,42838,33499,100,61,44811,32145
5,1,5,1,0,3,1,0,124,22,42843,33500,105,24,44814,32145
6,1,1,1,2,1,2,1,59,40,42844,33501,68,44,44815,32146
7,1,2,0,0,3,1,0,24,19,42846,33501,33,29,44818,32146
8,1,1,0,0,3,1,0,30,26,42847,33501,28,13,44821,32146
9,1,0,1,1,0,0,3,45,52,42847,33502,58,3,44821,32149
10,2,2,1,0,3,1,0,58,39,42849,33503,71,0,44824,32149
11,2,1,2,1,0,0,3,29,27,42850,33505,28,21,44824,32152
12,2,1,2,1,0,0,3,65,48,42851,33507,66,33,44824,32155
13,2,1,1,2,1,2,1,65,51,42852,33508,67,34,44825,32156
14,2,1,2,1,0,0,3,55,35,42853,33510,72,88,44825,32159
15,2,2,1,0,3,1,0,59,46,42855,33511,63,93,44828,32159
16,2,1,1,2,1,2,1,23,21,42856,33512,30,44,44829,32160
17,2,3,3,2,1,2,1,77,44,42859,33515,73,14,44830,32161
18,2,2,0,0,3,1,0,2,0,42861,33515,3,33,44833,32161
19,2,4,0,0,3,1,0,75,37,42865,33515,74,39,44836,32161
20,3,2,0,0,3,1,0,2,1,42867,33515,3,29,44839,32161
21,3,0,1,1,0,0,3,45,53,42867,33516,58,44,44839,32164
22,3,1,1,2,1,2,1,25,20,42868,33517,34,32,44840,32165
23,3,1,0,0,3,1,0,49,35,42869,33517,69,24,44843,32165
24,3,0,0,2,1,2,1,30,26,42869,33517,29,45,44844,32166
25,3,2,0,0,3,1,0,66,46,42871,33517,71,3,44847,32166
26,3,3,2,0,3,1,0,62,42,42874,33519,71,29,44850,32166
27,3,3,0,0,3,1,0,135,32,42877,33519,103,13,44853,32166
28,3,1,0,0,3,1,0,125,22,42878,33519,108,61,44856,32166
29,3,2,4,1,0,0,3,31,31,42880,33523,28,47,44856,32169
30,4,3,1,0,3,1,0,68,52,42883,33524,70,33,44859,32169
31,4,2,1,0,3,1,0,79,45,42885,33525,76,0,44862,32169
32,4,1,4,1,0,0,3,60,50,42886,33529,63,91,44862,32172
33,4,1,0,0,3,1,0,70,53,42887,33529,71,93,44865,32172
34,4,3,3,2,1,2,1,68,51,42890,33532,67,40,44866,32173
35,4,1,1,2,1,2,1,24,22,42891,33533,31,15,44867,32174
36,4,1,1,2,1,2,1,56,36,42892,33534,73,35,44868,32175
37,4,2,0,0,3,1,0,60,39,42894,33534,74,33,44871,32175
38,4,4,3,0,3,1,0,79,40,42898,33537,77,21,44874,32175
39,4,0,1,1,0,0,3,2,1,42898,33538,3,25,44874,32178
40,5,3,1,0,3,1,0,48,54,42901,33539,61,29,44877,32178
41,5,2,1,0,3,1,0,4,2,42903,33540,6,32,44880,32178
42,5,1,0,0,3,1,0,32,31,42904,33540,31,29,44883,32178
43,5,2,0,0,3,1,0,127,22,42906,33540,111,13,44886,32178
44,5,2,0,0,3,1,0,51,35,42908,33540,72,61,44889,32178
45,5,2,1,0,3,1,0,64,43,42910,33541,74,24,44892,32178
46,5,2,1,0,3,1,0,81,41,42912,33542,80,3,44895,32178
47,5,0,0,2,1,2,1,66,46,42912,33542,72,45,44896,32179
48,5,0,2,1,0,0,3,30,28,42912,33544,29,96,44896,32182
49,5,0,2,1,0,0,3,25,22,42912,33546,34,48,44896,32185
50,6,2,0,0,3,1,0,81,45,42914,33546,79,33,44899,32185
51,6,4,0,0,3,1,0,72,52,42918,33546,73,25,44902,32185
52,6,2,0,0,3,1,0,62,39,42920,33546,77,40,44905,32185
53,6,2,3,1,0,0,3,72,56,42922,33549,71,94,44905,32188
54,6,2,1,0,3,1,0,26,23,42924,33550,34,0,44908,32188
55,6,6,1,0,3,1,0,8,2,42930,33551,6,21,44911,32188
56,6,4,0,0,3,1,0,60,36,42934,33551,76,33,44914,32188
57,6,5,1,0,3,1,0,140,33,42939,33552,106,15,44917,32188
58,6,0,1,1,0,0,3,68,52,42939,33553,67,50,44917,32191
59,6,1,0,0,3,1,0,61,50,42940,33553,66,35,44920,32191
60,7,2,0,0,3,1,0,6,2,42942,33553,9,48,44923,32191
61,7,2,1,0,3,1,0,32,29,42944,33554,32,15,44926,32191
62,7,0,1,1,0,0,3,48,55,42944,33555,61,35,44926,32194
63,7,1,1,2,1,2,1,9,3,42945,33556,7,30,44927,32195
64,7,2,0,0,3,1,0,34,31,42947,33556,34,24,44930,32195
65,7,1,0,0,3,1,0,65,43,42948,33556,77,61,44933,32195
66,7,1,2,1,0,0,3,52,37,42949,33558,72,16,44933,32198
67,7,1,0,0,3,1,0,67,46,42950,33558,75,29,44936,32198
68,7,2,2,2,1,2,1,129,24,42952,33560,112,97,44937,32199
69,7,2,1,0,3,1,0,83,42,42954,33561,83,45,44940,32199
70,8,2,1,0,3,1,0,74,53,42956,33562,76,3,44943,32199
71,8,2,0,0,3,1,0,142,33,42958,33562,109,0,44946,32199
72,8,3,2,0,3,1,0,84,47,42961,33564,82,40,44949,32199
73,8,4,5,1,0,0,3,29,27,42965,33569,34,97,44949,32202
74,8,0,1,1,0,0,3,61,51,42965,33570,66,36,44949,32205
75,8,3,2,0,3,1,0,71,54,42968,33572,70,21,44952,32205
76,8,1,2,1,0,0,3,27,25,42969,33574,34,36,44952,32208
77,8,0,0,2,1,2,1,60,36,42969,33574,77,26,44953,32209
78,8,0,1,1,0,0,3,62,40,42969,33575,77,53,44953,32212
79,8,3,2,0,3,1,0,75,58,42972,33577,74,35,44956,32212
80,9,0,0,2,1,2,1,71,54,42972,33577,71,46,44957,32213
81,9,1,0,0,3,1,0,35,31,42973,33577,37,61,44960,32213
82,9,1,1,2,1,2,1,7,3,42974,33578,10,16,44961,32214
83,9,0,5,1,0,0,3,32,34,42974,33583,32,100,44961,32217
84,9,2,1,0,3,1,0,50,56,42976,33584,64,48,44964,32217
85,9,3,1,0,3,1,0,68,44,42979,33585,80,16,44967,32217
86,9,1,2,1,0,0,3,68,48,42980,33587,75,38,44967,32220
87,9,3,1,0,3,1,0,86,43,42983,33588,86,29,44970,32220
88,9,0,5,1,0,0,3,52,42,42983,33593,72,100,44970,32223
89,9,2,2,2,1,2,1,11,5,42985,33595,8,25,44971,32224
90,10,1,2,1,0,0,3,75,55,42986,33597,76,24,44971,32227
91,10,3,1,0,3,1,0,132,25,42989,33598,115,0,44974,32227
92,10,4,0,0,3,1,0,146,33,42993,33598,112,36,44977,32227
93,10,2,0,0,3,1,0,86,47,42995,33598,85,53,44980,32227
94,10,0,1,1,0,0,3,62,41,42995,33599,77,33,44980,32230
95,10,1,0,0,3,1,0,30,27,42996,33599,37,35,44983,32230
96,10,0,1,1,0,0,3,60,37,42996,33600,77,6,44983,32233
97,10,1,2,1,0,0,3,28,27,42997,33602,34,43,44983,32236
98,10,0,0,2,1,2,1,75,58,42997,33602,75,37,44984,32237
99,10,2,4,1,0,0,3,63,55,42999,33606,66,29,44984,32240
100,11,1,2,1,0,0,3,36,33,43000,33608,37,19,44984,32243
101,11,3,2,0,3,1,0,35,36,43003,33610,35,0,44987,32243
102,11,0,3,1,0,0,3,71,57,43003,33613,71,32,44987,32246
103,11,5,3,0,3,1,0,55,59,43008,33616,67,16,44990,32246
104,11,1,2,1,0,0,3,76,57,43009,33618,76,28,44990,32249
105,11,1,1,2,1,2,1,12,6,43010,33619,9,62,44991,32250
106,11,2,1,0,3,1,0,70,49,43012,33620,78,48,44994,32250
107,11,2,4,1,0,0,3,54,46,43014,33624,72,103,44994,32253
108,11,2,0,0,3,1,0,88,43,43016,33624,89,38,44997,32253
109,11,1,2,1,0,0,3,69,46,43017,33626,80,103,44997,32256
110,12,0,0,2,1,2,1,60,37,43017,33626,78,47,44998,32257
111,12,2,1,0,3,1,0,88,48,43019,33627,88,33,45001,32257
112,12,3,1,0,3,1,0,135,26,43022,33628,118,36,45004,32257
113,12,5,1,0,3,1,0,151,34,43027,33629,115,43,45007,32257
114,12,0,2,1,0,0,3,30,29,43027,33631,37,40,45007,32260
115,12,1,1,2,1,2,1,8,4,43028,33632,11,36,45008,32261
116,12,2,1,0,3,1,0,65,56,43030,33633,69,6,45011,32261
117,12,0,1,1,0,0,3,28,28,43030,33634,34,56,45011,32264
118,12,5,1,0,3,1,0,80,59,43035,33635,78,29,45014,32264
119,12,4,0,0,3,1,0,66,41,43039,33635,80,24,45017,32264
120,13,0,0,2,1,2,1,66,41,43039,33635,81,33,45018,32265
121,13,2,0,0,3,1,0,37,36,43041,33635,38,36,45021,32265
122,13,1,0,0,3,1,0,13,6,43042,33635,12,19,45024,32265
123,13,4,0,0,3,1,0,80,57,43046,33635,79,62,45027,32265
124,13,1,0,0,3,1,0,37,33,43047,33635,40,103,45030,32265
125,13,0,2,1,0,0,3,71,59,43047,33637,71,41,45030,32268
126,13,1,1,2,1,2,1,71,50,43048,33638,79,17,45031,32269
127,13,4,0,0,3,1,0,92,43,43052,33638,92,48,45034,32269
128,13,0,4,1,0,0,3,69,50,43052,33642,80,106,45034,32272
129,13,0,1,1,0,0,3,55,60,43052,33643,67,3,45034,32275
130,14,1,0,0,3,1,0,61,37,43053,33643,81,24,45037,32275
131,14,1,0,0,3,1,0,66,56,43054,33643,72,47,45040,32275
132,14,2,5,1,0,0,3,90,53,43056,33648,88,31,45040,32278
133,14,5,1,0,3,1,0,140,27,43061,33649,121,43,45043,32278
134,14,2,0,0,3,1,0,153,34,43063,33649,118,56,45046,32278
135,14,0,0,2,1,2,1,28,28,43063,33649,35,34,45047,32279
136,14,2,3,1,0,0,3,32,32,43065,33652,37,32,45047,32282
137,14,1,1,2,1,2,1,9,5,43066,33653,12,41,45048,32283
138,14,1,1,2,1,2,1,55,47,43067,33654,73,37,45049,32284
139,14,1,2,1,0,0,3,81,61,43068,33656,78,9,45049,32287
140,15,2,2,2,1,2,1,73,61,43070,33658,72,49,45050,32288
141,15,1,1,2,1,2,1,67,42,43071,33659,82,42,45051,32289
142,15,4,0,0,3,1,0,84,57,43075,33659,82,19,45054,32289
143,15,2,3,1,0,0,3,15,9,43077,33662,12,106,45054,32292
144,15,0,1,1,0,0,3,61,38,43077,33663,81,65,45054,32295
145,15,4,0,0,3,1,0,73,50,43081,33663,83,36,45057,32295
146,15,1,0,0,3,1,0,72,50,43082,33663,82,3,45060,32295
147,15,6,0,0,3,1,0,98,43,43088,33663,95,17,45063,32295
148,15,1,2,1,0,0,3,38,35,43089,33665,40,109,45063,32298
149,15,0,2,1,0,0,3,37,38,43089,33667,38,40,45063,32301
150,16,1,1,2,1,2,1,67,57,43090,33668,73,34,45064,32302
151,16,0,1,1,0,0,3,55,48,43090,33669,73,46,45064,32305
152,16,0,0,2,1,2,1,28,28,43090,33669,36,32,45065,32306
153,16,0,2,1,0,0,3,81,63,43090,33671,78,50,45065,32309
154,16,0,1,1,0,0,3,55,61,43090,33672,67,44,45065,32312
155,16,0,1,1,0,0,3,90,54,43090,33673,88,27,45065,32315
156,16,2,2,2,1,2,1,155,36,43092,33675,119,35,45066,32316
157,16,4,1,0,3,1,0,144,28,43096,33676,124,56,45069,32316
158,16,0,0,2,1,2,1,32,32,43096,33676,38,10,45070,32317
159,16,0,1,1,0,0,3,9,6,43096,33677,12,35,45070,32320
160,17,3,0,0,3,1,0,40,38,43099,33677,41,44,45073,32320
161,17,2,1,0,3,1,0,69,43,43101,33678,85,49,45076,32320
162,17,2,0,0,3,1,0,75,61,43103,33678,75,17,45079,32320
163,17,4,2,0,3,1,0,94,56,43107,33680,91,42,45082,32320
164,17,1,0,0,3,1,0,99,43,43108,33680,98,3,45085,32320
165,17,1,2,1,0,0,3,39,37,43109,33682,40,39,45085,32323
166,17,1,3,1,0,0,3,16,12,43110,33685,12,112,45085,32326
167,17,1,2,1,0,0,3,62,40,43111,33687,81,22,45085,32329
168,17,3,2,0,3,1,0,87,59,43114,33689,85,106,45088,32329
169,17,0,2,1,0,0,3,72,52,43114,33691,82,43,45088,32332
170,18,1,2,1,0,0,3,56,63,43115,33693,67,38,45088,32335
171,18,3,1,0,3,1,0,76,51,43118,33694,86,46,45091,32335
172,18,1,2,1,0,0,3,29,30,43119,33696,36,68,45091,32338
173,18,1,0,0,3,1,0,33,32,43120,33696,41,50,45094,32338
174,18,1,0,0,3,1,0,82,63,43121,33696,81,34,45097,32338
175,18,3,1,0,3,1,0,12,7,43124,33697,15,10,45100,32338
176,18,4,3,0,3,1,0,159,39,43128,33700,122,32,45103,32338
177,18,4,0,0,3,1,0,148,28,43132,33700,127,35,45106,32338
178,18,1,1,2,1,2,1,56,49,43133,33701,74,57,45107,32339
179,18,3,1,0,3,1,0,43,39,43136,33702,44,42,45110,32339
180,19,1,2,1,0,0,3,73,54,43137,33704,82,30,45110,32342
181,19,3,1,0,3,1,0,19,13,43140,33705,15,39,45113,32342
182,19,1,0,0,3,1,0,76,61,43141,33705,78,3,45116,32342
183,19,0,0,2,1,2,1,62,40,43141,33705,82,107,45117,32343
184,19,2,0,0,3,1,0,96,56,43143,33705,94,49,45120,32343
185,19,2,0,0,3,1,0,41,37,43145,33705,43,44,45123,32343
186,19,1,1,2,1,2,1,70,44,43146,33706,86,18,45124,32344
187,19,2,0,0,3,1,0,101,43,43148,33706,101,43,45127,32344
188,19,1,3,1,0,0,3,88,62,43149,33709,85,115,45127,32347
189,19,2,2,2,1,2,1,69,59,43151,33711,74,23,45128,32348
190,20,3,2,0,3,1,0,79,63,43154,33713,81,39,45131,32348
191,20,2,0,0,3,1,0,31,30,43156,33713,39,30,45134,32348
192,20,3,2,0,3,1,0,73,46,43159,33715,89,115,45137,32348
193,20,1,1,2,1,2,1,70,60,43160,33716,75,50,45138,32349
194,20,1,1,2,1,2,1,89,63,43161,33717,86,4,45139,32350
195,20,2,1,0,3,1,0,64,41,43163,33718,85,18,45142,32350
196,20,2,0,0,3,1,0,21,13,43165,33718,18,43,45145,32350
197,20,2,0,0,3,1,0,103,43,43167,33718,104,44,45148,32350
198,20,0,5,1,0,0,3,96,61,43167,33723,94,110,45148,32353
199,20,1,1,2,1,2,1,42,38,43168,33724,44,47,45149,32354
200,21,1,1,2,1,2,1,13,8,43169,33725,16,33,45150,32355
201,21,2,1,0,3,1,0,78,52,43171,33726,89,10,45153,32355
202,21,0,0,2,1,2,1,56,63,43171,33726,68,36,45154,32356
203,21,2,3,1,0,0,3,35,35,43173,33729,41,71,45154,32359
204,21,4,0,0,3,1,0,163,39,43177,33729,125,42,45157,32359
205,21,3,0,0,3,1,0,46,39,43180,33729,47,38,45160,32359
206,21,5,1,0,3,1,0,153,29,43185,33730,130,34,45163,32359
207,21,3,0,0,3,1,0,76,54,43188,33730,85,57,45166,32359
208,21,2,3,1,0,0,3,58,52,43190,33733,74,53,45166,32362
209,21,3,0,0,3,1,0,85,63,43193,33733,84,23,45169,32362
210,22,2,2,2,1,2,1,23,15,43195,33735,19,48,45170,32363
211,22,1,0,0,3,1,0,65,41,43196,33735,88,4,45173,32363
212,22,3,1,0,3,1,0,73,61,43199,33736,78,18,45176,32363
213,22,3,2,0,3,1,0,82,65,43202,33738,84,44,45179,32363
214,22,1,0,0,3,1,0,32,30,43203,33738,42,110,45182,32363
215,22,1,1,2,1,2,1,90,64,43204,33739,87,44,45183,32364
216,22,2,1,0,3,1,0,87,64,43206,33740,87,30,45186,32364
217,22,1,1,2,1,2,1,97,62,43207,33741,95,116,45187,32365
218,22,1,0,0,3,1,0,104,43,43208,33741,107,38,45190,32365
219,22,3,0,0,3,1,0,76,46,43211,33741,92,39,45193,32365
220,23,1,1,2,1,2,1,59,53,43212,33742,75,35,45194,32366
221,23,0,1,1,0,0,3,13,9,43212,33743,16,74,45194,32369
222,23,1,2,1,0,0,3,79,54,43213,33745,89,56,45194,32372
223,23,0,3,1,0,0,3,35,38,43213,33748,41,26,45194,32375
224,23,4,1,0,3,1,0,167,40,43217,33749,128,50,45197,32375
225,23,6,1,0,3,1,0,159,30,43223,33750,133,42,45200,32375
226,23,1,2,1,0,0,3,57,65,43224,33752,68,36,45200,32378
227,23,0,4,1,0,0,3,76,58,43224,33756,85,39,45200,32381
228,23,2,1,0,3,1,0,48,40,43226,33757,50,57,45203,32381
229,23,0,0,2,1,2,1,42,38,43226,33757,45,11,45204,32382
230,24,3,1,0,3,1,0,90,65,43229,33758,90,18,45207,32382
231,24,3,1,0,3,1,0,76,62,43232,33759,81,4,45210,32382
232,24,1,0,0,3,1,0,91,64,43233,33759,90,48,45213,32382
233,24,1,2,1,0,0,3,33,32,43234,33761,42,119,45213,32385
234,24,1,0,0,3,1,0,66,41,43235,33761,91,44,45216,32385
235,24,1,1,2,1,2,1,77,47,43236,33762,93,45,45217,32386
236,24,2,0,0,3,1,0,99,62,43238,33762,98,39,45220,32386
237,24,0,3,1,0,0,3,23,18,43238,33765,19,60,45220,32389
238,24,1,0,0,3,1,0,83,65,43239,33765,87,38,45223,32389
239,24,2,0,0,3,1,0,169,40,43241,33765,131,30,45226,32389
240,25,1,3,1,0,0,3,77,61,43242,33768,85,39,45226,32392
241,25,1,3,1,0,0,3,60,56,43243,33771,75,45,45226,32395
242,25,2,2,2,1,2,1,59,67,43245,33773,69,75,45227,32396
243,25,1,2,1,0,0,3,36,40,43246,33775,41,113,45227,32399
244,25,2,1,0,3,1,0,161,31,43248,33776,136,50,45230,32399
245,25,1,2,1,0,0,3,49,42,43249,33778,50,14,45230,32402
246,25,2,1,0,3,1,0,15,10,43251,33779,19,26,45233,32402
247,25,1,0,0,3,1,0,105,43,43252,33779,110,39,45236,32402
248,25,3,0,0,3,1,0,45,38,43255,33779,48,56,45239,32402
249,25,0,2,1,0,0,3,79,56,43255,33781,89,38,45239,32405
250,26,2,0,0,3,1,0,78,62,43257,33781,84,44,45242,32405
251,26,2,1,0,3,1,0,171,41,43259,33782,134,119,45245,32405
252,26,0,0,2,1,2,1,36,40,43259,33782,42,31,45246,32406
253,26,0,1,1,0,0,3,66,42,43259,33783,91,51,45246,32409
254,26,2,2,2,1,2,1,101,64,43261,33785,99,46,45247,32410
255,26,1,2,1,0,0,3,34,34,43262,33787,42,42,45247,32413
256,26,0,0,2,1,2,1,83,65,43262,33787,88,15,45248,32414
257,26,0,0,2,1,2,1,91,64,43262,33787,91,61,45249,32415
258,26,3,3,2,1,2,1,80,50,43265,33790,94,39,45250,32416
259,26,4,1,0,3,1,0,94,66,43269,33791,93,4,45253,32416
260,27,2,1,0,3,1,0,47,39,43271,33792,51,38,45256,32416
261,27,2,0,0,3,1,0,51,42,43273,33792,53,39,45259,32416
262,27,1,1,2,1,2,1,24,19,43274,33793,20,57,45260,32417
263,27,2,0,0,3,1,0,163,31,43276,33793,139,18,45263,32417
264,27,2,1,0,3,1,0,62,57,43278,33794,78,50,45266,32417
265,27,1,0,0,3,1,0,78,61,43279,33794,88,75,45269,32417
266,27,0,0,2,1,2,1,79,56,43279,33794,90,46,45270,32418
267,27,1,2,1,0,0,3,16,12,43280,33796,19,116,45270,32421
268,27,0,1,1,0,0,3,105,44,43280,33797,110,42,45270,32424
269,27,0,0,2,1,2,1,59,67,43280,33797,70,27,45271,32425
270,28,3,1,0,3,1,0,39,41,43283,33798,45,4,45274,32425
271,28,4,1,0,3,1,0,84,51,43287,33799,97,15,45277,32425
272,28,1,0,0,3,1,0,79,62,43288,33799,87,51,45280,32425
273,28,5,2,0,3,1,0,176,43,43293,33801,137,42,45283,32425
274,28,3,0,0,3,1,0,104,64,43296,33801,102,39,45286,32425
275,28,0,2,1,0,0,3,91,66,43296,33803,91,42,45286,32428
276,28,4,0,0,3,1,0,98,66,43300,33803,96,44,45289,32428
277,28,0,2,1,0,0,3,66,44,43300,33805,91,64,45289,32431
278,28,1,1,2,1,2,1,35,35,43301,33806,43,47,45290,32432
279,28,3,1,0,3,1,0,166,32,43304,33807,142,31,45293,32432
280,29,1,3,1,0,0,3,52,45,43305,33810,53,60,45293,32435
281,29,2,2,2,1,2,1,18,14,43307,33812,20,120,45294,32436
282,29,1,1,2,1,2,1,60,68,43308,33813,71,117,45295,32437
283,29,1,0,0,3,1,0,80,56,43309,33813,93,50,45298,32437
284,29,1,3,1,0,0,3,25,22,43310,33816,20,41,45298,32440
285,29,2,3,1,0,0,3,64,60,43312,33819,78,21,45298,32443
286,29,2,2,2,1,2,1,85,67,43314,33821,89,43,45299,32444
287,29,1,1,2,1,2,1,106,45,43315,33822,111,76,45300,32445
288,29,1,0,0,3,1,0,79,61,43316,33822,91,27,45303,32445
289,29,0,0,2,1,2,1,47,39,43316,33822,52,47,45304,32446
290,30,1,5,1,0,0,3,36,40,43317,33827,43,42,45304,32449
291,30,4,2,0,3,1,0,88,53,43321,33829,100,60,45307,32449
292,30,5,1,0,3,1,0,181,44,43326,33830,140,47,45310,32449
293,30,3,2,0,3,1,0,42,43,43329,33832,48,44,45313,32449
294,30,5,0,0,3,1,0,171,32,43334,33832,145,42,45316,32449
295,30,0,2,1,0,0,3,18,16,43334,33834,20,34,45316,32452
296,30,0,2,1,0,0,3,66,46,43334,33836,91,45,45316,32455
297,30,0,0,2,1,2,1,79,62,43334,33836,88,65,45317,32456
298,30,2,1,0,3,1,0,106,65,43336,33837,105,15,45320,32456
299,30,2,1,0,3,1,0,100,67,43338,33838,99,51,45323,32456
300,31,3,3,2,1,2,1,50,42,43341,33841,53,51,45324,32457
301,31,2,1,0,3,1,0,27,23,43343,33842,23,47,45327,32457
302,31,0,4,1,0,0,3,80,60,43343,33846,93,24,45327,32460
303,31,3,3,2,1,2,1,88,70,43346,33849,90,77,45328,32461
304,31,1,0,0,3,1,0,92,66,43347,33849,94,41,45331,32461
305,31,0,2,1,0,0,3,52,47,43347,33851,53,46,45331,32464
306,31,5,0,0,3,1,0,111,45,43352,33851,114,27,45334,32464
307,31,0,3,1,0,0,3,60,71,43352,33854,71,123,45334,32467
308,31,0,3,1,0,0,3,79,64,43352,33857,91,120,45334,32470
309,31,1,0,0,3,1,0,65,60,43353,33857,81,4,45337,32470
310,32,1,1,2,1,2,1,66,61,43354,33858,82,35,45338,32471
311,32,1,1,2,1,2,1,37,41,43355,33859,44,16,45339,32472
312,32,3,1,0,3,1,0,184,45,43358,33860,143,42,45342,32472
313,32,1,0,0,3,1,0,172,32,43359,33860,148,47,45345,32472
314,32,5,1,0,3,1,0,111,66,43364,33861,108,60,45348,32472
315,32,0,2,1,0,0,3,79,64,43364,33863,88,48,45348,32475
316,32,1,1,2,1,2,1,43,44,43365,33864,49,52,45349,32476
317,32,0,0,2,1,2,1,66,46,43365,33864,92,47,45350,32477
318,32,0,1,1,0,0,3,100,68,43365,33865,99,68,45350,32480
319,32,2,1,0,3,1,0,20,17,43367,33866,23,44,45353,32480
320,33,2,2,2,1,2,1,54,49,43369,33868,54,42,45354,32481
321,33,0,1,1,0,0,3,80,61,43369,33869,93,7,45354,32484
322,33,2,2,2,1,2,1,81,66,43371,33871,92,124,45355,32485
323,33,1,2,1,0,0,3,112,47,43372,33873,114,123,45355,32488
324,33,3,2,0,3,1,0,63,73,43375,33875,74,42,45358,32488
325,33,0,1,1,0,0,3,88,71,43375,33876,90,30,45358,32491
326,33,2,1,0,3,1,0,94,67,43377,33877,97,47,45361,32491
327,33,1,1,2,1,2,1,28,24,43378,33878,24,52,45362,32492
328,33,4,2,0,3,1,0,92,55,43382,33880,103,77,45365,32492
329,33,1,1,2,1,2,1,51,43,43383,33881,54,25,45366,32493
330,34,1,1,2,1,2,1,21,18,43384,33882,24,53,45367,32494
331,34,4,0,0,3,1,0,115,66,43388,33882,111,42,45370,32494
332,34,1,0,0,3,1,0,38,41,43389,33882,47,60,45373,32494
333,34,4,3,0,3,1,0,188,48,43393,33885,146,16,45376,32494
334,34,0,0,2,1,2,1,43,44,43393,33885,50,69,45377,32495
335,34,1,1,2,1,2,1,67,62,43394,33886,83,48,45378,32496
336,34,3,0,0,3,1,0,66,73,43397,33886,77,35,45381,32496
337,34,3,0,0,3,1,0,103,68,43400,33886,102,48,45384,32496
338,34,4,2,0,3,1,0,176,34,43404,33888,151,42,45387,32496
339,34,2,1,0,3,1,0,81,65,43406,33889,91,47,45390,32496
340,35,0,0,2,1,2,1,80,61,43406,33889,94,45,45391,32497
341,35,2,1,0,3,1,0,83,67,43408,33890,95,42,45394,32497
342,35,1,0,0,3,1,0,29,24,43409,33890,27,25,45397,32497
343,35,1,0,0,3,1,0,67,46,43410,33890,95,47,45400,32497
344,35,1,1,2,1,2,1,89,72,43411,33891,91,124,45401,32498
345,35,0,4,1,0,0,3,54,53,43411,33895,54,80,45401,32501
346,35,1,0,0,3,1,0,52,43,43412,33895,57,7,45404,32501
347,35,1,2,1,0,0,3,113,49,43413,33897,114,127,45404,32504
348,35,0,0,2,1,2,1,94,67,43413,33897,98,53,45405,32505
349,35,2,2,2,1,2,1,94,57,43415,33899,104,31,45406,32506
350,36,1,3,1,0,0,3,22,21,43416,33902,24,72,45406,32509
351,36,6,2,0,3,1,0,194,50,43422,33904,149,60,45409,32509
352,36,0,1,1,0,0,3,81,66,43422,33905,91,83,45409,32512
353,36,3,0,0,3,1,0,41,41,43425,33905,50,42,45412,32512
354,36,1,2,1,0,0,3,104,70,43426,33907,102,50,45412,32515
355,36,2,3,1,0,0,3,82,64,43428,33910,94,38,45412,32518
356,36,2,0,0,3,1,0,45,44,43430,33910,53,48,45415,32518
357,36,1,2,1,0,0,3,67,75,43431,33912,77,56,45415,32521
358,36,2,1,0,3,1,0,178,35,43433,33913,154,16,45418,32521
359,36,1,0,0,3,1,0,68,62,43434,33913,86,42,45421,32521
360,37,1,2,1,0,0,3,82,68,43435,33915,91,41,45421,32524
361,37,1,0,0,3,1,0,116,66,43436,33915,114,31,45424,32524
362,37,2,1,0,3,1,0,69,47,43438,33916,98,53,45427,32524
363,37,3,3,2,1,2,1,97,60,43441,33919,105,125,45428,32525
364,37,3,1,0,3,1,0,97,68,43444,33920,101,25,45431,32525
365,37,0,2,1,0,0,3,89,74,43444,33922,91,130,45431,32528
366,37,0,2,1,0,0,3,29,26,43444,33924,27,10,45431,32531
367,37,0,0,2,1,2,1,113,49,43444,33924,115,43,45432,32532
368,37,4,0,0,3,1,0,56,43,43448,33924,60,45,45435,32532
369,37,0,1,1,0,0,3,83,68,43448,33925,95,51,45435,32535
370,38,4,2,0,3,1,0,198,52,43452,33927,152,42,45438,32535
371,38,4,1,0,3,1,0,182,36,43456,33928,157,60,45441,32535
372,38,2,0,0,3,1,0,43,41,43458,33928,53,47,45444,32535
373,38,4,3,0,3,1,0,108,73,43462,33931,105,83,45447,32535
374,38,0,1,1,0,0,3,45,45,43462,33932,53,53,45447,32538
375,38,1,0,0,3,1,0,23,21,43463,33932,27,48,45450,32538
376,38,4,2,0,3,1,0,72,64,43467,33934,89,16,45453,32538
377,38,1,3,1,0,0,3,68,78,43468,33937,77,75,45453,32541
378,38,1,1,2,1,2,1,83,65,43469,33938,95,43,45454,32542
379,38,2,2,2,1,2,1,56,55,43471,33940,55,57,45455,32543
0,1,2,0,0,3,1,0,99,60,43473,33940,108,47,45458,32543
1,1,1,2,1,0,0,3,30,28,43474,33942,27,60,45458,32546
2,1,1,0,0,3,1,0,117,66,43475,33942,117,60,45461,32546
3,1,7,0,0,3,1,0,189,36,43482,33942,160,51,45464,32546
4,1,2,1,0,3,1,0,200,53,43484,33943,155,43,45467,32546
5,1,1,2,1,0,0,3,70,49,43485,33945,98,34,45467,32549
6,1,1,3,1,0,0,3,109,76,43486,33948,105,78,45467,32552
7,1,3,0,0,3,1,0,59,55,43489,33948,58,0,45470,32552
8,1,2,2,2,1,2,1,25,23,43491,33950,28,49,45471,32553
9,1,2,3,1,0,0,3,25,38,43493,33953,19,36,45471,32556
10,2,2,2,2,1,2,1,84,70,43495,33955,92,12,45472,32557
11,2,2,0,0,3,1,0,85,68,43497,33955,98,42,45475,32557
12,2,1,1,2,1,2,1,1,1,43498,33956,1,54,45476,32558
13,2,3,1,0,3,1,0,92,75,43501,33957,94,83,45479,32558
14,2,2,1,0,3,1,0,61,35,43503,33958,73,16,45482,32558
15,2,5,0,0,3,1,0,118,49,43508,33958,118,41,45485,32558
16,2,0,0,2,1,2,1,83,65,43508,33958,96,54,45486,32559
17,2,0,1,1,0,0,3,97,69,43508,33959,101,133,45486,32562
18,2,1,2,1,0,0,3,57,45,43509,33961,60,13,45486,32565
19,2,0,1,1,0,0,3,43,42,43509,33962,53,128,45486,32568
20,3,2,2,2,1,2,1,27,40,43511,33964,20,1,45487,32569
21,3,1,2,1,0,0,3,60,57,43512,33966,58,54,45487,32572
22,3,1,1,2,1,2,1,26,24,43513,33967,29,35,45488,32573
23,3,1,0,0,3,1,0,31,28,43514,33967,30,47,45491,32573
24,3,0,3,1,0,0,3,70,52,43514,33970,98,39,45491,32576
25,3,3,1,0,3,1,0,203,54,43517,33971,158,60,45494,32576
26,3,0,0,2,1,2,1,92,75,43517,33971,95,44,45495,32577
27,3,1,2,1,0,0,3,100,62,43518,33973,108,81,45495,32580
28,3,2,2,2,1,2,1,111,78,43520,33975,106,61,45496,32581
29,3,2,3,1,0,0,3,119,69,43522,33978,117,136,45496,32584
30,4,4,2,0,3,1,0,122,51,43526,33980,121,12,45499,32584
31,4,0,0,2,1,2,1,83,65,43526,33980,97,55,45500,32585
32,4,3,2,0,3,1,0,192,38,43529,33982,163,54,45503,32585
33,4,2,2,2,1,2,1,63,37,43531,33984,74,129,45504,32586
34,4,0,1,1,0,0,3,43,43,43531,33985,53,52,45504,32589
35,4,2,1,0,3,1,0,86,71,43533,33986,95,42,45507,32589
36,4,5,0,0,3,1,0,102,69,43538,33986,104,41,45510,32589
37,4,3,1,0,3,1,0,60,46,43541,33987,63,83,45513,32589
38,4,0,0,2,1,2,1,1,1,43541,33987,2,17,45514,32590
39,4,3,2,0,3,1,0,88,70,43544,33989,101,13,45517,32590
40,5,2,1,0,3,1,0,72,53,43546,33990,101,1,45520,32590
41,5,0,0,2,1,2,1,100,62,43546,33990,109,62,45521,32591
42,5,2,2,2,1,2,1,29,42,43548,33992,21,55,45522,32592
43,5,0,4,1,0,0,3,60,61,43548,33996,58,139,45522,32595
44,5,0,2,1,0,0,3,31,30,43548,33998,30,84,45522,32598
45,5,0,0,2,1,2,1,60,46,43548,33998,64,36,45523,32599
46,5,0,0,2,1,2,1,26,24,43548,33998,30,40,45524,32600
47,5,4,1,0,3,1,0,207,55,43552,33999,161,47,45527,32600
48,5,3,1,0,3,1,0,122,70,43555,34000,120,54,45530,32600
49,5,3,2,0,3,1,0,95,77,43558,34002,98,60,45533,32600
50,6,4,1,0,3,1,0,196,39,43562,34003,166,55,45536,32600
51,6,1,1,2,1,2,1,84,66,43563,34004,98,18,45537,32601
52,6,2,1,0,3,1,0,124,52,43565,34005,124,42,45540,32601
53,6,2,0,0,3,1,0,104,69,43567,34005,107,12,45543,32601
54,6,0,1,1,0,0,3,43,44,43567,34006,53,86,45543,32604
55,6,4,1,0,3,1,0,115,79,43571,34007,109,41,45546,32604
56,6,1,2,1,0,0,3,2,3,43572,34009,2,132,45546,32607
57,6,2,1,0,3,1,0,90,71,43574,34010,104,44,45549,32607
58,6,2,1,0,3,1,0,65,38,43576,34011,77,52,45552,32607
59,6,2,0,0,3,1,0,88,71,43578,34011,98,13,45555,32607
60,7,2,2,2,1,2,1,33,32,43580,34013,31,63,45556,32608
61,7,1,0,0,3,1,0,123,70,43581,34013,123,41,45559,32608
62,7,0,2,1,0,0,3,29,44,43581,34015,21,142,45559,32611
63,7,1,1,2,1,2,1,101,63,43582,34016,110,55,45560,32612
64,7,0,1,1,0,0,3,207,56,43582,34017,161,87,45560,32615
65,7,0,1,1,0,0,3,72,54,43582,34018,101,58,45560,32618
66,7,0,1,1,0,0,3,26,25,43582,34019,30,4,45560,32621
67,7,0,2,1,0,0,3,95,79,43582,34021,98,50,45560,32624
68,7,1,0,0,3,1,0,61,46,43583,34021,67,40,45563,32624
69,7,2,0,0,3,1,0,45,44,43585,34021,56,60,45566,32624
70,8,3,0,0,3,1,0,68,38,43588,34021,80,36,45569,32624
71,8,0,1,1,0,0,3,104,70,43588,34022,107,45,45569,32627
72,8,2,1,0,3,1,0,4,4,43590,34023,5,52,45572,32627
73,8,1,0,0,3,1,0,61,61,43591,34023,61,55,45575,32627
74,8,2,3,1,0,0,3,86,69,43593,34026,98,135,45575,32630
75,8,4,1,0,3,1,0,200,40,43597,34027,169,18,45578,32630
76,8,2,1,0,3,1,0,126,53,43599,34028,127,13,45581,32630
77,8,2,1,0,3,1,0,117,80,43601,34029,112,12,45584,32630
78,8,3,1,0,3,1,0,91,72,43604,34030,101,44,45587,32630
79,8,1,1,2,1,2,1,91,72,43605,34031,105,87,45588,32631
80,9,2,0,0,3,1,0,209,56,43607,34031,164,63,45591,32631
81,9,1,2,1,0,0,3,124,72,43608,34033,123,58,45591,32634
82,9,0,0,2,1,2,1,72,54,43608,34033,102,143,45592,32635
83,9,1,0,0,3,1,0,96,79,43609,34033,101,87,45595,32635
84,9,0,2,1,0,0,3,45,46,43609,34035,56,53,45595,32638
85,9,0,1,1,0,0,3,29,45,43609,34036,21,44,45595,32641
86,9,1,2,1,0,0,3,62,48,43610,34038,67,7,45595,32644
87,9,2,2,2,1,2,1,35,34,43612,34040,32,56,45596,32645
88,9,0,1,1,0,0,3,26,26,43612,34041,30,61,45596,32648
89,9,2,0,0,3,1,0,93,72,43614,34041,108,40,45599,32648
90,10,0,3,1,0,0,3,61,64,43614,34044,61,21,45599,32651
91,10,0,5,1,0,0,3,104,75,43614,34049,107,16,45599,32654
92,10,2,1,0,3,1,0,202,41,43616,34050,172,135,45602,32654
93,10,0,1,1,0,0,3,4,5,43616,34051,5,39,45602,32657
94,10,3,0,0,3,1,0,89,69,43619,34051,101,52,45605,32657
95,10,2,1,0,3,1,0,119,81,43621,34052,115,45,45608,32657
96,10,4,1,0,3,1,0,72,39,43625,34053,83,87,45611,32657
97,10,3,0,0,3,1,0,104,63,43628,34053,113,12,45614,32657
98,10,5,0,0,3,1,0,131,53,43633,34053,130,44,45617,32657
99,10,0,1,1,0,0,3,91,73,43633,34054,101,63,45617,32660
100,11,0,0,2,1,2,1,96,79,43633,34054,102,64,45618,32661
101,11,0,3,1,0,0,3,26,29,43633,34057,30,146,45618,32664
102,11,2,2,2,1,2,1,37,36,43635,34059,33,59,45619,32665
103,11,1,2,1,0,0,3,125,74,43636,34061,123,15,45619,32668
104,11,7,3,0,3,1,0,216,59,43643,34064,167,56,45622,32668
105,11,3,1,0,3,1,0,75,55,43646,34065,105,44,45625,32668
106,11,0,2,1,0,0,3,72,41,43646,34067,83,56,45625,32671
107,11,1,2,1,0,0,3,46,48,43647,34069,56,90,45625,32674
108,11,2,2,2,1,2,1,95,74,43649,34071,109,8,45626,32675
109,11,0,0,2,1,2,1,62,48,43649,34071,68,62,45627,32676
110,12,1,0,0,3,1,0,203,41,43650,34071,175,52,45630,32676
111,12,5,0,0,3,1,0,109,63,43655,34071,116,45,45633,32676
112,12,1,0,0,3,1,0,30,45,43656,34071,24,21,45636,32676
113,12,2,3,1,0,0,3,63,67,43658,34074,61,138,45636,32679
114,12,0,1,1,0,0,3,119,82,43658,34075,115,19,45636,32682
115,12,0,1,1,0,0,3,91,74,43658,34076,101,90,45636,32685
116,12,2,0,0,3,1,0,133,53,43660,34076,133,63,45639,32685
117,12,0,1,1,0,0,3,89,70,43660,34077,101,42,45639,32688
118,12,3,2,0,3,1,0,107,77,43663,34079,110,44,45642,32688
119,12,0,1,1,0,0,3,4,6,43663,34080,5,43,45642,32691
120,13,0,1,1,0,0,3,75,56,43663,34081,105,18,45642,32694
121,13,3,1,0,3,1,0,49,49,43666,34082,59,64,45645,32694
122,13,5,1,0,3,1,0,221,60,43671,34083,170,59,45648,32694
123,13,1,1,2,1,2,1,92,75,43672,34084,102,9,45649,32695
124,13,2,1,0,3,1,0,97,75,43674,34085,112,62,45652,32695
125,13,0,2,1,0,0,3,26,31,43674,34087,30,47,45652,32698
126,13,1,3,1,0,0,3,97,82,43675,34090,102,59,45652,32701
127,13,2,2,2,1,2,1,127,76,43677,34092,124,22,45653,32702
128,13,1,1,2,1,2,1,73,42,43678,34093,84,91,45654,32703
129,13,1,4,1,0,0,3,63,52,43679,34097,68,149,45654,32706
130,14,0,1,1,0,0,3,37,37,43679,34098,33,48,45654,32709
131,14,4,0,0,3,1,0,207,41,43683,34098,178,42,45657,32709
132,14,4,3,0,3,1,0,113,66,43687,34101,119,19,45660,32709
133,14,0,5,1,0,0,3,30,50,43687,34106,24,141,45660,32712
134,14,7,0,0,3,1,0,140,53,43694,34106,136,56,45663,32712
135,14,0,3,1,0,0,3,89,73,43694,34109,101,46,45663,32715
136,14,1,4,1,0,0,3,64,71,43695,34113,61,55,45663,32718
137,14,2,1,0,3,1,0,6,7,43697,34114,8,90,45666,32718
138,14,4,0,0,3,1,0,123,82,43701,34114,118,44,45669,32718
139,14,1,2,1,0,0,3,108,79,43702,34116,110,66,45669,32721
140,15,1,0,0,3,1,0,93,75,43703,34116,105,62,45672,32721
141,15,1,1,2,1,2,1,74,43,43704,34117,85,65,45673,32722
142,15,0,2,1,0,0,3,6,9,43704,34119,8,94,45673,32725
143,15,3,1,0,3,1,0,29,32,43707,34120,33,18,45676,32725
144,15,4,0,0,3,1,0,225,60,43711,34120,173,22,45679,32725
145,15,1,2,1,0,0,3,98,84,43712,34122,102,62,45679,32728
146,15,2,2,2,1,2,1,65,54,43714,34124,69,48,45680,32729
147,15,1,2,1,0,0,3,50,51,43715,34126,59,62,45680,32732
148,15,3,0,0,3,1,0,130,76,43718,34126,127,48,45683,32732
149,15,1,0,0,3,1,0,98,75,43719,34126,115,149,45686,32732
150,16,2,1,0,3,1,0,91,74,43721,34127,104,9,45689,32732
151,16,2,2,2,1,2,1,77,58,43723,34129,106,142,45690,32733
152,16,0,2,1,0,0,3,64,73,43723,34131,61,45,45690,32736
153,16,2,1,0,3,1,0,209,42,43725,34132,181,46,45693,32736
154,16,1,0,0,3,1,0,109,79,43726,34132,113,56,45696,32736
155,16,0,0,2,1,2,1,30,50,43726,34132,25,56,45697,32737
156,16,5,1,0,3,1,0,118,67,43731,34133,122,44,45700,32737
157,16,1,1,2,1,2,1,124,83,43732,34134,119,67,45701,32738
158,16,3,0,0,3,1,0,143,53,43735,34134,139,90,45704,32738
159,16,3,0,0,3,1,0,40,37,43738,34134,36,19,45707,32738
160,17,0,1,1,0,0,3,6,10,43738,34135,8,68,45707,32741
161,17,1,2,1,0,0,3,75,45,43739,34137,85,65,45707,32744
162,17,0,1,1,0,0,3,65,55,43739,34138,69,21,45707,32747
163,17,3,2,0,3,1,0,146,55,43742,34140,142,62,45710,32747
164,17,1,3,1,0,0,3,51,54,43743,34143,59,65,45710,32750
165,17,4,2,0,3,1,0,102,86,43747,34145,105,22,45713,32750
166,17,2,5,1,0,0,3,95,80,43749,34150,105,152,45713,32753
167,17,2,1,0,3,1,0,100,76,43751,34151,118,48,45716,32753
168,17,1,1,2,1,2,1,30,33,43752,34152,34,49,45717,32754
169,17,2,3,1,0,0,3,132,79,43754,34155,127,145,45717,32757
170,18,0,1,1,0,0,3,109,80,43754,34156,113,97,45717,32760
171,18,0,0,2,1,2,1,40,37,43754,34156,37,45,45718,32761
172,18,2,0,0,3,1,0,134,79,43756,34156,130,62,45721,32761
173,18,3,0,0,3,1,0,33,50,43759,34156,28,45,45724,32761
174,18,3,0,0,3,1,0,127,83,43762,34156,122,56,45727,32761
175,18,4,0,0,3,1,0,213,42,43766,34156,184,9,45730,32761
176,18,1,0,0,3,1,0,78,58,43767,34156,109,56,45733,32761
177,18,2,0,0,3,1,0,120,67,43769,34156,125,67,45736,32761
178,18,3,0,0,3,1,0,228,60,43772,34156,176,19,45739,32761
179,18,2,5,1,0,0,3,66,78,43774,34161,61,49,45739,32764
180,19,4,0,0,3,1,0,55,54,43778,34161,62,22,45742,32764
181,19,6,1,0,3,1,0,106,77,43784,34162,121,21,45745,32764
182,19,2,1,0,3,1,0,32,34,43786,34163,37,90,45748,32764
183,19,0,0,2,1,2,1,146,55,43786,34163,143,153,45749,32765
184,19,1,1,2,1,2,1,7,11,43787,34164,9,66,45750,32766
185,19,0,1,1,0,0,3,95,81,43787,34165,105,51,45750,32769
186,19,1,2,1,0,0,3,66,57,43788,34167,69,52,45750,32772
187,19,0,1,1,0,0,3,102,87,43788,34168,105,148,45750,32775
188,19,1,0,0,3,1,0,92,74,43789,34168,107,68,45753,32775
189,19,5,1,0,3,1,0,80,46,43794,34169,88,65,45756,32775
190,20,0,0,2,1,2,1,109,80,43794,34169,114,91,45757,32776
191,20,0,5,1,0,0,3,66,62,43794,34174,69,151,45757,32779
192,20,2,0,0,3,1,0,9,11,43796,34174,12,51,45760,32779
193,20,0,0,2,1,2,1,55,54,43796,34174,63,53,45761,32780
194,20,1,0,0,3,1,0,103,87,43797,34174,108,19,45764,32780
195,20,2,2,2,1,2,1,97,83,43799,34176,106,66,45765,32781
196,20,2,0,0,3,1,0,82,46,43801,34176,91,21,45768,32781
197,20,1,1,2,1,2,1,93,75,43802,34177,108,154,45769,32782
198,20,1,1,2,1,2,1,147,56,43803,34178,144,67,45770,32783
199,20,4,2,0,3,1,0,110,79,43807,34180,124,22,45773,32783
200,21,4,2,0,3,1,0,36,36,43811,34182,40,45,45776,32783
201,21,2,0,0,3,1,0,230,60,43813,34182,179,45,45779,32783
202,21,1,0,0,3,1,0,41,37,43814,34182,40,49,45782,32783
203,21,2,2,2,1,2,1,136,81,43816,34184,131,57,45783,32784
204,21,2,3,1,0,0,3,129,86,43818,34187,122,65,45783,32787
205,21,1,0,0,3,1,0,34,50,43819,34187,31,56,45786,32787
206,21,1,5,1,0,0,3,79,63,43820,34192,109,70,45786,32790
207,21,2,4,1,0,0,3,68,82,43822,34196,61,100,45786,32793
208,21,3,0,0,3,1,0,216,42,43825,34196,187,68,45789,32793
209,21,4,0,0,3,1,0,124,67,43829,34196,128,9,45792,32793
210,22,1,2,1,0,0,3,56,56,43830,34198,63,22,45792,32796
211,22,2,3,1,0,0,3,218,45,43832,34201,187,94,45792,32799
212,22,0,0,2,1,2,1,93,75,43832,34201,109,52,45793,32800
213,22,0,0,2,1,2,1,97,83,43832,34201,107,23,45794,32801
214,22,3,2,0,3,1,0,112,82,43835,34203,117,67,45797,32801
215,22,1,0,0,3,1,0,10,11,43836,34203,15,21,45800,32801
216,22,2,0,0,3,1,0,68,62,43838,34203,72,57,45803,32801
217,22,4,0,0,3,1,0,151,56,43842,34203,147,66,45806,32801
218,22,1,1,2,1,2,1,111,80,43843,34204,125,152,45807,32802
219,22,3,1,0,3,1,0,85,47,43846,34205,94,53,45810,32802
220,23,1,0,0,3,1,0,104,87,43847,34205,111,45,45813,32802
221,23,5,0,0,3,1,0,141,81,43852,34205,134,45,45816,32802
222,23,4,1,0,3,1,0,72,83,43856,34206,64,68,45819,32802
223,23,4,2,0,3,1,0,234,62,43860,34208,182,49,45822,32802
224,23,2,0,0,3,1,0,36,50,43862,34208,34,100,45825,32802
225,23,2,0,0,3,1,0,81,63,43864,34208,112,56,45828,32802
226,23,2,2,2,1,2,1,43,39,43866,34210,41,10,45829,32803
227,23,0,0,2,1,2,1,124,67,43866,34210,129,66,45830,32804
228,23,1,4,1,0,0,3,130,90,43867,34214,122,157,45830,32807
229,23,0,0,2,1,2,1,36,36,43867,34214,41,71,45831,32808
230,24,0,0,2,1,2,1,10,11,43867,34214,16,54,45832,32809
231,24,3,0,0,3,1,0,154,56,43870,34214,150,23,45835,32809
232,24,1,0,0,3,1,0,94,75,43871,34214,112,21,45838,32809
233,24,6,0,0,3,1,0,224,45,43877,34214,190,52,45841,32809
234,24,0,2,1,0,0,3,85,49,43877,34216,94,25,45841,32812
235,24,1,0,0,3,1,0,57,56,43878,34216,66,45,45844,32812
236,24,0,3,1,0,0,3,97,86,43878,34219,107,155,45844,32815
237,24,1,2,1,0,0,3,112,82,43879,34221,125,60,45844,32818
238,24,0,0,2,1,2,1,130,90,43879,34221,123,95,45845,32819
239,24,0,1,1,0,0,3,112,83,43879,34222,117,69,45845,32822
240,25,1,1,2,1,2,1,44,40,43880,34223,42,67,45846,32823
241,25,3,0,0,3,1,0,237,62,43883,34223,185,10,45849,32823
242,25,1,1,2,1,2,1,37,37,43884,34224,42,57,45850,32824
243,25,3,1,0,3,1,0,127,68,43887,34225,132,157,45853,32824
244,25,0,0,2,1,2,1,36,50,43887,34225,35,69,45854,32825
245,25,0,1,1,0,0,3,72,84,43887,34226,64,70,45854,32828
246,25,0,2,1,0,0,3,68,64,43887,34228,72,74,45854,32831
247,25,2,1,0,3,1,0,143,82,43889,34229,137,45,45857,32831
248,25,3,0,0,3,1,0,84,63,43892,34229,115,100,45860,32831
249,25,1,2,1,0,0,3,105,89,43893,34231,111,52,45860,32834
250,26,4,0,0,3,1,0,116,82,43897,34231,128,45,45863,32834
251,26,1,1,2,1,2,1,113,84,43898,34232,118,24,45864,32835
252,26,2,0,0,3,1,0,96,75,43900,34232,115,54,45867,32835
253,26,0,0,2,1,2,1,97,86,43900,34232,108,61,45868,32836
254,26,1,0,0,3,1,0,11,11,43901,34232,19,25,45871,32836
255,26,1,1,2,1,2,1,86,50,43902,34233,95,46,45872,32837
256,26,2,2,2,1,2,1,156,58,43904,34235,151,156,45873,32838
257,26,1,0,0,3,1,0,131,90,43905,34235,126,69,45876,32838
258,26,4,1,0,3,1,0,228,46,43909,34236,193,21,45879,32838
259,26,1,0,0,3,1,0,73,84,43910,34236,67,95,45882,32838
260,27,1,0,0,3,1,0,45,40,43911,34236,45,157,45885,32838
261,27,2,0,0,3,1,0,70,64,43913,34236,75,57,45888,32838
262,27,0,2,1,0,0,3,37,39,43913,34238,42,103,45888,32841
263,27,2,0,0,3,1,0,59,56,43915,34238,69,52,45891,32841
264,27,3,1,0,3,1,0,108,90,43918,34239,114,10,45894,32841
265,27,1,3,1,0,0,3,37,53,43919,34242,35,73,45894,32844
266,27,3,0,0,3,1,0,240,62,43922,34242,188,67,45897,32844
267,27,1,1,2,1,2,1,144,83,43923,34243,138,75,45898,32845
268,27,0,2,1,0,0,3,84,65,43923,34245,115,72,45898,32848
269,27,2,3,1,0,0,3,129,71,43925,34248,132,55,45898,32851
270,28,3,3,2,1,2,1,100,89,43928,34251,109,46,45899,32852
271,28,0,1,1,0,0,3,96,76,43928,34252,115,28,45899,32855
272,28,3,1,0,3,1,0,76,85,43931,34253,70,21,45902,32855
273,28,0,1,1,0,0,3,113,85,43931,34254,118,159,45902,32858
274,28,1,0,0,3,1,0,157,58,43932,34254,154,61,45905,32858
275,28,0,0,2,1,2,1,11,11,43932,34254,20,47,45906,32859
276,28,7,0,0,3,1,0,235,46,43939,34254,196,54,45909,32859
277,28,4,1,0,3,1,0,135,91,43943,34255,129,24,45912,32859
278,28,1,0,0,3,1,0,130,71,43944,34255,135,95,45915,32859
279,28,1,1,2,1,2,1,87,51,43945,34256,96,76,45916,32860
280,29,0,2,1,0,0,3,37,41,43945,34258,42,75,45916,32863
281,29,1,0,0,3,1,0,60,56,43946,34258,72,10,45919,32863
282,29,0,0,2,1,2,1,108,90,43946,34258,115,68,45920,32864
283,29,1,1,2,1,2,1,46,41,43947,34259,46,56,45921,32865
284,29,1,0,0,3,1,0,117,82,43948,34259,131,57,45924,32865
285,29,1,2,1,0,0,3,85,67,43949,34261,115,76,45924,32868
286,29,0,2,1,0,0,3,70,66,43949,34263,75,106,45924,32871
287,29,2,1,0,3,1,0,146,84,43951,34264,141,52,45927,32871
288,29,3,4,1,0,0,3,243,66,43954,34268,188,160,45927,32874
289,29,4,3,0,3,1,0,41,56,43958,34271,38,69,45930,32874
290,30,1,2,1,0,0,3,114,87,43959,34273,118,64,45930,32877
291,30,0,0,2,1,2,1,11,11,43959,34273,21,77,45931,32878
292,30,3,0,0,3,1,0,238,46,43962,34273,199,28,45934,32878
293,30,1,0,0,3,1,0,77,85,43963,34273,73,54,45937,32878
294,30,1,0,0,3,1,0,158,58,43964,34273,157,46,45940,32878
295,30,2,1,0,3,1,0,137,92,43966,34274,132,159,45943,32878
296,30,0,1,1,0,0,3,100,90,43966,34275,109,55,45943,32881
297,30,1,0,0,3,1,0,131,71,43967,34275,138,24,45946,32881
298,30,1,3,1,0,0,3,97,79,43968,34278,115,50,45946,32884
299,30,2,2,2,1,2,1,43,58,43970,34280,39,96,45947,32885
300,31,0,1,1,0,0,3,108,91,43970,34281,115,163,45947,32888
301,31,1,0,0,3,1,0,38,41,43971,34281,45,76,45950,32888
302,31,1,2,1,0,0,3,118,84,43972,34283,131,109,45950,32891
303,31,5,0,0,3,1,0,248,66,43977,34283,191,56,45953,32891
304,31,1,0,0,3,1,0,47,41,43978,34283,49,21,45956,32891
305,31,1,1,2,1,2,1,86,68,43979,34284,116,70,45957,32892
306,31,1,1,2,1,2,1,88,52,43980,34285,97,11,45958,32893
307,31,1,3,1,0,0,3,147,87,43981,34288,141,60,45958,32896
308,31,0,2,1,0,0,3,60,58,43981,34290,72,71,45958,32899
309,31,1,2,1,0,0,3,71,68,43982,34292,75,78,45958,32902
310,32,1,2,1,0,0,3,44,60,43983,34294,39,57,45958,32905
311,32,1,0,0,3,1,0,159,58,43984,34294,160,55,45961,32905
312,32,3,1,0,3,1,0,241,47,43987,34295,202,50,45964,32905
313,32,0,4,1,0,0,3,131,75,43987,34299,138,162,45964,32908
314,32,3,0,0,3,1,0,80,85,43990,34299,76,28,45967,32908
315,32,4,1,0,3,1,0,118,88,43994,34300,121,46,45970,32908
316,32,1,0,0,3,1,0,12,11,43995,34300,24,60,45973,32908
317,32,4,1,0,3,1,0,141,93,43999,34301,135,64,45976,32908
318,32,0,0,2,1,2,1,47,41,43999,34301,50,97,45977,32909
319,32,1,2,1,0,0,3,98,81,44000,34303,115,80,45977,32912
320,33,0,0,2,1,2,1,86,68,44000,34303,117,25,45978,32913
321,33,2,2,2,1,2,1,40,43,44002,34305,46,71,45979,32914
322,33,1,0,0,3,1,0,89,52,44003,34305,100,71,45982,32914
323,33,1,0,0,3,1,0,61,58,44004,34305,75,163,45985,32914
324,33,4,0,0,3,1,0,252,66,44008,34305,194,21,45988,32914
325,33,0,2,1,0,0,3,71,70,44008,34307,75,79,45988,32917
326,33,2,1,0,3,1,0,149,88,44010,34308,144,11,45991,32917
327,33,0,2,1,0,0,3,100,92,44010,34310,109,112,45991,32920
328,33,2,2,2,1,2,1,110,93,44012,34312,116,57,45992,32921
329,33,3,0,0,3,1,0,121,84,44015,34312,134,78,45995,32921
330,34,2,0,0,3,1,0,161,58,44017,34312,163,11,45998,32921
331,34,1,1,2,1,2,1,87,69,44018,34313,118,98,45999,32922
332,34,0,0,2,1,2,1,98,81,44018,34313,116,61,46000,32923
333,34,2,1,0,3,1,0,133,76,44020,34314,141,64,46003,32923
334,34,2,4,1,0,0,3,46,64,44022,34318,39,31,46003,32926
335,34,3,1,0,3,1,0,83,86,44025,34319,79,50,46006,32926
336,34,4,0,0,3,1,0,145,93,44029,34319,138,46,46009,32926
337,34,2,1,0,3,1,0,243,48,44031,34320,205,80,46012,32926
338,34,2,0,0,3,1,0,120,88,44033,34320,124,55,46015,32926
339,34,1,1,2,1,2,1,48,42,44034,34321,51,163,46016,32927
340,35,1,1,2,1,2,1,13,12,44035,34322,25,72,46017,32928
341,35,0,3,1,0,0,3,61,61,44035,34325,75,60,46017,32931
342,35,1,0,0,3,1,0,101,92,44036,34325,112,78,46020,32931
343,35,4,0,0,3,1,0,256,66,44040,34325,197,57,46023,32931
344,35,0,1,1,0,0,3,71,71,44040,34326,75,74,46023,32934
345,35,1,2,1,0,0,3,111,95,44041,34328,116,24,46023,32937
346,35,0,1,1,0,0,3,149,89,44041,34329,144,115,46023,32940
347,35,3,1,0,3,1,0,124,85,44044,34330,137,79,46026,32940
348,35,2,3,1,0,0,3,91,55,44046,34333,100,166,46026,32943
349,35,4,1,0,3,1,0,44,44,44050,34334,49,25,46029,32943
350,36,0,3,1,0,0,3,83,89,44050,34337,79,83,46029,32946
351,36,2,2,2,1,2,1,245,50,44052,34339,206,62,46030,32947
352,36,0,1,1,0,0,3,120,89,44052,34340,124,14,46030,32950
353,36,0,2,1,0,0,3,87,71,44052,34342,118,34,46030,32953
354,36,1,0,0,3,1,0,49,42,44053,34342,54,64,46033,32953
355,36,3,2,0,3,1,0,49,66,44056,34344,42,50,46036,32953
356,36,2,0,0,3,1,0,100,81,44058,34344,119,115,46039,32953
357,36,0,0,2,1,2,1,145,93,44058,34344,139,56,46040,32954
358,36,2,2,2,1,2,1,258,68,44060,34346,198,99,46041,32955
359,36,1,1,2,1,2,1,134,77,44061,34347,142,47,46042,32956
360,37,4,0,0,3,1,0,95,55,44065,34347,103,60,46045,32956
361,37,2,0,0,3,1,0,102,81,44067,34347,122,99,46048,32956
362,37,1,1,2,1,2,1,125,86,44068,34348,138,75,46049,32957
363,37,1,1,2,1,2,1,162,59,44069,34349,164,79,46050,32958
364,37,0,0,2,1,2,1,13,12,44069,34349,26,167,46051,32959
365,37,1,0,0,3,1,0,102,92,44070,34349,115,79,46054,32959
366,37,0,2,1,0,0,3,61,63,44070,34351,75,27,46054,32962
367,37,4,3,0,3,1,0,75,74,44074,34354,78,25,46057,32962
368,37,1,1,2,1,2,1,112,96,44075,34355,117,58,46058,32963
369,37,2,0,0,3,1,0,46,44,44077,34355,52,163,46061,32963
370,38,1,0,0,3,1,0,121,89,44078,34355,127,72,46064,32963
371,38,3,1,0,3,1,0,261,69,44081,34356,201,64,46067,32963
372,38,1,1,2,1,2,1,246,51,44082,34357,207,116,46068,32964
373,38,2,1,0,3,1,0,151,90,44084,34358,147,34,46071,32964
374,38,1,2,1,0,0,3,135,79,44085,34360,142,59,46071,32967
375,38,2,1,0,3,1,0,89,72,44087,34361,121,50,46074,32967
376,38,0,1,1,0,0,3,49,43,44087,34362,54,50,46074,32970
377,38,0,0,2,1,2,1,49,66,44087,34362,43,84,46075,32971
378,38,1,2,1,0,0,3,84,91,44088,34364,79,65,46075,32974
379,38,3,1,0,3,1,0,148,94,44091,34365,142,14,46078,32974
0,1,1,0,0,3,1,0,122,89,44092,34365,130,84,46081,32974
1,1,1,1,2,1,2,1,149,95,44093,34366,143,100,46082,32975
2,1,2,1,0,3,1,0,63,64,44095,34367,78,25,46085,32975
3,1,1,1,2,1,2,1,50,67,44096,34368,44,65,46086,32976
4,1,1,0,0,3,1,0,1,0,44097,34368,3,75,46089,32976
5,1,3,1,0,3,1,0,49,45,44100,34369,55,65,46092,32976
6,1,3,0,0,3,1,0,249,51,44103,34369,210,14,46095,32976
7,1,0,2,1,0,0,3,102,83,44103,34371,122,62,46095,32979
8,1,2,0,0,3,1,0,263,69,44105,34371,204,0,46098,32979
9,1,0,0,2,1,2,1,84,91,44105,34371,80,117,46099,32980
10,2,1,0,0,3,1,0,103,92,44106,34371,118,27,46102,32980
11,2,3,0,0,3,1,0,154,90,44109,34371,150,79,46105,32980
12,2,1,1,2,1,2,1,1,1,44110,34372,1,35,46106,32981
13,2,3,0,0,3,1,0,128,86,44113,34372,141,72,46109,32981
14,2,2,1,0,3,1,0,164,60,44115,34373,167,0,46112,32981
15,2,1,2,1,0,0,3,113,98,44116,34375,117,82,46112,32984
16,2,0,1,1,0,0,3,95,56,44116,34376,103,170,46112,32987
17,2,4,2,0,3,1,0,139,81,44120,34378,145,163,46115,32987
18,2,2,2,2,1,2,1,47,47,44122,34380,54,61,46116,32988
19,2,1,1,2,1,2,1,14,13,44123,34381,27,51,46117,32989
20,3,1,1,2,1,2,1,51,68,44124,34382,45,1,46118,32990
21,3,2,0,0,3,1,0,251,51,44126,34382,213,84,46121,32990
22,3,0,0,2,1,2,1,122,89,44126,34382,131,73,46122,32991
23,3,1,2,1,0,0,3,264,71,44127,34384,204,120,46122,32994
24,3,2,2,2,1,2,1,51,47,44129,34386,56,76,46123,32995
25,3,2,3,1,0,0,3,86,94,44131,34389,80,17,46123,32998
26,3,3,1,0,3,1,0,157,91,44134,34390,153,65,46126,32998
27,3,2,0,0,3,1,0,151,95,44136,34390,146,65,46129,32998
28,3,0,0,2,1,2,1,63,64,44136,34390,79,63,46130,32999
29,3,0,1,1,0,0,3,1,1,44136,34391,3,28,46130,33002
30,4,0,2,1,0,0,3,14,15,44136,34393,27,3,46130,33005
31,4,2,8,1,0,0,3,49,55,44138,34401,54,166,46130,33008
32,4,0,1,1,0,0,3,128,87,44138,34402,141,54,46130,33011
33,4,2,2,2,1,2,1,166,62,44140,34404,168,36,46131,33012
34,4,2,2,2,1,2,1,115,100,44142,34406,118,80,46132,33013
35,4,1,2,1,0,0,3,140,83,44143,34408,145,30,46132,33016
36,4,4,2,0,3,1,0,99,58,44147,34410,106,61,46135,33016
37,4,1,3,1,0,0,3,2,4,44148,34413,1,85,46135,33019
38,4,0,5,1,0,0,3,102,88,44148,34418,122,173,46135,33022
39,4,0,3,1,0,0,3,103,95,44148,34421,118,103,46135,33025
40,5,5,1,0,3,1,0,269,72,44153,34422,207,17,46138,33025
41,5,2,1,0,3,1,0,53,48,44155,34423,59,28,46141,33025
42,5,0,1,1,0,0,3,51,69,44155,34424,45,123,46141,33028
43,5,1,1,2,1,2,1,2,2,44156,34425,4,64,46142,33029
44,5,2,1,0,3,1,0,88,95,44158,34426,83,84,46145,33029
45,5,1,0,0,3,1,0,152,95,44159,34426,149,76,46148,33029
46,5,0,1,1,0,0,3,63,65,44159,34427,79,76,46148,33032
47,5,0,0,2,1,2,1,122,89,44159,34427,132,174,46149,33033
48,5,2,0,0,3,1,0,117,100,44161,34427,121,65,46152,33033
49,5,3,0,0,3,1,0,160,91,44164,34427,156,1,46155,33033
50,6,0,1,1,0,0,3,14,16,44164,34428,27,39,46155,33036
51,6,0,2,1,0,0,3,99,60,44164,34430,106,169,46155,33039
52,6,6,0,0,3,1,0,257,51,44170,34430,216,54,46158,33039
53,6,4,0,0,3,1,0,170,62,44174,34430,171,85,46161,33039
54,6,0,0,2,1,2,1,128,87,44174,34430,142,4,46162,33040
55,6,0,2,1,0,0,3,102,90,44174,34432,122,64,46162,33043
56,6,1,0,0,3,1,0,104,95,44175,34432,121,80,46165,33043
57,6,0,1,1,0,0,3,49,56,44175,34433,54,33,46165,33046
58,6,1,1,2,1,2,1,141,84,44176,34434,146,104,46166,33047
59,6,0,0,2,1,2,1,2,4,44176,34434,2,66,46167,33048
60,7,1,1,2,1,2,1,105,96,44177,34435,122,2,46168,33049
61,7,3,1,0,3,1,0,163,92,44180,34436,159,123,46171,33049
62,7,0,2,1,0,0,3,88,97,44180,34438,83,177,46171,33052
63,7,3,3,2,1,2,1,5,5,44183,34441,5,77,46172,33053
64,7,2,2,2,1,2,1,53,71,44185,34443,46,18,46173,33054
65,7,2,1,0,3,1,0,124,90,44187,34444,135,54,46176,33054
66,7,4,1,0,3,1,0,156,96,44191,34445,152,28,46179,33054
67,7,1,3,1,0,0,3,54,51,44192,34448,59,67,46179,33057
68,7,2,0,0,3,1,0,119,100,44194,34448,124,76,46182,33057
69,7,5,0,0,3,1,0,274,72,44199,34448,210,84,46185,33057
70,8,0,1,1,0,0,3,63,66,44199,34449,79,67,46185,33060
71,8,0,5,1,0,0,3,102,95,44199,34454,122,172,46185,33063
72,8,1,1,2,1,2,1,129,88,44200,34455,143,40,46186,33064
73,8,3,0,0,3,1,0,260,51,44203,34455,219,4,46189,33064
74,8,1,2,1,0,0,3,3,6,44204,34457,2,83,46189,33067
75,8,2,0,0,3,1,0,172,62,44206,34457,174,66,46192,33067
76,8,3,0,0,3,1,0,52,56,44209,34457,57,104,46195,33067
77,8,0,2,1,0,0,3,14,18,44209,34459,27,88,46195,33070
78,8,2,0,0,3,1,0,101,60,44211,34459,109,33,46198,33070
79,8,1,2,1,0,0,3,142,86,44212,34461,146,68,46198,33073
80,9,3,0,0,3,1,0,57,51,44215,34461,62,77,46201,33073
81,9,0,1,1,0,0,3,53,72,44215,34462,46,87,46201,33076
82,9,3,1,0,3,1,0,277,73,44218,34463,213,177,46204,33076
83,9,3,1,0,3,1,0,166,93,44221,34464,162,18,46207,33076
84,9,1,1,2,1,2,1,4,7,44222,34465,3,77,46208,33077
85,9,1,1,2,1,2,1,6,6,44223,34466,6,55,46209,33078
86,9,4,0,0,3,1,0,128,90,44227,34466,138,67,46212,33078
87,9,0,0,2,1,2,1,119,100,44227,34466,125,29,46213,33079
88,9,2,1,0,3,1,0,158,97,44229,34467,155,67,46216,33079
89,9,0,1,1,0,0,3,105,97,44229,34468,122,126,46216,33082
90,10,1,2,1,0,0,3,53,58,44230,34470,57,71,46216,33085
91,10,0,4,1,0,0,3,63,70,44230,34474,79,175,46216,33088
92,10,4,2,0,3,1,0,176,64,44234,34476,177,2,46219,33088
93,10,0,1,1,0,0,3,260,52,44234,34477,219,43,46219,33091
94,10,0,1,1,0,0,3,142,87,44234,34478,146,86,46219,33094
95,10,1,0,0,3,1,0,130,88,44235,34478,146,88,46222,33094
96,10,1,3,1,0,0,3,102,63,44236,34481,109,107,46222,33097
97,10,2,1,0,3,1,0,104,96,44238,34482,125,33,46225,33097
98,10,2,1,0,3,1,0,16,19,44240,34483,30,66,46228,33097
99,10,2,3,1,0,0,3,90,100,44242,34486,83,7,46228,33100
100,11,0,0,2,1,2,1,4,7,44242,34486,4,30,46229,33101
101,11,1,2,1,0,0,3,54,74,44243,34488,46,180,46229,33104
102,11,0,0,2,1,2,1,105,97,44243,34488,123,19,46230,33105
103,11,5,1,0,3,1,0,282,74,44248,34489,216,67,46233,33105
104,11,0,0,2,1,2,1,57,51,44248,34489,63,56,46234,33106
105,11,2,1,0,3,1,0,130,91,44250,34490,141,7,46237,33106
106,11,1,1,2,1,2,1,159,98,44251,34491,156,78,46238,33107
107,11,1,1,2,1,2,1,120,101,44252,34492,126,68,46239,33108
108,11,0,0,2,1,2,1,166,93,44252,34492,163,88,46240,33109
109,11,2,1,0,3,1,0,144,88,44254,34493,149,126,46243,33109
110,12,3,1,0,3,1,0,133,89,44257,34494,149,66,46246,33109
111,12,3,1,0,3,1,0,179,65,44260,34495,180,86,46249,33109
112,12,0,4,1,0,0,3,6,10,44260,34499,6,178,46249,33112
113,12,5,1,0,3,1,0,265,53,44265,34500,222,88,46252,33112
114,12,0,0,2,1,2,1,53,58,44265,34500,58,78,46253,33113
115,12,1,0,0,3,1,0,91,100,44266,34500,86,43,46256,33113
116,12,2,1,0,3,1,0,106,97,44268,34501,128,107,46259,33113
117,12,2,2,2,1,2,1,18,21,44270,34503,31,3,46260,33114
118,12,2,1,0,3,1,0,104,64,44272,34504,112,71,46263,33114
119,12,0,0,2,1,2,1,63,70,44272,34504,80,34,46264,33115
120,13,3,0,0,3,1,0,147,88,44275,34504,152,19,46267,33115
121,13,1,2,1,0,0,3,106,99,44276,34506,123,91,46267,33118
122,13,2,1,0,3,1,0,122,102,44278,34507,129,78,46270,33118
123,13,1,2,1,0,0,3,131,93,44279,34509,141,181,46270,33121
124,13,0,1,1,0,0,3,57,52,44279,34510,63,10,46270,33124
125,13,2,0,0,3,1,0,181,65,44281,34510,183,30,46273,33124
126,13,5,1,0,3,1,0,164,99,44286,34511,159,56,46276,33124
127,13,0,2,1,0,0,3,4,9,44286,34513,4,71,46276,33127
128,13,0,1,1,0,0,3,166,94,44286,34514,163,183,46276,33130
129,13,0,1,1,0,0,3,54,75,44286,34515,46,70,46276,33133
130,14,0,2,1,0,0,3,18,23,44286,34517,31,129,46276,33136
131,14,0,1,1,0,0,3,133,90,44286,34518,149,6,46276,33139
132,14,3,0,0,3,1,0,285,74,44289,34518,219,43,46279,33139
133,14,0,1,1,0,0,3,53,59,44289,34519,58,89,46279,33142
134,14,0,1,1,0,0,3,91,101,44289,34520,86,91,46279,33145
135,14,5,1,0,3,1,0,270,54,44294,34521,225,66,46282,33145
136,14,4,0,0,3,1,0,108,64,44298,34521,115,78,46285,33145
137,14,1,1,2,1,2,1,64,71,44299,34522,81,108,46286,33146
138,14,5,2,0,3,1,0,11,12,44304,34524,9,34,46289,33146
139,14,1,1,2,1,2,1,107,98,44305,34525,129,72,46290,33147
140,15,1,4,1,0,0,3,55,79,44306,34529,46,184,46290,33150
141,15,0,0,2,1,2,1,106,99,44306,34529,124,184,46291,33151
142,15,3,0,0,3,1,0,169,94,44309,34529,166,70,46294,33151
143,15,0,0,2,1,2,1,4,9,44309,34529,5,79,46295,33152
144,15,1,0,0,3,1,0,132,93,44310,34529,144,43,46298,33152
145,15,2,1,0,3,1,0,124,103,44312,34530,132,56,46301,33152
146,15,0,0,2,1,2,1,164,99,44312,34530,160,11,46302,33153
147,15,0,1,1,0,0,3,181,66,44312,34531,183,74,46302,33156
148,15,1,1,2,1,2,1,148,89,44313,34532,153,92,46303,33157
149,15,1,0,0,3,1,0,54,59,44314,34532,61,19,46306,33157
150,16,0,1,1,0,0,3,57,53,44314,34533,63,37,46306,33160
151,16,5,0,0,3,1,0,275,54,44319,34533,228,6,46309,33160
152,16,1,1,2,1,2,1,108,99,44320,34534,130,79,46310,33161
153,16,0,1,1,0,0,3,11,13,44320,34535,9,111,46310,33164
154,16,1,3,1,0,0,3,92,104,44321,34538,86,69,46310,33167
155,16,3,0,0,3,1,0,111,64,44324,34538,118,30,46313,33167
156,16,1,1,2,1,2,1,65,72,44325,34539,82,73,46314,33168
157,16,1,2,1,0,0,3,19,25,44326,34541,31,92,46314,33171
158,16,1,4,1,0,0,3,134,94,44327,34545,149,132,46314,33174
159,16,2,1,0,3,1,0,287,75,44329,34546,222,91,46317,33174
160,17,3,1,0,3,1,0,184,67,44332,34547,186,79,46320,33174
161,17,1,0,0,3,1,0,165,99,44333,34547,163,43,46323,33174
162,17,2,2,2,1,2,1,21,27,44335,34549,32,75,46324,33175
163,17,1,0,0,3,1,0,55,59,44336,34549,64,92,46327,33175
164,17,1,2,1,0,0,3,133,95,44337,34551,144,40,46327,33178
165,17,1,2,1,0,0,3,107,101,44338,34553,124,73,46327,33181
166,17,2,1,0,3,1,0,171,95,44340,34554,169,184,46330,33181
167,17,1,2,1,0,0,3,125,105,44341,34556,132,14,46330,33184
168,17,1,0,0,3,1,0,149,89,44342,34556,156,184,46333,33184
169,17,2,0,0,3,1,0,6,9,44344,34556,8,56,46336,33184
170,18,0,0,2,1,2,1,108,99,44344,34556,131,31,46337,33185
171,18,3,0,0,3,1,0,290,75,44347,34556,225,69,46340,33185
172,18,1,1,2,1,2,1,134,96,44348,34557,145,76,46341,33186
173,18,1,1,2,1,2,1,58,54,44349,34558,64,112,46342,33187
174,18,2,1,0,3,1,0,13,14,44351,34559,12,73,46345,33187
175,18,0,2,1,0,0,3,55,81,44351,34561,46,94,46345,33190
176,18,1,2,1,0,0,3,135,96,44352,34563,149,22,46345,33193
177,18,1,1,2,1,2,1,66,73,44353,34564,83,80,46346,33194
178,18,3,1,0,3,1,0,278,55,44356,34565,231,132,46349,33194
179,18,0,1,1,0,0,3,92,105,44356,34566,86,9,46349,33197
180,19,1,1,2,1,2,1,7,10,44357,34567,9,15,46350,33198
181,19,0,1,1,0,0,3,149,90,44357,34568,156,76,46350,33201
182,19,3,2,0,3,1,0,174,97,44360,34570,172,40,46353,33201
183,19,2,0,0,3,1,0,113,64,44362,34570,121,92,46356,33201
184,19,1,0,0,3,1,0,126,105,44363,34570,135,43,46359,33201
185,19,0,3,1,0,0,3,107,104,44363,34573,124,187,46359,33204
186,19,2,0,0,3,1,0,186,67,44365,34573,189,56,46362,33204
187,19,0,4,1,0,0,3,55,63,44365,34577,64,187,46362,33207
188,19,1,0,0,3,1,0,22,27,44366,34577,35,79,46365,33207
189,19,2,0,0,3,1,0,167,99,44368,34577,166,92,46368,33207
190,20,1,2,1,0,0,3,8,12,44369,34579,9,190,46368,33210
191,20,0,6,1,0,0,3,22,33,44369,34585,35,190,46368,33213
192,20,3,1,0,3,1,0,189,68,44372,34586,192,76,46371,33213
193,20,1,0,0,3,1,0,150,90,44373,34586,159,15,46374,33213
194,20,1,0,0,3,1,0,114,64,44374,34586,124,79,46377,33213
195,20,2,2,2,1,2,1,57,65,44376,34588,65,57,46378,33214
196,20,1,1,2,1,2,1,136,97,44377,34589,150,93,46379,33215
197,20,3,0,0,3,1,0,129,105,44380,34589,138,40,46382,33215
198,20,3,1,0,3,1,0,177,98,44383,34590,175,94,46385,33215
199,20,2,1,0,3,1,0,109,105,44385,34591,127,43,46388,33215
200,21,1,2,1,0,0,3,93,107,44386,34593,86,34,46388,33218
201,21,4,1,0,3,1,0,294,76,44390,34594,228,80,46391,33218
202,21,1,3,1,0,0,3,14,17,44391,34597,12,135,46391,33221
203,21,1,0,0,3,1,0,67,73,44392,34597,86,22,46394,33221
204,21,1,0,0,3,1,0,59,54,44393,34597,67,9,46397,33221
205,21,0,2,1,0,0,3,108,101,44393,34599,131,95,46397,33224
206,21,1,0,0,3,1,0,56,81,44394,34599,49,73,46400,33224
207,21,3,2,0,3,1,0,170,101,44397,34601,169,69,46403,33224
208,21,3,2,0,3,1,0,281,57,44400,34603,234,76,46406,33224
209,21,1,0,0,3,1,0,135,96,44401,34603,148,112,46409,33224
210,22,2,0,0,3,1,0,59,65,44403,34603,68,15,46412,33224
211,22,4,0,0,3,1,0,193,68,44407,34603,195,190,46415,33224
212,22,2,0,0,3,1,0,116,64,44409,34603,127,57,46418,33224
213,22,4,1,0,3,1,0,112,102,44413,34604,134,93,46421,33224
214,22,1,1,2,1,2,1,151,91,44414,34605,160,44,46422,33225
215,22,1,2,1,0,0,3,9,14,44415,34607,9,43,46422,33228
216,22,2,1,0,3,1,0,111,106,44417,34608,130,94,46425,33228
217,22,1,2,1,0,0,3,130,107,44418,34610,138,115,46425,33231
218,22,2,5,1,0,0,3,138,102,44420,34615,150,193,46425,33234
219,22,2,0,0,3,1,0,24,33,44422,34615,38,76,46428,33234
220,23,2,2,2,1,2,1,58,83,44424,34617,50,81,46429,33235
221,23,3,0,0,3,1,0,173,101,44427,34617,172,9,46432,33235
222,23,2,0,0,3,1,0,296,76,44429,34617,231,34,46435,33235
223,23,0,0,2,1,2,1,67,73,44429,34617,87,96,46436,33236
224,23,0,2,1,0,0,3,135,98,44429,34619,148,72,46436,33239
225,23,1,0,0,3,1,0,178,98,44430,34619,178,73,46439,33239
226,23,5,0,0,3,1,0,286,57,44435,34619,237,79,46442,33239
227,23,2,0,0,3,1,0,95,107,44437,34619,89,76,46445,33239
228,23,2,0,0,3,1,0,61,54,44439,34619,70,135,46448,33239
229,23,0,1,1,0,0,3,14,18,44439,34620,12,25,46448,33242
230,24,2,1,0,3,1,0,113,107,44441,34621,133,72,46451,33242
231,24,0,1,1,0,0,3,286,58,44441,34622,237,96,46451,33245
232,24,1,2,1,0,0,3,10,16,44442,34624,9,118,46451,33248
233,24,3,0,0,3,1,0,196,68,44445,34624,198,43,46454,33248
234,24,0,2,1,0,0,3,59,67,44445,34626,68,47,46454,33251
235,24,4,3,0,3,1,0,155,94,44449,34629,163,94,46457,33251
236,24,1,0,0,3,1,0,139,102,44450,34629,153,76,46460,33251
237,24,1,0,0,3,1,0,117,64,44451,34629,130,15,46463,33251
238,24,0,2,1,0,0,3,24,35,44451,34631,38,193,46463,33254
239,24,2,1,0,3,1,0,114,103,44453,34632,137,57,46466,33254
240,25,1,0,0,3,1,0,131,107,44454,34632,141,9,46469,33254
241,25,1,3,1,0,0,3,68,76,44455,34635,87,196,46469,33257
242,25,4,2,0,3,1,0,99,109,44459,34637,92,79,46472,33257
243,25,0,0,2,1,2,1,58,83,44459,34637,51,35,46473,33258
244,25,3,2,0,3,1,0,138,100,44462,34639,151,73,46476,33258
245,25,2,0,0,3,1,0,180,98,44464,34639,181,81,46479,33258
246,25,0,1,1,0,0,3,14,19,44464,34640,12,99,46479,33261
247,25,0,0,2,1,2,1,173,101,44464,34640,173,136,46480,33262
248,25,1,1,2,1,2,1,297,77,44465,34641,232,77,46481,33263
249,25,1,1,2,1,2,1,62,55,44466,34642,71,26,46482,33264
250,26,2,1,0,3,1,0,116,104,44468,34643,140,15,46485,33264
251,26,3,4,1,0,0,3,62,71,44471,34647,68,97,46485,33267
252,26,1,0,0,3,1,0,140,102,44472,34647,156,193,46488,33267
253,26,1,0,0,3,1,0,25,35,44473,34647,41,43,46491,33267
254,26,1,0,0,3,1,0,69,76,44474,34647,90,96,46494,33267
255,26,6,1,0,3,1,0,292,59,44480,34648,240,76,46497,33267
256,26,1,0,0,3,1,0,156,94,44481,34648,166,72,46500,33267
257,26,4,1,0,3,1,0,121,65,44485,34649,133,47,46503,33267
258,26,1,1,2,1,2,1,197,69,44486,34650,199,119,46504,33268
259,26,1,2,1,0,0,3,11,18,44487,34652,9,76,46504,33271
260,27,2,0,0,3,1,0,182,98,44489,34652,184,35,46507,33271
261,27,0,0,2,1,2,1,131,107,44489,34652,142,137,46508,33272
262,27,0,2,1,0,0,3,14,21,44489,34654,12,199,46508,33275
263,27,3,1,0,3,1,0,102,110,44492,34655,95,57,46511,33275
264,27,1,2,1,0,0,3,63,57,44493,34657,71,102,46511,33278
265,27,0,0,2,1,2,1,58,83,44493,34657,52,78,46512,33279
266,27,2,0,0,3,1,0,140,100,44495,34657,154,9,46515,33279
267,27,3,0,0,3,1,0,176,101,44498,34657,176,26,46518,33279
268,27,2,0,0,3,1,0,299,77,44500,34657,235,79,46521,33279
269,27,0,1,1,0,0,3,113,108,44500,34658,133,84,46521,33282
270,28,0,4,1,0,0,3,25,39,44500,34662,41,122,46521,33285
271,28,2,0,0,3,1,0,199,69,44502,34662,202,76,46524,33285
272,28,1,0,0,3,1,0,103,110,44503,34662,98,96,46527,33285
273,28,0,1,1,0,0,3,116,105,44503,34663,140,50,46527,33288
274,28,2,1,0,3,1,0,142,103,44505,34664,159,43,46530,33288
275,28,0,0,2,1,2,1,69,76,44505,34664,91,16,46531,33289
276,28,0,0,2,1,2,1,62,71,44505,34664,69,73,46532,33290
277,28,0,2,1,0,0,3,121,67,44505,34666,133,100,46532,33293
278,28,3,1,0,3,1,0,159,95,44508,34667,169,9,46535,33293
279,28,2,1,0,3,1,0,294,60,44510,34668,243,193,46538,33293
280,29,1,2,1,0,0,3,15,23,44511,34670,12,79,46538,33296
281,29,2,0,0,3,1,0,178,101,44513,34670,179,102,46541,33296
282,29,0,2,1,0,0,3,11,20,44513,34672,9,140,46541,33299
283,29,1,4,1,0,0,3,59,87,44514,34676,52,82,46541,33302
284,29,1,1,2,1,2,1,141,101,44515,34677,155,85,46542,33303
285,29,9,1,0,3,1,0,308,78,44524,34678,238,57,46545,33303
286,29,0,0,2,1,2,1,182,98,44524,34678,185,79,46546,33304
287,29,2,1,0,3,1,0,115,109,44526,34679,136,35,46549,33304
288,29,0,1,1,0,0,3,63,58,44526,34680,71,202,46549,33307
289,29,1,1,2,1,2,1,132,108,44527,34681,143,27,46550,33308
290,30,2,0,0,3,1,0,201,69,44529,34681,205,85,46553,33308
291,30,1,2,1,0,0,3,117,107,44530,34683,140,103,46553,33311
292,30,1,0,0,3,1,0,16,23,44531,34683,15,96,46556,33311
293,30,1,1,2,1,2,1,63,72,44532,34684,70,10,46557,33312
294,30,4,0,0,3,1,0,298,60,44536,34684,246,43,46560,33312
295,30,1,1,2,1,2,1,70,77,44537,34685,92,51,46561,33313
296,30,0,2,1,0,0,3,103,112,44537,34687,98,196,46561,33316
297,30,1,1,2,1,2,1,143,104,44538,34688,160,123,46562,33317
298,30,0,1,1,0,0,3,25,40,44538,34689,41,79,46562,33320
299,30,0,3,1,0,0,3,121,70,44538,34692,133,76,46562,33323
300,31,3,0,0,3,1,0,311,78,44541,34692,241,16,46565,33323
301,31,2,2,2,1,2,1,143,103,44543,34694,156,141,46566,33324
302,31,2,2,2,1,2,1,180,103,44545,34696,180,203,46567,33325
303,31,3,0,0,3,1,0,62,87,44548,34696,55,57,46570,33325
304,31,6,1,0,3,1,0,69,59,44554,34697,74,79,46573,33325
305,31,1,1,2,1,2,1,116,110,44555,34698,137,80,46574,33326
306,31,1,0,0,3,1,0,133,108,44556,34698,146,102,46577,33326
307,31,2,2,2,1,2,1,161,97,44558,34700,170,36,46578,33327
308,31,0,2,1,0,0,3,11,22,44558,34702,9,30,46578,33330
309,31,3,0,0,3,1,0,185,98,44561,34702,188,82,46581,33330
310,32,2,2,2,1,2,1,119,109,44563,34704,141,77,46582,33331
311,32,2,0,0,3,1,0,300,60,44565,34704,249,123,46585,33331
312,32,1,2,1,0,0,3,64,74,44566,34706,70,144,46585,33334
313,32,3,1,0,3,1,0,314,79,44569,34707,244,96,46588,33334
314,32,4,0,0,3,1,0,147,104,44573,34707,163,79,46591,33334
315,32,2,0,0,3,1,0,105,112,44575,34707,101,43,46594,33334
316,32,1,1,2,1,2,1,71,78,44576,34708,93,104,46595,33335
317,32,0,0,2,1,2,1,121,70,44576,34708,134,11,46596,33336
318,32,0,1,1,0,0,3,16,24,44576,34709,15,54,46596,33339
319,32,1,0,0,3,1,0,26,40,44577,34709,44,85,46599,33339
320,33,0,1,1,0,0,3,11,23,44577,34710,9,105,46599,33342
321,33,0,2,1,0,0,3,133,110,44577,34712,146,206,46599,33345
322,33,3,0,0,3,1,0,204,69,44580,34712,208,30,46602,33345
323,33,0,1,1,0,0,3,116,111,44580,34713,137,85,46602,33348
324,33,0,0,2,1,2,1,161,97,44580,34713,171,81,46603,33349
325,33,1,1,2,1,2,1,144,104,44581,34714,157,37,46604,33350
326,33,2,0,0,3,1,0,64,87,44583,34714,58,16,46607,33350
327,33,2,0,0,3,1,0,182,103,44585,34714,183,79,46610,33350
328,33,2,4,1,0,0,3,71,63,44587,34718,74,199,46610,33353
329,33,4,0,0,3,1,0,189,98,44591,34718,191,57,46613,33353
330,34,6,0,0,3,1,0,306,60,44597,34718,252,79,46616,33353
331,34,1,1,2,1,2,1,148,105,44598,34719,164,86,46617,33354
332,34,1,0,0,3,1,0,120,109,44599,34719,144,11,46620,33354
333,34,1,3,1,0,0,3,17,27,44600,34722,15,107,46620,33357
334,34,3,0,0,3,1,0,317,79,44603,34722,247,43,46623,33357
335,34,1,0,0,3,1,0,72,63,44604,34722,77,96,46626,33357
336,34,4,0,0,3,1,0,30,40,44608,34722,47,37,46629,33357
337,34,0,1,1,0,0,3,121,71,44608,34723,134,147,46629,33360
338,34,1,1,2,1,2,1,106,113,44609,34724,102,124,46630,33361
339,34,1,2,1,0,0,3,72,80,44610,34726,93,80,46630,33364
340,35,3,0,0,3,1,0,164,97,44613,34726,174,85,46633,33364
341,35,0,8,1,0,0,3,11,31,44613,34734,9,209,46633,33367
342,35,0,0,2,1,2,1,204,69,44613,34734,209,106,46634,33368
343,35,2,3,1,0,0,3,184,106,44615,34737,183,202,46634,33371
344,35,1,1,2,1,2,1,65,75,44616,34738,71,82,46635,33372
345,35,1,1,2,1,2,1,134,111,44617,34739,147,80,46636,33373
346,35,1,2,1,0,0,3,117,113,44618,34741,137,60,46636,33376
347,35,3,1,0,3,1,0,192,99,44621,34742,194,16,46639,33376
348,35,1,2,1,0,0,3,145,106,44622,34744,157,33,46639,33379
349,35,2,2,2,1,2,1,66,89,44624,34746,59,55,46640,33380
350,36,0,2,1,0,0,3,17,29,44624,34748,15,83,46640,33383
351,36,2,0,0,3,1,0,74,80,44626,34748,96,11,46643,33383
352,36,2,0,0,3,1,0,308,60,44628,34748,255,86,46646,33383
353,36,2,2,2,1,2,1,319,81,44630,34750,248,125,46647,33384
354,36,1,1,2,1,2,1,149,106,44631,34751,165,38,46648,33385
355,36,2,2,2,1,2,1,122,111,44633,34753,145,148,46649,33386
356,36,1,0,0,3,1,0,122,71,44634,34753,137,33,46652,33386
357,36,1,2,1,0,0,3,67,91,44635,34755,59,99,46652,33389
358,36,1,1,2,1,2,1,73,64,44636,34756,78,108,46653,33390
359,36,2,0,0,3,1,0,108,113,44638,34756,105,79,46656,33390
360,37,2,1,0,3,1,0,124,72,44640,34757,140,99,46659,33390
361,37,2,3,1,0,0,3,32,43,44642,34760,47,109,46659,33393
362,37,2,0,0,3,1,0,67,75,44644,34760,74,85,46662,33393
363,37,0,1,1,0,0,3,204,70,44644,34761,209,212,46662,33396
364,37,0,3,1,0,0,3,164,100,44644,34764,174,63,46662,33399
365,37,1,2,1,0,0,3,12,33,44645,34766,9,83,46662,33402
366,37,1,1,2,1,2,1,118,114,44646,34767,138,17,46663,33403
367,37,1,4,1,0,0,3,135,115,44647,34771,147,205,46663,33406
368,37,1,1,2,1,2,1,193,100,44648,34772,195,56,46664,33407
369,37,2,1,0,3,1,0,186,107,44650,34773,186,43,46667,33407
370,38,0,0,2,1,2,1,122,111,44650,34773,146,34,46668,33408
371,38,4,0,0,3,1,0,153,106,44654,34773,168,82,46671,33408
372,38,2,2,2,1,2,1,310,62,44656,34775,256,39,46672,33409
373,38,0,0,2,1,2,1,74,80,44656,34775,97,149,46673,33410
374,38,2,4,1,0,0,3,110,117,44658,34779,105,89,46673,33413
375,38,3,0,0,3,1,0,20,29,44661,34779,18,11,46676,33413
376,38,3,2,0,3,1,0,76,66,44664,34781,81,83,46679,33413
377,38,2,3,1,0,0,3,69,94,44666,34784,59,128,46679,33416
378,38,2,3,1,0,0,3,147,109,44668,34787,157,111,46679,33419
379,38,7,3,0,3,1,0,326,84,44675,34790,251,79,46682,33419
0,1,0,0,2,1,2,1,147,109,44675,34790,158,112,46683,33420
1,1,1,0,0,3,1,0,136,115,44676,34790,150,79,46686,33420
2,1,0,0,2,1,2,1,67,75,44676,34790,75,90,46687,33421
3,1,1,0,0,3,1,0,205,70,44677,34790,212,0,46690,33421
4,1,0,0,2,1,2,1,110,117,44677,34790,106,129,46691,33422
5,1,0,1,1,0,0,3,153,107,44677,34791,168,215,46691,33425
6,1,0,0,2,1,2,1,47,42,44677,34791,59,206,46692,33426
7,1,1,2,1,0,0,3,123,113,44678,34793,146,59,46692,33429
8,1,1,1,2,1,2,1,76,75,44679,34794,79,83,46693,33430
9,1,1,3,1,0,0,3,75,83,44680,34797,97,20,46693,33433
10,2,3,1,0,3,1,0,127,73,44683,34798,143,83,46696,33433
11,2,0,0,2,1,2,1,164,100,44683,34798,175,27,46697,33434
12,2,1,0,0,3,1,0,311,62,44684,34798,259,99,46700,33434
13,2,3,0,0,3,1,0,79,66,44687,34798,84,83,46703,33434
14,2,5,0,0,3,1,0,331,84,44692,34798,254,50,46706,33434
15,2,2,0,0,3,1,0,22,29,44694,34798,21,109,46709,33434
16,2,0,3,1,0,0,3,186,110,44694,34801,186,152,46709,33437
17,2,1,1,2,1,2,1,194,101,44695,34802,196,40,46710,33438
18,2,0,0,2,1,2,1,0,0,44695,34802,1,86,46711,33439
19,2,1,2,1,0,0,3,119,116,44696,34804,138,66,46711,33442
20,3,1,1,2,1,2,1,124,114,44697,34805,147,113,46712,33443
21,3,0,6,1,0,0,3,136,121,44697,34811,150,209,46712,33446
22,3,0,1,1,0,0,3,47,43,44697,34812,59,132,46712,33449
23,3,1,2,1,0,0,3,206,72,44698,34814,212,218,46712,33452
24,3,1,0,0,3,1,0,77,75,44699,34814,82,90,46715,33452
25,3,1,3,1,0,0,3,76,86,44700,34817,97,86,46715,33455
26,3,3,1,0,3,1,0,156,108,44703,34818,171,79,46718,33455
27,3,3,3,2,1,2,1,82,69,44706,34821,85,1,46719,33456
28,3,0,0,2,1,2,1,147,109,44706,34821,159,21,46720,33457
29,3,1,3,1,0,0,3,111,120,44707,34824,106,43,46720,33460
30,4,1,0,0,3,1,0,120,116,44708,34824,141,99,46723,33460
31,4,1,0,0,3,1,0,332,84,44709,34824,257,66,46726,33460
32,4,0,0,2,1,2,1,194,101,44709,34824,197,51,46727,33461
33,4,0,2,1,0,0,3,22,31,44709,34826,21,155,46727,33464
34,4,2,3,1,0,0,3,166,103,44711,34829,175,86,46727,33467
35,4,1,2,1,0,0,3,187,112,44712,34831,186,62,46727,33470
36,4,2,3,1,0,0,3,69,78,44714,34834,75,30,46727,33473
37,4,3,1,0,3,1,0,130,74,44717,34835,146,109,46730,33473
38,4,0,1,1,0,0,3,0,1,44717,34836,1,86,46730,33476
39,4,4,1,0,3,1,0,315,63,44721,34837,262,86,46733,33476
40,5,2,0,0,3,1,0,208,72,44723,34837,215,79,46736,33476
41,5,1,0,0,3,1,0,137,121,44724,34837,153,132,46739,33476
42,5,0,3,1,0,0,3,76,89,44724,34840,97,93,46739,33479
43,5,4,1,0,3,1,0,86,70,44728,34841,88,218,46742,33479
44,5,2,2,2,1,2,1,126,116,44730,34843,148,22,46743,33480
45,5,2,1,0,3,1,0,113,121,44732,34844,109,30,46746,33480
46,5,1,2,1,0,0,3,157,110,44733,34846,171,212,46746,33483
47,5,2,0,0,3,1,0,2,1,44735,34846,4,113,46749,33483
48,5,0,1,1,0,0,3,147,110,44735,34847,159,89,46749,33486
49,5,1,2,1,0,0,3,78,77,44736,34849,82,46,46749,33489
50,6,1,0,0,3,1,0,195,101,44737,34849,200,66,46752,33489
51,6,2,1,0,3,1,0,317,64,44739,34850,265,1,46755,33489
52,6,0,0,2,1,2,1,332,84,44739,34850,258,100,46756,33490
53,6,3,2,0,3,1,0,190,114,44742,34852,189,86,46759,33490
54,6,1,0,0,3,1,0,131,74,44743,34852,149,155,46762,33490
55,6,1,1,2,1,2,1,23,32,44744,34853,22,63,46763,33491
56,6,1,2,1,0,0,3,48,45,44745,34855,59,54,46763,33494
57,6,3,0,0,3,1,0,72,78,44748,34855,78,86,46766,33494
58,6,3,0,0,3,1,0,123,116,44751,34855,144,86,46769,33494
59,6,0,0,2,1,2,1,166,103,44751,34855,176,110,46770,33495
60,7,0,0,2,1,2,1,86,70,44751,34855,89,80,46771,33496
61,7,2,1,0,3,1,0,192,115,44753,34856,192,218,46774,33496
62,7,1,1,2,1,2,1,77,90,44754,34857,98,47,46775,33497
63,7,1,2,1,0,0,3,138,123,44755,34859,153,33,46775,33500
64,7,0,2,1,0,0,3,2,3,44755,34861,4,25,46775,33503
65,7,3,1,0,3,1,0,150,111,44758,34862,162,93,46778,33503
66,7,0,2,1,0,0,3,113,123,44758,34864,109,57,46778,33506
67,7,3,1,0,3,1,0,160,111,44761,34865,174,132,46781,33506
68,7,1,0,0,3,1,0,127,116,44762,34865,151,89,46784,33506
69,7,1,1,2,1,2,1,209,73,44763,34866,216,213,46785,33507
70,8,3,0,0,3,1,0,335,84,44766,34866,261,86,46788,33507
71,8,1,1,2,1,2,1,24,33,44767,34867,23,114,46789,33508
72,8,5,2,0,3,1,0,322,66,44772,34869,268,86,46792,33508
73,8,3,0,0,3,1,0,198,101,44775,34869,203,100,46795,33508
74,8,1,3,1,0,0,3,79,80,44776,34872,82,89,46795,33511
75,8,1,2,1,0,0,3,132,76,44777,34874,149,66,46795,33514
76,8,0,2,1,0,0,3,166,105,44777,34876,176,158,46795,33517
77,8,4,0,0,3,1,0,127,116,44781,34876,147,1,46798,33517
78,8,2,2,2,1,2,1,74,80,44783,34878,79,111,46799,33518
79,8,3,3,2,1,2,1,51,48,44786,34881,60,67,46800,33519
80,9,3,0,0,3,1,0,116,123,44789,34881,112,89,46803,33519
81,9,1,3,1,0,0,3,87,73,44790,34884,89,216,46803,33522
82,9,1,1,2,1,2,1,78,91,44791,34885,99,58,46804,33523
83,9,5,0,0,3,1,0,197,115,44796,34885,195,80,46807,33523
84,9,2,0,0,3,1,0,152,111,44798,34885,165,47,46810,33523
85,9,0,4,1,0,0,3,127,120,44798,34889,151,96,46810,33526
86,9,0,0,2,1,2,1,2,3,44798,34889,5,90,46811,33527
87,9,3,1,0,3,1,0,325,67,44801,34890,271,25,46814,33527
88,9,2,1,0,3,1,0,211,74,44803,34891,219,132,46817,33527
89,9,3,0,0,3,1,0,163,111,44806,34891,177,33,46820,33527
90,10,1,1,2,1,2,1,75,81,44807,34892,80,159,46821,33528
91,10,3,1,0,3,1,0,338,85,44810,34893,264,1,46824,33528
92,10,2,1,0,3,1,0,134,77,44812,34894,152,114,46827,33528
93,10,3,0,0,3,1,0,201,101,44815,34894,206,86,46830,33528
94,10,0,2,1,0,0,3,127,118,44815,34896,147,221,46830,33531
95,10,2,3,1,0,0,3,168,108,44817,34899,176,69,46830,33534
96,10,1,0,0,3,1,0,25,33,44818,34899,26,86,46833,33534
97,10,1,1,2,1,2,1,139,124,44819,34900,154,68,46834,33535
98,10,1,0,0,3,1,0,52,48,44820,34900,63,100,46837,33535
99,10,1,3,1,0,0,3,80,83,44821,34903,82,114,46837,33538
100,11,2,0,0,3,1,0,4,3,44823,34903,8,96,46840,33538
101,11,1,5,1,0,0,3,88,78,44824,34908,89,135,46840,33541
102,11,1,1,2,1,2,1,128,121,44825,34909,152,48,46841,33542
103,11,3,1,0,3,1,0,28,34,44828,34910,29,80,46844,33542
104,11,2,1,0,3,1,0,118,124,44830,34911,115,68,46847,33542
105,11,0,1,1,0,0,3,152,112,44830,34912,165,61,46847,33545
106,11,2,1,0,3,1,0,165,112,44832,34913,180,89,46850,33545
107,11,3,0,0,3,1,0,328,67,44835,34913,274,90,46853,33545
108,11,1,0,0,3,1,0,212,74,44836,34913,222,33,46856,33545
109,11,3,2,0,3,1,0,200,117,44839,34915,198,216,46859,33545
110,12,2,0,0,3,1,0,170,108,44841,34915,179,114,46862,33545
111,12,0,4,1,0,0,3,338,89,44841,34919,264,224,46862,33548
112,12,2,0,0,3,1,0,141,124,44843,34919,157,100,46865,33548
113,12,1,1,2,1,2,1,202,102,44844,34920,207,2,46866,33549
114,12,2,0,0,3,1,0,77,81,44846,34920,83,69,46869,33549
115,12,0,3,1,0,0,3,52,51,44846,34923,63,89,46869,33552
116,12,1,1,2,1,2,1,135,78,44847,34924,153,26,46870,33553
117,12,2,0,0,3,1,0,80,91,44849,34924,102,114,46873,33553
118,12,0,1,1,0,0,3,80,84,44849,34925,82,162,46873,33556
119,12,1,1,2,1,2,1,128,119,44850,34926,148,87,46874,33557
120,13,0,1,1,0,0,3,128,122,44850,34927,152,64,46874,33560
121,13,4,0,0,3,1,0,332,67,44854,34927,277,96,46877,33560
122,13,1,0,0,3,1,0,213,74,44855,34927,225,89,46880,33560
123,13,2,2,2,1,2,1,154,114,44857,34929,166,69,46881,33561
124,13,0,2,1,0,0,3,4,5,44857,34931,8,51,46881,33564
125,13,2,1,0,3,1,0,90,79,44859,34932,92,33,46884,33564
126,13,2,0,0,3,1,0,130,119,44861,34932,151,90,46887,33564
127,13,0,2,1,0,0,3,28,36,44861,34934,29,219,46887,33567
128,13,0,3,1,0,0,3,118,127,44861,34937,115,117,46887,33570
129,13,1,0,0,3,1,0,201,117,44862,34937,201,135,46890,33570
130,14,4,1,0,3,1,0,342,90,44866,34938,267,80,46893,33570
131,14,0,2,1,0,0,3,80,93,44866,34940,102,165,46893,33573
132,14,1,1,2,1,2,1,203,103,44867,34941,208,225,46894,33574
133,14,1,1,2,1,2,1,78,82,44868,34942,84,115,46895,33575
134,14,1,1,2,1,2,1,81,85,44869,34943,83,70,46896,33576
135,14,2,1,0,3,1,0,172,109,44871,34944,182,26,46899,33576
136,14,2,1,0,3,1,0,137,79,44873,34945,156,87,46902,33576
137,14,3,1,0,3,1,0,55,52,44876,34946,66,2,46905,33576
138,14,0,0,2,1,2,1,165,112,44876,34946,181,101,46906,33577
139,14,1,1,2,1,2,1,142,125,44877,34947,158,90,46907,33578
140,15,1,1,2,1,2,1,131,120,44878,34948,152,97,46908,33579
141,15,2,2,2,1,2,1,334,69,44880,34950,278,52,46909,33580
142,15,1,0,0,3,1,0,91,79,44881,34950,95,89,46912,33580
143,15,1,2,1,0,0,3,129,124,44882,34952,152,72,46912,33583
144,15,2,0,0,3,1,0,203,117,44884,34952,204,33,46915,33583
145,15,1,0,0,3,1,0,5,5,44885,34952,11,64,46918,33583
146,15,1,2,1,0,0,3,119,129,44886,34954,115,104,46918,33586
147,15,1,1,2,1,2,1,29,37,44887,34955,30,136,46919,33587
148,15,2,1,0,3,1,0,215,75,44889,34956,228,117,46922,33587
149,15,1,0,0,3,1,0,138,79,44890,34956,159,219,46925,33587
150,16,2,2,2,1,2,1,205,105,44892,34958,209,81,46926,33588
151,16,1,0,0,3,1,0,143,125,44893,34958,161,2,46929,33588
152,16,0,0,2,1,2,1,81,85,44893,34958,84,116,46930,33589
153,16,2,0,0,3,1,0,80,82,44895,34958,87,26,46933,33589
154,16,1,2,1,0,0,3,343,92,44896,34960,267,90,46933,33592
155,16,0,2,1,0,0,3,172,111,44896,34962,182,93,46933,33595
156,16,2,0,0,3,1,0,167,112,44898,34962,184,90,46936,33595
157,16,0,2,1,0,0,3,80,95,44898,34964,102,73,46936,33598
158,16,1,0,0,3,1,0,155,114,44899,34964,169,165,46939,33598
159,16,1,3,1,0,0,3,56,55,44900,34967,66,228,46939,33601
160,17,0,1,1,0,0,3,129,125,44900,34968,152,107,46939,33604
161,17,3,1,0,3,1,0,346,93,44903,34969,270,97,46942,33604
162,17,2,0,0,3,1,0,205,117,44905,34969,207,89,46945,33604
163,17,0,2,1,0,0,3,119,131,44905,34971,115,168,46945,33607
164,17,2,0,0,3,1,0,31,37,44907,34971,33,33,46948,33607
165,17,0,0,2,1,2,1,131,120,44907,34971,153,53,46949,33608
166,17,4,0,0,3,1,0,338,69,44911,34971,281,64,46952,33608
167,17,0,1,1,0,0,3,91,80,44911,34972,95,120,46952,33611
168,17,4,1,0,3,1,0,9,6,44915,34973,14,72,46955,33611
169,17,1,0,0,3,1,0,139,79,44916,34973,162,136,46958,33611
170,18,0,0,2,1,2,1,143,125,44916,34973,162,229,46959,33612
171,18,1,0,0,3,1,0,216,75,44917,34973,231,90,46962,33612
172,18,2,0,0,3,1,0,157,114,44919,34973,172,73,46965,33612
173,18,2,2,2,1,2,1,121,133,44921,34975,116,98,46966,33613
174,18,0,4,1,0,0,3,81,89,44921,34979,84,29,46966,33616
175,18,2,1,0,3,1,0,82,96,44923,34980,105,116,46969,33616
176,18,2,2,2,1,2,1,169,114,44925,34982,185,3,46970,33617
177,18,1,2,1,0,0,3,81,84,44926,34984,87,96,46970,33620
178,18,2,2,2,1,2,1,207,107,44928,34986,210,220,46971,33621
179,18,1,2,1,0,0,3,57,57,44929,34988,66,84,46971,33624
180,19,4,0,0,3,1,0,342,69,44933,34988,284,72,46974,33624
181,19,1,0,0,3,1,0,132,120,44934,34988,156,64,46977,33624
182,19,2,0,0,3,1,0,207,117,44936,34988,210,120,46980,33624
183,19,5,0,0,3,1,0,351,93,44941,34988,273,53,46983,33624
184,19,2,1,0,3,1,0,131,126,44943,34989,155,90,46986,33624
185,19,2,0,0,3,1,0,141,79,44945,34989,165,33,46989,33624
186,19,2,0,0,3,1,0,174,111,44947,34989,185,136,46992,33624
187,19,2,1,0,3,1,0,33,38,44949,34990,36,89,46995,33624
188,19,1,1,2,1,2,1,10,7,44950,34991,15,108,46996,33625
189,19,0,2,1,0,0,3,91,82,44950,34993,95,171,46996,33628
190,20,2,1,0,3,1,0,209,118,44952,34994,213,108,46999,33628
191,20,4,3,0,3,1,0,95,85,44956,34997,98,90,47002,33628
192,20,0,0,2,1,2,1,141,79,44956,34997,166,65,47003,33629
193,20,1,1,2,1,2,1,175,112,44957,34998,186,54,47004,33630
194,20,2,2,2,1,2,1,209,109,44959,35000,211,91,47005,33631
195,20,5,1,0,3,1,0,356,94,44964,35001,276,33,47008,33631
196,20,0,3,1,0,0,3,10,10,44964,35004,15,174,47008,33634
197,20,3,1,0,3,1,0,135,121,44967,35005,159,89,47011,33634
198,20,6,0,0,3,1,0,348,69,44973,35005,287,120,47014,33634
199,20,5,1,0,3,1,0,38,39,44978,35006,39,72,47017,33634
200,21,5,1,0,3,1,0,62,58,44983,35007,69,98,47020,33634
201,21,1,2,1,0,0,3,158,116,44984,35009,172,232,47020,33637
202,21,2,2,2,1,2,1,145,127,44986,35011,163,97,47021,33638
203,21,3,2,0,3,1,0,85,98,44989,35013,108,84,47024,33638
204,21,3,0,0,3,1,0,124,133,44992,35013,119,73,47027,33638
205,21,5,2,0,3,1,0,174,116,44997,35015,188,29,47030,33638
206,21,0,0,2,1,2,1,216,75,44997,35015,232,117,47031,33639
207,21,1,1,2,1,2,1,82,85,44998,35016,88,137,47032,33640
208,21,1,1,2,1,2,1,82,90,44999,35017,85,221,47033,33641
209,21,3,2,0,3,1,0,134,128,45002,35019,158,3,47036,33641
210,22,2,1,0,3,1,0,350,70,45004,35020,290,174,47039,33641
211,22,1,2,1,0,0,3,39,41,45005,35022,39,111,47039,33644
212,22,0,1,1,0,0,3,135,122,45005,35023,159,123,47039,33647
213,22,1,0,0,3,1,0,142,79,45006,35023,169,72,47042,33647
214,22,2,1,0,3,1,0,177,113,45008,35024,189,65,47045,33647
215,22,3,1,0,3,1,0,212,119,45011,35025,216,90,47048,33647
216,22,0,1,1,0,0,3,209,110,45011,35026,211,36,47048,33650
217,22,2,1,0,3,1,0,12,11,45013,35027,18,73,47051,33650
218,22,6,0,0,3,1,0,362,94,45019,35027,279,89,47054,33650
219,22,2,2,2,1,2,1,84,87,45021,35029,89,92,47055,33651
220,23,3,0,0,3,1,0,161,116,45024,35029,175,84,47058,33651
221,23,3,1,0,3,1,0,219,76,45027,35030,235,29,47061,33651
222,23,2,0,0,3,1,0,126,133,45029,35030,122,3,47064,33651
223,23,0,0,2,1,2,1,174,116,45029,35030,189,98,47065,33652
224,23,1,1,2,1,2,1,63,59,45030,35031,70,55,47066,33653
225,23,0,2,1,0,0,3,134,130,45030,35033,158,235,47066,33656
226,23,1,0,0,3,1,0,83,90,45031,35033,88,137,47069,33656
227,23,1,1,2,1,2,1,96,86,45032,35034,99,118,47070,33657
228,23,1,2,1,0,0,3,86,100,45033,35036,108,224,47070,33660
229,23,0,5,1,0,0,3,145,132,45033,35041,163,101,47070,33663
230,24,2,2,2,1,2,1,65,61,45035,35043,71,93,47071,33664
231,24,4,2,0,3,1,0,366,96,45039,35045,282,123,47074,33664
232,24,1,0,0,3,1,0,143,79,45040,35045,172,111,47077,33664
233,24,2,1,0,3,1,0,211,111,45042,35046,214,89,47080,33664
234,24,2,2,2,1,2,1,86,89,45044,35048,90,66,47081,33665
235,24,3,0,0,3,1,0,180,113,45047,35048,192,72,47084,33665
236,24,2,0,0,3,1,0,214,119,45049,35048,219,3,47087,33665
237,24,2,0,0,3,1,0,41,41,45051,35048,42,90,47090,33665
238,24,0,1,1,0,0,3,135,123,45051,35049,159,177,47090,33668
239,24,6,1,0,3,1,0,356,71,45057,35050,293,73,47093,33668
240,25,3,0,0,3,1,0,137,130,45060,35050,161,84,47096,33668
241,25,1,2,1,0,0,3,13,13,45061,35052,18,238,47096,33671
242,25,1,0,0,3,1,0,146,132,45062,35052,166,55,47099,33671
243,25,1,1,2,1,2,1,84,91,45063,35053,89,37,47100,33672
244,25,3,2,0,3,1,0,99,88,45066,35055,102,29,47103,33672
245,25,2,2,2,1,2,1,128,135,45068,35057,123,119,47104,33673
246,25,1,1,2,1,2,1,162,117,45069,35058,176,225,47105,33674
247,25,0,1,1,0,0,3,174,117,45069,35059,189,104,47105,33677
248,25,1,2,1,0,0,3,87,102,45070,35061,108,140,47105,33680
249,25,0,0,2,1,2,1,219,76,45070,35061,236,99,47106,33681
250,26,0,1,1,0,0,3,41,42,45070,35062,42,6,47106,33684
251,26,0,1,1,0,0,3,366,97,45070,35063,282,180,47106,33687
252,26,0,1,1,0,0,3,135,124,45070,35064,159,76,47106,33690
253,26,2,4,1,0,0,3,67,65,45072,35068,71,92,47106,33693
254,26,2,2,2,1,2,1,86,93,45074,35070,90,94,47107,33694
255,26,1,1,2,1,2,1,181,114,45075,35071,193,112,47108,33695
256,26,3,0,0,3,1,0,146,79,45078,35071,175,90,47111,33695
257,26,0,3,1,0,0,3,211,114,45078,35074,214,126,47111,33698
258,26,0,1,1,0,0,3,86,90,45078,35075,90,75,47111,33701
259,26,2,1,0,3,1,0,358,72,45080,35076,296,119,47114,33701
260,27,3,0,0,3,1,0,222,76,45083,35076,239,104,47117,33701
261,27,4,0,0,3,1,0,17,13,45087,35076,21,84,47120,33701
262,27,1,0,0,3,1,0,215,119,45088,35076,222,29,47123,33701
263,27,0,0,2,1,2,1,99,88,45088,35076,103,100,47124,33702
264,27,1,2,1,0,0,3,163,119,45089,35078,176,143,47124,33705
265,27,4,1,0,3,1,0,178,118,45093,35079,192,55,47127,33705
266,27,1,3,1,0,0,3,138,133,45094,35082,161,228,47127,33708
267,27,2,0,0,3,1,0,89,102,45096,35082,111,37,47130,33708
268,27,0,3,1,0,0,3,146,135,45096,35085,166,69,47130,33711
269,27,1,5,1,0,0,3,129,140,45097,35090,123,241,47130,33714
270,28,7,1,0,3,1,0,373,98,45104,35091,285,76,47133,33714
271,28,0,1,1,0,0,3,146,80,45104,35092,175,9,47133,33717
272,28,1,1,2,1,2,1,136,125,45105,35093,160,120,47134,33718
273,28,3,3,2,1,2,1,89,93,45108,35096,91,113,47135,33719
274,28,2,0,0,3,1,0,88,93,45110,35096,93,75,47138,33719
275,28,0,4,1,0,0,3,41,46,45110,35100,42,244,47138,33722
276,28,1,1,2,1,2,1,182,115,45111,35101,194,91,47139,33723
277,28,0,2,1,0,0,3,67,67,45111,35103,71,129,47139,33726
278,28,1,3,1,0,0,3,212,117,45112,35106,214,183,47139,33729
279,28,2,1,0,3,1,0,148,136,45114,35107,169,94,47142,33729
280,29,1,0,0,3,1,0,164,119,45115,35107,179,37,47145,33729
281,29,6,0,0,3,1,0,364,72,45121,35107,299,84,47148,33729
282,29,1,0,0,3,1,0,100,88,45122,35107,106,104,47151,33729
283,29,3,0,0,3,1,0,225,76,45125,35107,242,55,47154,33729
284,29,1,1,2,1,2,1,130,141,45126,35108,124,30,47155,33730
285,29,1,0,0,3,1,0,139,133,45127,35108,164,143,47158,33730
286,29,4,2,0,3,1,0,219,121,45131,35110,225,100,47161,33730
287,29,3,1,0,3,1,0,181,119,45134,35111,195,69,47164,33730
288,29,1,2,1,0,0,3,18,15,45135,35113,21,231,47164,33733
289,29,1,1,2,1,2,1,90,103,45136,35114,112,93,47165,33734
290,30,1,1,2,1,2,1,137,126,45137,35115,161,31,47166,33735
291,30,2,1,0,3,1,0,69,68,45139,35116,74,183,47169,33735
292,30,0,1,1,0,0,3,182,116,45139,35117,194,12,47169,33738
293,30,2,2,2,1,2,1,92,105,45141,35119,113,95,47170,33739
294,30,2,1,0,3,1,0,91,94,45143,35120,94,91,47173,33739
295,30,0,1,1,0,0,3,88,94,45143,35121,93,116,47173,33742
296,30,2,1,0,3,1,0,150,137,45145,35122,172,129,47176,33742
297,30,2,2,2,1,2,1,148,82,45147,35124,176,245,47177,33743
298,30,0,2,1,0,0,3,212,119,45147,35126,214,79,47177,33746
299,30,4,0,0,3,1,0,377,98,45151,35126,288,120,47180,33746
300,31,2,0,0,3,1,0,132,141,45153,35126,127,84,47183,33746
301,31,5,1,0,3,1,0,230,77,45158,35127,245,69,47186,33746
302,31,2,1,0,3,1,0,20,16,45160,35128,24,143,47189,33746
303,31,1,2,1,0,0,3,365,74,45161,35130,299,234,47189,33749
304,31,1,1,2,1,2,1,101,89,45162,35131,107,56,47190,33750
305,31,1,1,2,1,2,1,182,120,45163,35132,196,76,47191,33751
306,31,1,1,2,1,2,1,165,120,45164,35133,180,94,47192,33752
307,31,1,2,1,0,0,3,42,48,45165,35135,42,103,47192,33755
308,31,1,2,1,0,0,3,220,123,45166,35137,225,107,47192,33758
309,31,0,0,2,1,2,1,139,133,45166,35137,165,38,47193,33759
310,32,0,0,2,1,2,1,92,105,45166,35137,114,117,47194,33760
311,32,4,0,0,3,1,0,381,98,45170,35137,291,31,47197,33760
312,32,1,3,1,0,0,3,151,140,45171,35140,172,186,47197,33763
313,32,1,0,0,3,1,0,183,116,45172,35140,197,245,47200,33763
314,32,1,0,0,3,1,0,89,94,45173,35140,96,91,47203,33763
315,32,0,1,1,0,0,3,69,69,45173,35141,74,82,47203,33766
316,32,2,1,0,3,1,0,214,120,45175,35142,217,120,47206,33766
317,32,2,0,0,3,1,0,150,82,45177,35142,179,84,47209,33766
318,32,1,0,0,3,1,0,183,120,45178,35142,199,95,47212,33766
319,32,1,3,1,0,0,3,92,97,45179,35145,94,15,47212,33769
320,33,2,1,0,3,1,0,141,134,45181,35146,168,94,47215,33769
321,33,1,5,1,0,0,3,138,131,45182,35151,161,237,47215,33772
322,33,1,1,2,1,2,1,21,17,45183,35152,25,39,47216,33773
323,33,2,1,0,3,1,0,44,49,45185,35153,45,107,47219,33773
324,33,1,1,2,1,2,1,102,90,45186,35154,108,70,47220,33774
325,33,0,1,1,0,0,3,165,121,45186,35155,180,132,47220,33777
326,33,1,1,2,1,2,1,221,124,45187,35156,226,57,47221,33778
327,33,2,1,0,3,1,0,134,142,45189,35157,130,103,47224,33778
328,33,3,0,0,3,1,0,233,77,45192,35157,248,76,47227,33778
329,33,1,2,1,0,0,3,366,76,45193,35159,299,146,47227,33781
330,34,1,1,2,1,2,1,152,141,45194,35160,173,83,47228,33782
331,34,1,0,0,3,1,0,90,94,45195,35160,99,15,47231,33782
332,34,0,8,1,0,0,3,92,105,45195,35168,94,248,47231,33785
333,34,4,0,0,3,1,0,218,120,45199,35168,220,31,47234,33785
334,34,2,1,0,3,1,0,71,70,45201,35169,77,120,47237,33785
335,34,0,1,1,0,0,3,183,121,45201,35170,199,189,47237,33788
336,34,1,1,2,1,2,1,166,122,45202,35171,181,96,47238,33789
337,34,3,0,0,3,1,0,384,98,45205,35171,294,103,47241,33789
338,34,1,2,1,0,0,3,184,118,45206,35173,197,87,47241,33792
339,34,5,1,0,3,1,0,97,106,45211,35174,117,91,47244,33792
340,35,4,0,0,3,1,0,25,17,45215,35174,28,94,47247,33792
341,35,2,3,1,0,0,3,136,145,45217,35177,130,240,47247,33795
342,35,1,0,0,3,1,0,234,77,45218,35177,251,117,47250,33795
343,35,6,0,0,3,1,0,372,76,45224,35177,302,39,47253,33795
344,35,1,1,2,1,2,1,45,50,45225,35178,46,58,47254,33796
345,35,2,2,2,1,2,1,143,136,45227,35180,169,133,47255,33797
346,35,2,0,0,3,1,0,223,124,45229,35180,229,70,47258,33797
347,35,2,2,2,1,2,1,140,133,45231,35182,162,147,47259,33798
348,35,0,0,2,1,2,1,150,82,45231,35182,180,108,47260,33799
349,35,2,1,0,3,1,0,104,91,45233,35183,111,76,47263,33799
350,36,2,0,0,3,1,0,73,70,45235,35183,80,31,47266,33799
351,36,0,1,1,0,0,3,184,119,45235,35184,197,243,47266,33802
352,36,1,0,0,3,1,0,235,77,45236,35184,254,96,47269,33802
353,36,0,2,1,0,0,3,90,96,45236,35186,99,251,47269,33805
354,36,3,2,0,3,1,0,100,108,45239,35188,120,15,47272,33805
355,36,2,1,0,3,1,0,185,122,45241,35189,202,83,47275,33805
356,36,1,0,0,3,1,0,153,141,45242,35189,176,120,47278,33805
357,36,0,2,1,0,0,3,92,107,45242,35191,94,90,47278,33808
358,36,0,2,1,0,0,3,218,122,45242,35193,220,106,47278,33811
359,36,3,1,0,3,1,0,169,123,45245,35194,184,91,47281,33811
360,37,2,1,0,3,1,0,186,120,45247,35195,200,96,47284,33811
361,37,3,2,0,3,1,0,387,100,45250,35197,297,147,47287,33811
362,37,0,2,1,0,0,3,150,84,45250,35199,180,61,47287,33814
363,37,1,1,2,1,2,1,141,134,45251,35200,163,40,47288,33815
364,37,1,1,2,1,2,1,46,51,45252,35201,47,71,47289,33816
365,37,5,0,0,3,1,0,377,76,45257,35201,305,94,47292,33816
366,37,1,4,1,0,0,3,224,128,45258,35205,229,79,47292,33819
367,37,0,0,2,1,2,1,25,17,45258,35205,29,134,47293,33820
368,37,1,0,0,3,1,0,105,91,45259,35205,114,117,47296,33820
369,37,2,1,0,3,1,0,145,137,45261,35206,172,189,47299,33820
370,38,0,1,1,0,0,3,218,123,45261,35207,220,111,47299,33823
371,38,0,2,1,0,0,3,92,109,45261,35209,94,246,47299,33826
372,38,0,3,1,0,0,3,100,111,45261,35212,120,254,47299,33829
373,38,3,1,0,3,1,0,188,123,45264,35213,205,120,47302,33829
374,38,2,0,0,3,1,0,237,77,45266,35213,257,83,47305,33829
375,38,4,1,0,3,1,0,173,124,45270,35214,187,15,47308,33829
376,38,4,2,0,3,1,0,157,143,45274,35216,179,31,47311,33829
377,38,2,0,0,3,1,0,75,70,45276,35216,83,106,47314,33829
378,38,2,1,0,3,1,0,92,97,45278,35217,102,90,47317,33829
379,38,3,1,0,3,1,0,139,146,45281,35218,133,91,47320,33829
0,1,1,1,2,1,2,1,174,125,45282,35219,188,59,47321,33830
1,1,2,1,0,3,1,0,94,110,45284,35220,97,31,47324,33830
2,1,6,2,0,3,1,0,383,78,45290,35222,308,71,47327,33830
3,1,1,1,2,1,2,1,101,112,45291,35223,121,107,47328,33831
4,1,6,4,0,3,1,0,230,132,45297,35227,232,94,47331,33831
5,1,2,1,0,3,1,0,77,71,45299,35228,86,134,47334,33831
6,1,0,3,1,0,0,3,186,123,45299,35231,200,249,47334,33834
7,1,1,1,2,1,2,1,238,78,45300,35232,258,1,47335,33835
8,1,0,1,1,0,0,3,105,92,45300,35233,114,3,47335,33838
9,1,2,4,1,0,0,3,220,127,45302,35237,220,18,47335,33841
10,2,0,0,2,1,2,1,92,97,45302,35237,103,62,47336,33842
11,2,2,2,2,1,2,1,159,145,45304,35239,180,118,47337,33843
12,2,0,2,1,0,0,3,89,74,45304,35241,121,114,47337,33846
13,2,1,0,0,3,1,0,47,51,45305,35241,50,147,47340,33846
14,2,2,1,0,3,1,0,389,101,45307,35242,300,83,47343,33846
15,2,0,0,2,1,2,1,0,0,45307,35242,1,190,47344,33847
16,2,5,1,0,3,1,0,30,18,45312,35243,32,79,47347,33847
17,2,0,0,2,1,2,1,0,0,45312,35243,1,41,47348,33848
18,2,0,1,1,0,0,3,188,124,45312,35244,205,257,47348,33851
19,2,0,0,2,1,2,1,150,84,45312,35244,181,121,47349,33852
20,3,1,1,2,1,2,1,187,124,45313,35245,201,95,47350,33853
21,3,0,4,1,0,0,3,105,96,45313,35249,114,193,47350,33856
22,3,5,2,0,3,1,0,394,103,45318,35251,303,59,47353,33856
23,3,0,2,1,0,0,3,174,127,45318,35253,188,110,47353,33859
24,3,2,1,0,3,1,0,232,133,45320,35254,235,18,47356,33859
25,3,1,2,1,0,0,3,384,80,45321,35256,308,4,47356,33862
26,3,2,1,0,3,1,0,79,72,45323,35257,89,3,47359,33862
27,3,2,3,1,0,0,3,222,130,45325,35260,220,74,47359,33865
28,3,1,2,1,0,0,3,102,114,45326,35262,121,34,47359,33868
29,3,0,1,1,0,0,3,94,111,45326,35263,97,137,47359,33871
30,4,2,2,2,1,2,1,94,99,45328,35265,104,80,47360,33872
31,4,1,5,1,0,0,3,1,5,45329,35270,1,260,47360,33875
32,4,5,0,0,3,1,0,243,78,45334,35270,261,41,47363,33875
33,4,1,1,2,1,2,1,48,52,45335,35271,51,122,47364,33876
34,4,1,0,0,3,1,0,31,18,45336,35271,35,118,47367,33876
35,4,0,0,2,1,2,1,89,74,45336,35271,122,84,47368,33877
36,4,2,1,0,3,1,0,190,125,45338,35272,208,147,47371,33877
37,4,2,1,0,3,1,0,152,85,45340,35273,184,114,47374,33877
38,4,0,2,1,0,0,3,159,147,45340,35275,180,252,47374,33880
39,4,0,0,2,1,2,1,0,0,45340,35275,2,63,47375,33881
40,5,2,1,0,3,1,0,176,128,45342,35276,191,34,47378,33881
41,5,1,0,0,3,1,0,233,133,45343,35276,238,74,47381,33881
42,5,1,1,2,1,2,1,395,104,45344,35277,304,111,47382,33882
43,5,2,1,0,3,1,0,107,97,45346,35278,117,41,47385,33882
44,5,4,1,0,3,1,0,191,125,45350,35279,204,18,47388,33882
45,5,1,2,1,0,0,3,103,116,45351,35281,121,140,47388,33885
46,5,1,1,2,1,2,1,385,81,45352,35282,309,194,47389,33886
47,5,1,2,1,0,0,3,90,76,45353,35284,122,98,47389,33889
48,5,1,2,1,0,0,3,95,113,45354,35286,97,6,47389,33892
49,5,2,1,0,3,1,0,224,131,45356,35287,223,4,47392,33892
50,6,1,0,0,3,1,0,95,99,45357,35287,107,118,47395,33892
51,6,2,0,0,3,1,0,50,52,45359,35287,54,114,47398,33892
52,6,0,5,1,0,0,3,79,77,45359,35292,89,263,47398,33895
53,6,3,1,0,3,1,0,193,126,45362,35293,211,122,47401,33895
54,6,2,2,2,1,2,1,33,20,45364,35295,36,253,47402,33896
55,6,1,2,1,0,0,3,2,7,45365,35297,1,150,47402,33899
56,6,1,0,0,3,1,0,244,78,45366,35297,264,63,47405,33899
57,6,3,1,0,3,1,0,155,86,45369,35298,187,59,47408,33899
58,6,0,2,1,0,0,3,159,149,45369,35300,180,87,47408,33902
59,6,3,1,0,3,1,0,3,1,45372,35301,5,80,47411,33902
60,7,1,0,0,3,1,0,192,125,45373,35301,207,74,47414,33902
61,7,0,1,1,0,0,3,103,117,45373,35302,121,9,47414,33905
62,7,2,1,0,3,1,0,235,134,45375,35303,241,4,47417,33905
63,7,2,2,2,1,2,1,92,78,45377,35305,123,19,47418,33906
64,7,2,1,0,3,1,0,97,114,45379,35306,100,41,47421,33906
65,7,0,2,1,0,0,3,224,133,45379,35308,223,197,47421,33909
66,7,1,1,2,1,2,1,396,105,45380,35309,305,35,47422,33910
67,7,0,0,2,1,2,1,159,149,45380,35309,181,112,47423,33911
68,7,2,1,0,3,1,0,178,129,45382,35310,194,140,47426,33911
69,7,4,3,0,3,1,0,111,100,45386,35313,120,263,47429,33911
70,8,0,0,2,1,2,1,33,20,45386,35313,37,99,47430,33912
71,8,2,3,1,0,0,3,4,10,45388,35316,1,125,47430,33915
72,8,4,0,0,3,1,0,389,81,45392,35316,312,63,47433,33915
73,8,7,1,0,3,1,0,251,79,45399,35317,267,80,47436,33915
74,8,1,6,1,0,0,3,96,105,45400,35323,107,256,47436,33918
75,8,1,1,2,1,2,1,4,2,45401,35324,6,119,47437,33919
76,8,3,2,0,3,1,0,196,128,45404,35326,214,114,47440,33919
77,8,1,2,1,0,0,3,80,79,45405,35328,89,153,47440,33922
78,8,5,0,0,3,1,0,160,86,45410,35328,190,87,47443,33922
79,8,2,3,1,0,0,3,52,55,45412,35331,54,62,47443,33925
80,9,1,2,1,0,0,3,93,80,45413,35333,123,77,47443,33928
81,9,3,3,2,1,2,1,162,152,45416,35336,182,36,47444,33929
82,9,2,3,1,0,0,3,226,136,45418,35339,223,266,47444,33932
83,9,3,0,0,3,1,0,195,125,45421,35339,210,4,47447,33932
84,9,0,0,2,1,2,1,103,117,45421,35339,122,42,47448,33933
85,9,4,1,0,3,1,0,115,101,45425,35340,123,63,47451,33933
86,9,1,0,0,3,1,0,236,134,45426,35340,244,197,47454,33933
87,9,2,1,0,3,1,0,162,87,45428,35341,193,19,47457,33933
88,9,4,0,0,3,1,0,182,129,45432,35341,197,9,47460,33933
89,9,2,1,0,3,1,0,398,106,45434,35342,308,140,47463,33933
90,10,0,2,1,0,0,3,4,12,45434,35344,1,117,47463,33936
91,10,1,1,2,1,2,1,81,80,45435,35345,90,126,47464,33937
92,10,1,4,1,0,0,3,5,6,45436,35349,6,259,47464,33940
93,10,4,2,0,3,1,0,255,81,45440,35351,270,119,47467,33940
94,10,1,0,0,3,1,0,390,81,45441,35351,315,80,47470,33940
95,10,2,1,0,3,1,0,54,56,45443,35352,57,112,47473,33940
96,10,1,1,2,1,2,1,197,129,45444,35353,215,63,47474,33941
97,10,0,1,1,0,0,3,96,106,45444,35354,107,102,47474,33944
98,10,3,3,2,1,2,1,36,23,45447,35357,38,88,47475,33945
99,10,1,1,2,1,2,1,98,115,45448,35358,101,154,47476,33946
100,11,3,2,0,3,1,0,185,131,45451,35360,200,42,47479,33946
101,11,1,1,2,1,2,1,104,118,45452,35361,123,64,47480,33947
102,11,2,0,0,3,1,0,197,125,45454,35361,213,197,47483,33947
103,11,0,1,1,0,0,3,93,81,45454,35362,123,7,47483,33950
104,11,1,0,0,3,1,0,37,23,45455,35362,41,36,47486,33950
105,11,3,0,0,3,1,0,401,106,45458,35362,311,9,47489,33950
106,11,0,0,2,1,2,1,162,152,45458,35362,183,141,47490,33951
107,11,2,1,0,3,1,0,117,102,45460,35363,126,154,47493,33951
108,11,2,0,0,3,1,0,164,87,45462,35363,196,77,47496,33951
109,11,1,2,1,0,0,3,237,136,45463,35365,244,269,47496,33954
110,12,2,0,0,3,1,0,98,106,45465,35365,110,19,47499,33954
111,12,2,3,1,0,0,3,100,118,45467,35368,101,129,47499,33957
112,12,0,0,2,1,2,1,390,81,45467,35368,316,120,47500,33958
113,12,1,0,0,3,1,0,55,56,45468,35368,60,88,47503,33958
114,12,0,3,1,0,0,3,255,84,45468,35371,270,262,47503,33961
115,12,0,1,1,0,0,3,5,7,45468,35372,6,105,47503,33964
116,12,1,1,2,1,2,1,227,137,45469,35373,224,81,47504,33965
117,12,1,3,1,0,0,3,82,83,45470,35376,90,120,47504,33968
118,12,1,0,0,3,1,0,198,129,45471,35376,218,112,47507,33968
119,12,2,0,0,3,1,0,6,12,45473,35376,4,63,47510,33968
120,13,3,1,0,3,1,0,58,57,45476,35377,63,77,47513,33968
121,13,4,3,0,3,1,0,189,134,45480,35380,203,64,47516,33968
122,13,2,1,0,3,1,0,403,107,45482,35381,314,42,47519,33968
123,13,3,0,0,3,1,0,165,152,45485,35381,186,9,47522,33968
124,13,2,1,0,3,1,0,239,137,45487,35382,247,154,47525,33968
125,13,0,2,1,0,0,3,164,89,45487,35384,196,10,47525,33971
126,13,0,3,1,0,0,3,93,84,45487,35387,123,200,47525,33974
127,13,3,1,0,3,1,0,120,103,45490,35388,129,81,47528,33974
128,13,1,1,2,1,2,1,198,126,45491,35389,214,270,47529,33975
129,13,3,1,0,3,1,0,40,24,45494,35390,44,141,47532,33975
130,14,2,1,0,3,1,0,106,119,45496,35391,126,129,47535,33975
131,14,1,1,2,1,2,1,391,82,45497,35392,317,263,47536,33976
132,14,0,0,2,1,2,1,6,12,45497,35392,5,113,47537,33977
133,14,0,0,2,1,2,1,255,84,45497,35392,271,106,47538,33978
134,14,3,3,2,1,2,1,101,109,45500,35395,111,89,47539,33979
135,14,3,1,0,3,1,0,201,130,45503,35396,221,36,47542,33979
136,14,3,1,0,3,1,0,85,84,45506,35397,93,63,47545,33979
137,14,1,1,2,1,2,1,6,8,45507,35398,7,20,47546,33980
138,14,2,2,2,1,2,1,229,139,45509,35400,225,121,47547,33981
139,14,5,1,0,3,1,0,105,119,45514,35401,104,120,47550,33981
140,15,1,1,2,1,2,1,190,135,45515,35402,204,82,47551,33982
141,15,0,3,1,0,0,3,93,87,45515,35405,123,273,47551,33985
142,15,3,2,0,3,1,0,201,128,45518,35407,217,154,47554,33985
143,15,1,1,2,1,2,1,41,25,45519,35408,45,10,47555,33986
144,15,3,2,0,3,1,0,406,109,45522,35410,317,64,47558,33986
145,15,0,0,2,1,2,1,58,57,45522,35410,64,11,47559,33987
146,15,0,3,1,0,0,3,120,106,45522,35413,129,132,47559,33990
147,15,2,1,0,3,1,0,167,153,45524,35414,189,42,47562,33990
148,15,1,0,0,3,1,0,102,109,45525,35414,114,141,47565,33990
149,15,3,0,0,3,1,0,167,89,45528,35414,199,200,47568,33990
150,16,1,0,0,3,1,0,7,8,45529,35414,10,77,47571,33990
151,16,1,3,1,0,0,3,86,87,45530,35417,93,116,47571,33993
152,16,1,0,0,3,1,0,256,84,45531,35417,274,20,47574,33993
153,16,0,2,1,0,0,3,106,121,45531,35419,126,123,47574,33996
154,16,4,1,0,3,1,0,243,138,45535,35420,250,121,47577,33996
155,16,1,1,2,1,2,1,7,13,45536,35421,6,37,47578,33997
156,16,2,0,0,3,1,0,107,119,45538,35421,107,63,47581,33997
157,16,4,1,0,3,1,0,395,83,45542,35422,320,106,47584,33997
158,16,2,1,0,3,1,0,203,131,45544,35423,224,89,47587,33997
159,16,2,1,0,3,1,0,231,140,45546,35424,228,263,47590,33997
160,17,1,1,2,1,2,1,168,154,45547,35425,190,65,47591,33998
161,17,5,0,0,3,1,0,411,109,45552,35425,320,82,47594,33998
162,17,0,2,1,0,0,3,58,59,45552,35427,64,203,47594,34001
163,17,1,0,0,3,1,0,42,25,45553,35427,48,42,47597,34001
164,17,0,4,1,0,0,3,201,132,45553,35431,217,135,47597,34004
165,17,0,0,2,1,2,1,203,131,45553,35431,225,12,47598,34005
166,17,2,0,0,3,1,0,104,109,45555,35431,117,10,47601,34005
167,17,3,1,0,3,1,0,123,107,45558,35432,132,121,47604,34005
168,17,1,1,2,1,2,1,168,90,45559,35433,200,274,47605,34006
169,17,3,3,2,1,2,1,96,90,45562,35436,124,155,47606,34007
170,18,0,0,2,1,2,1,7,13,45562,35436,7,142,47607,34008
171,18,5,0,0,3,1,0,400,83,45567,35436,323,20,47610,34008
172,18,1,0,0,3,1,0,257,84,45568,35436,277,77,47613,34008
173,18,0,0,2,1,2,1,107,119,45568,35436,108,117,47614,34009
174,18,2,1,0,3,1,0,233,141,45570,35437,231,106,47617,34009
175,18,1,0,0,3,1,0,124,107,45571,35437,135,12,47620,34009
176,18,2,3,1,0,0,3,88,90,45573,35440,93,40,47620,34012
177,18,1,1,2,1,2,1,107,122,45574,35441,127,64,47621,34013
178,18,2,1,0,3,1,0,245,139,45576,35442,253,263,47624,34013
179,18,0,2,1,0,0,3,190,137,45576,35444,204,126,47624,34016
180,19,1,1,2,1,2,1,43,26,45577,35445,49,66,47625,34017
181,19,3,1,0,3,1,0,171,155,45580,35446,193,82,47628,34017
182,19,2,1,0,3,1,0,413,110,45582,35447,323,121,47631,34017
183,19,2,2,2,1,2,1,9,10,45584,35449,11,11,47632,34018
184,19,0,2,1,0,0,3,168,92,45584,35451,200,158,47632,34021
185,19,3,4,1,0,0,3,99,94,45587,35455,124,138,47632,34024
186,19,2,2,2,1,2,1,205,133,45589,35457,226,204,47633,34025
187,19,0,0,2,1,2,1,104,109,45589,35457,118,43,47634,34026
188,19,1,0,0,3,1,0,202,132,45590,35457,220,89,47637,34026
189,19,0,4,1,0,0,3,58,63,45590,35461,64,277,47637,34029
190,20,1,1,2,1,2,1,100,95,45591,35462,125,122,47638,34030
191,20,2,0,0,3,1,0,170,92,45593,35462,203,82,47641,34030
192,20,0,0,2,1,2,1,9,10,45593,35462,12,205,47642,34031
193,20,3,1,0,3,1,0,61,64,45596,35463,67,66,47645,34031
194,20,0,2,1,0,0,3,7,15,45596,35465,7,92,47645,34034
195,20,1,1,2,1,2,1,105,110,45597,35466,119,278,47646,34035
196,20,3,1,0,3,1,0,174,156,45600,35467,196,138,47649,34035
197,20,2,1,0,3,1,0,207,134,45602,35468,229,43,47652,34035
198,20,3,0,0,3,1,0,416,110,45605,35468,326,126,47655,34035
199,20,3,1,0,3,1,0,46,27,45608,35469,52,158,47658,34035
200,21,0,1,1,0,0,3,190,138,45608,35470,204,109,47658,34038
201,21,3,0,0,3,1,0,403,83,45611,35470,326,142,47661,34038
202,21,2,0,0,3,1,0,259,84,45613,35470,280,11,47664,34038
203,21,0,4,1,0,0,3,233,145,45613,35474,231,43,47664,34041
204,21,0,0,2,1,2,1,245,139,45613,35474,254,118,47665,34042
205,21,2,4,1,0,0,3,90,94,45615,35478,93,15,47665,34045
206,21,3,2,0,3,1,0,205,134,45618,35480,223,64,47668,34045
207,21,1,0,0,3,1,0,108,122,45619,35480,130,20,47671,34045
208,21,1,1,2,1,2,1,108,120,45620,35481,109,78,47672,34046
209,21,1,4,1,0,0,3,125,111,45621,35485,135,266,47672,34049
210,22,1,2,1,0,0,3,175,158,45622,35487,196,129,47672,34052
211,22,0,0,2,1,2,1,105,110,45622,35487,120,159,47673,34053
212,22,0,6,1,0,0,3,9,16,45622,35493,12,281,47673,34056
213,22,2,1,0,3,1,0,209,135,45624,35494,232,66,47676,34056
214,22,1,3,1,0,0,3,101,98,45625,35497,125,269,47676,34059
215,22,1,1,2,1,2,1,171,93,45626,35498,204,123,47677,34060
216,22,0,2,1,0,0,3,7,17,45626,35500,7,46,47677,34063
217,22,0,1,1,0,0,3,46,28,45626,35501,52,141,47677,34066
218,22,3,2,0,3,1,0,262,86,45629,35503,283,92,47680,34066
219,22,4,0,0,3,1,0,65,64,45633,35503,70,82,47683,34066
220,23,4,1,0,3,1,0,112,123,45637,35504,133,78,47686,34066
221,23,1,4,1,0,0,3,91,98,45638,35508,93,208,47686,34069
222,23,2,0,0,3,1,0,418,110,45640,35508,329,109,47689,34069
223,23,0,1,1,0,0,3,108,121,45640,35509,109,18,47689,34072
224,23,2,0,0,3,1,0,247,139,45642,35509,257,43,47692,34072
225,23,0,1,1,0,0,3,205,135,45642,35510,223,121,47692,34075
226,23,2,0,0,3,1,0,235,145,45644,35510,234,142,47695,34075
227,23,3,0,0,3,1,0,128,111,45647,35510,138,64,47698,34075
228,23,2,1,0,3,1,0,405,84,45649,35511,329,11,47701,34075
229,23,2,1,0,3,1,0,192,139,45651,35512,207,20,47704,34075
230,24,0,1,1,0,0,3,46,29,45651,35513,52,132,47704,34078
231,24,2,1,0,3,1,0,11,17,45653,35514,15,159,47707,34078
232,24,1,2,1,0,0,3,106,112,45654,35516,120,144,47707,34081
233,24,4,0,0,3,1,0,11,17,45658,35516,10,66,47710,34081
234,24,3,0,0,3,1,0,68,64,45661,35516,73,123,47713,34081
235,24,3,0,0,3,1,0,178,158,45664,35516,199,64,47716,34081
236,24,1,2,1,0,0,3,263,88,45665,35518,283,284,47716,34084
237,24,3,1,0,3,1,0,212,136,45668,35519,235,82,47719,34084
238,24,1,1,2,1,2,1,92,99,45669,35520,94,93,47720,34085
239,24,2,3,1,0,0,3,173,96,45671,35523,204,272,47720,34088
240,25,2,2,2,1,2,1,207,137,45673,35525,224,44,47721,34089
241,25,1,2,1,0,0,3,193,141,45674,35527,207,81,47721,34092
242,25,1,0,0,3,1,0,236,145,45675,35527,237,11,47724,34092
243,25,1,4,1,0,0,3,102,102,45676,35531,125,124,47724,34095
244,25,6,1,0,3,1,0,411,85,45682,35532,332,46,47727,34095
245,25,2,2,2,1,2,1,130,113,45684,35534,139,110,47728,34096
246,25,3,3,2,1,2,1,421,113,45687,35537,330,21,47729,34097
247,25,2,1,0,3,1,0,114,124,45689,35538,136,18,47732,34097
248,25,1,1,2,1,2,1,109,122,45690,35539,110,209,47733,34098
249,25,1,0,0,3,1,0,248,139,45691,35539,260,142,47736,34098
250,26,2,3,1,0,0,3,108,115,45693,35542,120,135,47736,34101
251,26,1,0,0,3,1,0,12,17,45694,35542,13,82,47739,34101
252,26,1,4,1,0,0,3,69,68,45695,35546,73,275,47739,34104
253,26,2,0,0,3,1,0,175,96,45697,35546,207,110,47742,34104
254,26,5,0,0,3,1,0,416,85,45702,35546,335,93,47745,34104
255,26,0,1,1,0,0,3,92,100,45702,35547,94,69,47745,34107
256,26,3,0,0,3,1,0,266,88,45705,35547,286,159,47748,34107
257,26,5,2,0,3,1,0,51,31,45710,35549,55,64,47751,34107
258,26,1,0,0,3,1,0,213,136,45711,35549,238,123,47754,34107
259,26,1,1,2,1,2,1,12,18,45712,35550,16,145,47755,34108
260,27,4,3,0,3,1,0,182,161,45716,35553,202,21,47758,34108
261,27,1,1,2,1,2,1,237,146,45717,35554,238,47,47759,34109
262,27,1,1,2,1,2,1,249,140,45718,35555,261,12,47760,34110
263,27,1,2,1,0,0,3,194,143,45719,35557,207,21,47760,34113
264,27,0,1,1,0,0,3,114,125,45719,35558,136,212,47760,34116
265,27,0,2,1,0,0,3,207,139,45719,35560,224,145,47760,34119
266,27,2,1,0,3,1,0,111,123,45721,35561,113,284,47763,34119
267,27,0,1,1,0,0,3,130,114,45721,35562,139,127,47763,34122
268,27,2,1,0,3,1,0,423,114,45723,35563,333,81,47766,34122
269,27,1,1,2,1,2,1,103,103,45724,35564,126,45,47767,34123
270,28,1,0,0,3,1,0,52,31,45725,35564,58,127,47770,34123
271,28,1,1,2,1,2,1,70,69,45726,35565,74,111,47771,34124
272,28,1,2,1,0,0,3,214,138,45727,35567,238,278,47771,34127
273,28,1,0,0,3,1,0,13,18,45728,35567,19,135,47774,34127
274,28,2,0,0,3,1,0,110,115,45730,35567,123,64,47777,34127
275,28,0,0,2,1,2,1,12,17,45730,35567,14,124,47778,34128
276,28,3,1,0,3,1,0,269,89,45733,35568,289,145,47781,34128
277,28,3,1,0,3,1,0,95,101,45736,35569,97,82,47784,34128
278,28,0,1,1,0,0,3,111,124,45736,35570,113,96,47784,34131
279,28,4,2,0,3,1,0,420,87,45740,35572,338,159,47787,34131
280,29,2,1,0,3,1,0,184,162,45742,35573,205,81,47790,34131
281,29,2,3,1,0,0,3,177,99,45744,35576,207,48,47790,34134
282,29,1,2,1,0,0,3,104,105,45745,35578,126,148,47790,34137
283,29,1,1,2,1,2,1,208,140,45746,35579,225,13,47791,34138
284,29,0,2,1,0,0,3,194,145,45746,35581,207,215,47791,34141
285,29,0,0,2,1,2,1,249,140,45746,35581,262,48,47792,34142
286,29,3,0,0,3,1,0,426,114,45749,35581,336,21,47795,34142
287,29,3,0,0,3,1,0,240,146,45752,35581,241,69,47798,34142
288,29,1,4,1,0,0,3,115,129,45753,35585,136,287,47798,34145
289,29,3,1,0,3,1,0,133,115,45756,35586,142,21,47801,34145
290,30,2,0,0,3,1,0,216,138,45758,35586,241,111,47804,34145
291,30,0,1,1,0,0,3,110,116,45758,35587,123,130,47804,34148
292,30,1,0,0,3,1,0,270,89,45759,35587,292,135,47807,34148
293,30,3,0,0,3,1,0,423,87,45762,35587,341,145,47810,34148
294,30,0,1,1,0,0,3,13,19,45762,35588,19,67,47810,34151
295,30,0,1,1,0,0,3,95,102,45762,35589,97,127,47810,34154
296,30,0,0,2,1,2,1,111,124,45762,35589,114,83,47811,34155
297,30,2,4,1,0,0,3,14,21,45764,35593,14,281,47811,34158
298,30,3,1,0,3,1,0,73,70,45767,35594,77,21,47814,34158
299,30,3,2,0,3,1,0,243,148,45770,35596,244,96,47817,34158
300,31,3,1,0,3,1,0,180,100,45773,35597,210,148,47820,34158
301,31,1,0,0,3,1,0,185,162,45774,35597,208,21,47823,34158
302,31,1,1,2,1,2,1,427,115,45775,35598,337,216,47824,34159
303,31,4,2,0,3,1,0,253,142,45779,35600,265,69,47827,34159
304,31,2,0,0,3,1,0,196,145,45781,35600,210,287,47830,34159
305,31,1,3,1,0,0,3,116,132,45782,35603,136,162,47830,34162
306,31,0,2,1,0,0,3,133,117,45782,35605,142,51,47830,34165
307,31,2,1,0,3,1,0,106,106,45784,35606,129,13,47833,34165
308,31,4,1,0,3,1,0,56,32,45788,35607,61,81,47836,34165
309,31,3,1,0,3,1,0,211,141,45791,35608,228,48,47839,34165
310,32,5,1,0,3,1,0,221,139,45796,35609,244,21,47842,34165
311,32,2,0,0,3,1,0,113,124,45798,35609,117,127,47845,34165
312,32,2,3,1,0,0,3,97,105,45800,35612,97,284,47845,34168
313,32,3,0,0,3,1,0,273,89,45803,35612,295,67,47848,34168
314,32,3,2,0,3,1,0,426,89,45806,35614,344,135,47851,34168
315,32,0,1,1,0,0,3,14,22,45806,35615,14,114,47851,34171
316,32,0,0,2,1,2,1,243,148,45806,35615,245,146,47852,34172
317,32,2,0,0,3,1,0,112,116,45808,35615,126,51,47855,34172
318,32,0,3,1,0,0,3,116,135,45808,35618,136,99,47855,34175
319,32,2,1,0,3,1,0,15,20,45810,35619,22,130,47858,34175
320,33,2,0,0,3,1,0,255,142,45812,35619,268,83,47861,34175
321,33,2,0,0,3,1,0,198,145,45814,35619,213,162,47864,34175
322,33,2,1,0,3,1,0,182,101,45816,35620,213,13,47867,34175
323,33,2,2,2,1,2,1,108,108,45818,35622,130,49,47868,34176
324,33,0,1,1,0,0,3,185,163,45818,35623,208,219,47868,34179
325,33,1,0,0,3,1,0,212,141,45819,35623,231,69,47871,34179
326,33,0,1,1,0,0,3,133,118,45819,35624,142,84,47871,34182
327,33,1,1,2,1,2,1,57,33,45820,35625,62,22,47872,34183
328,33,2,3,1,0,0,3,429,118,45822,35628,337,290,47872,34186
329,33,0,1,1,0,0,3,73,71,45822,35629,77,151,47872,34189
330,34,1,1,2,1,2,1,98,106,45823,35630,98,115,47873,34190
331,34,0,2,1,0,0,3,116,137,45823,35632,136,130,47873,34193
332,34,0,1,1,0,0,3,273,90,45823,35633,295,133,47873,34196
333,34,7,1,0,3,1,0,433,90,45830,35634,347,67,47876,34196
334,34,3,0,0,3,1,0,17,22,45833,35634,17,21,47879,34196
335,34,2,3,1,0,0,3,245,151,45835,35637,245,138,47879,34199
336,34,2,6,1,0,0,3,115,130,45837,35643,117,287,47879,34202
337,34,0,0,2,1,2,1,15,20,45837,35643,23,52,47880,34203
338,34,2,1,0,3,1,0,257,143,45839,35644,271,99,47883,34203
339,34,2,1,0,3,1,0,223,140,45841,35645,247,84,47886,34203
340,35,3,1,0,3,1,0,185,102,45844,35646,216,49,47889,34203
341,35,2,1,0,3,1,0,214,142,45846,35647,234,83,47892,34203
342,35,2,1,0,3,1,0,431,119,45848,35648,340,162,47895,34203
343,35,0,5,1,0,0,3,57,38,45848,35653,62,222,47895,34206
344,35,0,3,1,0,0,3,185,166,45848,35656,208,293,47895,34209
345,35,2,2,2,1,2,1,110,110,45850,35658,131,70,47896,34210
346,35,1,4,1,0,0,3,113,120,45851,35662,126,25,47896,34213
347,35,2,0,0,3,1,0,75,71,45853,35662,80,13,47899,34213
348,35,0,3,1,0,0,3,133,121,45853,35665,142,154,47899,34216
349,35,4,2,0,3,1,0,202,147,45857,35667,216,146,47902,34216
350,36,1,1,2,1,2,1,258,144,45858,35668,272,139,47903,34217
351,36,1,0,0,3,1,0,99,106,45859,35668,101,21,47906,34217
352,36,1,0,0,3,1,0,274,90,45860,35668,298,52,47909,34217
353,36,4,1,0,3,1,0,437,91,45864,35669,350,133,47912,34217
354,36,0,4,1,0,0,3,116,141,45864,35673,136,290,47912,34220
355,36,1,0,0,3,1,0,16,20,45865,35673,26,154,47915,34220
356,36,4,1,0,3,1,0,249,152,45869,35674,248,67,47918,34220
357,36,1,2,1,0,0,3,116,132,45870,35676,117,118,47918,34223
358,36,3,0,0,3,1,0,205,147,45873,35676,219,99,47921,34223
359,36,4,0,0,3,1,0,21,22,45877,35676,20,84,47924,34223
360,37,0,1,1,0,0,3,185,167,45877,35677,208,165,47924,34226
361,37,2,1,0,3,1,0,112,111,45879,35678,134,83,47927,34226
362,37,3,1,0,3,1,0,19,21,45882,35679,29,99,47930,34226
363,37,1,4,1,0,0,3,58,42,45883,35683,62,296,47930,34229
364,37,1,1,2,1,2,1,224,141,45884,35684,248,14,47931,34230
365,37,1,1,2,1,2,1,114,121,45885,35685,127,223,47932,34231
366,37,0,1,1,0,0,3,75,72,45885,35686,80,52,47932,34234
367,37,0,0,2,1,2,1,185,102,45885,35686,217,71,47933,34235
368,37,4,1,0,3,1,0,435,120,45889,35687,343,146,47936,34235
369,37,2,2,2,1,2,1,216,144,45891,35689,235,131,47937,34236
370,38,1,2,1,0,0,3,117,143,45892,35691,136,121,47937,34239
371,38,2,2,2,1,2,1,101,108,45894,35693,102,85,47938,34240
372,38,1,1,2,1,2,1,22,23,45895,35694,21,26,47939,34241
373,38,3,0,0,3,1,0,119,132,45898,35694,120,21,47942,34241
374,38,5,0,0,3,1,0,263,144,45903,35694,275,67,47945,34241
375,38,3,1,0,3,1,0,277,91,45906,35695,301,154,47948,34241
376,38,1,3,1,0,0,3,250,155,45907,35698,248,136,47948,34244
377,38,2,2,2,1,2,1,135,123,45909,35700,143,140,47949,34245
378,38,4,2,0,3,1,0,441,93,45913,35702,353,52,47952,34245
379,38,0,2,1,0,0,3,205,149,45913,35704,219,293,47952,34248
0,1,1,0,0,3,1,0,23,23,45914,35704,24,26,47955,34248
1,1,1,0,0,3,1,0,251,155,45915,35704,251,21,47958,34248
2,1,2,3,1,0,0,3,137,126,45917,35707,143,143,47958,34251
3,1,2,2,2,1,2,1,2,2,45919,35709,1,224,47959,34252
4,1,1,1,2,1,2,1,264,145,45920,35710,276,122,47960,34253
5,1,0,0,2,1,2,1,224,141,45920,35710,249,91,47961,34254
6,1,2,0,0,3,1,0,443,93,45922,35710,356,85,47964,34254
7,1,0,3,1,0,0,3,119,135,45922,35713,120,296,47964,34257
8,1,1,0,0,3,1,0,146,137,45923,35713,175,136,47967,34257
9,1,0,1,1,0,0,3,205,150,45923,35714,219,55,47967,34260
10,2,3,0,0,3,1,0,219,144,45926,35714,238,136,47970,34260
11,2,2,1,0,3,1,0,116,122,45928,35715,130,99,47973,34260
12,2,0,2,1,0,0,3,19,23,45928,35717,29,299,47973,34263
13,2,2,2,2,1,2,1,148,139,45930,35719,176,72,47974,34264
14,2,1,0,0,3,1,0,3,2,45931,35719,4,131,47977,34264
15,2,1,5,1,0,0,3,59,47,45932,35724,62,227,47977,34267
16,2,0,1,1,0,0,3,185,168,45932,35725,208,17,47977,34270
17,2,0,1,1,0,0,3,75,73,45932,35726,80,157,47977,34273
18,2,0,1,1,0,0,3,141,135,45932,35727,163,149,47977,34276
19,2,2,2,2,1,2,1,437,122,45934,35729,344,166,47978,34277
20,3,1,2,1,0,0,3,24,25,45935,35731,24,94,47978,34280
21,3,1,1,2,1,2,1,438,123,45936,35732,345,92,47979,34281
22,3,0,0,2,1,2,1,251,155,45936,35732,252,228,47980,34282
23,3,3,0,0,3,1,0,267,145,45939,35732,279,55,47983,34282
24,3,5,0,0,3,1,0,448,93,45944,35732,359,122,47986,34282
25,3,2,4,1,0,0,3,121,139,45946,35736,120,146,47986,34285
26,3,2,0,0,3,1,0,226,141,45948,35736,252,0,47989,34285
27,3,1,0,0,3,1,0,138,126,45949,35736,146,26,47992,34285
28,3,3,1,0,3,1,0,188,103,45952,35737,220,85,47995,34285
29,3,1,3,1,0,0,3,206,153,45953,35740,219,24,47995,34288
30,4,1,0,0,3,1,0,76,73,45954,35740,83,17,47998,34288
31,4,1,1,2,1,2,1,149,140,45955,35741,177,167,47999,34289
32,4,1,2,1,0,0,3,142,137,45956,35743,163,302,47999,34292
33,4,2,1,0,3,1,0,118,123,45958,35744,133,72,48002,34292
34,4,1,0,0,3,1,0,278,91,45959,35744,304,131,48005,34292
35,4,0,3,1,0,0,3,19,26,45959,35747,29,139,48005,34295
36,4,0,1,1,0,0,3,3,3,45959,35748,4,152,48005,34298
37,4,1,0,0,3,1,0,60,47,45960,35748,65,157,48008,34298
38,4,1,3,1,0,0,3,220,147,45961,35751,238,299,48008,34301
39,4,2,1,0,3,1,0,187,169,45963,35752,211,99,48011,34301
40,5,5,0,0,3,1,0,256,155,45968,35752,255,131,48014,34301
41,5,6,1,0,3,1,0,454,94,45974,35753,362,55,48017,34301
42,5,0,0,2,1,2,1,24,25,45974,35753,25,1,48018,34302
43,5,1,2,1,0,0,3,227,143,45975,35755,252,231,48018,34305
44,5,1,0,0,3,1,0,122,139,45976,35755,123,26,48021,34305
45,5,0,1,1,0,0,3,438,124,45976,35756,345,88,48021,34308
46,5,1,0,0,3,1,0,268,145,45977,35756,282,24,48024,34308
47,5,0,0,2,1,2,1,188,103,45977,35756,221,123,48025,34309
48,5,1,1,2,1,2,1,139,127,45978,35757,147,95,48026,34310
49,5,3,0,0,3,1,0,152,140,45981,35757,180,146,48029,34310
50,6,2,0,0,3,1,0,280,91,45983,35757,307,152,48032,34310
51,6,1,2,1,0,0,3,20,28,45984,35759,29,302,48032,34313
52,6,3,3,2,1,2,1,209,156,45987,35762,220,158,48033,34314
53,6,0,3,1,0,0,3,3,6,45987,35765,4,305,48033,34317
54,6,4,1,0,3,1,0,191,170,45991,35766,214,72,48036,34317
55,6,4,0,0,3,1,0,146,137,45995,35766,166,139,48039,34317
56,6,0,4,1,0,0,3,76,77,45995,35770,83,102,48039,34320
57,6,0,2,1,0,0,3,60,49,45995,35772,65,20,48039,34323
58,6,2,3,1,0,0,3,222,150,45997,35775,238,170,48039,34326
59,6,4,0,0,3,1,0,122,123,46001,35775,136,92,48042,34326
60,7,3,3,2,1,2,1,142,130,46004,35778,148,2,48043,34327
61,7,2,1,0,3,1,0,124,140,46006,35779,126,95,48046,34327
62,7,2,0,0,3,1,0,270,145,46008,35779,285,131,48049,34327
63,7,0,2,1,0,0,3,152,142,46008,35781,180,29,48049,34330
64,7,0,0,2,1,2,1,24,25,46008,35781,26,232,48050,34331
65,7,4,4,2,1,2,1,226,154,46012,35785,239,89,48051,34332
66,7,3,0,0,3,1,0,457,94,46015,35785,365,24,48054,34332
67,7,3,0,0,3,1,0,191,103,46018,35785,224,55,48057,34332
68,7,3,2,0,3,1,0,259,157,46021,35787,258,158,48060,34332
69,7,2,0,0,3,1,0,440,124,46023,35787,348,123,48063,34332
70,8,0,0,2,1,2,1,191,170,46023,35787,215,93,48064,34333
71,8,1,0,0,3,1,0,228,143,46024,35787,255,152,48067,34333
72,8,1,2,1,0,0,3,147,139,46025,35789,166,305,48067,34336
73,8,0,2,1,0,0,3,20,30,46025,35791,29,149,48067,34339
74,8,1,1,2,1,2,1,281,92,46026,35792,308,306,48068,34340
75,8,0,0,2,1,2,1,76,77,46026,35792,84,73,48069,34341
76,8,1,2,1,0,0,3,4,8,46027,35794,4,142,48069,34344
77,8,0,2,1,0,0,3,209,158,46027,35796,220,23,48069,34347
78,8,3,6,1,0,0,3,125,129,46030,35802,136,173,48069,34350
79,8,2,5,1,0,0,3,62,54,46032,35807,65,105,48069,34353
80,9,1,1,2,1,2,1,153,143,46033,35808,181,96,48070,34354
81,9,2,0,0,3,1,0,127,129,46035,35808,139,29,48073,34354
82,9,4,0,0,3,1,0,263,157,46039,35808,261,152,48076,34354
83,9,2,0,0,3,1,0,459,94,46041,35808,368,131,48079,34354
84,9,4,0,0,3,1,0,195,103,46045,35808,227,24,48082,34354
85,9,0,1,1,0,0,3,142,131,46045,35809,148,235,48082,34357
86,9,1,0,0,3,1,0,25,25,46046,35809,29,158,48085,34357
87,9,3,0,0,3,1,0,443,124,46049,35809,351,55,48088,34357
88,9,1,1,2,1,2,1,227,155,46050,35810,240,124,48089,34358
89,9,1,2,1,0,0,3,125,142,46051,35812,126,5,48089,34361
90,10,1,2,1,0,0,3,21,32,46052,35814,29,176,48089,34364
91,10,1,1,2,1,2,1,282,93,46053,35815,309,143,48090,34365
92,10,0,2,1,0,0,3,228,145,46053,35817,255,309,48090,34368
93,10,2,1,0,3,1,0,272,146,46055,35818,288,23,48093,34368
94,10,2,1,0,3,1,0,149,140,46057,35819,169,149,48096,34368
95,10,2,1,0,3,1,0,6,9,46059,35820,7,305,48099,34368
96,10,2,2,2,1,2,1,78,79,46061,35822,85,94,48100,34369
97,10,2,1,0,3,1,0,211,159,46063,35823,223,105,48103,34369
98,10,1,0,0,3,1,0,192,170,46064,35823,218,89,48106,34369
99,10,1,3,1,0,0,3,63,57,46065,35826,65,76,48106,34372
100,11,2,2,2,1,2,1,129,131,46067,35828,140,97,48107,34373
101,11,3,0,0,3,1,0,266,157,46070,35828,264,23,48110,34373
102,11,0,1,1,0,0,3,125,143,46070,35829,126,238,48110,34376
103,11,1,0,0,3,1,0,22,32,46071,35829,32,124,48113,34376
104,11,2,1,0,3,1,0,461,95,46073,35830,371,152,48116,34376
105,11,1,2,1,0,0,3,154,145,46074,35832,181,8,48116,34379
106,11,3,1,0,3,1,0,145,132,46077,35833,151,158,48119,34379
107,11,3,1,0,3,1,0,230,156,46080,35834,243,55,48122,34379
108,11,2,0,0,3,1,0,197,103,46082,35834,230,131,48125,34379
109,11,3,0,0,3,1,0,446,124,46085,35834,354,24,48128,34379
110,12,1,1,2,1,2,1,7,10,46086,35835,8,150,48129,34380
111,12,4,1,0,3,1,0,153,141,46090,35836,172,29,48132,34380
112,12,0,3,1,0,0,3,25,28,46090,35839,29,312,48132,34383
113,12,2,1,0,3,1,0,274,147,46092,35840,291,105,48135,34383
114,12,0,0,2,1,2,1,282,93,46092,35840,310,306,48136,34384
115,12,3,2,0,3,1,0,214,161,46095,35842,226,76,48139,34384
116,12,0,2,1,0,0,3,192,172,46095,35844,218,179,48139,34387
117,12,0,2,1,0,0,3,63,59,46095,35846,65,97,48139,34390
118,12,1,1,2,1,2,1,229,146,46096,35847,256,144,48140,34391
119,12,5,0,0,3,1,0,83,79,46101,35847,88,89,48143,34391
120,13,1,0,0,3,1,0,146,132,46102,35847,154,23,48146,34391
121,13,1,2,1,0,0,3,23,34,46103,35849,32,58,48146,34394
122,13,3,2,0,3,1,0,449,126,46106,35851,357,131,48149,34394
123,13,2,2,2,1,2,1,131,133,46108,35853,141,9,48150,34395
124,13,0,5,1,0,0,3,154,150,46108,35858,181,241,48150,34398
125,13,2,2,2,1,2,1,127,145,46110,35860,127,159,48151,34399
126,13,2,2,2,1,2,1,232,158,46112,35862,244,25,48152,34400
127,13,2,3,1,0,0,3,199,106,46114,35865,230,155,48152,34403
128,13,1,1,2,1,2,1,267,158,46115,35866,265,313,48153,34404
129,13,1,0,0,3,1,0,193,172,46116,35866,221,97,48156,34404
130,14,0,0,2,1,2,1,214,161,46116,35866,227,98,48157,34405
131,14,2,2,2,1,2,1,463,97,46118,35868,372,106,48158,34406
132,14,2,1,0,3,1,0,284,94,46120,35869,313,150,48161,34406
133,14,2,0,0,3,1,0,276,147,46122,35869,294,76,48164,34406
134,14,0,0,2,1,2,1,229,146,46122,35869,257,307,48165,34407
135,14,3,1,0,3,1,0,28,29,46125,35870,32,144,48168,34407
136,14,1,0,0,3,1,0,154,141,46126,35870,175,179,48171,34407
137,14,3,1,0,3,1,0,86,80,46129,35871,91,124,48174,34407
138,14,1,0,0,3,1,0,64,59,46130,35871,68,89,48177,34407
139,14,2,3,1,0,0,3,9,13,46132,35874,8,32,48177,34410
140,15,2,0,0,3,1,0,25,34,46134,35874,35,25,48180,34410
141,15,0,0,2,1,2,1,154,141,46134,35874,176,59,48181,34411
142,15,5,0,0,3,1,0,454,126,46139,35874,360,155,48184,34411
143,15,1,0,0,3,1,0,128,145,46140,35874,130,23,48187,34411
144,15,2,1,0,3,1,0,269,159,46142,35875,268,106,48190,34411
145,15,0,2,1,0,0,3,232,160,46142,35877,244,134,48190,34414
146,15,0,1,1,0,0,3,131,134,46142,35878,141,244,48190,34417
147,15,1,2,1,0,0,3,155,152,46143,35880,181,162,48190,34420
148,15,0,2,1,0,0,3,199,108,46143,35882,230,316,48190,34423
149,15,0,1,1,0,0,3,193,173,46143,35883,221,12,48190,34426
150,16,0,0,2,1,2,1,276,147,46143,35883,295,99,48191,34427
151,16,0,0,2,1,2,1,229,146,46143,35883,258,151,48192,34428
152,16,2,1,0,3,1,0,88,81,46145,35884,94,179,48195,34428
153,16,1,0,0,3,1,0,285,94,46146,35884,316,32,48198,34428
154,16,1,0,0,3,1,0,10,13,46147,35884,11,97,48201,34428
155,16,0,1,1,0,0,3,146,133,46147,35885,154,147,48201,34431
156,16,2,2,2,1,2,1,66,61,46149,35887,69,125,48202,34432
157,16,4,0,0,3,1,0,467,97,46153,35887,375,76,48205,34432
158,16,0,2,1,0,0,3,214,163,46153,35889,227,92,48205,34435
159,16,1,3,1,0,0,3,29,32,46154,35892,32,310,48205,34438
160,17,0,0,2,1,2,1,155,152,46154,35892,182,24,48206,34439
161,17,2,0,0,3,1,0,156,141,46156,35892,179,25,48209,34439
162,17,3,1,0,3,1,0,235,161,46159,35893,247,155,48212,34439
163,17,4,1,0,3,1,0,92,82,46163,35894,97,12,48215,34439
164,17,1,0,0,3,1,0,26,34,46164,35894,38,134,48218,34439
165,17,0,2,1,0,0,3,131,136,46164,35896,141,165,48218,34442
166,17,1,0,0,3,1,0,194,173,46165,35896,224,244,48221,34442
167,17,0,3,1,0,0,3,454,129,46165,35899,360,319,48221,34445
168,17,0,1,1,0,0,3,269,160,46165,35900,268,150,48221,34448
169,17,1,3,1,0,0,3,129,148,46166,35903,130,109,48221,34451
170,18,2,0,0,3,1,0,287,94,46168,35903,319,97,48224,34451
171,18,2,1,0,3,1,0,271,161,46170,35904,271,12,48227,34451
172,18,1,2,1,0,0,3,67,63,46171,35906,69,62,48227,34454
173,18,3,5,1,0,0,3,279,152,46174,35911,295,95,48227,34457
174,18,1,0,0,3,1,0,30,32,46175,35911,35,151,48230,34457
175,18,3,0,0,3,1,0,470,97,46178,35911,378,99,48233,34457
176,18,2,0,0,3,1,0,231,146,46180,35911,261,32,48236,34457
177,18,1,1,2,1,2,1,200,109,46181,35912,231,77,48237,34458
178,18,2,2,2,1,2,1,148,135,46183,35914,155,311,48238,34459
179,18,0,1,1,0,0,3,214,164,46183,35915,227,128,48238,34462
180,19,1,0,0,3,1,0,157,141,46184,35915,182,134,48241,34462
181,19,6,0,0,3,1,0,16,13,46190,35915,14,25,48244,34462
182,19,0,1,1,0,0,3,454,130,46190,35916,360,153,48244,34465
183,19,0,1,1,0,0,3,92,83,46190,35917,97,247,48244,34468
184,19,1,2,1,0,0,3,130,150,46191,35919,130,182,48244,34471
185,19,0,1,1,0,0,3,155,153,46191,35920,182,112,48244,34474
186,19,1,0,0,3,1,0,27,34,46192,35920,41,155,48247,34474
187,19,1,1,2,1,2,1,195,174,46193,35921,225,166,48248,34475
188,19,2,4,1,0,0,3,237,165,46195,35925,247,322,48248,34478
189,19,3,2,0,3,1,0,134,138,46198,35927,144,24,48251,34478
190,20,2,2,2,1,2,1,159,143,46200,35929,183,167,48252,34479
191,20,0,3,1,0,0,3,195,177,46200,35932,225,158,48252,34482
192,20,1,1,2,1,2,1,288,95,46201,35933,320,13,48253,34483
193,20,2,1,0,3,1,0,202,110,46203,35934,234,99,48256,34483
194,20,2,1,0,3,1,0,69,64,46205,35935,72,182,48259,34483
195,20,2,2,2,1,2,1,29,36,46207,35937,42,25,48260,34484
196,20,7,1,0,3,1,0,461,131,46214,35938,363,77,48263,34484
197,20,1,2,1,0,0,3,238,167,46215,35940,247,115,48263,34487
198,20,0,5,1,0,0,3,134,143,46215,35945,144,325,48263,34490
199,20,1,1,2,1,2,1,93,84,46216,35946,98,135,48264,34491
200,21,1,1,2,1,2,1,232,147,46217,35947,262,63,48265,34492
201,21,2,2,2,1,2,1,132,152,46219,35949,131,100,48266,34493
202,21,1,4,1,0,0,3,272,165,46220,35953,271,314,48266,34496
203,21,0,0,2,1,2,1,214,164,46220,35953,228,14,48267,34497
204,21,4,2,0,3,1,0,206,112,46224,35955,237,151,48270,34497
205,21,3,2,0,3,1,0,33,34,46227,35957,38,128,48273,34497
206,21,3,0,0,3,1,0,291,95,46230,35957,323,25,48276,34497
207,21,1,1,2,1,2,1,280,153,46231,35958,296,98,48277,34498
208,21,2,1,0,3,1,0,472,98,46233,35959,381,32,48280,34498
209,21,3,2,0,3,1,0,151,137,46236,35961,158,95,48283,34498
210,22,5,0,0,3,1,0,243,167,46241,35961,250,77,48286,34498
211,22,5,1,0,3,1,0,98,85,46246,35962,101,158,48289,34498
212,22,2,1,0,3,1,0,136,144,46248,35963,147,153,48292,34498
213,22,2,1,0,3,1,0,31,37,46250,35964,45,115,48295,34498
214,22,2,2,2,1,2,1,157,155,46252,35966,183,315,48296,34499
215,22,0,0,2,1,2,1,159,143,46252,35966,184,26,48297,34500
216,22,1,1,2,1,2,1,196,178,46253,35967,226,326,48298,34501
217,22,2,0,0,3,1,0,18,13,46255,35967,17,167,48301,34501
218,22,1,0,0,3,1,0,292,95,46256,35967,326,182,48304,34501
219,22,1,0,0,3,1,0,70,64,46257,35967,75,135,48307,34501
220,23,0,0,2,1,2,1,232,147,46257,35967,263,26,48308,34502
221,23,1,2,1,0,0,3,207,114,46258,35969,237,35,48308,34505
222,23,0,1,1,0,0,3,214,165,46258,35970,228,250,48308,34508
223,23,0,1,1,0,0,3,33,35,46258,35971,38,66,48308,34511
224,23,5,2,0,3,1,0,466,133,46263,35973,366,151,48311,34511
225,23,1,0,0,3,1,0,281,153,46264,35973,299,14,48314,34511
226,23,0,0,2,1,2,1,472,98,46264,35973,382,99,48315,34512
227,23,2,2,2,1,2,1,153,139,46266,35975,159,129,48316,34513
228,23,3,1,0,3,1,0,275,166,46269,35976,274,100,48319,34513
229,23,0,1,1,0,0,3,132,153,46269,35977,131,98,48319,34516
230,24,3,0,0,3,1,0,21,13,46272,35977,20,26,48322,34516
231,24,1,2,1,0,0,3,71,66,46273,35979,75,161,48322,34519
232,24,0,2,1,0,0,3,98,87,46273,35981,101,329,48322,34522
233,24,1,0,0,3,1,0,32,37,46274,35981,48,77,48325,34522
234,24,1,2,1,0,0,3,215,167,46275,35983,228,185,48325,34525
235,24,3,0,0,3,1,0,246,167,46278,35983,253,100,48328,34525
236,24,2,0,0,3,1,0,294,95,46280,35983,329,167,48331,34525
237,24,1,1,2,1,2,1,197,179,46281,35984,227,154,48332,34526
238,24,3,5,1,0,0,3,139,149,46284,35989,147,318,48332,34529
239,24,3,0,0,3,1,0,162,143,46287,35989,187,115,48335,34529
240,25,0,0,2,1,2,1,132,153,46287,35989,132,130,48336,34530
241,25,2,0,0,3,1,0,155,139,46289,35989,162,66,48339,34530
242,25,4,0,0,3,1,0,470,133,46293,35989,369,35,48342,34530
243,25,0,0,2,1,2,1,33,35,46293,35989,39,27,48343,34531
244,25,6,1,0,3,1,0,478,99,46299,35990,385,14,48346,34531
245,25,1,0,0,3,1,0,208,114,46300,35990,240,99,48349,34531
246,25,2,1,0,3,1,0,234,148,46302,35991,266,135,48352,34531
247,25,2,1,0,3,1,0,277,167,46304,35992,277,151,48355,34531
248,25,2,5,1,0,0,3,283,158,46306,35997,299,253,48355,34534
249,25,0,2,1,0,0,3,157,157,46306,35999,183,101,48355,34537
250,26,1,0,0,3,1,0,198,179,46307,35999,230,318,48358,34537
251,26,1,0,0,3,1,0,22,13,46308,35999,23,115,48361,34537
252,26,3,0,0,3,1,0,165,143,46311,35999,190,77,48364,34537
253,26,0,1,1,0,0,3,215,168,46311,36000,228,164,48364,34540
254,26,1,1,2,1,2,1,235,149,46312,36001,267,186,48365,34541
255,26,1,0,0,3,1,0,99,87,46313,36001,104,154,48368,34541
256,26,4,0,0,3,1,0,298,95,46317,36001,332,26,48371,34541
257,26,0,0,2,1,2,1,139,149,46317,36001,148,152,48372,34542
258,26,1,1,2,1,2,1,72,67,46318,36002,76,330,48373,34543
259,26,1,0,0,3,1,0,33,37,46319,36002,51,100,48376,34543
260,27,0,2,1,0,0,3,208,116,46319,36004,240,17,48376,34546
261,27,2,0,0,3,1,0,285,158,46321,36004,302,167,48379,34546
262,27,1,1,2,1,2,1,133,154,46322,36005,133,67,48380,34547
263,27,2,0,0,3,1,0,35,35,46324,36005,42,135,48383,34547
264,27,3,1,0,3,1,0,473,134,46327,36006,372,99,48386,34547
265,27,1,1,2,1,2,1,158,158,46328,36007,184,131,48387,34548
266,27,1,0,0,3,1,0,479,99,46329,36007,388,253,48390,34548
267,27,2,1,0,3,1,0,248,168,46331,36008,256,35,48393,34548
268,27,2,0,0,3,1,0,279,167,46333,36008,280,101,48396,34548
269,27,2,1,0,3,1,0,157,140,46335,36009,165,27,48399,34548
270,28,2,0,0,3,1,0,24,13,46337,36009,26,77,48402,34548
271,28,1,2,1,0,0,3,100,89,46338,36011,104,321,48402,34551
272,28,0,2,1,0,0,3,285,160,46338,36013,302,189,48402,34554
273,28,0,1,1,0,0,3,165,144,46338,36014,190,103,48402,34557
274,28,0,2,1,0,0,3,215,170,46338,36016,228,333,48402,34560
275,28,2,1,0,3,1,0,200,180,46340,36017,233,152,48405,34560
276,28,3,0,0,3,1,0,301,95,46343,36017,335,115,48408,34560
277,28,0,2,1,0,0,3,72,69,46343,36019,76,157,48408,34563
278,28,2,0,0,3,1,0,237,149,46345,36019,270,26,48411,34563
279,28,1,3,1,0,0,3,34,40,46346,36022,51,104,48411,34566
280,29,2,1,0,3,1,0,160,159,46348,36023,187,67,48414,34566
281,29,1,1,2,1,2,1,134,155,46349,36024,134,28,48415,34567
282,29,3,1,0,3,1,0,282,168,46352,36025,283,35,48418,34567
283,29,1,2,1,0,0,3,249,170,46353,36027,256,102,48418,34570
284,29,3,0,0,3,1,0,142,149,46356,36027,151,131,48421,34570
285,29,2,1,0,3,1,0,37,36,46358,36028,45,164,48424,34570
286,29,2,0,0,3,1,0,481,99,46360,36028,391,167,48427,34570
287,29,2,1,0,3,1,0,210,117,46362,36029,243,253,48430,34570
288,29,0,0,2,1,2,1,157,140,46362,36029,166,136,48431,34571
289,29,6,3,0,3,1,0,479,137,46368,36032,375,17,48434,34571
290,30,1,1,2,1,2,1,25,14,46369,36033,27,104,48435,34572
291,30,1,1,2,1,2,1,238,150,46370,36034,271,116,48436,34573
292,30,0,3,1,0,0,3,72,72,46370,36037,76,324,48436,34576
293,30,2,2,2,1,2,1,287,162,46372,36039,303,334,48437,34577
294,30,0,0,2,1,2,1,200,180,46372,36039,234,36,48438,34578
295,30,0,1,1,0,0,3,37,37,46372,36040,45,192,48438,34581
296,30,0,0,2,1,2,1,100,89,46372,36040,105,153,48439,34582
297,30,1,0,0,3,1,0,216,170,46373,36040,231,157,48442,34582
298,30,1,0,0,3,1,0,302,95,46374,36040,338,77,48445,34582
299,30,0,1,1,0,0,3,165,145,46374,36041,190,107,48445,34585
300,31,3,2,0,3,1,0,137,157,46377,36043,137,136,48448,34585
301,31,2,0,0,3,1,0,36,40,46379,36043,54,102,48451,34585
302,31,4,0,0,3,1,0,161,140,46383,36043,169,164,48454,34585
303,31,2,0,0,3,1,0,144,149,46385,36043,154,67,48457,34585
304,31,3,1,0,3,1,0,484,100,46388,36044,394,26,48460,34585
305,31,2,1,0,3,1,0,162,160,46390,36045,190,28,48463,34585
306,31,1,1,2,1,2,1,480,138,46391,36046,376,254,48464,34586
307,31,5,0,0,3,1,0,254,170,46396,36046,259,17,48467,34586
308,31,1,0,0,3,1,0,283,168,46397,36046,286,131,48470,34586
309,31,1,3,1,0,0,3,211,120,46398,36049,243,170,48470,34589
310,32,0,1,1,0,0,3,25,15,46398,36050,27,110,48470,34592
311,32,2,2,2,1,2,1,289,164,46400,36052,304,158,48471,34593
312,32,2,1,0,3,1,0,486,101,46402,36053,397,192,48474,34593
313,32,0,1,1,0,0,3,72,73,46402,36054,76,156,48474,34596
314,32,1,0,0,3,1,0,38,37,46403,36054,48,116,48477,34596
315,32,2,3,1,0,0,3,240,153,46405,36057,271,80,48477,34599
316,32,0,1,1,0,0,3,100,90,46405,36058,105,39,48477,34602
317,32,3,0,0,3,1,0,305,95,46408,36058,341,104,48480,34602
318,32,1,0,0,3,1,0,166,145,46409,36058,193,131,48483,34602
319,32,1,2,1,0,0,3,217,172,46410,36060,231,327,48483,34605
320,33,0,0,2,1,2,1,137,157,46410,36060,138,165,48484,34606
321,33,2,2,2,1,2,1,163,142,46412,36062,170,335,48485,34607
322,33,2,1,0,3,1,0,213,121,46414,36063,246,26,48488,34607
323,33,1,2,1,0,0,3,284,170,46415,36065,286,105,48488,34610
324,33,0,1,1,0,0,3,200,181,46415,36066,234,70,48488,34613
325,33,1,1,2,1,2,1,481,139,46416,36067,377,171,48489,34614
326,33,1,2,1,0,0,3,37,42,46417,36069,54,20,48489,34617
327,33,3,0,0,3,1,0,257,170,46420,36069,262,254,48492,34617
328,33,1,0,0,3,1,0,145,149,46421,36069,157,28,48495,34617
329,33,1,0,0,3,1,0,163,160,46422,36069,193,136,48498,34617
330,34,0,0,2,1,2,1,38,37,46422,36069,49,81,48499,34618
331,34,0,1,1,0,0,3,100,91,46422,36070,105,108,48499,34621
332,34,1,1,2,1,2,1,164,143,46423,36071,171,193,48500,34622
333,34,0,2,1,0,0,3,25,17,46423,36073,27,134,48500,34625
334,34,2,0,0,3,1,0,219,172,46425,36073,234,156,48503,34625
335,34,0,4,1,0,0,3,72,77,46425,36077,76,42,48503,34628
336,34,0,0,2,1,2,1,305,95,46425,36077,342,111,48504,34629
337,34,1,3,1,0,0,3,241,156,46426,36080,271,107,48504,34632
338,34,5,1,0,3,1,0,491,102,46431,36081,400,158,48507,34632
339,34,3,2,0,3,1,0,292,166,46434,36083,307,327,48510,34632
340,35,2,1,0,3,1,0,165,161,46436,36084,196,165,48513,34632
341,35,1,1,2,1,2,1,201,182,46437,36085,235,29,48514,34633
342,35,3,1,0,3,1,0,260,171,46440,36086,265,171,48517,34633
343,35,2,1,0,3,1,0,483,140,46442,36087,380,26,48520,34633
344,35,4,1,0,3,1,0,217,122,46446,36088,249,116,48523,34633
345,35,1,1,2,1,2,1,167,146,46447,36089,194,21,48524,34634
346,35,0,1,1,0,0,3,37,43,46447,36090,54,257,48524,34637
347,35,0,0,2,1,2,1,284,170,46447,36090,287,71,48525,34638
348,35,2,4,1,0,0,3,139,161,46449,36094,138,338,48525,34641
349,35,2,1,0,3,1,0,147,150,46451,36095,160,136,48528,34641
350,36,1,0,0,3,1,0,293,166,46452,36095,310,156,48531,34641
351,36,1,4,1,0,0,3,26,21,46453,36099,27,74,48531,34644
352,36,2,0,0,3,1,0,243,156,46455,36099,274,111,48534,34644
353,36,1,1,2,1,2,1,165,144,46456,36100,172,82,48535,34645
354,36,1,0,0,3,1,0,218,122,46457,36100,252,193,48538,34645
355,36,0,3,1,0,0,3,219,175,46457,36103,234,45,48538,34648
356,36,0,2,1,0,0,3,305,97,46457,36105,342,137,48538,34651
357,36,0,1,1,0,0,3,72,78,46457,36106,76,111,48538,34654
358,36,2,2,2,1,2,1,493,104,46459,36108,401,328,48539,34655
359,36,0,3,1,0,0,3,38,40,46459,36111,49,110,48539,34658
360,37,3,2,0,3,1,0,263,173,46462,36113,268,26,48542,34658
361,37,2,2,2,1,2,1,149,152,46464,36115,161,166,48543,34659
362,37,0,1,1,0,0,3,26,22,46464,36116,27,196,48543,34662
363,37,1,0,0,3,1,0,101,91,46465,36116,108,29,48546,34662
364,37,0,1,1,0,0,3,167,147,46465,36117,194,260,48546,34665
365,37,3,1,0,3,1,0,40,44,46468,36118,57,171,48549,34665
366,37,2,4,1,0,0,3,141,165,46470,36122,138,161,48549,34668
367,37,6,0,0,3,1,0,489,140,46476,36122,383,116,48552,34668
368,37,4,1,0,3,1,0,205,183,46480,36123,238,136,48555,34668
369,37,5,4,0,3,1,0,170,165,46485,36127,199,338,48558,34668
370,38,4,2,0,3,1,0,169,146,46489,36129,175,110,48561,34668
371,38,3,2,0,3,1,0,41,42,46492,36131,52,111,48564,34668
372,38,1,0,0,3,1,0,294,166,46493,36131,313,45,48567,34668
373,38,0,1,1,0,0,3,219,176,46493,36132,234,114,48567,34671
374,38,1,2,1,0,0,3,73,80,46494,36134,76,24,48567,34674
375,38,2,2,2,1,2,1,220,124,46496,36136,253,329,48568,34675
376,38,2,1,0,3,1,0,286,171,46498,36137,290,82,48571,34675
377,38,0,1,1,0,0,3,243,157,46498,36138,274,140,48571,34678
378,38,2,2,2,1,2,1,307,99,46500,36140,343,75,48572,34679
379,38,1,0,0,3,1,0,494,104,46501,36140,404,156,48575,34679
0,1,0,0,2,1,2,1,26,22,46501,36140,28,26,48576,34680
1,1,0,3,1,0,0,3,149,155,46501,36143,161,113,48576,34683
2,1,1,1,2,1,2,1,170,147,46502,36144,176,141,48577,34684
3,1,1,2,1,0,0,3,221,126,46503,36146,253,159,48577,34687
4,1,3,0,0,3,1,0,497,104,46506,36146,407,45,48580,34687
5,1,1,2,1,0,0,3,102,93,46507,36148,108,3,48580,34690
6,1,1,4,1,0,0,3,140,150,46508,36152,133,169,48580,34693
7,1,2,0,0,3,1,0,491,140,46510,36152,386,114,48583,34693
8,1,1,1,2,1,2,1,287,172,46511,36153,291,261,48584,34694
9,1,2,1,0,3,1,0,245,158,46513,36154,277,26,48587,34694
10,2,2,0,0,3,1,0,169,147,46515,36154,197,75,48590,34694
11,2,2,2,2,1,2,1,43,44,46517,36156,53,160,48591,34695
12,2,0,0,2,1,2,1,40,44,46517,36156,58,112,48592,34696
13,2,1,0,0,3,1,0,308,99,46518,36156,346,96,48595,34696
14,2,0,1,1,0,0,3,49,44,46518,36157,54,341,48595,34699
15,2,2,0,0,3,1,0,207,183,46520,36157,241,196,48598,34699
16,2,1,4,1,0,0,3,27,26,46521,36161,28,332,48598,34702
17,2,0,0,2,1,2,1,294,166,46521,36161,314,162,48599,34703
18,2,1,2,1,0,0,3,171,167,46522,36163,199,119,48599,34706
19,2,2,2,2,1,2,1,247,160,46524,36165,278,4,48600,34707
20,3,0,0,2,1,2,1,169,147,46524,36165,198,27,48601,34708
21,3,2,1,0,3,1,0,104,94,46526,36166,111,160,48604,34708
22,3,0,1,1,0,0,3,221,127,46526,36167,253,27,48604,34711
23,3,2,0,0,3,1,0,172,147,46528,36167,179,261,48607,34711
24,3,4,1,0,3,1,0,495,141,46532,36168,389,26,48610,34711
25,3,2,2,2,1,2,1,173,169,46534,36170,200,197,48611,34712
26,3,2,1,0,3,1,0,42,45,46536,36171,61,141,48614,34712
27,3,8,2,0,3,1,0,505,106,46544,36173,410,4,48617,34712
28,3,1,0,0,3,1,0,150,155,46545,36173,164,169,48620,34712
29,3,1,1,2,1,2,1,141,151,46546,36174,134,172,48621,34713
30,4,0,1,1,0,0,3,0,1,46546,36175,0,99,48621,34716
31,4,1,1,2,1,2,1,309,100,46547,36176,347,76,48622,34717
32,4,1,2,1,0,0,3,264,175,46548,36178,268,344,48622,34720
33,4,0,0,2,1,2,1,287,172,46548,36178,292,113,48623,34721
34,4,1,1,2,1,2,1,248,161,46549,36179,279,333,48624,34722
35,4,0,1,1,0,0,3,43,45,46549,36180,53,165,48624,34725
36,4,1,0,0,3,1,0,208,183,46550,36180,244,113,48627,34725
37,4,0,1,1,0,0,3,49,45,46550,36181,54,48,48627,34728
38,4,0,2,1,0,0,3,294,168,46550,36183,314,117,48627,34731
39,4,3,2,0,3,1,0,30,28,46553,36185,31,119,48630,34731
40,5,0,1,1,0,0,3,0,2,46553,36186,0,163,48630,34734
41,5,1,5,1,0,0,3,142,156,46554,36191,134,51,48630,34737
42,5,3,3,2,1,2,1,175,150,46557,36194,180,28,48631,34738
43,5,1,0,0,3,1,0,105,94,46558,36194,114,26,48634,34738
44,5,0,2,1,0,0,3,169,149,46558,36196,198,264,48634,34741
45,5,1,0,0,3,1,0,496,141,46559,36196,392,141,48637,34741
46,5,2,6,1,0,0,3,175,175,46561,36202,200,172,48637,34744
47,5,0,0,2,1,2,1,221,127,46561,36202,254,198,48638,34745
48,5,2,2,2,1,2,1,152,157,46563,36204,165,173,48639,34746
49,5,2,2,2,1,2,1,507,108,46565,36206,411,28,48640,34747
50,6,1,0,0,3,1,0,209,183,46566,36206,247,76,48643,34747
51,6,2,2,2,1,2,1,266,177,46568,36208,269,100,48644,34748
52,6,3,0,0,3,1,0,312,100,46571,36208,350,4,48647,34748
53,6,0,3,1,0,0,3,248,164,46571,36211,279,168,48647,34751
54,6,2,1,0,3,1,0,45,46,46573,36212,56,344,48650,34751
55,6,1,1,2,1,2,1,288,173,46574,36213,293,120,48651,34752
56,6,3,0,0,3,1,0,297,168,46577,36213,317,333,48654,34752
57,6,1,1,2,1,2,1,43,46,46578,36214,62,118,48655,34753
58,6,2,1,0,3,1,0,51,46,46580,36215,57,113,48658,34753
59,6,0,1,1,0,0,3,30,29,46580,36216,31,116,48658,34756
60,7,2,2,2,1,2,1,144,158,46582,36218,135,142,48659,34757
61,7,0,1,1,0,0,3,266,178,46582,36219,269,201,48659,34760
62,7,1,1,2,1,2,1,508,109,46583,36220,412,174,48660,34761
63,7,1,3,1,0,0,3,106,97,46584,36223,114,175,48660,34764
64,7,0,0,2,1,2,1,496,141,46584,36223,393,265,48661,34765
65,7,1,1,2,1,2,1,1,3,46585,36224,1,29,48662,34766
66,7,0,1,1,0,0,3,221,128,46585,36225,254,31,48662,34769
67,7,2,1,0,3,1,0,177,176,46587,36226,203,51,48665,34769
68,7,1,0,0,3,1,0,153,157,46588,36226,168,26,48668,34769
69,7,1,1,2,1,2,1,176,151,46589,36227,181,119,48669,34770
70,8,1,3,1,0,0,3,249,167,46590,36230,279,166,48669,34773
71,8,2,3,1,0,0,3,32,32,46592,36233,31,79,48669,34776
72,8,0,1,1,0,0,3,169,150,46592,36234,198,116,48669,34779
73,8,1,0,0,3,1,0,44,46,46593,36234,65,333,48672,34779
74,8,1,0,0,3,1,0,46,46,46594,36234,59,100,48675,34779
75,8,1,0,0,3,1,0,52,46,46595,36234,60,4,48678,34779
76,8,1,0,0,3,1,0,313,100,46596,36234,353,116,48681,34779
77,8,3,1,0,3,1,0,212,184,46599,36235,250,168,48684,34779
78,8,2,1,0,3,1,0,299,169,46601,36236,320,120,48687,34779
79,8,1,1,2,1,2,1,289,174,46602,36237,294,345,48688,34780
80,9,0,1,1,0,0,3,176,152,46602,36238,181,54,48688,34783
81,9,1,2,1,0,0,3,497,143,46603,36240,393,119,48688,34786
82,9,1,1,2,1,2,1,290,175,46604,36241,295,27,48689,34787
83,9,1,1,2,1,2,1,222,129,46605,36242,255,266,48690,34788
84,9,4,2,0,3,1,0,512,111,46609,36244,415,175,48693,34788
85,9,1,2,1,0,0,3,145,160,46610,36246,135,122,48693,34791
86,9,1,1,2,1,2,1,107,98,46611,36247,115,175,48694,34792
87,9,0,2,1,0,0,3,1,5,46611,36249,1,145,48694,34795
88,9,0,1,1,0,0,3,153,158,46611,36250,168,34,48694,34798
89,9,0,0,2,1,2,1,266,178,46611,36250,270,30,48695,34799
90,10,1,1,2,1,2,1,53,47,46612,36251,61,146,48696,34800
91,10,2,1,0,3,1,0,34,33,46614,36252,34,100,48699,34800
92,10,0,0,2,1,2,1,249,167,46614,36252,280,202,48700,34801
93,10,4,0,0,3,1,0,180,152,46618,36252,184,79,48703,34801
94,10,2,0,0,3,1,0,179,176,46620,36252,206,27,48706,34801
95,10,2,0,0,3,1,0,315,100,46622,36252,356,166,48709,34801
96,10,2,0,0,3,1,0,171,150,46624,36252,201,116,48712,34801
97,10,5,1,0,3,1,0,517,112,46629,36253,418,333,48715,34801
98,10,2,1,0,3,1,0,46,47,46631,36254,68,168,48718,34801
99,10,2,1,0,3,1,0,301,170,46633,36255,323,4,48721,34801
100,11,1,1,2,1,2,1,47,47,46634,36256,60,267,48722,34802
101,11,2,0,0,3,1,0,499,143,46636,36256,396,34,48725,34802
102,11,0,1,1,0,0,3,290,176,46636,36257,295,33,48725,34805
103,11,2,3,1,0,0,3,147,163,46638,36260,135,348,48725,34808
104,11,2,1,0,3,1,0,109,99,46640,36261,118,54,48728,34808
105,11,1,1,2,1,2,1,223,130,46641,36262,256,120,48729,34809
106,11,0,0,2,1,2,1,266,178,46641,36262,271,176,48730,34810
107,11,1,1,2,1,2,1,2,6,46642,36263,2,123,48731,34811
108,11,3,3,2,1,2,1,156,161,46645,36266,169,121,48732,34812
109,11,1,0,0,3,1,0,213,184,46646,36266,253,175,48735,34812
110,12,1,3,1,0,0,3,180,179,46647,36269,206,169,48735,34815
111,12,0,0,2,1,2,1,53,47,46647,36269,62,80,48736,34816
112,12,0,1,1,0,0,3,171,151,46647,36270,201,205,48736,34819
113,12,3,2,0,3,1,0,318,102,46650,36272,359,175,48739,34819
114,12,0,0,2,1,2,1,34,33,46650,36272,35,28,48740,34820
115,12,2,1,0,3,1,0,48,48,46652,36273,71,4,48743,34820
116,12,3,4,1,0,0,3,520,116,46655,36277,418,119,48743,34823
117,12,2,2,2,1,2,1,149,165,46657,36279,136,169,48744,34824
118,12,2,1,0,3,1,0,303,171,46659,36280,326,146,48747,34824
119,12,2,4,1,0,0,3,182,156,46661,36284,184,336,48747,34827
120,13,1,0,0,3,1,0,48,47,46662,36284,63,54,48750,34827
121,13,3,0,0,3,1,0,112,99,46665,36284,121,336,48753,34827
122,13,3,0,0,3,1,0,293,176,46668,36284,298,100,48756,34827
123,13,2,2,2,1,2,1,4,8,46670,36286,3,121,48757,34828
124,13,1,1,2,1,2,1,319,103,46671,36287,360,349,48758,34829
125,13,1,1,2,1,2,1,250,168,46672,36288,281,124,48759,34830
126,13,1,0,0,3,1,0,304,171,46673,36288,329,34,48762,34830
127,13,1,3,1,0,0,3,214,187,46674,36291,253,36,48762,34833
128,13,2,1,0,3,1,0,225,131,46676,36292,259,119,48765,34833
129,13,2,1,0,3,1,0,268,179,46678,36293,274,121,48768,34833
130,14,1,0,0,3,1,0,150,165,46679,36293,139,80,48771,34833
131,14,2,0,0,3,1,0,184,156,46681,36293,187,4,48774,34833
132,14,2,4,1,0,0,3,55,51,46683,36297,62,31,48774,34836
133,14,3,0,0,3,1,0,174,151,46686,36297,204,146,48777,34836
134,14,2,0,0,3,1,0,501,143,46688,36297,399,205,48780,34836
135,14,1,0,0,3,1,0,157,161,46689,36297,172,169,48783,34836
136,14,1,1,2,1,2,1,35,34,46690,36298,36,268,48784,34837
137,14,2,0,0,3,1,0,522,116,46692,36298,421,169,48787,34837
138,14,1,1,2,1,2,1,49,49,46693,36299,72,177,48788,34838
139,14,3,0,0,3,1,0,183,179,46696,36299,209,175,48791,34838
140,15,1,1,2,1,2,1,49,48,46697,36300,64,125,48792,34839
141,15,3,0,0,3,1,0,322,103,46700,36300,363,54,48795,34839
142,15,1,1,2,1,2,1,294,177,46701,36301,299,178,48796,34840
143,15,2,3,1,0,0,3,227,134,46703,36304,259,124,48796,34843
144,15,0,4,1,0,0,3,214,191,46703,36308,253,352,48796,34846
145,15,4,4,2,1,2,1,116,103,46707,36312,122,122,48797,34847
146,15,0,1,1,0,0,3,4,9,46707,36313,3,339,48797,34850
147,15,1,2,1,0,0,3,269,181,46708,36315,274,37,48797,34853
148,15,2,0,0,3,1,0,159,161,46710,36315,175,100,48800,34853
149,15,1,0,0,3,1,0,251,168,46711,36315,284,36,48803,34853
150,16,0,0,2,1,2,1,184,156,46711,36315,188,32,48804,34854
151,16,1,0,0,3,1,0,175,151,46712,36315,207,169,48807,34854
152,16,2,3,1,0,0,3,57,54,46714,36318,62,271,48807,34857
153,16,1,0,0,3,1,0,502,143,46715,36318,402,100,48810,34857
154,16,1,1,2,1,2,1,117,104,46716,36319,123,206,48811,34858
155,16,2,0,0,3,1,0,306,171,46718,36319,332,36,48814,34858
156,16,1,3,1,0,0,3,215,194,46719,36322,253,122,48814,34861
157,16,2,2,2,1,2,1,6,11,46721,36324,4,170,48815,34862
158,16,0,5,1,0,0,3,183,184,46721,36329,209,355,48815,34865
159,16,0,0,2,1,2,1,49,49,46721,36329,73,176,48816,34866
160,17,1,1,2,1,2,1,36,35,46722,36330,37,126,48817,34867
161,17,0,1,1,0,0,3,269,182,46722,36331,274,57,48817,34870
162,17,1,1,2,1,2,1,160,162,46723,36332,176,81,48818,34871
163,17,1,0,0,3,1,0,323,103,46724,36332,366,146,48821,34871
164,17,2,0,0,3,1,0,524,116,46726,36332,424,124,48824,34871
165,17,1,1,2,1,2,1,252,169,46727,36333,285,38,48825,34872
166,17,2,1,0,3,1,0,296,178,46729,36334,302,4,48828,34872
167,17,1,1,2,1,2,1,50,49,46730,36335,65,179,48829,34873
168,17,2,1,0,3,1,0,152,166,46732,36336,142,122,48832,34873
169,17,2,2,2,1,2,1,229,136,46734,36338,260,340,48833,34874
170,18,2,2,2,1,2,1,185,186,46736,36340,210,37,48834,34875
171,18,1,0,0,3,1,0,216,194,46737,36340,256,32,48837,34875
172,18,0,1,1,0,0,3,57,55,46737,36341,62,103,48837,34878
173,18,2,1,0,3,1,0,51,50,46739,36342,76,206,48840,34878
174,18,2,1,0,3,1,0,8,12,46741,36343,7,122,48843,34878
175,18,0,0,2,1,2,1,117,104,46741,36343,124,171,48844,34879
176,18,1,1,2,1,2,1,307,172,46742,36344,333,272,48845,34880
177,18,0,2,1,0,0,3,502,145,46742,36346,402,172,48845,34883
178,18,1,2,1,0,0,3,176,153,46743,36348,207,358,48845,34886
179,18,1,2,1,0,0,3,185,158,46744,36350,188,179,48845,34889
180,19,4,2,0,3,1,0,156,168,46748,36352,145,124,48848,34889
181,19,1,0,0,3,1,0,51,49,46749,36352,68,4,48851,34889
182,19,1,1,2,1,2,1,297,179,46750,36353,303,39,48852,34890
183,19,1,1,2,1,2,1,37,36,46751,36354,38,58,48853,34891
184,19,1,2,1,0,0,3,230,138,46752,36356,260,129,48853,34894
185,19,1,0,0,3,1,0,324,103,46753,36356,369,122,48856,34894
186,19,2,0,0,3,1,0,254,169,46755,36356,288,179,48859,34894
187,19,3,0,0,3,1,0,527,116,46758,36356,427,81,48862,34894
188,19,1,2,1,0,0,3,161,164,46759,36358,176,343,48862,34897
189,19,3,2,0,3,1,0,272,184,46762,36360,277,146,48865,34897
190,20,4,0,0,3,1,0,180,153,46766,36360,210,58,48868,34897
191,20,2,0,0,3,1,0,504,145,46768,36360,405,179,48871,34897
192,20,0,3,1,0,0,3,8,15,46768,36363,7,275,48871,34900
193,20,1,2,1,0,0,3,186,160,46769,36365,188,209,48871,34903
194,20,3,2,0,3,1,0,164,166,46772,36367,179,37,48874,34903
195,20,1,1,2,1,2,1,231,139,46773,36368,261,180,48875,34904
196,20,2,0,0,3,1,0,187,186,46775,36368,213,39,48878,34904
197,20,2,2,2,1,2,1,158,170,46777,36370,146,173,48879,34905
198,20,3,1,0,3,1,0,530,117,46780,36371,430,32,48882,34905
199,20,3,0,0,3,1,0,120,104,46783,36371,127,146,48885,34905
200,21,5,0,0,3,1,0,312,172,46788,36371,336,122,48888,34905
201,21,2,0,0,3,1,0,326,103,46790,36371,372,129,48891,34905
202,21,2,2,2,1,2,1,53,51,46792,36373,69,82,48892,34906
203,21,3,0,0,3,1,0,300,179,46795,36373,306,171,48895,34906
204,21,2,1,0,3,1,0,59,56,46797,36374,65,124,48898,34906
205,21,0,2,1,0,0,3,37,38,46797,36376,38,361,48898,34909
206,21,1,0,0,3,1,0,255,169,46798,36376,291,122,48901,34909
207,21,0,0,2,1,2,1,272,184,46798,36376,278,5,48902,34910
208,21,2,4,1,0,0,3,218,198,46800,36380,256,346,48902,34913
209,21,0,1,1,0,0,3,51,51,46800,36381,76,106,48902,34916
210,22,4,0,0,3,1,0,12,15,46804,36381,10,39,48905,34916
211,22,0,0,2,1,2,1,187,186,46804,36381,214,130,48906,34917
212,22,2,1,0,3,1,0,274,185,46806,36382,281,180,48909,34917
213,22,2,2,2,1,2,1,532,119,46808,36384,431,210,48910,34918
214,22,1,0,0,3,1,0,187,160,46809,36384,191,179,48913,34918
215,22,2,2,2,1,2,1,233,141,46811,36386,262,147,48914,34919
216,22,1,0,0,3,1,0,165,166,46812,36386,182,275,48917,34919
217,22,3,0,0,3,1,0,123,104,46815,36386,130,37,48920,34919
218,22,3,0,0,3,1,0,507,145,46818,36386,408,58,48923,34919
219,22,1,2,1,0,0,3,159,172,46819,36388,146,35,48923,34922
220,23,0,0,2,1,2,1,59,56,46819,36388,66,172,48924,34923
221,23,3,1,0,3,1,0,183,154,46822,36389,213,124,48927,34923
222,23,1,3,1,0,0,3,327,106,46823,36392,372,349,48927,34926
223,23,2,1,0,3,1,0,220,199,46825,36393,259,106,48930,34926
224,23,0,2,1,0,0,3,37,40,46825,36395,38,8,48930,34929
225,23,3,0,0,3,1,0,56,51,46828,36395,72,122,48933,34929
226,23,0,0,2,1,2,1,300,179,46828,36395,307,174,48934,34930
227,23,2,2,2,1,2,1,314,174,46830,36397,337,83,48935,34931
228,23,0,0,2,1,2,1,255,169,46830,36397,292,362,48936,34932
229,23,2,0,0,3,1,0,53,51,46832,36397,79,122,48939,34932
230,24,2,2,2,1,2,1,125,106,46834,36399,131,131,48940,34933
231,24,1,4,1,0,0,3,188,164,46835,36403,191,125,48940,34936
232,24,0,1,1,0,0,3,159,173,46835,36404,146,278,48940,34939
233,24,3,0,0,3,1,0,277,185,46838,36404,284,35,48943,34939
234,24,1,0,0,3,1,0,533,119,46839,36404,434,39,48946,34939
235,24,1,2,1,0,0,3,508,147,46840,36406,408,40,48946,34942
236,24,0,0,2,1,2,1,300,179,46840,36406,308,148,48947,34943
237,24,3,0,0,3,1,0,236,141,46843,36406,265,179,48950,34943
238,24,1,1,2,1,2,1,166,167,46844,36407,183,59,48951,34944
239,24,0,1,1,0,0,3,12,16,46844,36408,10,183,48951,34947
240,25,1,1,2,1,2,1,221,200,46845,36409,260,9,48952,34948
241,25,2,1,0,3,1,0,185,155,46847,36410,216,106,48955,34948
242,25,2,4,1,0,0,3,316,178,46849,36414,337,365,48955,34951
243,25,0,0,2,1,2,1,53,51,46849,36414,80,125,48956,34952
244,25,1,0,0,3,1,0,256,169,46850,36414,295,83,48959,34952
245,25,1,1,2,1,2,1,57,52,46851,36415,73,211,48960,34953
246,25,2,0,0,3,1,0,329,106,46853,36415,375,172,48963,34953
247,25,0,2,1,0,0,3,59,58,46853,36417,66,125,48963,34956
248,25,1,2,1,0,0,3,188,188,46854,36419,214,352,48963,34959
249,25,0,0,2,1,2,1,37,40,46854,36419,39,175,48964,34960
250,26,0,2,1,0,0,3,159,175,46854,36421,146,43,48964,34963
251,26,3,1,0,3,1,0,224,201,46857,36422,263,39,48967,34963
252,26,1,2,1,0,0,3,237,143,46858,36424,265,62,48967,34966
253,26,2,1,0,3,1,0,14,17,46860,36425,13,179,48970,34966
254,26,0,1,1,0,0,3,508,148,46860,36426,408,368,48970,34969
255,26,1,0,0,3,1,0,126,106,46861,36426,134,125,48973,34969
256,26,1,2,1,0,0,3,167,169,46862,36428,183,134,48973,34972
257,26,0,2,1,0,0,3,277,187,46862,36430,284,281,48973,34975
258,26,2,0,0,3,1,0,302,179,46864,36430,311,183,48976,34975
259,26,1,0,0,3,1,0,58,52,46865,36430,76,125,48979,34975
260,27,1,1,2,1,2,1,257,170,46866,36431,296,149,48980,34976
261,27,1,1,2,1,2,1,54,52,46867,36432,81,84,48981,34977
262,27,1,0,0,3,1,0,330,106,46868,36432,378,35,48984,34977
263,27,3,1,0,3,1,0,536,120,46871,36433,437,106,48987,34977
264,27,2,1,0,3,1,0,187,156,46873,36434,219,9,48990,34977
265,27,0,1,1,0,0,3,188,165,46873,36435,191,128,48990,34980
266,27,2,3,1,0,0,3,39,43,46875,36438,39,214,48990,34983
267,27,0,2,1,0,0,3,188,190,46875,36440,214,175,48990,34986
268,27,5,2,0,3,1,0,321,180,46880,36442,340,175,48993,34986
269,27,1,4,1,0,0,3,60,62,46881,36446,66,355,48993,34989
270,28,1,1,2,1,2,1,278,188,46882,36447,285,126,48994,34990
271,28,1,3,1,0,0,3,15,20,46883,36450,13,65,48994,34993
272,28,2,0,0,3,1,0,510,148,46885,36450,411,125,48997,34993
273,28,2,0,0,3,1,0,259,170,46887,36450,299,281,49000,34993
274,28,0,2,1,0,0,3,58,54,46887,36452,76,46,49000,34996
275,28,1,2,1,0,0,3,127,108,46888,36454,134,42,49000,34999
276,28,0,1,1,0,0,3,224,202,46888,36455,263,182,49000,35002
277,28,0,0,2,1,2,1,302,179,46888,36455,312,135,49001,35003
278,28,3,1,0,3,1,0,240,144,46891,36456,268,106,49004,35003
279,28,1,4,1,0,0,3,168,173,46892,36460,183,371,49004,35006
280,29,1,2,1,0,0,3,40,45,46893,36462,39,186,49004,35009
281,29,0,2,1,0,0,3,187,158,46893,36464,219,38,49004,35012
282,29,2,0,0,3,1,0,538,120,46895,36464,440,149,49007,35012
283,29,3,2,0,3,1,0,191,167,46898,36466,194,175,49010,35012
284,29,0,4,1,0,0,3,54,56,46898,36470,81,284,49010,35015
285,29,2,2,2,1,2,1,190,192,46900,36472,215,85,49011,35016
286,29,1,1,2,1,2,1,160,176,46901,36473,147,129,49012,35017
287,29,0,1,1,0,0,3,321,181,46901,36474,340,217,49012,35020
288,29,1,1,2,1,2,1,61,63,46902,36475,67,176,49013,35021
289,29,3,2,0,3,1,0,513,150,46905,36477,414,9,49016,35021
290,30,2,0,0,3,1,0,332,106,46907,36477,381,46,49019,35021
291,30,1,1,2,1,2,1,225,203,46908,36478,264,136,49020,35022
292,30,4,4,2,1,2,1,244,148,46912,36482,269,372,49021,35023
293,30,3,2,0,3,1,0,262,172,46915,36484,302,126,49024,35023
294,30,2,1,0,3,1,0,129,109,46917,36485,137,106,49027,35023
295,30,3,3,2,1,2,1,18,23,46920,36488,14,126,49028,35024
296,30,2,1,0,3,1,0,304,180,46922,36489,315,355,49031,35024
297,30,2,0,0,3,1,0,323,181,46924,36489,343,65,49034,35024
298,30,1,0,0,3,1,0,59,54,46925,36489,79,42,49037,35024
299,30,2,1,0,3,1,0,280,189,46927,36490,288,129,49040,35024
300,31,1,2,1,0,0,3,41,47,46928,36492,39,152,49040,35027
301,31,2,1,0,3,1,0,515,151,46930,36493,417,85,49043,35027
302,31,2,0,0,3,1,0,162,176,46932,36493,150,217,49046,35027
303,31,2,0,0,3,1,0,540,120,46934,36493,443,284,49049,35027
304,31,1,1,2,1,2,1,55,57,46935,36494,82,39,49050,35028
305,31,1,0,0,3,1,0,188,158,46936,36494,222,186,49053,35028
306,31,0,2,1,0,0,3,61,65,46936,36496,67,185,49053,35031
307,31,3,1,0,3,1,0,194,168,46939,36497,197,176,49056,35031
308,31,2,2,2,1,2,1,192,194,46941,36499,216,10,49057,35032
309,31,2,1,0,3,1,0,170,174,46943,36500,186,175,49060,35032
310,32,2,1,0,3,1,0,227,204,46945,36501,267,65,49063,35032
311,32,0,0,2,1,2,1,18,23,46945,36501,15,373,49064,35033
312,32,2,0,0,3,1,0,334,106,46947,36501,384,126,49067,35033
313,32,3,2,0,3,1,0,326,183,46950,36503,346,129,49070,35033
314,32,2,2,2,1,2,1,63,67,46952,36505,68,137,49071,35034
315,32,3,2,0,3,1,0,265,174,46955,36507,305,106,49074,35034
316,32,1,1,2,1,2,1,281,190,46956,36508,289,86,49075,35035
317,32,0,1,1,0,0,3,41,48,46956,36509,39,178,49075,35038
318,32,3,1,0,3,1,0,307,181,46959,36510,318,126,49078,35038
319,32,1,1,2,1,2,1,60,55,46960,36511,80,356,49079,35039
320,33,2,2,2,1,2,1,57,59,46962,36513,83,43,49080,35040
321,33,2,1,0,3,1,0,196,169,46964,36514,200,46,49083,35040
322,33,0,1,1,0,0,3,129,110,46964,36515,137,287,49083,35043
323,33,0,0,2,1,2,1,162,176,46964,36515,151,11,49084,35044
324,33,2,1,0,3,1,0,542,121,46966,36516,446,176,49087,35044
325,33,2,2,2,1,2,1,194,196,46968,36518,217,153,49088,35045
326,33,3,0,0,3,1,0,191,158,46971,36518,225,185,49091,35045
327,33,3,0,0,3,1,0,518,151,46974,36518,420,186,49094,35045
328,33,2,1,0,3,1,0,246,149,46976,36519,272,39,49097,35045
329,33,1,2,1,0,0,3,171,176,46977,36521,186,220,49097,35048
330,34,2,0,0,3,1,0,20,23,46979,36521,18,86,49100,35048
331,34,1,0,0,3,1,0,64,67,46980,36521,71,46,49103,35048
332,34,0,2,1,0,0,3,57,61,46980,36523,83,376,49103,35051
333,34,3,2,0,3,1,0,337,108,46983,36525,387,220,49106,35051
334,34,0,1,1,0,0,3,60,56,46983,36526,80,189,49106,35054
335,34,1,1,2,1,2,1,228,205,46984,36527,268,127,49107,35055
336,34,4,0,0,3,1,0,198,196,46988,36527,220,129,49110,35055
337,34,5,0,0,3,1,0,331,183,46993,36527,349,106,49113,35055
338,34,0,1,1,0,0,3,281,191,46993,36528,289,181,49113,35058
339,34,0,0,2,1,2,1,191,158,46993,36528,226,357,49114,35059
340,35,1,1,2,1,2,1,266,175,46994,36529,306,66,49115,35060
341,35,1,0,0,3,1,0,338,108,46995,36529,390,43,49118,35060
342,35,0,0,2,1,2,1,60,56,46995,36529,81,128,49119,35061
343,35,1,0,0,3,1,0,543,121,46996,36529,449,126,49122,35061
344,35,0,1,1,0,0,3,307,182,46996,36530,318,89,49122,35064
345,35,1,0,0,3,1,0,42,48,46997,36530,42,185,49125,35064
346,35,2,1,0,3,1,0,283,192,46999,36531,292,137,49128,35064
347,35,1,1,2,1,2,1,247,150,47000,36532,273,12,49129,35065
348,35,1,0,0,3,1,0,163,176,47001,36532,154,357,49132,35065
349,35,1,1,2,1,2,1,172,177,47002,36533,187,154,49133,35066
350,36,0,3,1,0,0,3,331,186,47002,36536,349,42,49133,35069
351,36,4,1,0,3,1,0,202,197,47006,36537,223,106,49136,35069
352,36,3,0,0,3,1,0,231,205,47009,36537,271,287,49139,35069
353,36,0,1,1,0,0,3,57,62,47009,36538,83,179,49139,35072
354,36,2,0,0,3,1,0,198,169,47011,36538,203,376,49142,35072
355,36,2,0,0,3,1,0,193,158,47013,36538,229,46,49145,35072
356,36,1,0,0,3,1,0,130,110,47014,36538,140,129,49148,35072
357,36,3,2,0,3,1,0,521,153,47017,36540,423,181,49151,35072
358,36,1,0,0,3,1,0,65,67,47018,36540,74,189,49154,35072
359,36,2,6,1,0,0,3,22,29,47020,36546,18,223,49154,35075
360,37,3,1,0,3,1,0,269,176,47023,36547,309,128,49157,35075
361,37,1,1,2,1,2,1,339,109,47024,36548,391,186,49158,35076
362,37,2,0,0,3,1,0,545,121,47026,36548,452,137,49161,35076
363,37,2,1,0,3,1,0,174,178,47028,36549,190,12,49164,35076
364,37,1,2,1,0,0,3,43,50,47029,36551,42,129,49164,35079
365,37,1,2,1,0,0,3,164,178,47030,36553,154,46,49164,35082
366,37,3,1,0,3,1,0,310,183,47033,36554,321,66,49167,35082
367,37,1,0,0,3,1,0,248,150,47034,36554,276,89,49170,35082
368,37,0,2,1,0,0,3,60,58,47034,36556,81,157,49170,35085
369,37,3,1,0,3,1,0,286,193,47037,36557,295,357,49173,35085
370,38,2,2,2,1,2,1,204,199,47039,36559,224,288,49174,35086
371,38,2,0,0,3,1,0,233,205,47041,36559,274,179,49177,35086
372,38,2,2,2,1,2,1,195,160,47043,36561,230,182,49178,35087
373,38,2,0,0,3,1,0,333,186,47045,36561,352,189,49181,35087
374,38,0,2,1,0,0,3,65,69,47045,36563,74,226,49181,35090
375,38,2,1,0,3,1,0,59,63,47047,36564,86,46,49184,35090
376,38,2,2,2,1,2,1,200,171,47049,36566,204,107,49185,35091
377,38,2,1,0,3,1,0,24,30,47051,36567,21,42,49188,35091
378,38,0,2,1,0,0,3,521,155,47051,36569,423,132,49188,35094
379,38,2,2,2,1,2,1,132,112,47053,36571,141,377,49189,35095
0,1,1,0,0,3,1,0,270,176,47054,36571,312,377,49192,35095
1,1,1,3,1,0,0,3,201,174,47055,36574,204,360,49192,35098
2,1,1,1,2,1,2,1,311,184,47056,36575,322,180,49193,35099
3,1,2,1,0,3,1,0,74,65,47058,36576,92,89,49196,35099
4,1,0,1,1,0,0,3,60,59,47058,36577,81,70,49196,35102
5,1,4,4,2,1,2,1,252,154,47062,36581,277,84,49197,35103
6,1,1,0,0,3,1,0,60,63,47063,36581,89,129,49200,35103
7,1,0,2,1,0,0,3,233,207,47063,36583,274,189,49200,35106
8,1,1,2,1,0,0,3,175,180,47064,36585,190,49,49200,35109
9,1,1,0,0,3,1,0,340,109,47065,36585,394,137,49203,35109
10,2,0,1,1,0,0,3,117,144,47065,36586,136,192,49203,35112
11,2,2,1,0,3,1,0,206,200,47067,36587,227,182,49206,35112
12,2,0,0,2,1,2,1,112,111,47067,36587,135,90,49207,35113
13,2,1,1,2,1,2,1,522,156,47068,36588,424,50,49208,35114
14,2,1,0,0,3,1,0,202,174,47069,36588,207,226,49211,35114
15,2,1,1,2,1,2,1,196,161,47070,36589,231,190,49212,35115
16,2,0,0,2,1,2,1,60,63,47070,36589,90,158,49213,35116
17,2,0,1,1,0,0,3,74,66,47070,36590,92,183,49213,35119
18,2,0,1,1,0,0,3,60,60,47070,36591,81,291,49213,35122
19,2,5,2,0,3,1,0,550,123,47075,36593,455,132,49216,35122
20,3,1,1,2,1,2,1,334,187,47076,36594,353,129,49217,35123
21,3,2,0,0,3,1,0,272,176,47078,36594,315,183,49220,35123
22,3,2,2,2,1,2,1,114,113,47080,36596,136,378,49221,35124
23,3,1,1,2,1,2,1,197,162,47081,36597,232,67,49222,35125
24,3,2,0,0,3,1,0,208,200,47083,36597,230,50,49225,35125
25,3,2,1,0,3,1,0,177,181,47085,36598,193,42,49228,35125
26,3,2,0,0,3,1,0,313,184,47087,36598,325,43,49231,35125
27,3,3,2,0,3,1,0,343,111,47090,36600,397,90,49234,35125
28,3,0,3,1,0,0,3,233,210,47090,36603,274,87,49234,35128
29,3,2,2,2,1,2,1,254,156,47092,36605,278,361,49235,35129
30,4,0,0,2,1,2,1,74,66,47092,36605,93,191,49236,35130
31,4,3,2,0,3,1,0,525,158,47095,36607,427,129,49239,35130
32,4,0,3,1,0,0,3,60,63,47095,36610,81,185,49239,35133
33,4,2,0,0,3,1,0,288,193,47097,36610,298,291,49242,35133
34,4,5,2,0,3,1,0,555,125,47102,36612,458,226,49245,35133
35,4,1,2,1,0,0,3,133,114,47103,36614,141,161,49245,35136
36,4,0,1,1,0,0,3,60,64,47103,36615,90,195,49245,35139
37,4,0,2,1,0,0,3,202,176,47103,36617,207,90,49245,35142
38,4,1,1,2,1,2,1,66,70,47104,36618,75,71,49246,35143
39,4,1,1,2,1,2,1,178,182,47105,36619,194,138,49247,35144
40,5,0,0,2,1,2,1,114,113,47105,36619,137,133,49248,35145
41,5,2,0,0,3,1,0,256,156,47107,36619,281,50,49251,35145
42,5,0,0,2,1,2,1,208,200,47107,36619,231,91,49252,35146
43,5,0,0,2,1,2,1,343,111,47107,36619,398,130,49253,35147
44,5,2,0,0,3,1,0,119,144,47109,36619,139,378,49256,35147
45,5,4,2,0,3,1,0,201,164,47113,36621,235,43,49259,35147
46,5,1,3,1,0,0,3,234,213,47114,36624,274,186,49259,35150
47,5,1,1,2,1,2,1,314,185,47115,36625,326,43,49260,35151
48,5,2,0,0,3,1,0,274,176,47117,36625,318,67,49263,35151
49,5,0,1,1,0,0,3,334,188,47117,36626,353,364,49263,35154
50,6,1,1,2,1,2,1,67,71,47118,36627,76,91,49264,35155
51,6,3,1,0,3,1,0,181,183,47121,36628,197,129,49267,35155
52,6,2,1,0,3,1,0,557,126,47123,36629,461,185,49270,35155
53,6,1,1,2,1,2,1,61,64,47124,36630,82,192,49271,35156
54,6,0,2,1,0,0,3,74,68,47124,36632,93,294,49271,35159
55,6,3,3,2,1,2,1,317,188,47127,36635,327,139,49272,35160
56,6,2,0,0,3,1,0,527,158,47129,36635,430,71,49275,35160
57,6,3,2,0,3,1,0,136,116,47132,36637,144,195,49278,35160
58,6,1,1,2,1,2,1,203,177,47133,36638,208,162,49279,35161
59,6,3,0,0,3,1,0,291,193,47136,36638,301,67,49282,35161
60,7,5,1,0,3,1,0,261,157,47141,36639,284,133,49285,35161
61,7,0,1,1,0,0,3,274,177,47141,36640,318,229,49285,35164
62,7,0,2,1,0,0,3,201,166,47141,36642,235,381,49285,35167
63,7,1,0,0,3,1,0,120,144,47142,36642,142,43,49288,35167
64,7,0,0,2,1,2,1,343,111,47142,36642,399,365,49289,35168
65,7,0,2,1,0,0,3,234,215,47142,36644,274,53,49289,35171
66,7,2,0,0,3,1,0,138,116,47144,36644,147,130,49292,35171
67,7,2,0,0,3,1,0,62,64,47146,36644,93,43,49295,35171
68,7,1,1,2,1,2,1,209,201,47147,36645,232,72,49296,35172
69,7,3,2,0,3,1,0,337,190,47150,36647,356,186,49299,35172
70,8,1,1,2,1,2,1,182,184,47151,36648,198,92,49300,35173
71,8,1,2,1,0,0,3,62,66,47152,36650,82,132,49300,35176
72,8,4,2,0,3,1,0,531,160,47156,36652,433,91,49303,35176
73,8,2,1,0,3,1,0,319,189,47158,36653,330,67,49306,35176
74,8,2,1,0,3,1,0,116,114,47160,36654,140,185,49309,35176
75,8,2,0,0,3,1,0,76,68,47162,36654,96,162,49312,35176
76,8,1,0,0,3,1,0,204,177,47163,36654,211,192,49315,35176
77,8,0,0,2,1,2,1,67,71,47163,36654,77,295,49316,35177
78,8,1,2,1,0,0,3,292,195,47164,36656,301,142,49316,35180
79,8,4,0,0,3,1,0,561,126,47168,36656,464,195,49319,35180
80,9,1,0,0,3,1,0,121,144,47169,36656,145,72,49322,35180
81,9,0,3,1,0,0,3,138,119,47169,36659,147,384,49322,35183
82,9,1,1,2,1,2,1,344,112,47170,36660,400,230,49323,35184
83,9,2,0,0,3,1,0,203,166,47172,36660,238,43,49326,35184
84,9,1,0,0,3,1,0,77,68,47173,36660,99,365,49329,35184
85,9,2,0,0,3,1,0,64,64,47175,36660,96,130,49332,35184
86,9,3,1,0,3,1,0,295,196,47178,36661,304,133,49335,35184
87,9,0,1,1,0,0,3,234,216,47178,36662,274,188,49335,35187
88,9,1,1,2,1,2,1,275,178,47179,36663,319,54,49336,35188
89,9,1,0,0,3,1,0,338,190,47180,36663,359,132,49339,35188
90,10,4,1,0,3,1,0,265,158,47184,36664,287,67,49342,35188
91,10,1,0,0,3,1,0,63,66,47185,36664,85,43,49345,35188
92,10,2,0,0,3,1,0,69,71,47187,36664,80,92,49348,35188
93,10,2,0,0,3,1,0,346,112,47189,36664,403,192,49351,35188
94,10,0,1,1,0,0,3,204,178,47189,36665,211,189,49351,35191
95,10,1,0,0,3,1,0,122,144,47190,36665,148,133,49354,35191
96,10,0,1,1,0,0,3,209,202,47190,36666,232,165,49354,35194
97,10,2,0,0,3,1,0,340,190,47192,36666,362,142,49357,35194
98,10,3,1,0,3,1,0,119,115,47195,36667,143,230,49360,35194
99,10,0,0,2,1,2,1,561,126,47195,36667,465,366,49361,35195
100,11,1,1,2,1,2,1,65,65,47196,36668,97,296,49362,35196
101,11,5,1,0,3,1,0,566,127,47201,36669,468,54,49365,35196
102,11,1,2,1,0,0,3,296,198,47202,36671,304,135,49365,35199
103,11,1,1,2,1,2,1,320,190,47203,36672,331,196,49366,35200
104,11,3,0,0,3,1,0,278,178,47206,36672,322,165,49369,35200
105,11,2,1,0,3,1,0,184,185,47208,36673,201,130,49372,35200
106,11,5,0,0,3,1,0,536,160,47213,36673,436,43,49375,35200
107,11,2,1,0,3,1,0,140,120,47215,36674,150,188,49378,35200
108,11,2,2,2,1,2,1,79,70,47217,36676,100,73,49379,35201
109,11,3,1,0,3,1,0,206,167,47220,36677,241,91,49382,35201
110,12,1,2,1,0,0,3,235,218,47221,36679,274,233,49382,35204
111,12,3,1,0,3,1,0,212,203,47224,36680,235,384,49385,35204
112,12,1,1,2,1,2,1,341,191,47225,36681,363,297,49386,35205
113,12,0,0,2,1,2,1,536,160,47225,36681,437,134,49387,35206
114,12,3,0,0,3,1,0,72,71,47228,36681,83,43,49390,35206
115,12,0,0,2,1,2,1,265,158,47228,36681,288,193,49391,35207
116,12,4,2,0,3,1,0,123,117,47232,36683,146,67,49394,35207
117,12,0,1,1,0,0,3,204,179,47232,36684,211,145,49394,35210
118,12,1,2,1,0,0,3,64,68,47233,36686,85,95,49394,35213
119,12,1,2,1,0,0,3,123,146,47234,36688,148,192,49394,35216
120,13,1,1,2,1,2,1,297,199,47235,36689,305,44,49395,35217
121,13,3,0,0,3,1,0,68,65,47238,36689,100,54,49398,35217
122,13,2,0,0,3,1,0,322,190,47240,36689,334,91,49401,35217
123,13,0,4,1,0,0,3,140,124,47240,36693,150,369,49401,35220
124,13,4,1,0,3,1,0,570,128,47244,36694,471,130,49404,35220
125,13,3,1,0,3,1,0,82,71,47247,36695,103,188,49407,35220
126,13,2,1,0,3,1,0,280,179,47249,36696,325,135,49410,35220
127,13,3,1,0,3,1,0,349,113,47252,36697,406,165,49413,35220
128,13,0,0,2,1,2,1,206,167,47252,36697,242,74,49414,35221
129,13,1,2,1,0,0,3,185,187,47253,36699,201,199,49414,35224
130,14,2,1,0,3,1,0,214,204,47255,36700,238,43,49417,35224
131,14,1,2,1,0,0,3,65,70,47256,36702,85,387,49417,35227
132,14,2,1,0,3,1,0,187,188,47258,36703,204,233,49420,35227
133,14,1,1,2,1,2,1,124,147,47259,36704,149,298,49421,35228
134,14,3,1,0,3,1,0,539,161,47262,36705,440,192,49424,35228
135,14,1,1,2,1,2,1,236,219,47263,36706,275,146,49425,35229
136,14,1,2,1,0,0,3,124,119,47264,36708,146,196,49425,35232
137,14,0,2,1,0,0,3,140,126,47264,36710,150,70,49425,35235
138,14,1,3,1,0,0,3,266,161,47265,36713,288,133,49425,35238
139,14,0,1,1,0,0,3,72,72,47265,36714,83,202,49425,35241
140,15,0,0,2,1,2,1,204,179,47265,36714,212,55,49426,35242
141,15,1,2,1,0,0,3,69,67,47266,36716,100,372,49426,35245
142,15,4,1,0,3,1,0,301,200,47270,36717,308,95,49429,35245
143,15,1,2,1,0,0,3,83,73,47271,36719,103,137,49429,35248
144,15,2,1,0,3,1,0,324,191,47273,36720,337,188,49432,35248
145,15,1,0,0,3,1,0,342,191,47274,36720,366,44,49435,35248
146,15,2,0,0,3,1,0,282,179,47276,36720,328,91,49438,35248
147,15,2,4,1,0,0,3,238,223,47278,36724,275,77,49438,35251
148,15,4,0,0,3,1,0,210,167,47282,36724,245,135,49441,35251
149,15,0,1,1,0,0,3,349,114,47282,36725,406,390,49441,35254
150,16,0,0,2,1,2,1,266,161,47282,36725,289,299,49442,35255
151,16,2,0,0,3,1,0,541,161,47284,36725,443,165,49445,35255
152,16,3,0,0,3,1,0,127,147,47287,36725,152,70,49448,35255
153,16,2,4,1,0,0,3,216,208,47289,36729,238,236,49448,35258
154,16,5,2,0,3,1,0,575,130,47294,36731,474,43,49451,35258
155,16,0,1,1,0,0,3,140,127,47294,36732,150,149,49451,35261
156,16,3,2,0,3,1,0,190,190,47297,36734,207,196,49454,35261
157,16,0,0,2,1,2,1,72,72,47297,36734,84,193,49455,35262
158,16,3,2,0,3,1,0,68,72,47300,36736,88,133,49458,35262
159,16,1,1,2,1,2,1,125,120,47301,36737,147,203,49459,35263
160,17,1,1,2,1,2,1,70,68,47302,36738,101,45,49460,35264
161,17,1,2,1,0,0,3,128,149,47303,36740,152,138,49460,35267
162,17,2,2,2,1,2,1,303,202,47305,36742,309,391,49461,35268
163,17,0,0,2,1,2,1,282,179,47305,36742,329,96,49462,35269
164,17,2,0,0,3,1,0,351,114,47307,36742,409,77,49465,35269
165,17,2,0,0,3,1,0,212,167,47309,36742,248,55,49468,35269
166,17,2,2,2,1,2,1,206,181,47311,36744,213,44,49469,35270
167,17,2,2,2,1,2,1,240,225,47313,36746,276,138,49470,35271
168,17,1,2,1,0,0,3,343,193,47314,36748,366,191,49470,35274
169,17,1,1,2,1,2,1,325,192,47315,36749,338,373,49471,35275
170,18,3,0,0,3,1,0,143,127,47318,36749,153,91,49474,35275
171,18,0,2,1,0,0,3,83,75,47318,36751,103,206,49474,35278
172,18,4,1,0,3,1,0,579,131,47322,36752,477,70,49477,35278
173,18,1,0,0,3,1,0,267,161,47323,36752,292,149,49480,35278
174,18,1,1,2,1,2,1,73,73,47324,36753,85,237,49481,35279
175,18,2,0,0,3,1,0,70,72,47326,36753,91,165,49484,35279
176,18,3,4,1,0,0,3,128,124,47329,36757,147,196,49484,35282
177,18,1,2,1,0,0,3,191,192,47330,36759,207,302,49484,35285
178,18,3,1,0,3,1,0,219,209,47333,36760,241,133,49487,35285
179,18,0,0,2,1,2,1,541,161,47333,36760,444,197,49488,35286
180,19,2,2,2,1,2,1,75,75,47335,36762,86,46,49489,35287
181,19,1,1,2,1,2,1,344,194,47336,36763,367,198,49490,35288
182,19,1,0,0,3,1,0,326,192,47337,36763,341,96,49493,35288
183,19,0,3,1,0,0,3,212,170,47337,36766,248,376,49493,35291
184,19,2,1,0,3,1,0,353,115,47339,36767,412,138,49496,35291
185,19,2,2,2,1,2,1,242,227,47341,36769,277,392,49497,35292
186,19,1,0,0,3,1,0,129,149,47342,36769,155,44,49500,35292
187,19,1,2,1,0,0,3,304,204,47343,36771,309,194,49500,35295
188,19,1,1,2,1,2,1,71,69,47344,36772,102,139,49501,35296
189,19,1,1,2,1,2,1,207,182,47345,36773,214,78,49502,35297
190,20,0,3,1,0,0,3,70,75,47345,36776,91,152,49502,35300
191,20,0,1,1,0,0,3,219,210,47345,36777,241,73,49502,35303
192,20,2,1,0,3,1,0,543,162,47347,36778,447,206,49505,35303
193,20,0,0,2,1,2,1,128,124,47347,36778,148,56,49506,35304
194,20,2,0,0,3,1,0,145,127,47349,36778,156,302,49509,35304
195,20,4,1,0,3,1,0,87,76,47353,36779,106,237,49512,35304
196,20,3,0,0,3,1,0,194,192,47356,36779,210,196,49515,35304
197,20,1,2,1,0,0,3,268,163,47357,36781,292,168,49515,35307
198,20,1,1,2,1,2,1,283,180,47358,36782,330,134,49516,35308
199,20,1,0,0,3,1,0,580,131,47359,36782,480,91,49519,35308
200,21,2,0,0,3,1,0,130,124,47361,36782,151,138,49522,35308
201,21,1,1,2,1,2,1,243,228,47362,36783,278,199,49523,35309
202,21,2,0,0,3,1,0,328,192,47364,36783,344,392,49526,35309
203,21,1,2,1,0,0,3,72,71,47365,36785,102,197,49526,35312
204,21,2,0,0,3,1,0,346,194,47367,36785,370,91,49529,35312
205,21,0,0,2,1,2,1,353,115,47367,36785,413,47,49530,35313
206,21,0,0,2,1,2,1,207,182,47367,36785,215,97,49531,35314
207,21,1,0,0,3,1,0,213,170,47368,36785,251,139,49534,35314
208,21,3,0,0,3,1,0,307,204,47371,36785,312,44,49537,35314
209,21,0,1,1,0,0,3,75,76,47371,36786,86,379,49537,35317
210,22,2,1,0,3,1,0,131,150,47373,36787,158,168,49540,35317
211,22,1,0,0,3,1,0,544,162,47374,36787,450,302,49543,35317
212,22,0,1,1,0,0,3,87,77,47374,36788,106,59,49543,35320
213,22,1,0,0,3,1,0,329,192,47375,36788,347,134,49546,35320
214,22,2,1,0,3,1,0,72,76,47377,36789,94,196,49549,35320
215,22,1,1,2,1,2,1,146,128,47378,36790,157,140,49550,35321
216,22,0,2,1,0,0,3,283,182,47378,36792,330,155,49550,35324
217,22,1,1,2,1,2,1,347,195,47379,36793,371,74,49551,35325
218,22,3,1,0,3,1,0,271,164,47382,36794,295,78,49554,35325
219,22,2,1,0,3,1,0,582,132,47384,36795,483,138,49557,35325
220,23,2,1,0,3,1,0,74,72,47386,36796,105,97,49560,35325
221,23,2,0,0,3,1,0,221,210,47388,36796,244,47,49563,35325
222,23,3,0,0,3,1,0,216,170,47391,36796,254,237,49566,35325
223,23,1,1,2,1,2,1,76,77,47392,36797,87,198,49567,35326
224,23,1,0,0,3,1,0,354,115,47393,36797,416,91,49570,35326
225,23,1,0,0,3,1,0,244,228,47394,36797,281,44,49573,35326
226,23,2,1,0,3,1,0,309,205,47396,36798,315,199,49576,35326
227,23,1,4,1,0,0,3,131,128,47397,36802,151,382,49576,35329
228,23,2,1,0,3,1,0,209,183,47399,36803,218,206,49579,35329
229,23,2,3,1,0,0,3,196,195,47401,36806,210,395,49579,35332
230,24,2,2,2,1,2,1,331,194,47403,36808,348,303,49580,35333
231,24,1,0,0,3,1,0,88,77,47404,36808,109,74,49583,35333
232,24,2,1,0,3,1,0,584,133,47406,36809,486,155,49586,35333
233,24,2,1,0,3,1,0,273,165,47408,36810,298,138,49589,35333
234,24,2,1,0,3,1,0,133,151,47410,36811,161,59,49592,35333
235,24,2,2,2,1,2,1,349,197,47412,36813,372,169,49593,35334
236,24,0,0,2,1,2,1,72,76,47412,36813,95,141,49594,35335
237,24,0,1,1,0,0,3,283,183,47412,36814,330,81,49594,35338
238,24,2,2,2,1,2,1,546,164,47414,36816,451,135,49595,35339
239,24,1,2,1,0,0,3,147,130,47415,36818,157,199,49595,35342
240,25,3,3,2,1,2,1,199,198,47418,36821,211,45,49596,35343
241,25,1,0,0,3,1,0,210,183,47419,36821,221,47,49599,35343
242,25,5,0,0,3,1,0,589,133,47424,36821,489,97,49602,35343
243,25,3,0,0,3,1,0,312,205,47427,36821,318,237,49605,35343
244,25,1,0,0,3,1,0,222,210,47428,36821,247,382,49608,35343
245,25,0,3,1,0,0,3,131,131,47428,36824,151,94,49608,35346
246,25,2,1,0,3,1,0,76,73,47430,36825,108,199,49611,35346
247,25,2,1,0,3,1,0,78,78,47432,36826,90,169,49614,35346
248,25,0,3,1,0,0,3,216,173,47432,36829,254,209,49614,35349
249,25,3,1,0,3,1,0,357,116,47435,36830,419,198,49617,35349
250,26,1,0,0,3,1,0,313,205,47436,36830,321,59,49620,35349
251,26,3,0,0,3,1,0,150,130,47439,36830,160,138,49623,35349
252,26,2,1,0,3,1,0,333,195,47441,36831,351,141,49626,35349
253,26,1,1,2,1,2,1,73,77,47442,36832,96,75,49627,35350
254,26,0,0,2,1,2,1,133,151,47442,36832,162,136,49628,35351
255,26,3,2,0,3,1,0,352,199,47445,36834,375,81,49631,35351
256,26,1,0,0,3,1,0,284,183,47446,36834,333,198,49634,35351
257,26,1,1,2,1,2,1,245,229,47447,36835,282,304,49635,35352
258,26,0,1,1,0,0,3,88,78,47447,36836,109,158,49635,35355
259,26,2,0,0,3,1,0,548,164,47449,36836,454,395,49638,35355
260,27,1,1,2,1,2,1,77,74,47450,36837,109,238,49639,35356
261,27,1,2,1,0,0,3,151,132,47451,36839,160,48,49639,35359
262,27,2,2,2,1,2,1,359,118,47453,36841,420,210,49640,35360
263,27,1,0,0,3,1,0,590,133,47454,36841,492,199,49643,35360
264,27,0,0,2,1,2,1,216,173,47454,36841,255,137,49644,35361
265,27,1,0,0,3,1,0,132,131,47455,36841,154,169,49647,35361
266,27,1,4,1,0,0,3,79,82,47456,36845,90,202,49647,35364
267,27,1,1,2,1,2,1,223,211,47457,36846,248,95,49648,35365
268,27,1,2,1,0,0,3,274,167,47458,36848,298,50,49648,35368
269,27,2,1,0,3,1,0,201,199,47460,36849,214,382,49651,35368
270,28,2,0,0,3,1,0,354,199,47462,36849,378,141,49654,35368
271,28,2,1,0,3,1,0,135,152,47464,36850,165,158,49657,35368
272,28,1,1,2,1,2,1,334,196,47465,36851,352,139,49658,35369
273,28,2,0,0,3,1,0,247,229,47467,36851,285,75,49661,35369
274,28,0,1,1,0,0,3,210,184,47467,36852,221,201,49661,35372
275,28,1,2,1,0,0,3,74,79,47468,36854,96,62,49661,35375
276,28,0,4,1,0,0,3,88,82,47468,36858,109,398,49661,35378
277,28,1,1,2,1,2,1,285,184,47469,36859,334,305,49662,35379
278,28,3,1,0,3,1,0,551,165,47472,36860,457,97,49665,35379
279,28,1,1,2,1,2,1,314,206,47473,36861,322,82,49666,35380
280,29,1,1,2,1,2,1,224,212,47474,36862,249,211,49667,35381
281,29,2,2,2,1,2,1,203,201,47476,36864,215,96,49668,35382
282,29,0,0,2,1,2,1,216,173,47476,36864,256,170,49669,35383
283,29,1,0,0,3,1,0,275,167,47477,36864,301,48,49672,35383
284,29,2,0,0,3,1,0,592,133,47479,36864,495,50,49675,35383
285,29,2,2,2,1,2,1,153,134,47481,36866,161,203,49676,35384
286,29,0,0,2,1,2,1,79,82,47481,36866,91,138,49677,35385
287,29,0,5,1,0,0,3,132,136,47481,36871,154,308,49677,35388
288,29,2,0,0,3,1,0,79,74,47483,36871,112,199,49680,35388
289,29,3,0,0,3,1,0,554,165,47486,36871,460,238,49683,35388
290,30,1,1,2,1,2,1,89,83,47487,36872,110,51,49684,35389
291,30,0,1,1,0,0,3,135,153,47487,36873,165,204,49684,35392
292,30,0,0,2,1,2,1,354,199,47487,36873,379,399,49685,35393
293,30,1,3,1,0,0,3,248,232,47488,36876,285,142,49685,35396
294,30,1,0,0,3,1,0,286,184,47489,36876,337,141,49688,35396
295,30,1,1,2,1,2,1,217,174,47490,36877,257,98,49689,35397
296,30,1,0,0,3,1,0,360,118,47491,36877,423,62,49692,35397
297,30,6,0,0,3,1,0,216,184,47497,36877,224,75,49695,35397
298,30,2,0,0,3,1,0,336,196,47499,36877,355,82,49698,35397
299,30,1,2,1,0,0,3,315,208,47500,36879,322,385,49698,35400
300,31,2,2,2,1,2,1,277,169,47502,36881,302,212,49699,35401
301,31,0,0,2,1,2,1,74,79,47502,36881,97,97,49700,35402
302,31,0,1,1,0,0,3,224,213,47502,36882,249,311,49700,35405
303,31,1,1,2,1,2,1,80,83,47503,36883,92,159,49701,35406
304,31,1,0,0,3,1,0,593,133,47504,36883,498,203,49704,35406
305,31,0,1,1,0,0,3,79,75,47504,36884,112,85,49704,35409
306,31,0,1,1,0,0,3,315,209,47504,36885,322,141,49704,35412
307,31,2,0,0,3,1,0,556,165,47506,36885,463,48,49707,35412
308,31,1,0,0,3,1,0,154,134,47507,36885,164,238,49710,35412
309,31,1,0,0,3,1,0,204,201,47508,36885,218,170,49713,35412
310,32,1,1,2,1,2,1,355,200,47509,36886,380,63,49714,35413
311,32,3,1,0,3,1,0,289,185,47512,36887,340,48,49717,35413
312,32,2,2,2,1,2,1,218,186,47514,36889,225,400,49718,35414
313,32,2,1,0,3,1,0,134,137,47516,36890,157,51,49721,35414
314,32,2,1,0,3,1,0,362,119,47518,36891,426,75,49724,35414
315,32,4,2,0,3,1,0,228,215,47522,36893,252,141,49727,35414
316,32,2,0,0,3,1,0,279,169,47524,36893,305,238,49730,35414
317,32,1,2,1,0,0,3,136,155,47525,36895,165,101,49730,35417
318,32,0,1,1,0,0,3,248,233,47525,36896,285,388,49730,35420
319,32,2,1,0,3,1,0,219,175,47527,36897,260,199,49733,35420
320,33,5,1,0,3,1,0,94,84,47532,36898,113,141,49736,35420
321,33,0,3,1,0,0,3,74,82,47532,36901,97,215,49736,35423
322,33,2,2,2,1,2,1,595,135,47534,36903,499,312,49737,35424
323,33,0,2,1,0,0,3,79,77,47534,36905,112,100,49737,35427
324,33,0,2,1,0,0,3,336,198,47534,36907,355,206,49737,35430
325,33,0,2,1,0,0,3,204,203,47534,36909,218,207,49737,35433
326,33,0,0,2,1,2,1,80,83,47534,36909,93,143,49738,35434
327,33,0,2,1,0,0,3,154,136,47534,36911,164,88,49738,35437
328,33,2,1,0,3,1,0,317,210,47536,36912,325,170,49741,35437
329,33,1,0,0,3,1,0,557,165,47537,36912,466,159,49744,35437
330,34,3,0,0,3,1,0,365,119,47540,36912,429,48,49747,35437
331,34,1,1,2,1,2,1,219,187,47541,36913,226,142,49748,35438
332,34,1,0,0,3,1,0,81,83,47542,36913,96,75,49751,35438
333,34,2,2,2,1,2,1,138,157,47544,36915,166,239,49752,35439
334,34,0,1,1,0,0,3,289,186,47544,36916,340,391,49752,35442
335,34,0,1,1,0,0,3,248,234,47544,36917,285,54,49752,35445
336,34,0,0,2,1,2,1,134,137,47544,36917,158,160,49753,35446
337,34,1,4,1,0,0,3,280,173,47545,36921,305,403,49753,35449
338,34,1,1,2,1,2,1,229,216,47546,36922,253,200,49754,35450
339,34,1,0,0,3,1,0,356,200,47547,36922,383,101,49757,35450
340,35,2,1,0,3,1,0,338,199,47549,36923,358,63,49760,35450
341,35,1,1,2,1,2,1,220,188,47550,36924,227,313,49761,35451
342,35,3,0,0,3,1,0,207,203,47553,36924,221,88,49764,35451
343,35,1,3,1,0,0,3,220,178,47554,36927,260,210,49764,35454
344,35,1,0,0,3,1,0,596,135,47555,36927,502,170,49767,35454
345,35,0,0,2,1,2,1,154,136,47555,36927,165,55,49768,35455
346,35,2,0,0,3,1,0,96,84,47557,36927,116,143,49771,35455
347,35,1,2,1,0,0,3,290,188,47558,36929,340,218,49771,35458
348,35,2,3,1,0,0,3,319,213,47560,36932,325,103,49771,35461
349,35,2,0,0,3,1,0,559,165,47562,36932,469,75,49774,35461
350,36,2,1,0,3,1,0,136,138,47564,36933,161,141,49777,35461
351,36,0,1,1,0,0,3,81,84,47564,36934,96,406,49777,35464
352,36,1,0,0,3,1,0,366,119,47565,36934,432,142,49780,35464
353,36,0,2,1,0,0,3,248,236,47565,36936,285,104,49780,35467
354,36,1,2,1,0,0,3,230,218,47566,36938,253,209,49780,35470
355,36,1,0,0,3,1,0,75,82,47567,36938,100,239,49783,35470
356,36,2,0,0,3,1,0,358,200,47569,36938,386,48,49786,35470
357,36,0,0,2,1,2,1,79,77,47569,36938,113,161,49787,35471
358,36,1,2,1,0,0,3,281,175,47570,36940,305,203,49787,35474
359,36,1,2,1,0,0,3,139,159,47571,36942,166,394,49787,35477
360,37,3,1,0,3,1,0,157,137,47574,36943,168,63,49790,35477
361,37,0,2,1,0,0,3,290,190,47574,36945,340,58,49790,35480
362,37,1,2,1,0,0,3,597,137,47575,36947,502,91,49790,35483
363,37,1,0,0,3,1,0,339,199,47576,36947,361,170,49793,35483
364,37,1,2,1,0,0,3,208,205,47577,36949,221,78,49793,35486
365,37,0,0,2,1,2,1,319,213,47577,36949,326,219,49794,35487
366,37,2,3,1,0,0,3,222,191,47579,36952,227,146,49794,35490
367,37,2,1,0,3,1,0,561,166,47581,36953,472,210,49797,35490
368,37,0,2,1,0,0,3,220,180,47581,36955,260,316,49797,35493
369,37,1,2,1,0,0,3,97,86,47582,36957,116,106,49797,35496
370,38,0,5,1,0,0,3,79,82,47582,36962,113,409,49797,35499
371,38,4,0,0,3,1,0,285,175,47586,36962,308,104,49800,35499
372,38,2,0,0,3,1,0,83,84,47588,36962,99,142,49803,35499
373,38,2,2,2,1,2,1,77,84,47590,36964,101,395,49804,35500
374,38,1,0,0,3,1,0,359,200,47591,36964,389,239,49807,35500
375,38,0,0,2,1,2,1,248,236,47591,36964,286,142,49808,35501
376,38,1,0,0,3,1,0,231,218,47592,36964,256,161,49811,35501
377,38,4,0,0,3,1,0,143,159,47596,36964,169,209,49814,35501
378,38,2,2,2,1,2,1,138,140,47598,36966,162,49,49815,35502
379,38,1,1,2,1,2,1,367,120,47599,36967,433,204,49816,35503
0,1,0,0,2,1,2,1,157,137,47599,36967,169,143,49817,35504
1,1,2,0,0,3,1,0,145,159,47601,36967,172,209,49820,35504
2,1,0,2,1,0,0,3,0,2,47601,36969,0,94,49820,35507
3,1,0,1,1,0,0,3,79,83,47601,36970,113,145,49820,35510
4,1,1,1,2,1,2,1,84,85,47602,36971,100,205,49821,35511
5,1,1,1,2,1,2,1,286,176,47603,36972,309,13,49822,35512
6,1,4,2,0,3,1,0,343,201,47607,36974,364,146,49825,35512
7,1,2,0,0,3,1,0,369,120,47609,36974,436,219,49828,35512
8,1,2,0,0,3,1,0,563,166,47611,36974,475,161,49831,35512
9,1,3,0,0,3,1,0,600,137,47614,36974,505,34,49834,35512
10,2,2,1,0,3,1,0,288,177,47616,36975,312,104,49837,35512
11,2,1,0,0,3,1,0,221,180,47617,36975,263,94,49840,35512
12,2,2,1,0,3,1,0,224,192,47619,36976,230,239,49843,35512
13,2,0,2,1,0,0,3,24,32,47619,36978,21,3,49843,35515
14,2,2,0,0,3,1,0,210,205,47621,36978,224,63,49846,35515
15,2,2,1,0,3,1,0,147,160,47623,36979,175,78,49849,35515
16,2,0,0,2,1,2,1,319,213,47623,36979,327,396,49850,35516
17,2,2,3,1,0,0,3,292,193,47625,36982,340,412,49850,35519
18,2,1,1,2,1,2,1,232,219,47626,36983,257,317,49851,35520
19,2,2,0,0,3,1,0,361,200,47628,36983,392,34,49854,35520
20,3,0,0,2,1,2,1,79,83,47628,36983,114,162,49855,35521
21,3,1,1,2,1,2,1,344,202,47629,36984,365,14,49856,35522
22,3,0,3,1,0,0,3,32,46,47629,36987,47,208,49856,35525
23,3,2,3,1,0,0,3,212,208,47631,36990,224,399,49856,35528
24,3,1,3,1,0,0,3,139,143,47632,36993,162,149,49856,35531
25,3,1,2,1,0,0,3,158,139,47633,36995,169,212,49856,35534
26,3,6,1,0,3,1,0,375,121,47639,36996,439,106,49859,35534
27,3,1,3,1,0,0,3,1,5,47640,36999,0,222,49859,35537
28,3,1,1,2,1,2,1,85,86,47641,37000,101,144,49860,35538
29,3,4,0,0,3,1,0,604,137,47645,37000,508,210,49863,35538
30,4,0,1,1,0,0,3,319,214,47645,37001,327,242,49863,35541
31,4,3,0,0,3,1,0,224,180,47648,37001,266,145,49866,35541
32,4,0,0,2,1,2,1,24,32,47648,37001,22,318,49867,35542
33,4,3,1,0,3,1,0,291,178,47651,37002,315,78,49870,35542
34,4,0,1,1,0,0,3,158,140,47651,37003,169,37,49870,35545
35,4,1,0,0,3,1,0,564,166,47652,37003,478,63,49873,35545
36,4,0,1,1,0,0,3,292,194,47652,37004,340,6,49873,35548
37,4,1,0,0,3,1,0,362,200,47653,37004,395,149,49876,35548
38,4,0,3,1,0,0,3,224,195,47653,37007,230,415,49876,35551
39,4,2,0,0,3,1,0,149,160,47655,37007,178,94,49879,35551
40,5,1,2,1,0,0,3,86,88,47656,37009,101,107,49879,35554
41,5,0,0,2,1,2,1,375,121,47656,37009,440,211,49880,35555
42,5,3,0,0,3,1,0,322,214,47659,37009,330,162,49883,35555
43,5,0,0,2,1,2,1,32,46,47659,37009,48,15,49884,35556
44,5,0,2,1,0,0,3,344,204,47659,37011,365,148,49884,35559
45,5,2,0,0,3,1,0,141,143,47661,37011,165,144,49887,35559
46,5,1,0,0,3,1,0,80,83,47662,37011,117,212,49890,35559
47,5,0,2,1,0,0,3,232,221,47662,37013,257,402,49890,35562
48,5,1,1,2,1,2,1,2,6,47663,37014,1,107,49891,35563
49,5,1,1,2,1,2,1,605,138,47664,37015,509,223,49892,35564
50,6,1,0,0,3,1,0,150,160,47665,37015,181,223,49895,35564
51,6,0,2,1,0,0,3,224,197,47665,37017,230,321,49895,35567
52,6,0,1,1,0,0,3,564,167,47665,37018,478,9,49895,35570
53,6,1,0,0,3,1,0,225,180,47666,37018,269,415,49898,35570
54,6,0,0,2,1,2,1,158,140,47666,37018,170,95,49899,35571
55,6,2,0,0,3,1,0,294,194,47668,37018,343,149,49902,35571
56,6,2,1,0,3,1,0,293,179,47670,37019,318,242,49905,35571
57,6,0,2,1,0,0,3,80,85,47670,37021,117,40,49905,35574
58,6,2,2,2,1,2,1,26,34,47672,37023,23,64,49906,35575
59,6,0,3,1,0,0,3,212,211,47672,37026,224,211,49906,35578
60,7,2,1,0,3,1,0,34,47,47674,37027,51,242,49909,35578
61,7,1,3,1,0,0,3,606,141,47675,37030,509,405,49909,35581
62,7,1,0,0,3,1,0,142,143,47676,37030,168,212,49912,35581
63,7,0,1,1,0,0,3,362,201,47676,37031,395,110,49912,35584
64,7,2,0,0,3,1,0,377,121,47678,37031,443,148,49915,35584
65,7,0,2,1,0,0,3,86,90,47678,37033,101,81,49915,35587
66,7,0,0,2,1,2,1,2,6,47678,37033,2,212,49916,35588
67,7,0,1,1,0,0,3,225,181,47678,37034,269,110,49916,35591
68,7,4,1,0,3,1,0,326,215,47682,37035,333,15,49919,35591
69,7,1,1,2,1,2,1,233,222,47683,37036,258,145,49920,35592
70,8,0,2,1,0,0,3,158,142,47683,37038,170,12,49920,35595
71,8,4,1,0,3,1,0,568,168,47687,37039,481,15,49923,35595
72,8,2,1,0,3,1,0,296,195,47689,37040,346,223,49926,35595
73,8,1,3,1,0,0,3,143,146,47690,37043,168,324,49926,35598
74,8,1,1,2,1,2,1,81,86,47691,37044,118,416,49927,35599
75,8,3,1,0,3,1,0,215,212,47694,37045,227,40,49930,35599
76,8,1,4,1,0,0,3,225,201,47695,37049,230,214,49930,35602
77,8,1,1,2,1,2,1,151,161,47696,37050,182,150,49931,35603
78,8,2,2,2,1,2,1,346,206,47698,37052,366,163,49932,35604
79,8,2,0,0,3,1,0,295,179,47700,37052,321,64,49935,35604
80,9,1,1,2,1,2,1,35,48,47701,37053,52,146,49936,35605
81,9,1,1,2,1,2,1,27,35,47702,37054,24,111,49937,35606
82,9,5,2,0,3,1,0,611,143,47707,37056,512,148,49940,35606
83,9,1,0,0,3,1,0,363,201,47708,37056,398,95,49943,35606
84,9,4,0,0,3,1,0,381,121,47712,37056,446,12,49946,35606
85,9,1,3,1,0,0,3,226,184,47713,37059,269,215,49946,35609
86,9,2,0,0,3,1,0,328,215,47715,37059,336,110,49949,35609
87,9,1,1,2,1,2,1,234,223,47716,37060,259,82,49950,35610
88,9,2,1,0,3,1,0,88,91,47718,37061,104,212,49953,35610
89,9,4,1,0,3,1,0,350,207,47722,37062,369,405,49956,35610
90,10,1,1,2,1,2,1,144,147,47723,37063,169,16,49957,35611
91,10,1,1,2,1,2,1,235,224,47724,37064,260,41,49958,35612
92,10,1,1,2,1,2,1,296,180,47725,37065,322,406,49959,35613
93,10,4,2,0,3,1,0,367,203,47729,37067,401,146,49962,35613
94,10,1,0,0,3,1,0,382,121,47730,37067,449,416,49965,35613
95,10,0,0,2,1,2,1,158,142,47730,37067,171,164,49966,35614
96,10,0,1,1,0,0,3,2,7,47730,37068,2,217,49966,35617
97,10,1,3,1,0,0,3,152,164,47731,37071,182,67,49966,35620
98,10,2,2,2,1,2,1,83,88,47733,37073,119,243,49967,35621
99,10,4,0,0,3,1,0,300,195,47737,37073,349,148,49970,35621
100,11,1,1,2,1,2,1,89,92,47738,37074,105,151,49971,35622
101,11,1,1,2,1,2,1,36,49,47739,37075,53,13,49972,35623
102,11,0,1,1,0,0,3,350,208,47739,37076,369,327,49972,35626
103,11,0,1,1,0,0,3,27,36,47739,37077,24,226,49972,35629
104,11,1,2,1,0,0,3,569,170,47740,37079,481,85,49972,35632
105,11,4,0,0,3,1,0,615,143,47744,37079,515,95,49975,35632
106,11,1,1,2,1,2,1,227,185,47745,37080,270,213,49976,35633
107,11,3,1,0,3,1,0,228,202,47748,37081,233,110,49979,35633
108,11,1,1,2,1,2,1,329,216,47749,37082,337,216,49980,35634
109,11,0,2,1,0,0,3,215,214,47749,37084,227,114,49980,35637
110,12,0,2,1,0,0,3,300,197,47749,37086,349,149,49980,35640
111,12,3,0,0,3,1,0,238,224,47752,37086,263,164,49983,35640
112,12,0,1,1,0,0,3,367,204,47752,37087,401,409,49983,35643
113,12,2,0,0,3,1,0,384,121,47754,37087,452,67,49986,35643
114,12,2,1,0,3,1,0,4,8,47756,37088,5,416,49989,35643
115,12,3,3,2,1,2,1,155,167,47759,37091,183,17,49990,35644
116,12,0,2,1,0,0,3,144,149,47759,37093,169,151,49990,35647
117,12,0,0,2,1,2,1,296,180,47759,37093,323,42,49991,35648
118,12,0,0,2,1,2,1,83,88,47759,37093,120,218,49992,35649
119,12,0,0,2,1,2,1,158,142,47759,37093,172,244,49993,35650
120,13,3,2,0,3,1,0,92,94,47762,37095,108,95,49996,35650
121,13,2,2,2,1,2,1,352,210,47764,37097,370,214,49997,35651
122,13,0,1,1,0,0,3,227,186,47764,37098,270,229,49997,35654
123,13,1,0,0,3,1,0,28,36,47765,37098,27,85,50000,35654
124,13,2,0,0,3,1,0,571,170,47767,37098,484,327,50003,35654
125,13,1,1,2,1,2,1,330,217,47768,37099,338,115,50004,35655
126,13,1,1,2,1,2,1,216,215,47769,37100,228,217,50005,35656
127,13,0,1,1,0,0,3,36,50,47769,37101,53,113,50005,35659
128,13,1,0,0,3,1,0,616,143,47770,37101,518,151,50008,35659
129,13,4,0,0,3,1,0,232,202,47774,37101,236,13,50011,35659
130,14,2,0,0,3,1,0,302,197,47776,37101,352,17,50014,35659
131,14,3,1,0,3,1,0,387,122,47779,37102,455,42,50017,35659
132,14,2,2,2,1,2,1,618,145,47781,37104,519,245,50018,35660
133,14,2,1,0,3,1,0,240,225,47783,37105,266,218,50021,35660
134,14,1,3,1,0,0,3,145,152,47784,37108,169,220,50021,35663
135,14,1,1,2,1,2,1,368,205,47785,37109,402,68,50022,35664
136,14,2,0,0,3,1,0,234,202,47787,37109,239,85,50025,35664
137,14,2,0,0,3,1,0,157,167,47789,37109,186,151,50028,35664
138,14,0,2,1,0,0,3,4,10,47789,37111,5,167,50028,35667
139,14,1,3,1,0,0,3,159,145,47790,37114,172,412,50028,35670
140,15,0,1,1,0,0,3,352,211,47790,37115,370,232,50028,35673
141,15,2,2,2,1,2,1,38,52,47792,37117,54,96,50029,35674
142,15,1,1,2,1,2,1,29,37,47793,37118,28,152,50030,35675
143,15,0,2,1,0,0,3,330,219,47793,37120,338,330,50030,35678
144,15,0,3,1,0,0,3,92,97,47793,37123,108,419,50030,35681
145,15,1,1,2,1,2,1,297,181,47794,37124,324,215,50031,35682
146,15,1,1,2,1,2,1,228,187,47795,37125,271,150,50032,35683
147,15,2,0,0,3,1,0,573,170,47797,37125,487,113,50035,35683
148,15,2,1,0,3,1,0,85,89,47799,37126,123,115,50038,35683
149,15,1,0,0,3,1,0,217,215,47800,37126,231,13,50041,35683
150,16,2,0,0,3,1,0,370,205,47802,37126,405,220,50044,35683
151,16,1,1,2,1,2,1,619,146,47803,37127,520,116,50045,35684
152,16,0,0,2,1,2,1,4,10,47803,37127,6,69,50046,35685
153,16,4,3,0,3,1,0,244,228,47807,37130,269,151,50049,35685
154,16,2,1,0,3,1,0,159,168,47809,37131,189,245,50052,35685
155,16,1,0,0,3,1,0,388,122,47810,37131,458,167,50055,35685
156,16,2,1,0,3,1,0,236,203,47812,37132,242,17,50058,35685
157,16,1,1,2,1,2,1,39,53,47813,37133,55,413,50059,35686
158,16,0,1,1,0,0,3,302,198,47813,37134,352,221,50059,35689
159,16,1,1,2,1,2,1,146,153,47814,37135,170,86,50060,35690
160,17,2,1,0,3,1,0,299,182,47816,37136,327,152,50063,35690
161,17,1,1,2,1,2,1,218,216,47817,37137,232,233,50064,35691
162,17,0,1,1,0,0,3,228,188,47817,37138,271,72,50064,35694
163,17,2,0,0,3,1,0,575,170,47819,37138,490,150,50067,35694
164,17,1,0,0,3,1,0,303,198,47820,37138,355,42,50070,35694
165,17,1,2,1,0,0,3,86,91,47821,37140,123,333,50070,35697
166,17,2,0,0,3,1,0,161,145,47823,37140,175,113,50073,35697
167,17,1,1,2,1,2,1,331,220,47824,37141,339,97,50074,35698
168,17,0,1,1,0,0,3,29,38,47824,37142,28,422,50074,35701
169,17,1,1,2,1,2,1,353,212,47825,37143,371,14,50075,35702
170,18,0,4,1,0,0,3,236,207,47825,37147,242,223,50075,35705
171,18,3,2,0,3,1,0,373,207,47828,37149,408,221,50078,35705
172,18,0,4,1,0,0,3,159,172,47828,37153,189,425,50078,35708
173,18,0,0,2,1,2,1,146,153,47828,37153,171,414,50079,35709
174,18,2,1,0,3,1,0,246,229,47830,37154,272,116,50082,35709
175,18,3,1,0,3,1,0,7,11,47833,37155,9,86,50085,35709
176,18,0,1,1,0,0,3,92,98,47833,37156,108,248,50085,35712
177,18,1,3,1,0,0,3,40,56,47834,37159,55,170,50085,35715
178,18,0,2,1,0,0,3,29,40,47834,37161,28,154,50085,35718
179,18,2,1,0,3,1,0,390,123,47836,37162,461,215,50088,35718
180,19,3,1,0,3,1,0,578,171,47839,37163,493,215,50091,35718
181,19,2,1,0,3,1,0,621,147,47841,37164,523,221,50094,35718
182,19,2,2,2,1,2,1,9,13,47843,37166,10,153,50095,35719
183,19,2,2,2,1,2,1,94,100,47845,37168,109,43,50096,35720
184,19,1,2,1,0,0,3,87,93,47846,37170,123,236,50096,35723
185,19,1,0,0,3,1,0,229,188,47847,37170,274,17,50099,35723
186,19,2,1,0,3,1,0,220,217,47849,37171,235,150,50102,35723
187,19,2,2,2,1,2,1,301,184,47851,37173,328,114,50103,35724
188,19,1,1,2,1,2,1,354,213,47852,37174,372,98,50104,35725
189,19,1,2,1,0,0,3,162,147,47853,37176,175,336,50104,35728
190,20,2,2,2,1,2,1,248,231,47855,37178,273,73,50105,35729
191,20,0,0,2,1,2,1,29,40,47855,37178,29,224,50106,35730
192,20,3,0,0,3,1,0,376,207,47858,37178,411,14,50109,35730
193,20,2,2,2,1,2,1,333,222,47860,37180,340,155,50110,35731
194,20,1,4,1,0,0,3,88,97,47861,37184,123,417,50110,35734
195,20,3,1,0,3,1,0,149,154,47864,37185,174,114,50113,35734
196,20,0,2,1,0,0,3,40,58,47864,37187,55,428,50113,35737
197,20,1,1,2,1,2,1,237,208,47865,37188,243,117,50114,35738
198,20,3,1,0,3,1,0,393,124,47868,37189,464,248,50117,35738
199,20,5,1,0,3,1,0,308,199,47873,37190,358,170,50120,35738
200,21,1,3,1,0,0,3,95,103,47874,37193,109,20,50120,35741
201,21,0,2,1,0,0,3,162,149,47874,37195,175,239,50120,35744
202,21,1,2,1,0,0,3,579,173,47875,37197,493,156,50120,35747
203,21,1,0,0,3,1,0,355,213,47876,37197,375,43,50123,35747
204,21,1,1,2,1,2,1,302,185,47877,37198,329,222,50124,35748
205,21,0,0,2,1,2,1,229,188,47877,37198,275,87,50125,35749
206,21,2,4,1,0,0,3,11,17,47879,37202,10,339,50125,35752
207,21,0,0,2,1,2,1,159,172,47879,37202,190,151,50126,35753
208,21,2,1,0,3,1,0,623,148,47881,37203,526,215,50129,35753
209,21,1,0,0,3,1,0,221,217,47882,37203,238,98,50132,35753
210,22,1,0,0,3,1,0,89,97,47883,37203,126,73,50135,35753
211,22,2,2,2,1,2,1,250,233,47885,37205,274,115,50136,35754
212,22,1,2,1,0,0,3,30,42,47886,37207,29,420,50136,35757
213,22,2,2,2,1,2,1,42,60,47888,37209,56,225,50137,35758
214,22,3,0,0,3,1,0,379,207,47891,37209,414,170,50140,35758
215,22,4,1,0,3,1,0,337,223,47895,37210,343,14,50143,35758
216,22,1,1,2,1,2,1,309,200,47896,37211,359,249,50144,35759
217,22,2,1,0,3,1,0,151,155,47898,37212,177,117,50147,35759
218,22,2,3,1,0,0,3,223,220,47900,37215,238,431,50147,35762
219,22,2,2,2,1,2,1,395,126,47902,37217,465,152,50148,35763
220,23,3,1,0,3,1,0,240,209,47905,37218,246,43,50151,35763
221,23,1,2,1,0,0,3,160,174,47906,37220,190,342,50151,35766
222,23,1,0,0,3,1,0,380,207,47907,37220,417,20,50154,35766
223,23,1,1,2,1,2,1,163,150,47908,37221,176,74,50155,35767
224,23,5,1,0,3,1,0,628,149,47913,37222,529,87,50158,35767
225,23,0,1,1,0,0,3,229,189,47913,37223,275,225,50158,35770
226,23,2,0,0,3,1,0,581,173,47915,37223,496,249,50161,35770
227,23,0,1,1,0,0,3,250,234,47915,37224,274,101,50161,35773
228,23,1,2,1,0,0,3,303,187,47916,37226,329,158,50161,35776
229,23,0,4,1,0,0,3,11,21,47916,37230,10,218,50161,35779
230,24,1,0,0,3,1,0,224,220,47917,37230,241,170,50164,35779
231,24,1,0,0,3,1,0,43,60,47918,37230,59,117,50167,35779
232,24,0,2,1,0,0,3,395,128,47918,37232,465,159,50167,35782
233,24,2,0,0,3,1,0,357,213,47920,37232,378,152,50170,35782
234,24,0,1,1,0,0,3,95,104,47920,37233,109,423,50170,35785
235,24,1,1,2,1,2,1,629,150,47921,37234,530,15,50171,35786
236,24,4,0,0,3,1,0,341,223,47925,37234,346,87,50174,35786
237,24,3,2,0,3,1,0,33,44,47928,37236,32,115,50177,35786
238,24,1,1,2,1,2,1,310,201,47929,37237,360,226,50178,35787
239,24,0,2,1,0,0,3,151,157,47929,37239,177,242,50178,35790
240,25,1,1,2,1,2,1,251,235,47930,37240,275,219,50179,35791
241,25,1,1,2,1,2,1,164,151,47931,37241,177,21,50180,35792
242,25,0,2,1,0,0,3,380,209,47931,37243,417,434,50180,35795
243,25,0,1,1,0,0,3,89,98,47931,37244,126,104,50180,35798
244,25,3,0,0,3,1,0,232,189,47934,37244,278,249,50183,35798
245,25,1,1,2,1,2,1,241,210,47935,37245,247,75,50184,35799
246,25,0,1,1,0,0,3,11,22,47935,37246,10,161,50184,35802
247,25,2,1,0,3,1,0,162,175,47937,37247,193,43,50187,35802
248,25,0,2,1,0,0,3,303,189,47937,37249,329,345,50187,35805
249,25,1,1,2,1,2,1,582,174,47938,37250,497,226,50188,35806
250,26,2,1,0,3,1,0,359,214,47940,37251,381,226,50191,35806
251,26,2,1,0,3,1,0,97,105,47942,37252,112,170,50194,35806
252,26,2,1,0,3,1,0,45,61,47944,37253,62,242,50197,35806
253,26,1,0,0,3,1,0,12,22,47945,37253,13,117,50200,35806
254,26,0,2,1,0,0,3,151,159,47945,37255,177,437,50200,35809
255,26,3,4,1,0,0,3,36,48,47948,37259,32,155,50200,35812
256,26,1,1,2,1,2,1,396,129,47949,37260,466,424,50201,35813
257,26,1,0,0,3,1,0,342,223,47950,37260,349,159,50204,35813
258,26,2,1,0,3,1,0,312,202,47952,37261,363,115,50207,35813
259,26,3,2,0,3,1,0,227,222,47955,37263,244,87,50210,35813
260,27,1,0,0,3,1,0,252,235,47956,37263,278,249,50213,35813
261,27,1,1,2,1,2,1,90,99,47957,37264,127,16,50214,35814
262,27,2,1,0,3,1,0,584,175,47959,37265,500,43,50217,35814
263,27,0,0,2,1,2,1,151,159,47959,37265,178,76,50218,35815
264,27,0,0,2,1,2,1,232,189,47959,37265,279,346,50219,35816
265,27,0,0,2,1,2,1,241,210,47959,37265,248,220,50220,35817
266,27,1,0,0,3,1,0,163,175,47960,37265,196,226,50223,35817
267,27,1,3,1,0,0,3,165,154,47961,37268,177,229,50223,35820
268,27,1,0,0,3,1,0,381,209,47962,37268,420,161,50226,35820
269,27,4,1,0,3,1,0,633,151,47966,37269,533,21,50229,35820
270,28,2,0,0,3,1,0,229,222,47968,37269,247,159,50232,35820
271,28,1,1,2,1,2,1,313,203,47969,37270,364,118,50233,35821
272,28,1,3,1,0,0,3,242,213,47970,37273,248,427,50233,35824
273,28,0,0,2,1,2,1,36,48,47970,37273,33,105,50234,35825
274,28,1,1,2,1,2,1,98,106,47971,37274,113,243,50235,35826
275,28,1,1,2,1,2,1,233,190,47972,37275,280,44,50236,35827
276,28,2,1,0,3,1,0,361,215,47974,37276,384,115,50239,35827
277,28,2,1,0,3,1,0,305,190,47976,37277,332,16,50242,35827
278,28,1,0,0,3,1,0,397,129,47977,37277,469,87,50245,35827
279,28,1,6,1,0,0,3,343,229,47978,37283,349,440,50245,35830
280,29,0,2,1,0,0,3,252,237,47978,37285,278,24,50245,35833
281,29,0,3,1,0,0,3,163,178,47978,37288,196,232,50245,35836
282,29,2,0,0,3,1,0,586,175,47980,37288,503,118,50248,35836
283,29,0,0,2,1,2,1,151,159,47980,37288,179,171,50249,35837
284,29,1,3,1,0,0,3,91,102,47981,37291,127,158,50249,35840
285,29,1,1,2,1,2,1,46,62,47982,37292,63,162,50250,35841
286,29,2,1,0,3,1,0,14,23,47984,37293,16,249,50253,35841
287,29,1,0,0,3,1,0,382,209,47985,37293,423,346,50256,35841
288,29,1,0,0,3,1,0,634,151,47986,37293,536,76,50259,35841
289,29,1,1,2,1,2,1,344,230,47987,37294,350,221,50260,35842
290,30,3,1,0,3,1,0,39,49,47990,37295,36,44,50263,35842
291,30,0,1,1,0,0,3,233,191,47990,37296,280,19,50263,35845
292,30,0,0,2,1,2,1,313,203,47990,37296,365,88,50264,35846
293,30,0,1,1,0,0,3,165,155,47990,37297,177,162,50264,35849
294,30,2,1,0,3,1,0,588,176,47992,37298,506,440,50267,35849
295,30,1,2,1,0,0,3,306,192,47993,37300,332,108,50267,35852
296,30,2,2,2,1,2,1,363,217,47995,37302,385,227,50268,35853
297,30,1,2,1,0,0,3,99,108,47996,37304,113,118,50268,35856
298,30,1,1,2,1,2,1,230,223,47997,37305,248,347,50269,35857
299,30,3,4,1,0,0,3,245,217,48000,37309,248,246,50269,35860
0,1,3,0,0,3,1,0,102,108,48003,37309,116,0,50272,35860
1,1,1,2,1,0,0,3,246,219,48004,37311,248,3,50272,35863
2,1,4,2,0,3,1,0,47,52,48008,37313,45,0,50275,35863
3,1,3,2,0,3,1,0,76,82,48011,37315,79,0,50278,35863
4,1,0,0,2,1,2,1,0,0,48011,37315,1,25,50279,35864
5,1,1,0,0,3,1,0,47,62,48012,37315,66,0,50282,35864
6,1,3,2,0,3,1,0,167,180,48015,37317,157,0,50285,35864
7,1,1,1,2,1,2,1,1,1,48016,37318,1,12,50286,35865
8,1,1,1,2,1,2,1,1,1,48017,37319,1,1,50287,35866
9,1,1,4,1,0,0,3,1,4,48018,37323,0,3,50287,35869
10,1,4,1,0,3,1,0,234,224,48022,37324,251,118,50290,35869
11,2,0,1,1,0,0,3,0,1,48022,37325,0,47,50290,35872
12,2,2,0,0,3,1,0,2,0,48024,37325,3,46,50293,35872
13,2,0,0,2,1,2,1,39,49,48024,37325,37,30,50294,35873
14,2,1,0,0,3,1,0,1,0,48025,37325,3,0,50297,35873
15,2,1,3,1,0,0,3,1,3,48026,37328,0,165,50297,35876
16,2,2,3,1,0,0,3,14,36,48028,37331,9,110,50297,35879
17,2,2,0,0,3,1,0,2,0,48030,37331,3,0,50300,35879
18,2,1,3,1,0,0,3,1,3,48031,37334,0,161,50300,35882
19,2,0,1,1,0,0,3,163,179,48031,37335,196,79,50300,35885
20,2,1,2,1,0,0,3,1,2,48032,37337,0,3,50300,35888
21,2,2,1,0,3,1,0,2,1,48034,37338,3,0,50303,35888
22,3,1,0,0,3,1,0,2,1,48035,37338,4,0,50306,35888
23,3,3,2,0,3,1,0,249,221,48038,37340,251,12,50309,35888
24,3,1,0,0,3,1,0,168,180,48039,37340,160,0,50312,35888
25,3,1,5,1,0,0,3,1,5,48040,37345,1,3,50312,35891
26,3,0,2,1,0,0,3,47,64,48040,37347,66,168,50312,35894
27,3,5,1,0,3,1,0,5,2,48045,37348,3,3,50315,35894
28,3,4,1,0,3,1,0,80,83,48049,37349,82,1,50318,35894
29,3,2,1,0,3,1,0,3,2,48051,37350,4,118,50321,35894
30,3,4,0,0,3,1,0,106,108,48055,37350,119,0,50324,35894
31,3,3,1,0,3,1,0,50,53,48058,37351,48,25,50327,35894
32,3,1,0,0,3,1,0,2,4,48059,37351,3,0,50330,35894
33,4,0,3,1,0,0,3,1,3,48059,37354,3,33,50330,35897
34,4,2,0,0,3,1,0,4,1,48061,37354,6,47,50333,35897
35,4,2,0,0,3,1,0,3,3,48063,37354,3,3,50336,35897
36,4,0,2,1,0,0,3,14,38,48063,37356,9,3,50336,35900
37,4,0,2,1,0,0,3,1,4,48063,37358,0,164,50336,35903
38,4,0,1,1,0,0,3,39,50,48063,37359,37,6,50336,35906
39,4,3,1,0,3,1,0,5,1,48066,37360,6,46,50339,35906
40,4,2,1,0,3,1,0,236,225,48068,37361,254,79,50342,35906
41,4,0,1,1,0,0,3,2,1,48068,37362,3,113,50342,35909
42,4,2,0,0,3,1,0,165,179,48070,37362,199,0,50345,35909
43,4,0,0,2,1,2,1,1,3,48070,37362,1,1,50346,35910
44,5,2,0,0,3,1,0,4,4,48072,37362,6,0,50349,35910
45,5,2,1,0,3,1,0,5,3,48074,37363,7,168,50352,35910
46,5,1,2,1,0,0,3,6,4,48075,37365,3,15,50352,35913
47,5,4,0,0,3,1,0,172,180,48079,37365,163,25,50355,35913
48,5,2,3,1,0,0,3,52,56,48081,37368,48,6,50355,35916
49,5,1,1,2,1,2,1,81,84,48082,37369,83,119,50356,35917
50,5,2,2,2,1,2,1,49,66,48084,37371,67,80,50357,35918
51,5,1,0,0,3,1,0,5,1,48085,37371,9,0,50360,35918
52,5,1,0,0,3,1,0,250,221,48086,37371,254,0,50363,35918
53,5,1,1,2,1,2,1,3,2,48087,37372,5,2,50364,35919
54,5,1,1,2,1,2,1,2,6,48088,37373,2,1,50365,35920
55,6,0,1,1,0,0,3,1,4,48088,37374,3,9,50365,35923
56,6,3,0,0,3,1,0,239,225,48091,37374,257,0,50368,35923
57,6,0,2,1,0,0,3,2,3,48091,37376,3,6,50368,35926
58,6,1,2,1,0,0,3,40,52,48092,37378,37,167,50368,35929
59,6,1,1,2,1,2,1,2,4,48093,37379,2,34,50369,35930
60,6,2,0,0,3,1,0,7,1,48095,37379,9,113,50372,35930
61,6,2,0,0,3,1,0,5,3,48097,37379,6,47,50375,35930
62,6,2,0,0,3,1,0,16,38,48099,37379,12,3,50378,35930
63,6,2,1,0,3,1,0,167,180,48101,37380,202,46,50381,35930
64,6,1,1,2,1,2,1,2,5,48102,37381,1,4,50382,35931
65,6,1,1,2,1,2,1,107,109,48103,37382,120,2,50383,35932
66,7,3,0,0,3,1,0,175,180,48106,37382,166,6,50386,35932
67,7,2,2,2,1,2,1,8,6,48108,37384,4,1,50387,35933
68,7,2,2,2,1,2,1,83,86,48110,37386,84,169,50388,35934
69,7,1,0,0,3,1,0,50,66,48111,37386,70,2,50391,35934
70,7,3,0,0,3,1,0,253,221,48114,37386,257,2,50394,35934
71,7,1,1,2,1,2,1,6,4,48115,37387,7,16,50395,35935
72,7,1,3,1,0,0,3,5,7,48116,37390,6,28,50395,35938
73,7,1,2,1,0,0,3,4,4,48117,37392,5,122,50395,35941
74,7,0,0,2,1,2,1,52,56,48117,37392,49,2,50396,35942
75,7,1,1,2,1,2,1,3,7,48118,37393,3,81,50397,35943
76,7,3,1,0,3,1,0,8,2,48121,37394,12,0,50400,35943
77,8,0,2,1,0,0,3,2,6,48121,37396,2,12,50400,35946
78,8,2,1,0,3,1,0,241,226,48123,37397,260,46,50403,35946
79,8,1,1,2,1,2,1,3,4,48124,37398,4,4,50404,35947
80,8,0,0,2,1,2,1,40,52,48124,37398,38,5,50405,35948
81,8,3,1,0,3,1,0,10,2,48127,37399,12,6,50408,35948
82,8,2,2,2,1,2,1,3,6,48129,37401,4,168,50409,35949
83,8,0,1,1,0,0,3,5,4,48129,37402,7,3,50409,35952
84,8,1,1,2,1,2,1,168,181,48130,37403,203,114,50410,35953
85,8,0,0,2,1,2,1,16,38,48130,37403,13,48,50411,35954
86,8,3,0,0,3,1,0,110,109,48133,37403,123,34,50414,35954
87,8,1,1,2,1,2,1,3,6,48134,37404,2,1,50415,35955
88,9,3,1,0,3,1,0,8,8,48137,37405,9,6,50418,35955
89,9,0,0,2,1,2,1,175,180,48137,37405,167,3,50419,35956
90,9,2,2,2,1,2,1,18,40,48139,37407,14,1,50420,35957
91,9,0,1,1,0,0,3,8,3,48139,37408,12,31,50420,35960
92,9,1,0,0,3,1,0,9,6,48140,37408,7,2,50423,35960
93,9,1,1,2,1,2,1,254,222,48141,37409,258,123,50424,35961
94,9,2,0,0,3,1,0,54,56,48143,37409,52,81,50427,35961
95,9,2,0,0,3,1,0,52,66,48145,37409,73,3,50430,35961
96,9,2,1,0,3,1,0,85,87,48147,37410,87,2,50433,35961
97,9,0,3,1,0,0,3,4,7,48147,37413,5,172,50433,35964
98,9,1,0,0,3,1,0,7,4,48148,37413,10,1,50436,35964
99,10,1,1,2,1,2,1,3,7,48149,37414,3,169,50437,35965
100,10,1,0,0,3,1,0,111,109,48150,37414,126,12,50440,35965
101,10,0,0,2,1,2,1,40,52,48150,37414,39,2,50441,35966
102,10,2,0,0,3,1,0,5,6,48152,37414,7,5,50444,35966
103,10,5,0,0,3,1,0,173,181,48157,37414,206,6,50447,35966
104,10,1,1,2,1,2,1,6,5,48158,37415,8,47,50448,35967
105,10,3,2,0,3,1,0,6,9,48161,37417,6,34,50451,35967
106,10,4,0,0,3,1,0,245,226,48165,37417,263,114,50454,35967
107,10,1,3,1,0,0,3,11,5,48166,37420,12,7,50454,35970
108,10,1,1,2,1,2,1,4,5,48167,37421,5,17,50455,35971
109,10,1,0,0,3,1,0,4,6,48168,37421,5,48,50458,35971
110,11,2,2,2,1,2,1,54,68,48170,37423,74,35,50459,35972
111,11,2,1,0,3,1,0,9,5,48172,37424,13,2,50462,35972
112,11,2,0,0,3,1,0,20,40,48174,37424,17,31,50465,35972
113,11,4,1,0,3,1,0,12,4,48178,37425,15,6,50468,35972
114,11,2,1,0,3,1,0,11,7,48180,37426,10,123,50471,35972
115,11,3,0,0,3,1,0,178,180,48183,37426,170,81,50474,35972
116,11,3,0,0,3,1,0,57,56,48186,37426,55,3,50477,35972
117,11,1,1,2,1,2,1,9,9,48187,37427,10,4,50478,35973
118,11,1,0,0,3,1,0,5,7,48188,37427,8,2,50481,35973
119,11,1,1,2,1,2,1,255,223,48189,37428,259,173,50482,35974
120,11,0,2,1,0,0,3,4,8,48189,37430,5,4,50482,35977
121,12,1,0,0,3,1,0,6,6,48190,37430,10,2,50485,35977
122,12,4,1,0,3,1,0,177,182,48194,37431,209,7,50488,35977
123,12,0,0,2,1,2,1,4,5,48194,37431,6,49,50489,35978
124,12,0,0,2,1,2,1,40,52,48194,37431,40,2,50490,35979
125,12,3,1,0,3,1,0,248,227,48197,37432,266,6,50493,35979
126,12,1,1,2,1,2,1,7,6,48198,37433,9,115,50494,35980
127,12,1,1,2,1,2,1,86,88,48199,37434,88,48,50495,35981
128,12,3,2,0,3,1,0,114,111,48202,37436,129,169,50498,35981
129,12,3,0,0,3,1,0,6,7,48205,37436,6,5,50501,35981
130,12,3,2,0,3,1,0,9,11,48208,37438,9,12,50504,35981
131,12,2,1,0,3,1,0,13,6,48210,37439,15,17,50507,35981
132,13,1,1,2,1,2,1,13,5,48211,37440,16,5,50508,35982
133,13,4,2,0,3,1,0,9,9,48215,37442,11,35,50511,35982
134,13,0,0,2,1,2,1,4,5,48215,37442,7,32,50512,35983
135,13,2,1,0,3,1,0,13,8,48217,37443,13,173,50515,35983
136,13,3,1,0,3,1,0,181,181,48220,37444,173,3,50518,35983
137,13,0,0,2,1,2,1,54,68,48220,37444,75,49,50519,35984
138,13,4,0,0,3,1,0,13,9,48224,37444,13,81,50522,35984
139,13,0,0,2,1,2,1,20,40,48224,37444,18,7,50523,35985
140,13,3,2,0,3,1,0,12,7,48227,37446,16,123,50526,35985
141,13,3,1,0,3,1,0,258,224,48230,37447,262,2,50529,35985
142,13,1,0,0,3,1,0,5,8,48231,37447,8,2,50532,35985
143,14,0,0,2,1,2,1,9,11,48231,37447,10,170,50533,35986
144,14,2,2,2,1,2,1,42,54,48233,37449,41,50,50534,35987
145,14,1,1,2,1,2,1,8,7,48234,37450,10,7,50535,35988
146,14,2,1,0,3,1,0,88,89,48236,37451,91,115,50538,35988
147,14,1,1,2,1,2,1,58,57,48237,37452,56,13,50539,35989
148,14,1,1,2,1,2,1,14,7,48238,37453,16,5,50540,35990
149,14,1,1,2,1,2,1,178,183,48239,37454,210,18,50541,35991
150,14,0,2,1,0,0,3,6,8,48239,37456,10,5,50541,35994
151,14,1,0,0,3,1,0,7,7,48240,37456,9,2,50544,35994
152,14,0,1,1,0,0,3,114,112,48240,37457,129,8,50544,35997
153,14,2,2,2,1,2,1,250,229,48242,37459,267,8,50545,35998
154,15,0,0,2,1,2,1,13,9,48242,37459,14,4,50546,35999
155,15,1,2,1,0,0,3,13,9,48243,37461,16,176,50546,36002
156,15,3,1,0,3,1,0,45,55,48246,37462,44,2,50549,36002
157,15,1,2,1,0,0,3,5,7,48247,37464,7,10,50549,36005
158,15,3,3,2,1,2,1,23,43,48250,37467,19,6,50550,36006
159,15,0,0,2,1,2,1,13,5,48250,37467,17,82,50551,36007
160,15,1,1,2,1,2,1,14,9,48251,37468,14,3,50552,36008
161,15,2,0,0,3,1,0,260,224,48253,37468,265,35,50555,36008
162,15,2,0,0,3,1,0,183,181,48255,37468,176,49,50558,36008
163,15,3,1,0,3,1,0,57,69,48258,37469,78,13,50561,36008
164,15,2,2,2,1,2,1,7,10,48260,37471,9,124,50562,36009
165,16,1,2,1,0,0,3,10,13,48261,37473,10,11,50562,36012
166,16,4,5,1,0,0,3,118,117,48265,37478,129,5,50562,36015
167,16,0,1,1,0,0,3,14,8,48265,37479,16,53,50562,36018
168,16,1,1,2,1,2,1,7,9,48266,37480,11,33,50563,36019
169,16,3,1,0,3,1,0,253,230,48269,37481,270,18,50566,36019
170,16,0,3,1,0,0,3,88,92,48269,37484,91,10,50566,36022
171,16,1,1,2,1,2,1,59,58,48270,37485,57,171,50567,36023
172,16,0,1,1,0,0,3,9,10,48270,37486,11,118,50567,36026
173,16,6,1,0,3,1,0,184,184,48276,37487,213,5,50570,36026
174,16,3,0,0,3,1,0,10,7,48279,37487,12,5,50573,36026
175,16,2,2,2,1,2,1,10,9,48281,37489,11,9,50574,36027
176,17,3,1,0,3,1,0,16,10,48284,37490,17,49,50577,36027
177,17,1,1,2,1,2,1,58,70,48285,37491,79,119,50578,36028
178,17,1,2,1,0,0,3,15,10,48286,37493,16,13,50578,36031
179,17,0,0,2,1,2,1,45,55,48286,37493,45,125,50579,36032
180,17,0,0,2,1,2,1,5,7,48286,37493,8,7,50580,36033
181,17,0,3,1,0,0,3,7,13,48286,37496,9,179,50580,36036
182,17,1,0,0,3,1,0,24,43,48287,37496,22,82,50583,36036
183,17,0,1,1,0,0,3,13,10,48287,37497,16,6,50583,36039
184,17,1,0,0,3,1,0,261,224,48288,37497,268,13,50586,36039
185,17,5,2,0,3,1,0,19,11,48293,37499,17,35,50589,36039
186,17,1,1,2,1,2,1,14,6,48294,37500,18,5,50590,36040
187,18,1,3,1,0,0,3,184,184,48295,37503,176,174,50590,36043
188,18,1,0,0,3,1,0,185,184,48296,37503,216,2,50593,36043
189,18,1,0,0,3,1,0,254,230,48297,37503,273,5,50596,36043
190,18,1,1,2,1,2,1,8,10,48298,37504,12,54,50597,36044
191,18,0,1,1,0,0,3,10,8,48298,37505,12,36,50597,36047
192,18,2,2,2,1,2,1,120,119,48300,37507,130,6,50598,36048
193,18,1,0,0,3,1,0,11,9,48301,37507,14,18,50601,36048
194,18,0,4,1,0,0,3,10,17,48301,37511,10,8,50601,36051
195,18,2,2,2,1,2,1,90,94,48303,37513,92,10,50602,36052
196,18,1,1,2,1,2,1,60,59,48304,37514,58,12,50603,36053
197,18,2,3,1,0,0,3,11,13,48306,37517,11,13,50603,36056
198,19,2,1,0,3,1,0,10,11,48308,37518,15,125,50606,36056
199,19,1,0,0,3,1,0,6,7,48309,37518,11,82,50609,36056
200,19,3,3,2,1,2,1,27,46,48312,37521,23,6,50610,36057
201,19,4,0,0,3,1,0,17,10,48316,37521,19,35,50613,36057
202,19,1,2,1,0,0,3,15,8,48317,37523,18,52,50613,36060
203,19,1,0,0,3,1,0,20,11,48318,37523,20,13,50616,36060
204,19,1,3,1,0,0,3,59,73,48319,37526,79,177,50616,36063
205,19,2,1,0,3,1,0,17,11,48321,37527,19,7,50619,36063
206,19,0,1,1,0,0,3,16,11,48321,37528,17,122,50619,36066
207,19,1,1,2,1,2,1,46,56,48322,37529,46,180,50620,36067
208,19,0,1,1,0,0,3,7,14,48322,37530,9,9,50620,36070
209,20,2,0,0,3,1,0,62,59,48324,37530,61,8,50623,36070
210,20,3,0,0,3,1,0,257,230,48327,37530,276,2,50626,36070
211,20,2,0,0,3,1,0,122,119,48329,37530,133,36,50629,36070
212,20,0,1,1,0,0,3,11,10,48329,37531,14,8,50629,36073
213,20,0,1,1,0,0,3,90,95,48329,37532,92,21,50629,36076
214,20,2,3,1,0,0,3,13,16,48331,37535,11,13,50629,36079
215,20,3,1,0,3,1,0,187,185,48334,37536,179,12,50632,36079
216,20,1,1,2,1,2,1,262,225,48335,37537,269,14,50633,36080
217,20,0,0,2,1,2,1,59,73,48335,37537,80,126,50634,36081
218,20,2,0,0,3,1,0,12,8,48337,37537,15,13,50637,36081
219,20,1,1,2,1,2,1,11,18,48338,37538,11,7,50638,36082
220,21,0,0,2,1,2,1,16,11,48338,37538,18,55,50639,36083
221,21,1,0,0,3,1,0,18,11,48339,37538,22,82,50642,36083
222,21,2,1,0,3,1,0,187,185,48341,37539,219,7,50645,36083
223,21,1,0,0,3,1,0,11,11,48342,37539,18,180,50648,36083
224,21,1,0,0,3,1,0,47,56,48343,37539,49,9,50651,36083
225,21,1,2,1,0,0,3,16,10,48344,37541,18,125,50651,36086
226,21,0,4,1,0,0,3,20,15,48344,37545,20,180,50651,36089
227,21,1,1,2,1,2,1,8,15,48345,37546,10,36,50652,36090
228,21,0,0,2,1,2,1,6,7,48345,37546,12,7,50653,36091
229,21,1,1,2,1,2,1,28,47,48346,37547,24,53,50654,36092
230,21,3,2,0,3,1,0,20,12,48349,37549,22,13,50657,36092
231,22,2,0,0,3,1,0,20,11,48351,37549,25,9,50660,36092
232,22,0,0,2,1,2,1,12,8,48351,37549,16,56,50661,36093
233,22,1,2,1,0,0,3,21,17,48352,37551,20,17,50661,36096
234,22,1,1,2,1,2,1,17,11,48353,37552,19,181,50662,36097
235,22,0,3,1,0,0,3,20,15,48353,37555,22,128,50662,36100
236,22,2,0,0,3,1,0,30,47,48355,37555,27,13,50665,36100
237,22,0,0,2,1,2,1,6,7,48355,37555,13,37,50666,36101
238,22,1,0,0,3,1,0,48,56,48356,37555,52,7,50669,36101
239,22,2,0,0,3,1,0,13,11,48358,37555,21,82,50672,36101
240,22,3,0,0,3,1,0,190,185,48361,37555,222,180,50675,36101
241,22,3,3,2,1,2,1,11,18,48364,37558,11,54,50676,36102
242,23,1,0,0,3,1,0,17,11,48365,37558,21,13,50679,36102
243,23,2,3,1,0,0,3,124,122,48367,37561,133,129,50679,36105
244,23,1,2,1,0,0,3,60,75,48368,37563,80,15,50679,36108
245,23,4,2,0,3,1,0,191,187,48372,37565,182,21,50682,36108
246,23,1,2,1,0,0,3,14,18,48373,37567,11,10,50682,36111
247,23,2,1,0,3,1,0,64,60,48375,37568,64,8,50685,36111
248,23,1,1,2,1,2,1,91,96,48376,37569,93,37,50686,36112
249,23,0,2,1,0,0,3,11,12,48376,37571,14,16,50686,36115
250,23,0,1,1,0,0,3,257,231,48376,37572,276,10,50686,36118
251,23,1,2,1,0,0,3,12,20,48377,37574,11,5,50686,36121
252,23,4,0,0,3,1,0,266,225,48381,37574,272,8,50689,36121
253,24,3,0,0,3,1,0,193,185,48384,37574,225,9,50692,36121
254,24,3,0,0,3,1,0,20,11,48387,37574,22,15,50695,36121
255,24,0,1,1,0,0,3,48,57,48387,37575,52,57,50695,36124
256,24,5,0,0,3,1,0,25,11,48392,37575,28,37,50698,36124
257,24,1,0,0,3,1,0,14,11,48393,37575,24,7,50701,36124
258,24,0,1,1,0,0,3,12,9,48393,37576,16,85,50701,36127
259,24,1,4,1,0,0,3,258,235,48394,37580,276,59,50701,36130
260,24,3,0,0,3,1,0,23,15,48397,37580,25,17,50704,36130
261,24,2,1,0,3,1,0,13,19,48399,37581,14,128,50707,36130
262,24,2,0,0,3,1,0,8,7,48401,37581,16,13,50710,36130
263,24,0,0,2,1,2,1,30,47,48401,37581,28,182,50711,36131
264,25,3,1,0,3,1,0,67,61,48404,37582,67,5,50714,36131
265,25,1,1,2,1,2,1,192,188,48405,37583,183,9,50715,36132
266,25,2,1,0,3,1,0,62,76,48407,37584,83,13,50718,36132
267,25,1,0,0,3,1,0,22,17,48408,37584,23,8,50721,36132
268,25,1,3,1,0,0,3,18,14,48409,37587,21,24,50721,36135
269,25,1,0,0,3,1,0,267,225,48410,37587,275,10,50724,36135
270,25,1,1,2,1,2,1,15,19,48411,37588,12,38,50725,36136
271,25,2,2,2,1,2,1,93,98,48413,37590,94,17,50726,36137
272,25,1,1,2,1,2,1,12,13,48414,37591,15,11,50727,36138
273,25,1,0,0,3,1,0,125,122,48415,37591,136,180,50730,36138
274,25,0,0,2,1,2,1,12,20,48415,37591,12,130,50731,36139
275,26,2,1,0,3,1,0,15,20,48417,37592,17,17,50734,36139
276,26,1,2,1,0,0,3,9,9,48418,37594,16,185,50734,36142
277,26,4,6,1,0,0,3,27,21,48422,37600,25,16,50734,36145
278,26,2,0,0,3,1,0,32,47,48424,37600,31,15,50737,36145
279,26,4,0,0,3,1,0,29,11,48428,37600,31,13,50740,36145
280,26,0,1,1,0,0,3,14,12,48428,37601,24,60,50740,36148
281,26,5,2,0,3,1,0,198,187,48433,37603,228,37,50743,36148
282,26,1,1,2,1,2,1,13,10,48434,37604,17,8,50744,36149
283,26,2,0,0,3,1,0,127,122,48436,37604,139,59,50747,36149
284,26,4,1,0,3,1,0,52,58,48440,37605,55,128,50750,36149
285,26,2,0,0,3,1,0,260,235,48442,37605,279,9,50753,36149
286,27,1,0,0,3,1,0,63,76,48443,37605,86,8,50756,36149
287,27,4,1,0,3,1,0,24,12,48447,37606,25,24,50759,36149
288,27,1,0,0,3,1,0,23,17,48448,37606,26,10,50762,36149
289,27,1,0,0,3,1,0,16,19,48449,37606,15,17,50765,36149
290,27,2,0,0,3,1,0,69,61,48451,37606,70,130,50768,36149
291,27,1,2,1,0,0,3,19,16,48452,37608,21,12,50768,36152
292,27,1,0,0,3,1,0,193,188,48453,37608,186,5,50771,36152
293,27,1,1,2,1,2,1,13,14,48454,37609,16,86,50772,36153
294,27,1,1,2,1,2,1,94,99,48455,37610,95,12,50773,36154
295,27,1,2,1,0,0,3,268,227,48456,37612,275,41,50773,36157
296,27,1,1,2,1,2,1,13,21,48457,37613,13,181,50774,36158
297,28,1,2,1,0,0,3,15,14,48458,37615,24,131,50774,36161
298,28,2,0,0,3,1,0,11,9,48460,37615,19,15,50777,36161
299,28,0,1,1,0,0,3,198,188,48460,37616,228,16,50777,36164
300,28,0,2,1,0,0,3,13,16,48460,37618,16,62,50777,36167
301,28,1,0,0,3,1,0,30,11,48461,37618,34,185,50780,36167
302,28,1,2,1,0,0,3,33,49,48462,37620,31,11,50780,36170
303,28,1,1,2,1,2,1,53,59,48463,37621,56,18,50781,36171
304,28,4,0,0,3,1,0,17,10,48467,37621,20,60,50784,36171
305,28,4,1,0,3,1,0,264,236,48471,37622,282,37,50787,36171
306,28,2,1,0,3,1,0,129,123,48473,37623,142,8,50790,36171
307,28,1,4,1,0,0,3,16,24,48474,37627,17,19,50790,36174
308,29,2,1,0,3,1,0,65,77,48476,37628,89,24,50793,36174
309,29,0,1,1,0,0,3,69,62,48476,37629,70,184,50793,36177
310,29,2,1,0,3,1,0,29,22,48478,37630,28,10,50796,36177
311,29,4,0,0,3,1,0,28,12,48482,37630,28,12,50799,36177
312,29,2,0,0,3,1,0,25,17,48484,37630,29,41,50802,36177
313,29,0,0,2,1,2,1,19,16,48484,37630,22,6,50803,36178
314,29,0,1,1,0,0,3,268,228,48484,37631,275,20,50803,36181
315,29,2,0,0,3,1,0,96,99,48486,37631,98,86,50806,36181
316,29,2,1,0,3,1,0,15,22,48488,37632,16,9,50809,36181
317,29,1,1,2,1,2,1,194,189,48489,37633,187,131,50810,36182
318,29,0,1,1,0,0,3,16,20,48489,37634,15,15,50810,36185
319,30,1,2,1,0,0,3,16,16,48490,37636,24,21,50810,36188
320,30,1,1,2,1,2,1,18,11,48491,37637,21,132,50811,36189
321,30,1,2,1,0,0,3,17,26,48492,37639,17,27,50811,36192
322,30,1,1,2,1,2,1,54,60,48493,37640,57,20,50812,36193
323,30,0,0,2,1,2,1,30,11,48493,37640,35,16,50813,36194
324,30,1,0,0,3,1,0,265,236,48494,37640,285,16,50816,36194
325,30,0,1,1,0,0,3,13,17,48494,37641,16,40,50816,36197
326,30,0,1,1,0,0,3,15,23,48494,37642,16,65,50816,36200
327,30,1,1,2,1,2,1,199,189,48495,37643,229,186,50817,36201
328,30,1,0,0,3,1,0,12,9,48496,37643,22,11,50820,36201
329,30,1,0,0,3,1,0,130,123,48497,37643,145,60,50823,36201
330,31,3,1,0,3,1,0,32,23,48500,37644,31,41,50826,36201
331,31,2,0,0,3,1,0,27,17,48502,37644,32,20,50829,36201
332,31,3,0,0,3,1,0,72,62,48505,37644,73,9,50832,36201
333,31,1,0,0,3,1,0,97,99,48506,37644,101,8,50835,36201
334,31,1,0,0,3,1,0,34,49,48507,37644,34,12,50838,36201
335,31,2,0,0,3,1,0,30,12,48509,37644,31,6,50841,36201
336,31,0,3,1,0,0,3,268,231,48509,37647,275,18,50841,36204
337,31,0,5,1,0,0,3,16,25,48509,37652,15,89,50841,36207
338,31,1,0,0,3,1,0,66,77,48510,37652,92,10,50844,36207
339,31,1,1,2,1,2,1,20,17,48511,37653,23,132,50845,36208
340,31,1,0,0,3,1,0,195,189,48512,37653,190,184,50848,36208
341,32,2,1,0,3,1,0,99,100,48514,37654,104,65,50851,36208
342,32,2,1,0,3,1,0,201,190,48516,37655,232,16,50854,36208
343,32,1,1,2,1,2,1,13,10,48517,37656,23,11,50855,36209
344,32,2,0,0,3,1,0,56,60,48519,37656,60,27,50858,36209
345,32,2,3,1,0,0,3,18,19,48521,37659,24,23,50858,36212
346,32,2,2,2,1,2,1,132,125,48523,37661,146,133,50859,36213
347,32,1,1,2,1,2,1,19,12,48524,37662,22,22,50860,36214
348,32,1,0,0,3,1,0,14,17,48525,37662,19,16,50863,36214
349,32,3,1,0,3,1,0,33,12,48528,37663,38,11,50866,36214
350,32,1,1,2,1,2,1,266,237,48529,37664,286,187,50867,36215
351,32,1,1,2,1,2,1,16,24,48530,37665,17,61,50868,36216
352,33,4,0,0,3,1,0,34,12,48534,37665,34,132,50871,36216
353,33,1,2,1,0,0,3,269,233,48535,37667,275,92,50871,36219
354,33,1,0,0,3,1,0,67,77,48536,37667,95,12,50874,36219
355,33,0,1,1,0,0,3,17,27,48536,37668,17,44,50874,36222
356,33,1,3,1,0,0,3,28,20,48537,37671,32,21,50874,36225
357,33,3,3,2,1,2,1,198,192,48540,37674,191,10,50875,36226
358,33,2,3,1,0,0,3,22,20,48542,37677,23,187,50875,36229
359,33,1,4,1,0,0,3,35,53,48543,37681,34,9,50875,36232
360,33,2,1,0,3,1,0,34,24,48545,37682,34,20,50878,36232
361,33,2,2,2,1,2,1,18,27,48547,37684,16,9,50879,36233
362,33,1,1,2,1,2,1,73,63,48548,37685,74,41,50880,36234
363,34,1,1,2,1,2,1,20,13,48549,37686,23,24,50881,36235
364,34,2,0,0,3,1,0,203,190,48551,37686,235,11,50884,36235
365,34,1,1,2,1,2,1,57,61,48552,37687,61,13,50885,36236
366,34,5,0,0,3,1,0,271,237,48557,37687,289,16,50888,36236
367,34,0,1,1,0,0,3,16,25,48557,37688,17,136,50888,36239
368,34,2,1,0,3,1,0,101,101,48559,37689,107,16,50891,36239
369,34,2,2,2,1,2,1,75,65,48561,37691,75,66,50892,36240
370,34,3,2,0,3,1,0,36,14,48564,37693,41,11,50895,36240
371,34,0,1,1,0,0,3,14,18,48564,37694,19,190,50895,36243
372,34,0,3,1,0,0,3,18,22,48564,37697,24,30,50895,36246
373,34,2,1,0,3,1,0,134,126,48566,37698,149,22,50898,36246
374,35,1,0,0,3,1,0,19,27,48567,37698,19,61,50901,36246
375,35,2,0,0,3,1,0,200,192,48569,37698,194,41,50904,36246
376,35,3,0,0,3,1,0,70,77,48572,37698,98,44,50907,36246
377,35,0,1,1,0,0,3,17,28,48572,37699,17,23,50907,36249
378,35,1,1,2,1,2,1,36,54,48573,37700,35,133,50908,36250
379,35,1,2,1,0,0,3,35,26,48574,37702,34,24,50908,36253
380,35,1,1,2,1,2,1,29,21,48575,37703,33,93,50909,36254
381,35,4,2,0,3,1,0,26,22,48579,37705,26,10,50912,36254
382,35,1,1,2,1,2,1,270,234,48580,37706,276,10,50913,36255
383,35,0,3,1,0,0,3,34,15,48580,37709,34,190,50913,36258
384,35,2,0,0,3,1,0,15,10,48582,37709,26,9,50916,36258
385,36,2,1,0,3,1,0,136,127,48584,37710,152,24,50919,36258
386,36,5,4,0,3,1,0,24,31,48589,37714,22,66,50922,36258
387,36,0,1,1,0,0,3,36,15,48589,37715,41,47,50922,36261
388,36,0,2,1,0,0,3,18,24,48589,37717,24,16,50922,36264
389,36,2,1,0,3,1,0,22,14,48591,37718,26,30,50925,36264
390,36,4,1,0,3,1,0,275,238,48595,37719,292,11,50928,36264
391,36,1,2,1,0,0,3,15,20,48596,37721,19,19,50928,36267
392,36,1,2,1,0,0,3,17,27,48597,37723,17,25,50928,36270
393,36,1,1,2,1,2,1,102,102,48598,37724,108,191,50929,36271
394,36,1,3,1,0,0,3,76,68,48599,37727,75,139,50929,36274
395,36,2,1,0,3,1,0,205,191,48601,37728,238,11,50932,36274
396,37,1,0,0,3,1,0,71,77,48602,37728,101,9,50935,36274
397,37,0,4,1,0,0,3,270,238,48602,37732,276,64,50935,36277
398,37,3,0,0,3,1,0,60,61,48605,37732,64,23,50938,36277
399,37,1,0,0,3,1,0,18,28,48606,37732,20,24,50941,36277
400,37,3,3,2,1,2,1,38,29,48609,37735,35,94,50942,36278
401,37,2,1,0,3,1,0,36,16,48611,37736,37,10,50945,36278
402,37,1,1,2,1,2,1,30,22,48612,37737,34,11,50946,36279
403,37,2,1,0,3,1,0,28,23,48614,37738,29,41,50949,36279
404,37,1,2,1,0,0,3,201,194,48615,37740,194,19,50949,36282
405,37,1,1,2,1,2,1,37,55,48616,37741,36,191,50950,36283
406,37,0,3,1,0,0,3,15,13,48616,37744,26,136,50950,36286
407,38,1,0,0,3,1,0,23,14,48617,37744,29,16,50953,36286
408,38,5,1,0,3,1,0,141,128,48622,37745,155,30,50956,36286
409,38,1,2,1,0,0,3,16,22,48623,37747,19,14,50956,36289
410,38,2,2,2,1,2,1,19,29,48625,37749,18,25,50957,36290
411,38,3,1,0,3,1,0,278,239,48628,37750,295,11,50960,36290
412,38,1,4,1,0,0,3,19,28,48629,37754,24,12,50960,36293
413,38,2,0,0,3,1,0,207,191,48631,37754,241,47,50963,36293
414,38,4,2,0,3,1,0,80,70,48635,37756,78,25,50966,36293
415,38,2,0,0,3,1,0,104,102,48637,37756,111,19,50969,36293
416,38,1,1,2,1,2,1,25,32,48638,37757,23,192,50970,36294
417,38,1,2,1,0,0,3,202,196,48639,37759,194,69,50970,36297
418,39,3,2,0,3,1,0,21,30,48642,37761,23,94,50973,36297
419,39,5,1,0,3,1,0,42,56,48647,37762,39,10,50976,36297
420,39,3,0,0,3,1,0,41,29,48650,37762,38,11,50979,36297
421,39,3,1,0,3,1,0,18,14,48653,37763,29,191,50982,36297
422,39,2,0,0,3,1,0,38,15,48655,37763,44,136,50985,36297
423,39,1,1,2,1,2,1,61,62,48656,37764,65,25,50986,36298
424,39,3,5,1,0,0,3,39,21,48659,37769,37,44,50986,36301
425,39,1,0,0,3,1,0,31,22,48660,37769,37,64,50989,36301
426,39,2,0,0,3,1,0,30,23,48662,37769,32,19,50992,36301
427,39,0,0,2,1,2,1,270,238,48662,37769,277,140,50993,36302
428,39,0,0,2,1,2,1,71,77,48662,37769,102,24,50994,36303
429,40,3,0,0,3,1,0,210,191,48665,37769,244,24,50997,36303
430,40,1,0,0,3,1,0,142,128,48666,37769,158,16,51000,36303
431,40,0,0,2,1,2,1,23,14,48666,37769,30,13,51001,36304
432,40,3,1,0,3,1,0,281,240,48669,37770,298,47,51004,36304
433,40,1,2,1,0,0,3,17,24,48670,37772,19,14,51004,36307
434,40,3,0,0,3,1,0,22,29,48673,37772,21,30,51007,36307
435,40,0,0,2,1,2,1,104,102,48673,37772,112,15,51008,36308
436,40,0,2,1,0,0,3,80,72,48673,37774,78,28,51008,36311
437,40,2,0,0,3,1,0,27,32,48675,37774,26,19,51011,36311
438,40,2,2,2,1,2,1,272,240,48677,37776,278,70,51012,36312
439,40,3,0,0,3,1,0,205,196,48680,37776,197,25,51015,36312
440,41,1,1,2,1,2,1,22,31,48681,37777,24,12,51016,36313
441,41,2,0,0,3,1,0,21,28,48683,37777,27,25,51019,36313
442,41,2,1,0,3,1,0,20,15,48685,37778,32,10,51022,36313
443,41,2,0,0,3,1,0,44,56,48687,37778,42,44,51025,36313
444,41,4,0,0,3,1,0,45,29,48691,37778,41,64,51028,36313
445,41,5,1,0,3,1,0,44,22,48696,37779,40,19,51031,36313
446,41,3,3,2,1,2,1,213,194,48699,37782,245,71,51032,36314
447,41,3,3,2,1,2,1,41,18,48702,37785,45,192,51033,36315
448,41,1,0,0,3,1,0,62,62,48703,37785,68,94,51036,36315
449,41,2,4,1,0,0,3,33,26,48705,37789,37,143,51036,36318
450,41,2,1,0,3,1,0,32,24,48707,37790,35,192,51039,36318
451,42,2,1,0,3,1,0,283,241,48709,37791,301,24,51042,36318
452,42,3,1,0,3,1,0,20,25,48712,37792,22,47,51045,36318
453,42,1,1,2,1,2,1,23,30,48713,37793,22,17,51046,36319
454,42,1,0,0,3,1,0,105,102,48714,37793,115,14,51049,36319
455,42,2,1,0,3,1,0,82,73,48716,37794,81,30,51052,36319
456,42,2,2,2,1,2,1,29,34,48718,37796,27,16,51053,36320
457,42,2,3,1,0,0,3,207,199,48720,37799,197,31,51053,36323
458,42,0,0,2,1,2,1,23,14,48720,37799,31,137,51054,36324
459,42,2,0,0,3,1,0,144,128,48722,37799,161,13,51057,36324
460,42,3,0,0,3,1,0,275,240,48725,37799,281,19,51060,36324
461,42,4,1,0,3,1,0,75,78,48729,37800,105,25,51063,36324
0,1,2,0,0,3,1,0,146,128,48731,37800,164,0,51066,36324
1,1,0,1,1,0,0,3,21,29,48731,37801,27,12,51066,36327
2,1,2,0,0,3,1,0,277,240,48733,37801,284,64,51069,36327
3,1,3,1,0,3,1,0,72,95,48736,37802,62,17,51072,36327
4,1,0,1,1,0,0,3,75,79,48736,37803,105,33,51072,36330
5,1,0,1,1,0,0,3,62,63,48736,37804,68,34,51072,36333
6,1,2,2,2,1,2,1,34,26,48738,37806,36,1,51073,36334
7,1,4,0,0,3,1,0,49,29,48742,37806,44,0,51076,36334
8,1,0,2,1,0,0,3,23,16,48742,37808,31,3,51076,36337
9,1,2,0,0,3,1,0,107,102,48744,37808,118,13,51079,36337
10,1,2,1,0,3,1,0,35,27,48746,37809,40,82,51082,36337
11,2,1,4,1,0,0,3,83,77,48747,37813,81,74,51082,36340
12,2,0,2,1,0,0,3,44,24,48747,37815,40,27,51082,36343
13,2,1,0,0,3,1,0,142,165,48748,37815,141,25,51085,36343
14,2,2,0,0,3,1,0,29,27,48750,37815,29,19,51088,36343
15,2,2,1,0,3,1,0,2,1,48752,37816,3,47,51091,36343
16,2,0,1,1,0,0,3,41,19,48752,37817,45,28,51091,36346
17,2,1,1,2,1,2,1,1,1,48753,37818,1,45,51092,36347
18,2,1,1,2,1,2,1,1,1,48754,37819,1,17,51093,36348
19,2,1,1,2,1,2,1,45,57,48755,37820,43,44,51094,36349
20,2,1,3,1,0,0,3,1,3,48756,37823,0,195,51094,36352
21,2,0,3,1,0,0,3,20,18,48756,37826,32,97,51094,36355
22,3,3,4,1,0,0,3,24,33,48759,37830,27,4,51094,36358
23,3,0,3,1,0,0,3,62,66,48759,37833,68,16,51094,36361
24,3,0,2,1,0,0,3,34,28,48759,37835,36,3,51094,36364
25,3,2,2,2,1,2,1,74,97,48761,37837,63,65,51095,36365
26,3,1,0,0,3,1,0,76,79,48762,37837,108,3,51098,36365
27,3,1,0,0,3,1,0,108,102,48763,37837,121,0,51101,36365
28,3,2,0,0,3,1,0,148,128,48765,37837,167,33,51104,36365
29,3,0,0,2,1,2,1,49,29,48765,37837,45,18,51105,36366
30,3,0,4,1,0,0,3,35,31,48765,37841,40,37,51105,36369
31,3,0,1,1,0,0,3,142,166,48765,37842,141,15,51105,36372
32,3,1,2,1,0,0,3,24,18,48766,37844,31,198,51105,36375
33,4,0,1,1,0,0,3,29,28,48766,37845,29,28,51105,36378
34,4,3,2,0,3,1,0,5,3,48769,37847,6,19,51108,36378
35,4,1,1,2,1,2,1,42,20,48770,37848,46,28,51109,36379
36,4,2,1,0,3,1,0,3,2,48772,37849,4,47,51112,36379
37,4,0,1,1,0,0,3,1,2,48772,37850,1,31,51112,36382
38,4,1,0,0,3,1,0,46,57,48773,37850,46,17,51115,36382
39,4,0,2,1,0,0,3,1,5,48773,37852,0,47,51115,36385
40,4,1,2,1,0,0,3,278,242,48774,37854,284,77,51115,36388
41,4,2,3,1,0,0,3,46,27,48776,37857,40,85,51115,36391
42,4,1,3,1,0,0,3,21,21,48777,37860,32,48,51115,36394
43,4,1,1,2,1,2,1,84,78,48778,37861,82,98,51116,36395
44,5,2,1,0,3,1,0,31,29,48780,37862,32,37,51119,36395
45,5,1,3,1,0,0,3,149,131,48781,37865,167,6,51119,36398
46,5,2,1,0,3,1,0,144,167,48783,37866,144,4,51122,36398
47,5,0,2,1,0,0,3,35,33,48783,37868,40,19,51122,36401
48,5,3,3,2,1,2,1,65,69,48786,37871,69,1,51123,36402
49,5,0,0,2,1,2,1,34,28,48786,37871,37,19,51124,36403
50,5,1,0,0,3,1,0,50,29,48787,37871,48,65,51127,36403
51,5,1,0,0,3,1,0,25,18,48788,37871,34,77,51130,36403
52,5,0,1,1,0,0,3,108,103,48788,37872,121,36,51130,36406
53,5,1,0,0,3,1,0,75,97,48789,37872,66,198,51133,36406
54,5,3,3,2,1,2,1,27,36,48792,37875,28,4,51134,36407
55,6,1,3,1,0,0,3,77,82,48793,37878,108,50,51134,36410
56,6,1,1,2,1,2,1,6,4,48794,37879,7,16,51135,36411
57,6,2,2,2,1,2,1,48,29,48796,37881,41,29,51136,36412
58,6,4,0,0,3,1,0,46,20,48800,37881,49,85,51139,36412
59,6,2,0,0,3,1,0,5,2,48802,37881,7,19,51142,36412
60,6,1,1,2,1,2,1,2,3,48803,37882,2,29,51143,36413
61,6,1,3,1,0,0,3,22,24,48804,37885,32,50,51143,36416
62,6,4,2,0,3,1,0,88,80,48808,37887,85,48,51146,36416
63,6,2,1,0,3,1,0,48,58,48810,37888,49,31,51149,36416
64,6,2,1,0,3,1,0,3,6,48812,37889,3,17,51152,36416
65,6,1,1,2,1,2,1,279,243,48813,37890,285,99,51153,36417
66,7,3,2,0,3,1,0,30,38,48816,37892,31,19,51156,36417
67,7,4,0,0,3,1,0,148,167,48820,37892,147,4,51159,36417
68,7,0,1,1,0,0,3,48,30,48820,37893,41,7,51159,36420
69,7,1,0,0,3,1,0,32,29,48821,37893,35,19,51162,36420
70,7,1,2,1,0,0,3,36,35,48822,37895,40,4,51162,36423
71,7,0,1,1,0,0,3,65,70,48822,37896,69,39,51162,36426
72,7,1,1,2,1,2,1,109,104,48823,37897,122,7,51163,36427
73,7,0,1,1,0,0,3,25,19,48823,37898,34,53,51163,36430
74,7,2,1,0,3,1,0,151,132,48825,37899,170,77,51166,36430
75,7,0,2,1,0,0,3,50,31,48825,37901,48,201,51166,36433
76,7,2,1,0,3,1,0,36,29,48827,37902,40,65,51169,36433
77,8,1,1,2,1,2,1,89,81,48828,37903,86,51,51170,36434
78,8,2,2,2,1,2,1,48,22,48830,37905,50,38,51171,36435
79,8,0,0,2,1,2,1,3,6,48830,37905,4,32,51172,36436
80,8,1,2,1,0,0,3,280,245,48831,37907,285,51,51172,36439
81,8,2,2,2,1,2,1,79,84,48833,37909,109,18,51173,36440
82,8,2,0,0,3,1,0,4,3,48835,37909,5,85,51176,36440
83,8,1,2,1,0,0,3,6,4,48836,37911,7,19,51176,36443
84,8,0,0,2,1,2,1,22,24,48836,37911,33,20,51177,36444
85,8,1,1,2,1,2,1,76,98,48837,37912,67,100,51178,36445
86,8,1,1,2,1,2,1,49,59,48838,37913,50,30,51179,36446
87,8,1,0,0,3,1,0,7,4,48839,37913,10,29,51182,36446
88,9,2,2,2,1,2,1,32,40,48841,37915,32,66,51183,36447
89,9,2,2,2,1,2,1,150,169,48843,37917,148,20,51184,36448
90,9,1,0,0,3,1,0,8,4,48844,37917,13,19,51187,36448
91,9,1,0,0,3,1,0,33,29,48845,37917,38,4,51190,36448
92,9,0,0,2,1,2,1,36,35,48845,37917,41,40,51191,36449
93,9,2,2,2,1,2,1,67,72,48847,37919,70,8,51192,36450
94,9,1,0,0,3,1,0,51,31,48848,37919,51,53,51195,36450
95,9,1,1,2,1,2,1,26,20,48849,37920,35,101,51196,36451
96,9,1,1,2,1,2,1,110,105,48850,37921,123,78,51197,36452
97,9,1,2,1,0,0,3,49,32,48851,37923,41,7,51197,36455
98,9,3,3,2,1,2,1,39,32,48854,37926,41,202,51198,36456
99,10,1,0,0,3,1,0,7,4,48855,37926,10,7,51201,36456
100,10,2,1,0,3,1,0,153,133,48857,37927,173,18,51204,36456
101,10,2,1,0,3,1,0,50,23,48859,37928,53,29,51207,36456
102,10,1,4,1,0,0,3,5,7,48860,37932,5,41,51207,36459
103,10,0,1,1,0,0,3,22,25,48860,37933,33,22,51207,36462
104,10,0,2,1,0,0,3,49,61,48860,37935,50,88,51207,36465
105,10,0,2,1,0,0,3,89,83,48860,37937,86,23,51207,36468
106,10,3,1,0,3,1,0,6,7,48863,37938,7,30,51210,36468
107,10,4,0,0,3,1,0,284,245,48867,37938,288,51,51213,36468
108,10,1,0,0,3,1,0,80,84,48868,37938,112,32,51216,36468
109,10,1,1,2,1,2,1,77,99,48869,37939,68,52,51217,36469
110,11,1,0,0,3,1,0,34,29,48870,37939,41,40,51220,36469
111,11,1,1,2,1,2,1,27,21,48871,37940,36,19,51221,36470
112,11,1,0,0,3,1,0,51,23,48872,37940,56,7,51224,36470
113,11,2,2,2,1,2,1,10,6,48874,37942,14,5,51225,36471
114,11,1,0,0,3,1,0,50,32,48875,37942,44,20,51228,36471
115,11,0,1,1,0,0,3,67,73,48875,37943,70,81,51228,36474
116,11,0,1,1,0,0,3,39,33,48875,37944,41,56,51228,36477
117,11,1,0,0,3,1,0,111,105,48876,37944,126,101,51231,36477
118,11,1,2,1,0,0,3,37,37,48877,37946,41,11,51231,36480
119,11,2,3,1,0,0,3,34,43,48879,37949,32,205,51231,36483
120,11,3,2,0,3,1,0,153,171,48882,37951,151,66,51234,36483
121,12,1,1,2,1,2,1,50,62,48883,37952,51,42,51235,36484
122,12,2,1,0,3,1,0,155,134,48885,37953,176,32,51238,36484
123,12,0,2,1,0,0,3,7,6,48885,37955,10,32,51238,36487
124,12,0,0,2,1,2,1,5,7,48885,37955,6,20,51239,36488
125,12,1,0,0,3,1,0,90,83,48886,37955,89,22,51242,36488
126,12,1,0,0,3,1,0,285,245,48887,37955,291,23,51245,36488
127,12,3,0,0,3,1,0,83,84,48890,37955,115,30,51248,36488
128,12,2,1,0,3,1,0,79,100,48892,37956,71,51,51251,36488
129,12,3,2,0,3,1,0,54,33,48895,37958,54,52,51254,36488
130,12,5,0,0,3,1,0,27,25,48900,37958,36,7,51257,36488
131,12,0,0,2,1,2,1,6,7,48900,37958,8,89,51258,36489
132,13,2,2,2,1,2,1,69,75,48902,37960,71,102,51259,36490
133,13,0,1,1,0,0,3,51,24,48902,37961,56,23,51259,36493
134,13,2,2,2,1,2,1,52,34,48904,37963,45,67,51260,36494
135,13,0,1,1,0,0,3,34,30,48904,37964,41,14,51260,36497
136,13,1,1,2,1,2,1,38,38,48905,37965,42,82,51261,36498
137,13,1,2,1,0,0,3,40,35,48906,37967,41,22,51261,36501
138,13,0,3,1,0,0,3,10,9,48906,37970,14,43,51261,36504
139,13,1,1,2,1,2,1,8,7,48907,37971,11,6,51262,36505
140,13,2,1,0,3,1,0,36,44,48909,37972,35,56,51265,36505
141,13,4,2,0,3,1,0,31,23,48913,37974,39,52,51268,36505
142,13,2,1,0,3,1,0,155,172,48915,37975,154,205,51271,36505
143,14,0,0,2,1,2,1,27,25,48915,37975,37,8,51272,36506
144,14,2,1,0,3,1,0,157,135,48917,37976,179,30,51275,36506
145,14,2,1,0,3,1,0,7,8,48919,37977,9,32,51278,36506
146,14,3,1,0,3,1,0,53,63,48922,37978,54,20,51281,36506
147,14,1,1,2,1,2,1,91,84,48923,37979,90,8,51282,36507
148,14,0,2,1,0,0,3,6,9,48923,37981,8,45,51282,36510
149,14,0,1,1,0,0,3,285,246,48923,37982,291,25,51282,36513
150,14,1,1,2,1,2,1,55,34,48924,37983,55,52,51283,36514
151,14,0,0,2,1,2,1,111,105,48924,37983,127,33,51284,36515
152,14,3,2,0,3,1,0,86,86,48927,37985,118,89,51287,36515
153,14,0,0,2,1,2,1,79,100,48927,37985,72,24,51288,36516
154,15,3,1,0,3,1,0,158,173,48930,37986,157,56,51291,36516
155,15,3,1,0,3,1,0,11,8,48933,37987,14,43,51294,36516
156,15,0,0,2,1,2,1,7,8,48933,37987,10,24,51295,36517
157,15,1,0,0,3,1,0,52,24,48934,37987,59,67,51298,36517
158,15,2,1,0,3,1,0,54,35,48936,37988,48,205,51301,36517
159,15,0,0,2,1,2,1,38,38,48936,37988,43,103,51302,36518
160,15,0,0,2,1,2,1,36,44,48936,37988,36,23,51303,36519
161,15,2,0,0,3,1,0,71,75,48938,37988,74,52,51306,36519
162,15,1,2,1,0,0,3,32,25,48939,37990,39,36,51306,36522
163,15,1,2,1,0,0,3,35,32,48940,37992,41,85,51306,36525
164,15,2,2,2,1,2,1,12,11,48942,37994,15,15,51307,36526
165,16,3,1,0,3,1,0,114,106,48945,37995,130,30,51310,36526
166,16,3,0,0,3,1,0,89,86,48948,37995,121,45,51313,36526
167,16,1,2,1,0,0,3,28,27,48949,37997,37,35,51313,36529
168,16,0,0,2,1,2,1,91,84,48949,37997,91,9,51314,36530
169,16,0,2,1,0,0,3,6,11,48949,37999,8,23,51314,36533
170,16,4,1,0,3,1,0,289,247,48953,38000,294,8,51317,36533
171,16,1,1,2,1,2,1,80,101,48954,38001,73,26,51318,36534
172,16,0,0,2,1,2,1,55,34,48954,38001,56,25,51319,36535
173,16,1,3,1,0,0,3,41,38,48955,38004,41,55,51319,36538
174,16,3,0,0,3,1,0,56,63,48958,38004,57,6,51322,36538
175,16,0,0,2,1,2,1,157,135,48958,38004,180,90,51323,36539
176,17,3,3,2,1,2,1,57,38,48961,38007,49,57,51324,36540
177,17,0,0,2,1,2,1,12,11,48961,38007,16,86,51325,36541
178,17,0,0,2,1,2,1,28,27,48961,38007,38,44,51326,36542
179,17,2,1,0,3,1,0,9,9,48963,38008,13,67,51329,36542
180,17,0,0,2,1,2,1,52,24,48963,38008,60,206,51330,36543
181,17,3,1,0,3,1,0,161,174,48966,38009,160,23,51333,36543
182,17,0,0,2,1,2,1,38,38,48966,38009,44,53,51334,36544
183,17,3,1,0,3,1,0,39,45,48969,38010,39,36,51337,36544
184,17,1,1,2,1,2,1,33,26,48970,38011,40,56,51338,36545
185,17,2,2,2,1,2,1,37,34,48972,38013,42,104,51339,36546
186,17,2,1,0,3,1,0,13,9,48974,38014,17,15,51342,36546
187,18,6,0,0,3,1,0,95,86,48980,38014,124,23,51345,36546
188,18,1,0,0,3,1,0,158,135,48981,38014,183,45,51348,36546
189,18,0,0,2,1,2,1,56,63,48981,38014,58,36,51349,36547
190,18,3,2,0,3,1,0,94,86,48984,38016,94,24,51352,36547
191,18,3,2,0,3,1,0,9,13,48987,38018,11,6,51355,36547
192,18,2,0,0,3,1,0,291,247,48989,38018,297,9,51358,36547
193,18,2,1,0,3,1,0,57,35,48991,38019,59,26,51361,36547
194,18,3,0,0,3,1,0,44,38,48994,38019,44,25,51364,36547
195,18,1,0,0,3,1,0,72,75,48995,38019,77,30,51367,36547
196,18,0,1,1,0,0,3,114,107,48995,38020,130,93,51367,36550
197,18,3,0,0,3,1,0,83,101,48998,38020,76,8,51370,36550
198,19,0,3,1,0,0,3,9,12,48998,38023,13,209,51370,36553
199,19,1,1,2,1,2,1,58,39,48999,38024,50,24,51371,36554
200,19,2,4,1,0,0,3,15,13,49001,38028,17,89,51371,36557
201,19,1,4,1,0,0,3,13,15,49002,38032,16,107,51371,36560
202,19,2,1,0,3,1,0,39,35,49004,38033,45,53,51374,36560
203,19,2,1,0,3,1,0,163,175,49006,38034,163,36,51377,36560
204,19,2,0,0,3,1,0,40,38,49008,38034,47,56,51380,36560
205,19,3,1,0,3,1,0,36,27,49011,38035,43,30,51383,36560
206,19,0,2,1,0,0,3,28,29,49011,38037,38,18,51383,36563
207,19,1,1,2,1,2,1,53,25,49012,38038,61,58,51384,36564
208,19,1,0,0,3,1,0,57,63,49013,38038,61,67,51387,36564
209,20,1,0,0,3,1,0,292,247,49014,38038,300,24,51390,36564
210,20,4,0,0,3,1,0,87,101,49018,38038,79,9,51393,36564
211,20,3,0,0,3,1,0,39,27,49021,38038,46,67,51396,36564
212,20,2,1,0,3,1,0,11,14,49023,38039,14,44,51399,36564
213,20,1,2,1,0,0,3,96,88,49024,38041,124,9,51399,36567
214,20,1,1,2,1,2,1,159,136,49025,38042,184,24,51400,36568
215,20,3,1,0,3,1,0,117,108,49028,38043,133,45,51403,36568
216,20,0,0,2,1,2,1,39,45,49028,38043,40,26,51404,36569
217,20,0,2,1,0,0,3,72,77,49028,38045,77,96,51404,36572
218,20,2,1,0,3,1,0,46,39,49030,38046,47,26,51407,36572
219,20,2,1,0,3,1,0,59,36,49032,38047,62,8,51410,36572
220,21,2,2,2,1,2,1,11,14,49034,38049,14,59,51411,36573
221,21,1,0,0,3,1,0,164,175,49035,38049,166,30,51414,36573
222,21,1,1,2,1,2,1,95,87,49036,38050,95,19,51415,36574
223,21,1,0,0,3,1,0,29,29,49037,38050,41,89,51418,36574
224,21,0,3,1,0,0,3,15,16,49037,38053,17,110,51418,36577
225,21,2,2,2,1,2,1,55,27,49039,38055,62,25,51419,36578
226,21,1,1,2,1,2,1,14,16,49040,38056,17,54,51420,36579
227,21,2,0,0,3,1,0,41,35,49042,38056,48,56,51423,36579
228,21,3,1,0,3,1,0,43,39,49045,38057,50,36,51426,36579
229,21,0,0,2,1,2,1,57,63,49045,38057,62,210,51427,36580
230,21,2,0,0,3,1,0,60,39,49047,38057,53,36,51430,36580
231,22,0,1,1,0,0,3,11,15,49047,38058,14,113,51430,36583
232,22,0,2,1,0,0,3,41,37,49047,38060,48,33,51430,36586
233,22,4,2,0,3,1,0,64,41,49051,38062,56,56,51433,36586
234,22,2,0,0,3,1,0,16,16,49053,38062,20,36,51436,36586
235,22,3,1,0,3,1,0,58,28,49056,38063,65,54,51439,36586
236,22,1,0,0,3,1,0,16,16,49057,38063,20,25,51442,36586
237,22,0,1,1,0,0,3,95,88,49057,38064,95,213,51442,36589
238,22,0,3,1,0,0,3,11,17,49057,38067,14,39,51442,36592
239,22,2,0,0,3,1,0,59,63,49059,38067,65,89,51445,36592
240,22,2,1,0,3,1,0,166,176,49061,38068,169,26,51448,36592
241,22,1,2,1,0,0,3,30,31,49062,38070,41,62,51448,36595
242,23,0,0,2,1,2,1,39,45,49062,38070,41,46,51449,36596
243,23,0,1,1,0,0,3,39,28,49062,38071,46,99,51449,36599
244,23,0,0,2,1,2,1,72,77,49062,38071,78,9,51450,36600
245,23,2,2,2,1,2,1,48,41,49064,38073,48,25,51451,36601
246,23,2,0,0,3,1,0,61,36,49066,38073,65,9,51454,36601
247,23,2,1,0,3,1,0,89,102,49068,38074,82,44,51457,36601
248,23,1,0,0,3,1,0,97,88,49069,38074,127,67,51460,36601
249,23,1,0,0,3,1,0,293,247,49070,38074,303,19,51463,36601
250,23,3,2,0,3,1,0,120,110,49073,38076,136,9,51466,36601
251,23,0,3,1,0,0,3,43,42,49073,38079,50,29,51466,36604
252,23,4,0,0,3,1,0,163,136,49077,38079,187,24,51469,36604
253,24,4,1,0,3,1,0,297,248,49081,38080,306,39,51472,36604
254,24,0,2,1,0,0,3,11,19,49081,38082,14,92,51472,36607
255,24,4,0,0,3,1,0,68,41,49085,38082,59,26,51475,36607
256,24,3,1,0,3,1,0,19,17,49088,38083,23,33,51478,36607
257,24,2,0,0,3,1,0,60,28,49090,38083,68,56,51481,36607
258,24,1,2,1,0,0,3,17,18,49091,38085,20,39,51481,36610
259,24,2,0,0,3,1,0,13,15,49093,38085,17,54,51484,36610
260,24,1,1,2,1,2,1,31,32,49094,38086,42,26,51485,36611
261,24,2,0,0,3,1,0,61,63,49096,38086,68,113,51488,36611
262,24,1,4,1,0,0,3,42,41,49097,38090,48,102,51488,36614
263,24,0,1,1,0,0,3,95,89,49097,38091,95,65,51488,36617
264,25,5,0,0,3,1,0,66,36,49102,38091,68,44,51491,36617
265,25,1,0,0,3,1,0,164,136,49103,38091,190,67,51494,36617
266,25,2,1,0,3,1,0,168,177,49105,38092,172,46,51497,36617
267,25,1,0,0,3,1,0,44,42,49106,38092,53,9,51500,36617
268,25,0,3,1,0,0,3,39,48,49106,38095,41,28,51500,36620
269,25,2,1,0,3,1,0,74,78,49108,38096,81,9,51503,36620
270,25,1,0,0,3,1,0,49,41,49109,38096,51,9,51506,36620
271,25,4,2,0,3,1,0,93,104,49113,38098,85,19,51509,36620
272,25,0,2,1,0,0,3,97,90,49113,38100,127,216,51509,36623
273,25,1,0,0,3,1,0,121,110,49114,38100,139,24,51512,36623
274,25,1,0,0,3,1,0,40,28,49115,38100,49,29,51515,36623
275,26,0,1,1,0,0,3,68,42,49115,38101,59,32,51515,36626
276,26,2,0,0,3,1,0,13,19,49117,38101,17,113,51518,36626
277,26,1,0,0,3,1,0,20,17,49118,38101,26,102,51521,36626
278,26,1,0,0,3,1,0,61,28,49119,38101,71,26,51524,36626
279,26,0,2,1,0,0,3,17,20,49119,38103,20,36,51524,36629
280,26,0,3,1,0,0,3,13,18,49119,38106,17,59,51524,36632
281,26,0,1,1,0,0,3,31,33,49119,38107,42,42,51524,36635
282,26,2,0,0,3,1,0,97,89,49121,38107,98,26,51527,36635
283,26,0,3,1,0,0,3,97,93,49121,38110,127,42,51527,36638
284,26,4,3,0,3,1,0,301,251,49125,38113,309,65,51530,36638
285,26,1,0,0,3,1,0,62,63,49126,38113,71,54,51533,36638
286,27,2,1,0,3,1,0,170,178,49128,38114,175,28,51536,36638
287,27,1,0,0,3,1,0,43,41,49129,38114,51,9,51539,36638
288,27,0,2,1,0,0,3,44,44,49129,38116,53,12,51539,36641
289,27,4,3,0,3,1,0,43,51,49133,38119,44,9,51542,36641
290,27,0,0,2,1,2,1,74,78,49133,38119,82,25,51543,36642
291,27,1,2,1,0,0,3,50,43,49134,38121,51,47,51543,36645
292,27,1,0,0,3,1,0,67,36,49135,38121,71,19,51546,36645
293,27,1,2,1,0,0,3,165,138,49136,38123,190,219,51546,36648
294,27,3,2,0,3,1,0,124,112,49139,38125,142,67,51549,36648
295,27,0,2,1,0,0,3,93,106,49139,38127,85,95,51549,36651
296,27,0,0,2,1,2,1,40,28,49139,38127,50,47,51550,36652
297,28,5,0,0,3,1,0,306,251,49144,38127,312,26,51553,36652
298,28,5,3,0,3,1,0,102,92,49149,38130,101,42,51556,36652
299,28,0,0,2,1,2,1,20,17,49149,38130,27,48,51557,36653
300,28,1,0,0,3,1,0,62,28,49150,38130,74,32,51560,36653
301,28,1,2,1,0,0,3,18,22,49151,38132,20,105,51560,36656
302,28,0,1,1,0,0,3,31,34,49151,38133,42,39,51560,36659
303,28,3,1,0,3,1,0,65,64,49154,38134,74,59,51563,36659
304,28,1,2,1,0,0,3,14,21,49155,38136,17,57,51563,36662
305,28,2,2,2,1,2,1,95,108,49157,38138,86,43,51564,36663
306,28,1,2,1,0,0,3,98,95,49158,38140,127,116,51564,36666
307,28,2,2,2,1,2,1,15,20,49160,38142,18,27,51565,36667
308,29,1,1,2,1,2,1,44,52,49161,38143,45,48,51566,36668
309,29,3,0,0,3,1,0,173,178,49164,38143,178,9,51569,36668
310,29,1,1,2,1,2,1,41,29,49165,38144,51,10,51570,36669
311,29,5,0,0,3,1,0,48,41,49170,38144,54,12,51573,36669
312,29,1,3,1,0,0,3,45,47,49171,38147,53,28,51573,36672
313,29,2,1,0,3,1,0,76,79,49173,38148,85,67,51576,36672
314,29,3,1,0,3,1,0,53,44,49176,38149,54,19,51579,36672
315,29,3,1,0,3,1,0,127,113,49179,38150,145,219,51582,36672
316,29,3,0,0,3,1,0,70,36,49182,38150,74,95,51585,36672
317,29,1,1,2,1,2,1,166,139,49183,38151,191,66,51586,36673
318,29,3,2,0,3,1,0,71,44,49186,38153,62,28,51589,36673
319,30,2,0,0,3,1,0,67,64,49188,38153,77,27,51592,36673
320,30,2,1,0,3,1,0,104,93,49190,38154,104,39,51595,36673
321,30,1,0,0,3,1,0,63,28,49191,38154,77,10,51598,36673
322,30,2,0,0,3,1,0,20,22,49193,38154,23,48,51601,36673
323,30,0,5,1,0,0,3,15,25,49193,38159,18,35,51601,36676
324,30,0,1,1,0,0,3,14,22,49193,38160,17,62,51601,36679
325,30,4,1,0,3,1,0,310,252,49197,38161,315,42,51604,36679
326,30,1,2,1,0,0,3,99,97,49198,38163,127,60,51604,36682
327,30,1,2,1,0,0,3,32,36,49199,38165,42,108,51604,36685
328,30,2,0,0,3,1,0,97,108,49201,38165,89,26,51607,36685
329,30,1,0,0,3,1,0,167,139,49202,38165,194,43,51610,36685
330,31,2,0,0,3,1,0,46,52,49204,38165,48,19,51613,36685
331,31,1,3,1,0,0,3,49,44,49205,38168,54,31,51613,36688
332,31,1,2,1,0,0,3,42,31,49206,38170,51,31,51613,36691
333,31,2,2,2,1,2,1,22,19,49208,38172,28,13,51614,36692
334,31,1,1,2,1,2,1,46,48,49209,38173,54,68,51615,36693
335,31,1,1,2,1,2,1,77,80,49210,38174,86,220,51616,36694
336,31,0,0,2,1,2,1,53,44,49210,38174,55,96,51617,36695
337,31,2,2,2,1,2,1,129,115,49212,38176,146,67,51618,36696
338,31,2,1,0,3,1,0,73,45,49214,38177,65,9,51621,36696
339,31,1,4,1,0,0,3,71,40,49215,38181,74,119,51621,36699
340,31,2,0,0,3,1,0,175,178,49217,38181,181,48,51624,36699
341,32,1,0,0,3,1,0,72,40,49218,38181,77,43,51627,36699
342,32,1,0,0,3,1,0,105,93,49219,38181,107,108,51630,36699
343,32,1,2,1,0,0,3,21,24,49220,38183,23,34,51630,36702
344,32,2,1,0,3,1,0,17,26,49222,38184,21,10,51633,36702
345,32,1,1,2,1,2,1,33,37,49223,38185,43,49,51634,36703
346,32,2,1,0,3,1,0,16,23,49225,38186,20,27,51637,36703
347,32,1,2,1,0,0,3,100,99,49226,38188,127,65,51637,36706
348,32,1,1,2,1,2,1,98,109,49227,38189,90,43,51638,36707
349,32,2,1,0,3,1,0,169,140,49229,38190,197,60,51641,36707
350,32,3,1,0,3,1,0,70,65,49232,38191,80,35,51644,36707
351,32,2,0,0,3,1,0,312,252,49234,38191,318,39,51647,36707
352,33,4,2,0,3,1,0,53,46,49238,38193,57,68,51650,36707
353,33,0,4,1,0,0,3,53,48,49238,38197,55,122,51650,36710
354,33,4,2,0,3,1,0,46,33,49242,38199,54,13,51653,36710
355,33,2,1,0,3,1,0,65,29,49244,38200,80,9,51656,36710
356,33,1,0,0,3,1,0,23,19,49245,38200,31,31,51659,36710
357,33,1,1,2,1,2,1,47,49,49246,38201,55,221,51660,36711
358,33,2,0,0,3,1,0,48,52,49248,38201,51,96,51663,36711
359,33,1,0,0,3,1,0,78,80,49249,38201,89,67,51666,36711
360,33,1,1,2,1,2,1,130,116,49250,38202,147,27,51667,36712
361,33,3,1,0,3,1,0,178,179,49253,38203,184,19,51670,36712
362,33,2,0,0,3,1,0,75,45,49255,38203,68,48,51673,36712
363,34,0,0,2,1,2,1,98,109,49255,38203,91,40,51674,36713
364,34,2,1,0,3,1,0,102,100,49257,38204,130,27,51677,36713
365,34,0,1,1,0,0,3,17,27,49257,38205,21,16,51677,36716
366,34,0,0,2,1,2,1,70,65,49257,38205,81,11,51678,36717
367,34,1,1,2,1,2,1,106,94,49258,38206,108,50,51679,36718
368,34,2,6,1,0,0,3,18,29,49260,38212,20,38,51679,36721
369,34,3,0,0,3,1,0,172,140,49263,38212,200,65,51682,36721
370,34,2,2,2,1,2,1,74,42,49265,38214,78,44,51683,36722
371,34,0,0,2,1,2,1,130,116,49265,38214,148,44,51684,36723
372,34,2,3,1,0,0,3,314,255,49267,38217,318,111,51684,36726
373,34,0,2,1,0,0,3,33,39,49267,38219,43,37,51684,36729
374,35,0,1,1,0,0,3,48,53,49267,38220,51,125,51684,36732
375,35,1,1,2,1,2,1,48,50,49268,38221,56,68,51685,36733
376,35,1,3,1,0,0,3,47,36,49269,38224,54,12,51685,36736
377,35,1,0,0,3,1,0,22,24,49270,38224,26,31,51688,36736
378,35,2,0,0,3,1,0,67,29,49272,38224,83,48,51691,36736
379,35,2,3,1,0,0,3,25,22,49274,38227,31,71,51691,36739
380,35,1,0,0,3,1,0,54,46,49275,38227,60,221,51694,36739
381,35,2,1,0,3,1,0,80,81,49277,38228,92,27,51697,36739
382,35,2,0,0,3,1,0,55,48,49279,38228,58,60,51700,36739
383,35,4,3,0,3,1,0,182,182,49283,38231,187,96,51703,36739
384,35,1,0,0,3,1,0,76,45,49284,38231,71,19,51706,36739
385,36,3,2,0,3,1,0,73,67,49287,38233,84,16,51709,36739
386,36,2,1,0,3,1,0,174,141,49289,38234,203,27,51712,36739
387,36,2,0,0,3,1,0,35,39,49291,38234,46,12,51715,36739
388,36,0,0,2,1,2,1,106,94,49291,38234,109,38,51716,36740
389,36,1,0,0,3,1,0,19,29,49292,38234,23,11,51719,36740
390,36,2,0,0,3,1,0,100,109,49294,38234,94,111,51722,36740
391,36,0,1,1,0,0,3,74,43,49294,38235,78,43,51722,36743
392,36,1,3,1,0,0,3,131,119,49295,38238,148,68,51722,36746
393,36,4,1,0,3,1,0,318,256,49299,38239,321,50,51725,36746
394,36,0,3,1,0,0,3,102,103,49299,38242,130,41,51725,36749
395,36,3,1,0,3,1,0,58,49,49302,38243,61,44,51728,36749
396,37,3,3,2,1,2,1,20,30,49305,38246,22,49,51729,36750
397,37,2,1,0,3,1,0,50,51,49307,38247,59,27,51732,36750
398,37,1,4,1,0,0,3,23,28,49308,38251,26,74,51732,36753
399,37,3,0,0,3,1,0,70,29,49311,38251,86,19,51735,36753
400,37,1,2,1,0,0,3,26,24,49312,38253,31,224,51735,36756
401,37,0,1,1,0,0,3,76,46,49312,38254,71,99,51735,36759
402,37,0,0,2,1,2,1,54,46,49312,38254,61,69,51736,36760
403,37,1,4,1,0,0,3,49,57,49313,38258,51,63,51736,36763
404,37,2,1,0,3,1,0,82,82,49315,38259,95,44,51739,36763
405,37,2,2,2,1,2,1,49,38,49317,38261,55,32,51740,36764
406,37,1,1,2,1,2,1,183,183,49318,38262,188,126,51741,36765
407,38,4,2,0,3,1,0,77,69,49322,38264,87,32,51744,36765
408,38,1,2,1,0,0,3,132,121,49323,38266,148,30,51744,36768
409,38,1,2,1,0,0,3,101,111,49324,38268,94,53,51744,36771
410,38,5,1,0,3,1,0,111,95,49329,38269,112,12,51747,36771
411,38,2,2,2,1,2,1,21,31,49331,38271,24,17,51748,36772
412,38,3,0,0,3,1,0,321,256,49334,38271,324,38,51751,36772
413,38,0,3,1,0,0,3,74,46,49334,38274,78,114,51751,36775
414,38,0,2,1,0,0,3,82,84,49334,38276,95,47,51751,36778
415,38,1,1,2,1,2,1,175,142,49335,38277,204,42,51752,36779
416,38,1,1,2,1,2,1,103,104,49336,38278,131,12,51753,36780
417,38,0,1,1,0,0,3,58,50,49336,38279,61,46,51753,36783
418,39,0,3,1,0,0,3,23,31,49336,38282,26,227,51753,36786
419,39,0,1,1,0,0,3,49,39,49336,38283,55,52,51753,36789
420,39,1,1,2,1,2,1,36,40,49337,38284,47,75,51754,36790
421,39,1,3,1,0,0,3,21,33,49338,38287,22,22,51754,36793
422,39,3,1,0,3,1,0,73,30,49341,38288,89,99,51757,36793
423,39,2,1,0,3,1,0,28,25,49343,38289,34,69,51760,36793
424,39,1,3,1,0,0,3,55,49,49344,38292,61,30,51760,36796
425,39,3,1,0,3,1,0,186,184,49347,38293,191,63,51763,36796
426,39,0,0,2,1,2,1,50,51,49347,38293,60,45,51764,36797
427,39,4,2,0,3,1,0,53,59,49351,38295,54,68,51767,36797
428,39,1,2,1,0,0,3,77,48,49352,38297,71,129,51767,36800
429,40,2,3,1,0,0,3,105,107,49354,38300,131,20,51767,36803
430,40,2,0,0,3,1,0,103,111,49356,38300,97,38,51770,36803
431,40,2,0,0,3,1,0,134,121,49358,38300,151,42,51773,36803
432,40,1,0,0,3,1,0,83,84,49359,38300,98,30,51776,36803
433,40,2,0,0,3,1,0,55,59,49361,38300,57,47,51779,36803
434,40,3,1,0,3,1,0,114,96,49364,38301,115,52,51782,36803
435,40,4,0,0,3,1,0,325,256,49368,38301,327,12,51785,36803
436,40,3,0,0,3,1,0,77,46,49371,38301,81,53,51788,36803
437,40,2,2,2,1,2,1,23,33,49373,38303,25,33,51789,36804
438,40,3,2,0,3,1,0,61,52,49376,38305,64,114,51792,36804
439,40,2,0,0,3,1,0,177,142,49378,38305,207,12,51795,36804
440,41,2,0,0,3,1,0,79,48,49380,38305,74,63,51798,36804
441,41,0,0,2,1,2,1,114,96,49380,38305,116,48,51799,36805
442,41,2,1,0,3,1,0,79,70,49382,38306,90,22,51802,36805
443,41,1,2,1,0,0,3,37,42,49383,38308,47,230,51802,36808
444,41,4,0,0,3,1,0,25,33,49387,38308,25,99,51805,36808
445,41,0,1,1,0,0,3,23,32,49387,38309,26,72,51805,36811
446,41,2,2,2,1,2,1,75,32,49389,38311,90,130,51806,36812
447,41,1,3,1,0,0,3,29,28,49390,38314,34,33,51806,36815
448,41,2,2,2,1,2,1,57,51,49392,38316,62,46,51807,36816
449,41,2,1,0,3,1,0,188,185,49394,38317,194,68,51810,36816
450,41,6,2,0,3,1,0,56,53,49400,38319,63,46,51813,36816
451,42,3,2,0,3,1,0,137,123,49403,38321,154,12,51816,36816
452,42,1,2,1,0,0,3,24,35,49404,38323,25,78,51816,36819
453,42,1,2,1,0,0,3,50,41,49405,38325,55,33,51816,36822
454,42,0,0,2,1,2,1,325,256,49405,38325,328,53,51817,36823
455,42,1,0,0,3,1,0,106,107,49406,38325,134,33,51820,36823
456,42,1,0,0,3,1,0,104,111,49407,38325,100,12,51823,36823
457,42,1,3,1,0,0,3,178,145,49408,38328,207,23,51823,36826
458,42,0,1,1,0,0,3,77,47,49408,38329,81,41,51823,36829
459,42,0,6,1,0,0,3,61,58,49408,38335,64,56,51823,36832
460,42,1,2,1,0,0,3,84,86,49409,38337,98,45,51823,36835
461,42,0,1,1,0,0,3,55,60,49409,38338,57,117,51823,36838
0,1,4,5,1,0,0,3,83,53,49413,38343,74,75,51823,36841
1,1,0,1,1,0,0,3,0,1,49413,38344,0,71,51823,36844
2,1,2,1,0,3,1,0,308,193,49415,38345,335,0,51826,36844
3,1,0,0,2,1,2,1,114,96,49415,38345,117,13,51827,36845
4,1,1,0,0,3,1,0,1,0,49416,38345,3,45,51830,36845
5,1,2,0,0,3,1,0,63,58,49418,38345,67,48,51833,36845
6,1,0,1,1,0,0,3,36,46,49418,38346,46,66,51833,36848
7,1,2,0,0,3,1,0,79,47,49420,38346,84,52,51836,36848
8,1,1,1,2,1,2,1,76,33,49421,38347,91,24,51837,36849
9,1,4,2,0,3,1,0,110,109,49425,38349,137,12,51840,36849
10,1,0,0,2,1,2,1,24,35,49425,38349,26,54,51841,36850
11,2,2,1,0,3,1,0,106,112,49427,38350,103,46,51844,36850
12,2,0,0,2,1,2,1,29,28,49427,38350,35,233,51845,36851
13,2,1,5,1,0,0,3,24,37,49428,38355,26,81,51845,36854
14,2,2,0,0,3,1,0,25,30,49430,38355,25,41,51848,36854
15,2,1,1,2,1,2,1,138,124,49431,38356,155,1,51849,36855
16,2,2,3,1,0,0,3,103,111,49433,38359,102,25,51849,36858
17,2,1,1,2,1,2,1,85,87,49434,38360,99,34,51850,36859
18,2,1,0,0,3,1,0,51,41,49435,38360,58,0,51853,36859
19,2,3,2,0,3,1,0,3,2,49438,38362,3,56,51856,36859
20,2,1,2,1,0,0,3,58,53,49439,38364,62,102,51856,36862
21,2,2,0,0,3,1,0,81,70,49441,38364,93,27,51859,36862
22,3,1,0,0,3,1,0,115,96,49442,38364,120,12,51862,36862
23,3,3,1,0,3,1,0,113,110,49445,38365,140,66,51865,36862
24,3,1,1,2,1,2,1,2,1,49446,38366,4,55,51866,36863
25,3,2,1,0,3,1,0,26,36,49448,38367,29,71,51869,36863
26,3,0,0,2,1,2,1,79,47,49448,38367,85,49,51870,36864
27,3,0,4,1,0,0,3,63,62,49448,38371,67,3,51870,36867
28,3,2,1,0,3,1,0,310,194,49450,38372,338,24,51873,36867
29,3,1,0,0,3,1,0,107,112,49451,38372,106,0,51876,36867
30,3,0,0,2,1,2,1,36,46,49451,38372,47,53,51877,36868
31,3,1,0,0,3,1,0,77,33,49452,38372,94,45,51880,36868
32,3,2,0,0,3,1,0,85,53,49454,38372,77,13,51883,36868
33,4,3,2,0,3,1,0,54,43,49457,38374,61,25,51886,36868
34,4,3,0,0,3,1,0,32,28,49460,38374,38,75,51889,36868
35,4,0,1,1,0,0,3,24,38,49460,38375,26,59,51889,36871
36,4,0,1,1,0,0,3,25,31,49460,38376,25,236,51889,36874
37,4,0,0,2,1,2,1,0,1,49460,38376,1,35,51890,36875
38,4,2,1,0,3,1,0,60,54,49462,38377,65,81,51893,36875
39,4,1,3,1,0,0,3,139,127,49463,38380,155,44,51893,36878
40,4,3,2,0,3,1,0,6,4,49466,38382,6,46,51896,36878
41,4,0,1,1,0,0,3,81,71,49466,38383,93,105,51896,36881
42,4,1,1,2,1,2,1,104,112,49467,38384,103,2,51897,36882
43,4,1,1,2,1,2,1,86,88,49468,38385,100,28,51898,36883
44,5,2,3,1,0,0,3,8,7,49470,38388,6,16,51898,36886
45,5,4,0,0,3,1,0,111,112,49474,38388,109,24,51901,36886
46,5,2,1,0,3,1,0,87,54,49476,38389,80,12,51904,36886
47,5,2,1,0,3,1,0,79,34,49478,38390,97,55,51907,36886
48,5,2,1,0,3,1,0,115,111,49480,38391,143,53,51910,36886
49,5,2,4,1,0,0,3,4,5,49482,38395,4,74,51910,36889
50,5,3,0,0,3,1,0,39,46,49485,38395,50,49,51913,36889
51,5,2,0,0,3,1,0,65,62,49487,38395,70,35,51916,36889
52,5,2,2,2,1,2,1,28,38,49489,38397,30,4,51917,36890
53,5,5,0,0,3,1,0,120,96,49494,38397,123,66,51920,36890
54,5,1,0,0,3,1,0,311,194,49495,38397,341,45,51923,36890
55,6,0,3,1,0,0,3,60,57,49495,38400,65,62,51923,36893
56,6,3,0,0,3,1,0,35,28,49498,38400,41,46,51926,36893
57,6,2,2,2,1,2,1,27,33,49500,38402,26,76,51927,36894
58,6,2,2,2,1,2,1,141,129,49502,38404,156,237,51928,36895
59,6,2,1,0,3,1,0,106,113,49504,38405,106,44,51931,36895
60,6,0,0,2,1,2,1,86,88,49504,38405,101,106,51932,36896
61,6,3,0,0,3,1,0,57,43,49507,38405,64,2,51935,36896
62,6,0,1,1,0,0,3,0,2,49507,38406,1,31,51935,36899
63,6,3,4,1,0,0,3,27,42,49510,38410,26,3,51935,36902
64,6,2,0,0,3,1,0,83,71,49512,38410,96,81,51938,36902
65,6,1,0,0,3,1,0,80,47,49513,38410,88,25,51941,36902
66,7,1,2,1,0,0,3,9,9,49514,38412,6,15,51941,36905
67,7,3,1,0,3,1,0,123,97,49517,38413,126,53,51944,36905
68,7,1,1,2,1,2,1,88,55,49518,38414,81,67,51945,36906
69,7,2,0,0,3,1,0,313,194,49520,38414,344,55,51948,36906
70,7,1,0,0,3,1,0,80,34,49521,38414,100,74,51951,36906
71,7,2,0,0,3,1,0,6,5,49523,38414,7,4,51954,36906
72,7,1,1,2,1,2,1,40,47,49524,38415,51,36,51955,36907
73,7,0,3,1,0,0,3,65,65,49524,38418,70,28,51955,36910
74,7,2,1,0,3,1,0,37,29,49526,38419,44,24,51958,36910
75,7,3,0,0,3,1,0,118,111,49529,38419,146,49,51961,36910
76,7,0,0,2,1,2,1,111,112,49529,38419,110,46,51962,36911
77,8,1,1,2,1,2,1,28,43,49530,38420,27,47,51963,36912
78,8,3,1,0,3,1,0,30,34,49533,38421,29,16,51966,36912
79,8,2,1,0,3,1,0,85,72,49535,38422,99,62,51969,36912
80,8,0,0,2,1,2,1,86,88,49535,38422,102,82,51970,36913
81,8,4,2,0,3,1,0,61,45,49539,38424,67,44,51973,36913
82,8,1,2,1,0,0,3,1,4,49540,38426,1,109,51973,36916
83,8,3,0,0,3,1,0,83,47,49543,38426,91,2,51976,36916
84,8,1,2,1,0,0,3,142,131,49544,38428,156,79,51976,36919
85,8,1,0,0,3,1,0,29,38,49545,38428,33,31,51979,36919
86,8,2,0,0,3,1,0,108,113,49547,38428,109,237,51982,36919
87,8,2,4,1,0,0,3,62,61,49549,38432,65,6,51982,36922
88,9,2,0,0,3,1,0,30,43,49551,38432,30,15,51985,36922
89,9,3,0,0,3,1,0,91,55,49554,38432,84,53,51988,36922
90,9,4,0,0,3,1,0,84,34,49558,38432,103,4,51991,36922
91,9,2,1,0,3,1,0,8,6,49560,38433,10,28,51994,36922
92,9,1,1,2,1,2,1,66,66,49561,38434,71,32,51995,36923
93,9,1,1,2,1,2,1,314,195,49562,38435,345,75,51996,36924
94,9,4,0,0,3,1,0,122,111,49566,38435,149,36,51999,36924
95,9,1,2,1,0,0,3,38,31,49567,38437,44,49,51999,36927
96,9,5,2,0,3,1,0,128,99,49572,38439,129,49,52002,36927
97,9,3,0,0,3,1,0,114,112,49575,38439,113,55,52005,36927
98,9,3,2,0,3,1,0,12,11,49578,38441,9,67,52008,36927
99,10,1,0,0,3,1,0,86,72,49579,38441,102,6,52011,36927
100,10,0,1,1,0,0,3,30,35,49579,38442,29,50,52011,36930
101,10,0,0,2,1,2,1,62,61,49579,38442,66,25,52012,36931
102,10,2,1,0,3,1,0,110,114,49581,38443,112,79,52015,36931
103,10,1,1,2,1,2,1,2,5,49582,38444,2,83,52016,36932
104,10,0,1,1,0,0,3,83,48,49582,38445,91,47,52016,36935
105,10,0,0,2,1,2,1,40,47,49582,38445,52,3,52017,36936
106,10,2,0,0,3,1,0,63,45,49584,38445,70,237,52020,36936
107,10,1,0,0,3,1,0,143,131,49585,38445,159,16,52023,36936
108,10,1,0,0,3,1,0,30,38,49586,38445,36,109,52026,36936
109,10,1,4,1,0,0,3,87,92,49587,38449,102,65,52026,36939
110,11,2,3,1,0,0,3,93,58,49589,38452,84,52,52026,36942
111,11,1,0,0,3,1,0,115,112,49590,38452,116,75,52029,36942
112,11,2,3,1,0,0,3,32,46,49592,38455,30,70,52029,36945
113,11,1,1,2,1,2,1,39,32,49593,38456,45,56,52030,36946
114,11,2,0,0,3,1,0,316,195,49595,38456,348,4,52033,36946
115,11,2,4,1,0,0,3,14,15,49597,38460,9,56,52033,36949
116,11,1,0,0,3,1,0,31,35,49598,38460,32,49,52036,36949
117,11,3,1,0,3,1,0,131,100,49601,38461,132,36,52039,36949
118,11,1,0,0,3,1,0,85,34,49602,38461,106,28,52042,36949
119,11,1,0,0,3,1,0,123,111,49603,38461,152,32,52045,36949
120,11,1,0,0,3,1,0,67,66,49604,38461,74,3,52048,36949
121,12,3,0,0,3,1,0,5,5,49607,38461,5,65,52051,36949
122,12,1,1,2,1,2,1,84,49,49608,38462,92,238,52052,36950
123,12,0,1,1,0,0,3,30,39,49608,38463,36,86,52052,36953
124,12,2,1,0,3,1,0,42,48,49610,38464,55,47,52055,36953
125,12,1,5,1,0,0,3,63,66,49611,38469,66,53,52055,36956
126,12,1,0,0,3,1,0,87,72,49612,38469,105,25,52058,36956
127,12,2,2,2,1,2,1,89,94,49614,38471,103,7,52059,36957
128,12,1,0,0,3,1,0,144,131,49615,38471,162,15,52062,36957
129,12,1,0,0,3,1,0,9,6,49616,38471,13,109,52065,36957
130,12,0,0,2,1,2,1,110,114,49616,38471,113,17,52066,36958
131,12,0,2,1,0,0,3,63,47,49616,38473,70,82,52066,36961
132,13,1,0,0,3,1,0,132,100,49617,38473,135,32,52069,36961
133,13,3,3,2,1,2,1,96,61,49620,38476,85,37,52070,36962
134,13,2,1,0,3,1,0,34,47,49622,38477,33,56,52073,36962
135,13,1,0,0,3,1,0,40,32,49623,38477,48,75,52076,36962
136,13,0,0,2,1,2,1,67,66,49623,38477,75,110,52077,36963
137,13,0,2,1,0,0,3,63,68,49623,38479,66,73,52077,36966
138,13,1,1,2,1,2,1,317,196,49624,38480,349,29,52078,36967
139,13,3,5,1,0,0,3,34,40,49627,38485,32,59,52078,36970
140,13,0,0,2,1,2,1,115,112,49627,38485,117,5,52079,36971
141,13,2,1,0,3,1,0,87,35,49629,38486,109,3,52082,36971
142,13,0,1,1,0,0,3,14,16,49629,38487,9,55,52082,36974
143,14,2,3,1,0,0,3,112,117,49631,38490,113,18,52082,36977
144,14,0,3,1,0,0,3,42,51,49631,38493,55,241,52082,36980
145,14,1,0,0,3,1,0,31,39,49632,38493,39,65,52085,36980
146,14,1,2,1,0,0,3,10,8,49633,38495,13,89,52085,36983
147,14,1,1,2,1,2,1,145,132,49634,38496,163,54,52086,36984
148,14,1,2,1,0,0,3,88,74,49635,38498,105,52,52086,36987
149,14,2,5,1,0,0,3,65,52,49637,38503,70,20,52086,36990
150,14,1,0,0,3,1,0,124,111,49638,38503,155,47,52089,36990
151,14,2,1,0,3,1,0,91,95,49640,38504,106,25,52092,36990
152,14,0,0,2,1,2,1,5,5,49640,38504,6,8,52093,36991
153,14,0,0,2,1,2,1,84,49,49640,38504,93,83,52094,36992
154,15,3,0,0,3,1,0,148,132,49643,38504,166,59,52097,36992
155,15,1,1,2,1,2,1,64,69,49644,38505,67,57,52098,36993
156,15,1,0,0,3,1,0,35,47,49645,38505,36,55,52101,36993
157,15,0,1,1,0,0,3,132,101,49645,38506,135,113,52101,36996
158,15,1,1,2,1,2,1,41,33,49646,38507,49,6,52102,36997
159,15,1,1,2,1,2,1,318,197,49647,38508,350,4,52103,36998
160,15,4,1,0,3,1,0,100,62,49651,38509,88,32,52106,36998
161,15,2,1,0,3,1,0,36,41,49653,38510,35,75,52109,36998
162,15,3,2,0,3,1,0,118,114,49656,38512,120,29,52112,36998
163,15,2,4,1,0,0,3,69,70,49658,38516,75,50,52112,37001
164,15,2,4,1,0,0,3,16,20,49660,38520,9,40,52112,37004
165,16,0,0,2,1,2,1,31,39,49660,38520,40,9,52113,37005
166,16,0,0,2,1,2,1,88,74,49660,38520,106,55,52114,37006
167,16,1,1,2,1,2,1,113,118,49661,38521,114,74,52115,37007
168,16,1,2,1,0,0,3,11,10,49662,38523,13,68,52115,37010
169,16,0,2,1,0,0,3,65,54,49662,38525,70,21,52115,37013
170,16,3,4,1,0,0,3,45,55,49665,38529,55,86,52115,37016
171,16,1,1,2,1,2,1,92,96,49666,38530,107,53,52116,37017
172,16,0,0,2,1,2,1,5,5,49666,38530,7,26,52117,37018
173,16,2,1,0,3,1,0,86,50,49668,38531,96,20,52120,37018
174,16,4,1,0,3,1,0,91,36,49672,38532,112,89,52123,37018
175,16,1,0,0,3,1,0,125,111,49673,38532,158,241,52126,37018
176,17,4,0,0,3,1,0,152,132,49677,38532,169,75,52129,37018
177,17,5,1,0,3,1,0,40,48,49682,38533,39,40,52132,37018
178,17,0,1,1,0,0,3,118,115,49682,38534,120,7,52132,37021
179,17,1,1,2,1,2,1,101,63,49683,38535,89,114,52133,37022
180,17,2,2,2,1,2,1,43,35,49685,38537,50,30,52134,37023
181,17,1,1,2,1,2,1,89,75,49686,38538,107,58,52135,37024
182,17,1,1,2,1,2,1,65,70,49687,38539,68,56,52136,37025
183,17,3,1,0,3,1,0,39,42,49690,38540,38,6,52139,37025
184,17,4,0,0,3,1,0,322,197,49694,38540,353,50,52142,37025
185,17,0,2,1,0,0,3,69,72,49694,38542,75,92,52142,37028
186,17,4,0,0,3,1,0,20,20,49698,38542,12,32,52145,37028
187,18,3,2,0,3,1,0,14,12,49701,38544,16,9,52148,37028
188,18,1,3,1,0,0,3,93,99,49702,38547,107,62,52148,37031
189,18,1,1,2,1,2,1,92,37,49703,38548,113,69,52149,37032
190,18,0,1,1,0,0,3,31,40,49703,38549,40,29,52149,37035
191,18,2,0,0,3,1,0,134,101,49705,38549,138,241,52152,37035
192,18,0,1,1,0,0,3,45,56,49705,38550,55,23,52152,37038
193,18,1,0,0,3,1,0,126,111,49706,38550,161,86,52155,37038
194,18,3,0,0,3,1,0,116,118,49709,38550,117,55,52158,37038
195,18,0,0,2,1,2,1,65,54,49709,38550,71,75,52159,37039
196,18,3,2,0,3,1,0,8,7,49712,38552,10,53,52162,37039
197,18,0,1,1,0,0,3,86,51,49712,38553,96,24,52162,37042
198,19,0,0,2,1,2,1,69,72,49712,38553,76,242,52163,37043
199,19,0,1,1,0,0,3,20,21,49712,38554,12,117,52163,37046
200,19,0,1,1,0,0,3,118,116,49712,38555,120,53,52163,37049
201,19,0,2,1,0,0,3,89,77,49712,38557,107,59,52163,37052
202,19,4,4,2,1,2,1,105,67,49716,38561,90,93,52164,37053
203,19,1,0,0,3,1,0,117,118,49717,38561,120,75,52167,37053
204,19,2,0,0,3,1,0,154,132,49719,38561,172,6,52170,37053
205,19,1,3,1,0,0,3,66,73,49720,38564,68,43,52170,37056
206,19,1,0,0,3,1,0,40,42,49721,38564,41,30,52173,37056
207,19,1,1,2,1,2,1,41,49,49722,38565,40,33,52174,37057
208,19,0,1,1,0,0,3,43,36,49722,38566,50,10,52174,37060
209,20,1,1,2,1,2,1,66,55,49723,38567,72,59,52175,37061
210,20,2,1,0,3,1,0,47,57,49725,38568,58,24,52178,37061
211,20,1,3,1,0,0,3,323,200,49726,38571,353,72,52178,37064
212,20,3,2,0,3,1,0,95,39,49729,38573,116,9,52181,37064
213,20,2,1,0,3,1,0,33,41,49731,38574,43,53,52184,37064
214,20,0,1,1,0,0,3,134,102,49731,38575,138,89,52184,37067
215,20,1,1,2,1,2,1,70,73,49732,38576,77,76,52185,37068
216,20,0,0,2,1,2,1,8,7,49732,38576,11,63,52186,37069
217,20,3,0,0,3,1,0,89,51,49735,38576,99,75,52189,37069
218,20,0,0,2,1,2,1,14,12,49735,38576,17,30,52190,37070
219,20,3,2,0,3,1,0,129,113,49738,38578,164,23,52193,37070
220,21,4,2,0,3,1,0,109,69,49742,38580,93,55,52196,37070
221,21,0,0,2,1,2,1,41,49,49742,38580,41,118,52197,37071
222,21,1,1,2,1,2,1,119,117,49743,38581,121,243,52198,37072
223,21,1,1,2,1,2,1,118,119,49744,38582,121,7,52199,37073
224,21,2,0,0,3,1,0,68,73,49746,38582,71,33,52202,37073
225,21,0,0,2,1,2,1,20,21,49746,38582,13,94,52203,37074
226,21,3,1,0,3,1,0,96,100,49749,38583,110,59,52206,37074
227,21,0,1,1,0,0,3,40,43,49749,38584,41,13,52206,37077
228,21,2,0,0,3,1,0,45,36,49751,38584,53,53,52209,37077
229,21,1,0,0,3,1,0,90,77,49752,38584,110,43,52212,37077
230,21,3,2,0,3,1,0,157,134,49755,38586,175,30,52215,37077
231,22,4,1,0,3,1,0,49,37,49759,38587,56,94,52218,37077
232,22,3,0,0,3,1,0,44,49,49762,38587,44,53,52221,37077
233,22,1,0,0,3,1,0,158,134,49763,38587,178,33,52224,37077
234,22,5,0,0,3,1,0,25,21,49768,38587,16,243,52227,37077
235,22,3,0,0,3,1,0,71,73,49771,38587,74,13,52230,37077
236,22,5,0,0,3,1,0,95,77,49776,38587,113,30,52233,37077
237,22,1,1,2,1,2,1,119,120,49777,38588,122,44,52234,37078
238,22,2,0,0,3,1,0,68,55,49779,38588,75,55,52237,37078
239,22,2,2,2,1,2,1,121,119,49781,38590,122,73,52238,37079
240,22,0,1,1,0,0,3,96,101,49781,38591,110,10,52238,37082
241,22,1,1,2,1,2,1,41,44,49782,38592,42,119,52239,37083
242,23,3,0,0,3,1,0,326,200,49785,38592,356,23,52242,37083
243,23,2,0,0,3,1,0,136,102,49787,38592,141,30,52245,37083
244,23,3,1,0,3,1,0,17,13,49790,38593,20,75,52248,37083
245,23,1,3,1,0,0,3,48,60,49791,38596,58,66,52248,37086
246,23,1,1,2,1,2,1,34,42,49792,38597,44,60,52249,37087
247,23,2,0,0,3,1,0,131,113,49794,38597,167,53,52252,37087
248,23,0,2,1,0,0,3,70,75,49794,38599,77,92,52252,37090
249,23,3,1,0,3,1,0,112,70,49797,38600,96,9,52255,37090
250,23,1,0,0,3,1,0,96,39,49798,38600,119,24,52258,37090
251,23,1,2,1,0,0,3,90,53,49799,38602,99,79,52258,37093
252,23,2,1,0,3,1,0,10,8,49801,38603,14,59,52261,37093
253,24,3,2,0,3,1,0,52,39,49804,38605,59,73,52264,37093
254,24,0,0,2,1,2,1,44,49,49804,38605,45,244,52265,37094
255,24,0,0,2,1,2,1,158,134,49804,38605,179,120,52266,37095
256,24,1,2,1,0,0,3,120,122,49805,38607,122,36,52266,37098
257,24,3,0,0,3,1,0,74,73,49808,38607,77,53,52269,37098
258,24,2,0,0,3,1,0,43,44,49810,38607,45,94,52272,37098
259,24,2,0,0,3,1,0,70,55,49812,38607,78,44,52275,37098
260,24,1,0,0,3,1,0,96,77,49813,38607,116,13,52278,37098
261,24,2,0,0,3,1,0,98,101,49815,38607,113,30,52281,37098
262,24,1,0,0,3,1,0,11,8,49816,38607,17,55,52284,37098
263,24,2,1,0,3,1,0,27,22,49818,38608,19,92,52287,37098
264,25,5,1,0,3,1,0,126,120,49823,38609,125,23,52290,37098
265,25,0,1,1,0,0,3,112,71,49823,38610,96,33,52290,37101
266,25,0,1,1,0,0,3,70,76,49823,38611,77,12,52290,37104
267,25,3,0,0,3,1,0,329,200,49826,38611,359,24,52293,37104
268,25,1,1,2,1,2,1,137,103,49827,38612,142,54,52294,37105
269,25,1,2,1,0,0,3,18,15,49828,38614,20,63,52294,37108
270,25,1,0,0,3,1,0,49,60,49829,38614,61,79,52297,37108
271,25,1,2,1,0,0,3,35,44,49830,38616,44,62,52297,37111
272,25,0,0,2,1,2,1,131,113,49830,38616,168,67,52298,37112
273,25,0,0,2,1,2,1,90,53,49830,38616,100,11,52299,37113
274,25,3,1,0,3,1,0,99,40,49833,38617,122,75,52302,37113
275,26,2,2,2,1,2,1,46,51,49835,38619,46,93,52303,37114
276,26,3,2,0,3,1,0,46,46,49838,38621,48,73,52306,37114
277,26,3,1,0,3,1,0,55,40,49841,38622,62,12,52309,37114
278,26,0,2,1,0,0,3,120,124,49841,38624,122,123,52309,37117
279,26,1,0,0,3,1,0,71,55,49842,38624,81,36,52312,37117
280,26,5,2,0,3,1,0,163,136,49847,38626,182,94,52315,37117
281,26,1,1,2,1,2,1,97,78,49848,38627,117,54,52316,37118
282,26,3,0,0,3,1,0,101,101,49851,38627,116,13,52319,37118
283,26,0,1,1,0,0,3,11,9,49851,38628,17,33,52319,37121
284,26,3,0,0,3,1,0,93,53,49854,38628,103,55,52322,37121
285,26,1,1,2,1,2,1,75,74,49855,38629,78,245,52323,37122
286,27,2,0,0,3,1,0,20,15,49857,38629,23,62,52326,37122
287,27,0,1,1,0,0,3,99,41,49857,38630,122,66,52326,37125
288,27,0,0,2,1,2,1,35,44,49857,38630,45,45,52327,37126
289,27,1,0,0,3,1,0,113,71,49858,38630,99,54,52330,37126
290,27,2,0,0,3,1,0,51,60,49860,38630,64,11,52333,37126
291,27,2,1,0,3,1,0,29,23,49862,38631,22,33,52336,37126
292,27,4,1,0,3,1,0,130,121,49866,38632,128,24,52339,37126
293,27,2,0,0,3,1,0,139,103,49868,38632,145,67,52342,37126
294,27,3,1,0,3,1,0,134,114,49871,38633,171,79,52345,37126
295,27,1,1,2,1,2,1,330,201,49872,38634,360,76,52346,37127
296,27,0,1,1,0,0,3,70,77,49872,38635,77,26,52346,37130
297,28,3,3,2,1,2,1,166,139,49875,38638,183,74,52347,37131
298,28,1,2,1,0,0,3,72,57,49876,38640,81,126,52347,37134
299,28,0,1,1,0,0,3,101,102,49876,38641,116,57,52347,37137
300,28,0,2,1,0,0,3,75,76,49876,38643,78,96,52347,37140
301,28,1,1,2,1,2,1,47,52,49877,38644,47,27,52348,37141
302,28,1,0,0,3,1,0,12,9,49878,38644,20,13,52351,37141
303,28,2,0,0,3,1,0,95,53,49880,38644,106,36,52354,37141
304,28,3,1,0,3,1,0,38,45,49883,38645,48,55,52357,37141
305,28,2,0,0,3,1,0,48,46,49885,38645,51,12,52360,37141
306,28,4,0,0,3,1,0,124,124,49889,38645,125,94,52363,37141
307,28,0,2,1,0,0,3,97,80,49889,38647,117,248,52363,37144
308,29,0,1,1,0,0,3,134,115,49889,38648,171,14,52363,37147
309,29,4,3,0,3,1,0,117,74,49893,38651,102,67,52366,37147
310,29,0,0,2,1,2,1,20,15,49893,38651,24,46,52367,37148
311,29,0,1,1,0,0,3,70,78,49893,38652,77,36,52367,37151
312,29,0,3,1,0,0,3,55,43,49893,38655,62,27,52367,37154
313,29,2,3,1,0,0,3,132,124,49895,38658,128,79,52367,37157
314,29,2,1,0,3,1,0,332,202,49897,38659,363,66,52370,37157
315,29,2,1,0,3,1,0,141,104,49899,38660,148,79,52373,37157
316,29,2,1,0,3,1,0,53,61,49901,38661,67,33,52376,37157
317,29,2,1,0,3,1,0,101,42,49903,38662,125,62,52379,37157
318,29,1,1,2,1,2,1,30,24,49904,38663,23,55,52380,37158
319,30,2,0,0,3,1,0,168,139,49906,38663,186,12,52383,37158
320,30,5,2,0,3,1,0,129,126,49911,38665,128,74,52386,37158
321,30,1,3,1,0,0,3,73,60,49912,38668,81,97,52386,37161
322,30,0,1,1,0,0,3,101,103,49912,38669,116,251,52386,37164
323,30,4,1,0,3,1,0,101,81,49916,38670,120,96,52389,37164
324,30,0,1,1,0,0,3,38,46,49916,38671,48,16,52389,37167
325,30,1,1,2,1,2,1,54,62,49917,38672,68,56,52390,37168
326,30,2,2,2,1,2,1,50,48,49919,38674,52,37,52391,37169
327,30,3,1,0,3,1,0,78,77,49922,38675,81,27,52394,37169
328,30,3,1,0,3,1,0,98,54,49925,38676,109,126,52397,37169
329,30,0,2,1,0,0,3,12,11,49925,38678,20,60,52397,37172
330,31,3,2,0,3,1,0,23,17,49928,38680,27,36,52400,37172
331,31,0,1,1,0,0,3,117,75,49928,38681,102,82,52400,37175
332,31,4,0,0,3,1,0,145,104,49932,38681,151,14,52403,37175
333,31,1,2,1,0,0,3,71,80,49933,38683,77,30,52403,37178
334,31,4,0,0,3,1,0,34,24,49937,38683,26,67,52406,37178
335,31,0,2,1,0,0,3,47,54,49937,38685,47,58,52406,37181
336,31,0,1,1,0,0,3,132,125,49937,38686,128,69,52406,37184
337,31,0,4,1,0,0,3,55,47,49937,38690,62,82,52406,37187
338,31,1,1,2,1,2,1,333,203,49938,38691,364,63,52407,37188
339,31,1,0,0,3,1,0,135,115,49939,38691,174,33,52410,37188
340,31,1,1,2,1,2,1,102,43,49940,38692,126,47,52411,37189
341,32,0,1,1,0,0,3,168,140,49940,38693,186,40,52411,37192
342,32,1,0,0,3,1,0,130,126,49941,38693,131,12,52414,37192
343,32,4,0,0,3,1,0,27,17,49945,38693,30,56,52417,37192
344,32,3,0,0,3,1,0,104,81,49948,38693,123,27,52420,37192
345,32,1,1,2,1,2,1,79,78,49949,38694,82,31,52421,37193
346,32,1,2,1,0,0,3,102,105,49950,38696,116,99,52421,37196
347,32,0,0,2,1,2,1,54,62,49950,38696,69,127,52422,37197
348,32,2,0,0,3,1,0,75,60,49952,38696,84,74,52425,37197
349,32,1,5,1,0,0,3,13,16,49953,38701,20,254,52425,37200
350,32,1,1,2,1,2,1,39,47,49954,38702,49,61,52426,37201
351,32,2,1,0,3,1,0,100,55,49956,38703,112,97,52429,37201
352,33,1,1,2,1,2,1,118,76,49957,38704,103,15,52430,37202
353,33,0,1,1,0,0,3,50,49,49957,38705,52,85,52430,37205
354,33,0,0,2,1,2,1,135,115,49957,38705,175,17,52431,37206
355,33,0,1,1,0,0,3,102,44,49957,38706,126,39,52431,37209
356,33,0,0,2,1,2,1,71,80,49957,38706,78,59,52432,37210
357,33,3,1,0,3,1,0,50,55,49960,38707,50,67,52435,37210
358,33,6,1,0,3,1,0,339,204,49966,38708,367,47,52438,37210
359,33,5,2,0,3,1,0,150,106,49971,38710,154,33,52441,37210
360,33,2,1,0,3,1,0,134,126,49973,38711,131,63,52444,37210
361,33,4,3,0,3,1,0,59,50,49977,38714,65,69,52447,37210
362,33,5,1,0,3,1,0,39,25,49982,38715,29,82,52450,37210
363,34,0,0,2,1,2,1,168,140,49982,38715,187,60,52451,37211
364,34,3,0,0,3,1,0,133,126,49985,38715,134,40,52454,37211
365,34,1,0,0,3,1,0,14,16,49986,38715,23,99,52457,37211
366,34,0,1,1,0,0,3,54,63,49986,38716,69,100,52457,37214
367,34,0,1,1,0,0,3,27,18,49986,38717,30,64,52457,37217
368,34,1,3,1,0,0,3,76,63,49987,38720,84,15,52457,37220
369,34,0,1,1,0,0,3,100,56,49987,38721,112,77,52457,37223
370,34,0,1,1,0,0,3,104,82,49987,38722,123,34,52457,37226
371,34,1,1,2,1,2,1,40,48,49988,38723,50,255,52458,37227
372,34,2,1,0,3,1,0,137,116,49990,38724,178,56,52461,37227
373,34,4,3,0,3,1,0,106,108,49994,38727,119,27,52464,37227
374,35,1,1,2,1,2,1,60,51,49995,38728,66,64,52465,37228
375,35,4,0,0,3,1,0,154,106,49999,38728,157,17,52468,37228
376,35,1,2,1,0,0,3,72,82,50000,38730,78,88,52468,37231
377,35,1,0,0,3,1,0,51,49,50001,38730,55,69,52471,37231
378,35,1,0,0,3,1,0,51,55,50002,38730,53,82,52474,37231
379,35,1,0,0,3,1,0,103,44,50003,38730,129,127,52477,37231
380,35,1,0,0,3,1,0,80,78,50004,38730,85,67,52480,37231
381,35,1,1,2,1,2,1,135,127,50005,38731,132,48,52481,37232
382,35,1,1,2,1,2,1,119,77,50006,38732,104,34,52482,37233
383,35,1,0,0,3,1,0,340,204,50007,38732,370,39,52485,37233
384,35,6,1,0,3,1,0,45,26,50013,38733,32,15,52488,37233
385,36,2,0,0,3,1,0,16,16,50015,38733,26,27,52491,37233
386,36,1,2,1,0,0,3,55,65,50016,38735,69,80,52491,37236
387,36,0,0,2,1,2,1,27,18,50016,38735,31,256,52492,37237
388,36,5,1,0,3,1,0,109,83,50021,38736,126,88,52495,37237
389,36,0,1,1,0,0,3,133,127,50021,38737,134,63,52495,37240
390,36,2,1,0,3,1,0,105,45,50023,38738,132,56,52498,37240
391,36,1,1,2,1,2,1,107,109,50024,38739,120,35,52499,37241
392,36,0,0,2,1,2,1,137,116,50024,38739,179,101,52500,37242
393,36,1,0,0,3,1,0,41,48,50025,38739,53,99,52503,37242
394,36,1,0,0,3,1,0,77,63,50026,38739,87,40,52506,37242
395,36,3,3,2,1,2,1,103,59,50029,38742,113,16,52507,37243
396,37,1,3,1,0,0,3,73,85,50030,38745,78,70,52507,37246
397,37,4,2,0,3,1,0,172,142,50034,38747,190,69,52510,37246
398,37,2,2,2,1,2,1,121,79,50036,38749,105,18,52511,37247
399,37,1,0,0,3,1,0,52,49,50037,38749,58,64,52514,37247
400,37,3,2,0,3,1,0,157,108,50040,38751,160,64,52517,37247
401,37,1,1,2,1,2,1,52,56,50041,38752,54,16,52518,37248
402,37,2,1,0,3,1,0,82,79,50043,38753,88,82,52521,37248
403,37,2,3,1,0,0,3,342,207,50045,38756,370,130,52521,37251
404,37,2,0,0,3,1,0,47,26,50047,38756,35,34,52524,37251
405,37,2,1,0,3,1,0,137,128,50049,38757,135,39,52527,37251
406,37,2,1,0,3,1,0,62,52,50051,38758,69,48,52530,37251
407,38,1,1,2,1,2,1,138,117,50052,38759,180,81,52531,37252
408,38,3,0,0,3,1,0,136,127,50055,38759,137,70,52534,37252
409,38,2,2,2,1,2,1,105,61,50057,38761,114,41,52535,37253
410,38,3,5,1,0,0,3,30,23,50060,38766,31,102,52535,37256
411,38,2,4,1,0,0,3,159,112,50062,38770,160,59,52535,37259
412,38,0,0,2,1,2,1,107,109,50062,38770,121,89,52536,37260
413,38,1,1,2,1,2,1,42,49,50063,38771,54,28,52537,37261
414,38,0,0,2,1,2,1,16,16,50063,38771,27,36,52538,37262
415,38,1,3,1,0,0,3,106,48,50064,38774,132,259,52538,37265
416,38,1,0,0,3,1,0,56,65,50065,38774,72,16,52541,37265
417,38,0,2,1,0,0,3,77,65,50065,38776,87,66,52541,37268
418,39,0,2,1,0,0,3,73,87,50065,38778,78,72,52541,37271
419,39,0,0,2,1,2,1,172,142,50065,38778,191,65,52542,37272
420,39,3,1,0,3,1,0,50,27,50068,38779,38,18,52545,37272
421,39,1,1,2,1,2,1,122,80,50069,38780,106,65,52546,37273
422,39,1,1,2,1,2,1,53,50,50070,38781,59,49,52547,37274
423,39,4,1,0,3,1,0,346,208,50074,38782,373,101,52550,37274
424,39,2,2,2,1,2,1,111,85,50076,38784,127,83,52551,37275
425,39,2,1,0,3,1,0,139,129,50078,38785,138,130,52554,37275
426,39,1,0,0,3,1,0,83,79,50079,38785,91,16,52557,37275
427,39,0,2,1,0,0,3,62,54,50079,38787,69,42,52557,37278
428,39,3,1,0,3,1,0,55,57,50082,38788,57,34,52560,37278
429,40,2,1,0,3,1,0,109,110,50084,38789,124,72,52563,37278
430,40,1,0,0,3,1,0,17,16,50085,38789,30,89,52566,37278
431,40,0,3,1,0,0,3,106,51,50085,38792,132,105,52566,37281
432,40,2,1,0,3,1,0,79,66,50087,38793,90,70,52569,37281
433,40,1,0,0,3,1,0,160,112,50088,38793,163,81,52572,37281
434,40,0,2,1,0,0,3,42,51,50088,38795,54,39,52572,37284
435,40,1,1,2,1,2,1,139,118,50089,38796,181,17,52573,37285
436,40,2,0,0,3,1,0,32,23,50091,38796,34,28,52576,37285
437,40,0,0,2,1,2,1,56,65,50091,38796,73,42,52577,37286
438,40,3,2,0,3,1,0,108,63,50094,38798,117,66,52580,37286
439,40,3,2,0,3,1,0,349,210,50097,38800,376,59,52583,37286
440,41,0,0,2,1,2,1,62,54,50097,38800,70,131,52584,37287
441,41,3,1,0,3,1,0,112,111,50100,38801,127,59,52587,37287
442,41,0,0,2,1,2,1,136,127,50100,38801,138,66,52588,37288
443,41,1,2,1,0,0,3,112,87,50101,38803,127,19,52588,37291
444,41,2,1,0,3,1,0,174,143,50103,38804,194,49,52591,37291
445,41,0,2,1,0,0,3,83,81,50103,38806,91,37,52591,37294
446,41,2,2,2,1,2,1,55,52,50105,38808,60,43,52592,37295
447,41,0,1,1,0,0,3,55,58,50105,38809,57,21,52592,37298
448,41,4,0,0,3,1,0,54,27,50109,38809,41,65,52595,37298
449,41,2,1,0,3,1,0,141,130,50111,38810,141,101,52598,37298
450,41,0,3,1,0,0,3,122,83,50111,38813,106,262,52598,37301
451,42,0,0,2,1,2,1,79,66,50111,38813,91,84,52599,37302
452,42,2,1,0,3,1,0,19,17,50113,38814,33,72,52602,37302
453,42,1,0,0,3,1,0,43,51,50114,38814,57,89,52605,37302
454,42,3,0,0,3,1,0,59,65,50117,38814,76,66,52608,37302
455,42,2,2,2,1,2,1,34,25,50119,38816,35,40,52609,37303
456,42,3,1,0,3,1,0,142,119,50122,38817,184,42,52612,37303
457,42,4,0,0,3,1,0,110,51,50126,38817,135,28,52615,37303
458,42,1,1,2,1,2,1,161,113,50127,38818,164,18,52616,37304
459,42,1,0,0,3,1,0,350,210,50128,38818,379,105,52619,37304
460,42,2,1,0,3,1,0,75,88,50130,38819,81,81,52622,37304
461,42,1,0,0,3,1,0,109,63,50131,38819,120,70,52625,37304
0,1,1,0,0,3,1,0,162,113,50132,38819,167,88,52628,37304
1,1,2,1,0,3,1,0,21,18,50134,38820,36,81,52631,37304
2,1,1,1,2,1,2,1,84,82,50135,38821,92,46,52632,37305
3,1,0,1,1,0,0,3,174,144,50135,38822,194,120,52632,37308
4,1,1,0,0,3,1,0,113,87,50136,38822,130,40,52635,37308
5,1,0,0,2,1,2,1,34,25,50136,38822,36,50,52636,37309
6,1,1,0,0,3,1,0,111,51,50137,38822,138,14,52639,37309
7,1,1,0,0,3,1,0,137,127,50138,38822,141,18,52642,37309
8,1,4,0,0,3,1,0,66,54,50142,38822,73,49,52645,37309
9,1,1,2,1,0,0,3,1,2,50143,38824,0,121,52645,37312
10,1,2,3,1,0,0,3,45,54,50145,38827,57,69,52645,37315
11,2,0,1,1,0,0,3,188,186,50145,38828,194,73,52645,37318
12,2,0,0,2,1,2,1,68,78,50145,38828,78,20,52646,37319
13,2,1,1,2,1,2,1,92,103,50146,38829,128,90,52647,37320
14,2,0,3,1,0,0,3,165,158,50146,38832,177,104,52647,37323
15,2,2,1,0,3,1,0,124,84,50148,38833,109,21,52650,37323
16,2,0,1,1,0,0,3,54,28,50148,38834,41,68,52650,37326
17,2,0,0,2,1,2,1,22,31,50148,38834,25,67,52651,37327
18,2,1,1,2,1,2,1,80,67,50149,38835,92,73,52652,37328
19,2,2,0,0,3,1,0,57,52,50151,38835,63,28,52655,37328
20,2,4,2,0,3,1,0,113,65,50155,38837,123,0,52658,37328
21,2,2,4,1,0,0,3,99,90,50157,38841,116,40,52658,37331
22,3,2,1,0,3,1,0,86,83,50159,38842,95,18,52661,37331
23,3,1,1,2,1,2,1,175,145,50160,38843,195,122,52662,37332
24,3,2,2,2,1,2,1,164,115,50162,38845,168,51,52663,37333
25,3,1,0,0,3,1,0,125,84,50163,38845,112,46,52666,37333
26,3,3,0,0,3,1,0,140,127,50166,38845,144,49,52669,37333
27,3,0,3,1,0,0,3,66,57,50166,38848,73,123,52669,37336
28,3,2,0,0,3,1,0,23,18,50168,38848,39,14,52672,37336
29,3,1,1,2,1,2,1,114,88,50169,38849,131,89,52673,37337
30,3,4,2,0,3,1,0,38,27,50173,38851,39,0,52676,37337
31,3,2,2,2,1,2,1,47,56,50175,38853,58,41,52677,37338
32,3,3,0,0,3,1,0,114,51,50178,38853,141,69,52680,37338
33,4,0,1,1,0,0,3,68,79,50178,38854,78,24,52680,37341
34,4,2,1,0,3,1,0,101,91,50180,38855,119,68,52683,37341
35,4,1,1,2,1,2,1,93,104,50181,38856,129,29,52684,37342
36,4,1,1,2,1,2,1,114,66,50182,38857,124,91,52685,37343
37,4,0,1,1,0,0,3,188,187,50182,38858,194,43,52685,37346
38,4,2,2,2,1,2,1,59,54,50184,38860,64,74,52686,37347
39,4,2,2,2,1,2,1,24,33,50186,38862,26,82,52687,37348
40,4,0,1,1,0,0,3,54,29,50186,38863,41,23,52687,37351
41,4,1,0,0,3,1,0,166,158,50187,38863,180,73,52690,37351
42,4,3,1,0,3,1,0,4,3,50190,38864,3,104,52693,37351
43,4,2,0,0,3,1,0,82,67,50192,38864,95,67,52696,37351
44,5,3,0,0,3,1,0,71,79,50195,38864,81,14,52699,37351
45,5,0,3,1,0,0,3,23,21,50195,38867,39,72,52699,37354
46,5,3,1,0,3,1,0,117,89,50198,38868,134,51,52702,37354
47,5,1,2,1,0,0,3,39,29,50199,38870,39,107,52702,37357
48,5,1,0,0,3,1,0,67,57,50200,38870,76,122,52705,37357
49,5,2,0,0,3,1,0,127,84,50202,38870,115,18,52708,37357
50,5,2,0,0,3,1,0,142,127,50204,38870,147,123,52711,37357
51,5,2,2,2,1,2,1,88,85,50206,38872,96,50,52712,37358
52,5,1,0,0,3,1,0,176,145,50207,38872,198,0,52715,37358
53,5,2,1,0,3,1,0,49,57,50209,38873,61,89,52718,37358
54,5,0,1,1,0,0,3,114,52,50209,38874,141,44,52718,37361
55,6,3,0,0,3,1,0,85,67,50212,38874,98,82,52721,37361
56,6,0,1,1,0,0,3,24,34,50212,38875,26,27,52721,37364
57,6,3,1,0,3,1,0,117,67,50215,38876,127,29,52724,37364
58,6,0,0,2,1,2,1,166,158,50215,38876,181,44,52725,37365
59,6,1,2,1,0,0,3,55,31,50216,38878,41,49,52725,37368
60,6,3,0,0,3,1,0,96,104,50219,38878,132,74,52728,37368
61,6,1,0,0,3,1,0,102,91,50220,38878,122,23,52731,37368
62,6,5,1,0,3,1,0,64,55,50225,38879,67,67,52734,37368
63,6,0,2,1,0,0,3,164,117,50225,38881,168,94,52734,37371
64,6,1,0,0,3,1,0,189,187,50226,38881,197,68,52737,37371
65,6,0,0,2,1,2,1,4,3,50226,38881,4,74,52738,37372
66,7,3,2,0,3,1,0,145,129,50229,38883,150,122,52741,37372
67,7,3,0,0,3,1,0,70,57,50232,38883,79,0,52744,37372
68,7,3,0,0,3,1,0,42,29,50235,38883,42,94,52747,37372
69,7,2,0,0,3,1,0,116,52,50237,38883,144,89,52750,37372
70,7,0,2,1,0,0,3,88,87,50237,38885,96,126,52750,37375
71,7,0,1,1,0,0,3,127,85,50237,38886,115,53,52750,37378
72,7,1,0,0,3,1,0,24,21,50238,38886,42,44,52753,37378
73,7,2,0,0,3,1,0,119,89,50240,38886,137,107,52756,37378
74,7,1,0,0,3,1,0,25,34,50241,38886,29,18,52759,37378
75,7,1,2,1,0,0,3,72,81,50242,38888,81,75,52759,37381
76,7,2,1,0,3,1,0,51,58,50244,38889,64,51,52762,37381
77,8,0,0,2,1,2,1,117,67,50244,38889,128,75,52763,37382
78,8,2,0,0,3,1,0,178,145,50246,38889,201,74,52766,37382
79,8,0,0,2,1,2,1,189,187,50246,38889,198,24,52767,37383
80,8,2,4,1,0,0,3,104,95,50248,38893,122,52,52767,37386
81,8,2,1,0,3,1,0,87,68,50250,38894,101,14,52770,37386
82,8,1,0,0,3,1,0,65,55,50251,38894,70,82,52773,37386
83,8,0,0,2,1,2,1,166,158,50251,38894,182,69,52774,37387
84,8,1,1,2,1,2,1,165,118,50252,38895,169,30,52775,37388
85,8,3,2,0,3,1,0,7,5,50255,38897,7,44,52778,37388
86,8,2,0,0,3,1,0,57,31,50257,38897,44,27,52781,37388
87,8,3,1,0,3,1,0,99,105,50260,38898,135,67,52784,37388
88,9,2,3,1,0,0,3,26,24,50262,38901,42,92,52784,37391
89,9,1,0,0,3,1,0,43,29,50263,38901,45,74,52787,37391
90,9,1,0,0,3,1,0,52,58,50264,38901,67,107,52790,37391
91,9,1,2,1,0,0,3,58,33,50265,38903,44,78,52790,37394
92,9,0,0,2,1,2,1,70,57,50265,38903,80,95,52791,37395
93,9,0,1,1,0,0,3,127,86,50265,38904,115,129,52791,37398
94,9,1,1,2,1,2,1,146,130,50266,38905,151,1,52792,37399
95,9,0,1,1,0,0,3,25,35,50266,38906,29,56,52792,37402
96,9,0,0,2,1,2,1,88,87,50266,38906,97,123,52793,37403
97,9,2,1,0,3,1,0,74,82,50268,38907,84,44,52796,37403
98,9,0,1,1,0,0,3,116,53,50268,38908,144,54,52796,37406
99,10,0,1,1,0,0,3,65,56,50268,38909,70,17,52796,37409
100,10,2,3,1,0,0,3,101,108,50270,38912,135,85,52796,37412
101,10,1,0,0,3,1,0,120,89,50271,38912,140,30,52799,37412
102,10,3,3,2,1,2,1,90,71,50274,38915,102,28,52800,37413
103,10,1,1,2,1,2,1,190,188,50275,38916,199,53,52801,37414
104,10,1,0,0,3,1,0,167,158,50276,38916,185,24,52804,37414
105,10,1,0,0,3,1,0,8,5,50277,38916,10,69,52807,37414
106,10,2,0,0,3,1,0,106,95,50279,38916,125,18,52810,37414
107,10,2,1,0,3,1,0,167,119,50281,38917,172,75,52813,37414
108,10,0,0,2,1,2,1,178,145,50281,38917,202,45,52814,37415
109,10,1,1,2,1,2,1,118,68,50282,38918,129,68,52815,37416
110,11,2,2,2,1,2,1,76,84,50284,38920,85,93,52816,37417
111,11,2,0,0,3,1,0,27,35,50286,38920,32,129,52819,37417
112,11,3,1,0,3,1,0,93,72,50289,38921,105,56,52822,37417
113,11,0,2,1,0,0,3,127,88,50289,38923,115,126,52822,37420
114,11,0,0,2,1,2,1,26,24,50289,38923,43,55,52823,37421
115,11,0,1,1,0,0,3,88,88,50289,38924,97,4,52823,37424
116,11,2,3,1,0,0,3,148,133,50291,38927,151,98,52823,37427
117,11,1,0,0,3,1,0,44,29,50292,38927,48,30,52826,37427
118,11,2,2,2,1,2,1,54,60,50294,38929,68,75,52827,37428
119,11,1,1,2,1,2,1,59,34,50295,38930,45,45,52828,37429
120,11,0,0,2,1,2,1,116,53,50295,38930,145,108,52829,37430
121,12,3,2,0,3,1,0,170,160,50298,38932,188,53,52832,37430
122,12,1,0,0,3,1,0,119,68,50299,38932,132,85,52835,37430
123,12,0,0,2,1,2,1,106,95,50299,38932,126,29,52836,37431
124,12,2,2,2,1,2,1,169,121,50301,38934,173,69,52837,37432
125,12,1,0,0,3,1,0,179,145,50302,38934,205,69,52840,37432
126,12,2,2,2,1,2,1,122,91,50304,38936,141,76,52841,37433
127,12,1,2,1,0,0,3,9,7,50305,38938,10,27,52841,37436
128,12,2,1,0,3,1,0,72,58,50307,38939,83,45,52844,37436
129,12,2,2,2,1,2,1,103,110,50309,38941,136,18,52845,37437
130,12,2,0,0,3,1,0,192,188,50311,38941,202,18,52848,37437
131,12,3,1,0,3,1,0,68,57,50314,38942,73,78,52851,37437
132,13,1,1,2,1,2,1,45,30,50315,38943,49,46,52852,37438
133,13,0,3,1,0,0,3,127,91,50315,38946,115,7,52852,37441
134,13,1,2,1,0,0,3,77,86,50316,38948,85,58,52852,37444
135,13,0,0,2,1,2,1,116,53,50316,38948,146,76,52853,37445
136,13,2,1,0,3,1,0,90,89,50318,38949,100,98,52856,37445
137,13,0,1,1,0,0,3,93,73,50318,38950,105,132,52856,37448
138,13,2,2,2,1,2,1,108,97,50320,38952,127,46,52857,37449
139,13,1,2,1,0,0,3,27,26,50321,38954,43,111,52857,37452
140,13,3,1,0,3,1,0,151,134,50324,38955,154,30,52860,37452
141,13,2,0,0,3,1,0,29,35,50326,38955,35,126,52863,37452
142,13,1,0,0,3,1,0,60,34,50327,38955,48,93,52866,37452
143,14,0,2,1,0,0,3,68,59,50327,38957,73,32,52866,37455
144,14,3,3,2,1,2,1,106,113,50330,38960,137,79,52867,37456
145,14,1,2,1,0,0,3,170,123,50331,38962,173,88,52867,37459
146,14,1,1,2,1,2,1,55,61,50332,38963,69,77,52868,37460
147,14,3,0,0,3,1,0,12,7,50335,38963,13,53,52871,37460
148,14,3,1,0,3,1,0,182,146,50338,38964,208,27,52874,37460
149,14,1,2,1,0,0,3,73,60,50339,38966,83,72,52874,37463
150,14,3,1,0,3,1,0,195,189,50342,38967,205,56,52877,37463
151,14,0,0,2,1,2,1,119,68,50342,38967,133,19,52878,37464
152,14,6,0,0,3,1,0,176,160,50348,38967,191,18,52881,37464
153,14,4,2,0,3,1,0,126,93,50352,38969,144,69,52884,37464
154,15,2,1,0,3,1,0,110,98,50354,38970,130,93,52887,37464
155,15,0,0,2,1,2,1,60,34,50354,38970,49,59,52888,37465
156,15,1,2,1,0,0,3,128,93,50355,38972,115,101,52888,37468
157,15,1,3,1,0,0,3,46,33,50356,38975,49,80,52888,37471
158,15,1,2,1,0,0,3,94,75,50357,38977,105,129,52888,37474
159,15,1,0,0,3,1,0,78,86,50358,38977,88,111,52891,37474
160,15,3,1,0,3,1,0,30,27,50361,38978,46,76,52894,37474
161,15,3,0,0,3,1,0,93,89,50364,38978,103,30,52897,37474
162,15,2,1,0,3,1,0,31,36,50366,38979,38,7,52900,37474
163,15,0,1,1,0,0,3,68,60,50366,38980,73,135,52900,37477
164,15,0,0,2,1,2,1,116,53,50366,38980,147,47,52901,37478
165,16,0,1,1,0,0,3,176,161,50366,38981,191,59,52901,37481
166,16,1,2,1,0,0,3,127,95,50367,38983,144,91,52901,37484
167,16,0,0,2,1,2,1,195,189,50367,38983,206,33,52902,37485
168,16,0,1,1,0,0,3,182,147,50367,38984,208,56,52902,37488
169,16,1,2,1,0,0,3,56,63,50368,38986,69,72,52902,37491
170,16,2,2,2,1,2,1,108,115,50370,38988,138,47,52903,37492
171,16,2,2,2,1,2,1,172,125,50372,38990,174,20,52904,37493
172,16,3,1,0,3,1,0,76,61,50375,38991,86,27,52907,37493
173,16,2,2,2,1,2,1,153,136,50377,38993,155,73,52908,37494
174,16,0,1,1,0,0,3,12,8,50377,38994,13,21,52908,37497
175,16,2,3,1,0,0,3,121,71,50379,38997,133,82,52908,37500
176,17,3,2,0,3,1,0,63,36,50382,38999,52,111,52911,37500
177,17,1,2,1,0,0,3,47,35,50383,39001,49,76,52911,37503
178,17,1,1,2,1,2,1,95,76,50384,39002,106,8,52912,37504
179,17,3,0,0,3,1,0,34,36,50387,39002,41,101,52915,37504
180,17,2,0,0,3,1,0,130,93,50389,39002,118,30,52918,37504
181,17,0,1,1,0,0,3,93,90,50389,39003,103,83,52918,37507
182,17,2,1,0,3,1,0,197,190,50391,39004,209,93,52921,37507
183,17,0,0,2,1,2,1,110,98,50391,39004,131,60,52922,37508
184,17,1,1,2,1,2,1,31,28,50392,39005,47,48,52923,37509
185,17,2,1,0,3,1,0,80,87,50394,39006,91,76,52926,37509
186,17,2,1,0,3,1,0,70,61,50396,39007,76,129,52929,37509
187,18,1,0,0,3,1,0,77,61,50397,39007,89,56,52932,37509
188,18,2,1,0,3,1,0,110,116,50399,39008,141,33,52935,37509
189,18,0,2,1,0,0,3,116,55,50399,39010,147,75,52935,37512
190,18,1,1,2,1,2,1,173,126,50400,39011,175,83,52936,37513
191,18,0,2,1,0,0,3,182,149,50400,39013,208,24,52936,37516
192,18,2,0,0,3,1,0,123,71,50402,39013,136,47,52939,37516
193,18,2,1,0,3,1,0,178,162,50404,39014,194,135,52942,37516
194,18,3,2,0,3,1,0,156,138,50407,39016,158,27,52945,37516
195,18,3,1,0,3,1,0,59,64,50410,39017,72,91,52948,37516
196,18,1,0,0,3,1,0,128,95,50411,39017,147,20,52951,37516
197,18,2,1,0,3,1,0,14,9,50413,39018,16,59,52954,37516
198,19,1,3,1,0,0,3,48,38,50414,39021,49,78,52954,37519
199,19,0,2,1,0,0,3,110,118,50414,39023,141,132,52954,37522
200,19,3,3,2,1,2,1,200,193,50417,39026,210,61,52955,37523
201,19,2,2,2,1,2,1,132,95,50419,39028,119,84,52956,37524
202,19,3,1,0,3,1,0,66,37,50422,39029,55,76,52959,37524
203,19,0,3,1,0,0,3,34,39,50422,39032,41,33,52959,37527
204,19,1,3,1,0,0,3,96,79,50423,39035,106,104,52959,37530
205,19,1,0,0,3,1,0,71,61,50424,39035,79,8,52962,37530
206,19,2,0,0,3,1,0,112,98,50426,39035,134,111,52965,37530
207,19,0,0,2,1,2,1,80,87,50426,39035,92,49,52966,37531
208,19,1,1,2,1,2,1,32,29,50427,39036,48,77,52967,37532
209,20,0,0,2,1,2,1,48,38,50427,39036,50,133,52968,37533
210,20,0,2,1,0,0,3,123,73,50427,39038,136,96,52968,37536
211,20,3,2,0,3,1,0,80,63,50430,39040,92,24,52971,37536
212,20,1,0,0,3,1,0,94,90,50431,39040,106,27,52974,37536
213,20,1,2,1,0,0,3,60,66,50432,39042,72,23,52974,37539
214,20,2,0,0,3,1,0,130,95,50434,39042,150,83,52977,37539
215,20,2,2,2,1,2,1,184,151,50436,39044,209,60,52978,37540
216,20,2,3,1,0,0,3,158,141,50438,39047,158,59,52978,37543
217,20,1,1,2,1,2,1,174,127,50439,39048,176,48,52979,37544
218,20,2,2,2,1,2,1,118,57,50441,39050,148,92,52980,37545
219,20,0,0,2,1,2,1,14,9,50441,39050,17,136,52981,37546
220,21,1,2,1,0,0,3,111,120,50442,39052,141,11,52981,37549
221,21,0,0,2,1,2,1,200,193,50442,39052,211,112,52982,37550
222,21,2,2,2,1,2,1,68,39,50444,39054,56,50,52983,37551
223,21,0,0,2,1,2,1,71,61,50444,39054,80,105,52984,37552
224,21,2,2,2,1,2,1,114,100,50446,39056,135,77,52985,37553
225,21,1,2,1,0,0,3,179,164,50447,39058,194,64,52985,37556
226,21,1,2,1,0,0,3,97,81,50448,39060,106,36,52985,37559
227,21,5,0,0,3,1,0,137,95,50453,39060,122,78,52988,37559
228,21,0,0,2,1,2,1,34,39,50453,39060,42,85,52989,37560
229,21,3,1,0,3,1,0,83,88,50456,39061,95,77,52992,37560
230,21,2,0,0,3,1,0,34,29,50458,39061,51,33,52995,37560
231,22,1,2,1,0,0,3,69,41,50459,39063,56,88,52995,37563
232,22,1,1,2,1,2,1,112,121,50460,39064,142,113,52996,37564
233,22,0,0,2,1,2,1,97,81,50460,39064,107,51,52997,37565
234,22,0,4,1,0,0,3,34,43,50460,39068,42,80,52997,37568
235,22,1,2,1,0,0,3,201,195,50461,39070,211,108,52997,37571
236,22,4,1,0,3,1,0,118,101,50465,39071,138,36,53000,37571
237,22,2,0,0,3,1,0,181,164,50467,39071,197,11,53003,37571
238,22,0,1,1,0,0,3,123,74,50467,39072,136,36,53003,37574
239,22,1,1,2,1,2,1,138,96,50468,39073,123,28,53004,37575
240,22,0,0,2,1,2,1,83,88,50468,39073,96,79,53005,37576
241,22,0,1,1,0,0,3,71,62,50468,39074,80,80,53005,37579
242,23,1,1,2,1,2,1,175,128,50469,39075,177,134,53006,37580
243,23,0,1,1,0,0,3,34,30,50469,39076,51,62,53006,37583
244,23,0,1,1,0,0,3,130,96,50469,39077,150,139,53006,37586
245,23,1,0,0,3,1,0,49,38,50470,39077,53,92,53009,37586
246,23,0,2,1,0,0,3,184,153,50470,39079,209,99,53009,37589
247,23,0,0,2,1,2,1,158,141,50470,39079,159,84,53010,37590
248,23,1,1,2,1,2,1,81,64,50471,39080,93,49,53011,37591
249,23,0,0,2,1,2,1,14,9,50471,39080,18,65,53012,37592
250,23,2,3,1,0,0,3,96,93,50473,39083,106,26,53012,37595
251,23,0,2,1,0,0,3,118,59,50473,39085,148,27,53012,37598
252,23,2,2,2,1,2,1,62,68,50475,39087,73,61,53013,37599
253,24,4,0,0,3,1,0,73,41,50479,39087,59,79,53016,37599
254,24,2,1,0,3,1,0,203,196,50481,39088,214,36,53019,37599
255,24,1,0,0,3,1,0,182,164,50482,39088,200,108,53022,37599
256,24,2,0,0,3,1,0,73,62,50484,39088,83,51,53025,37599
257,24,1,3,1,0,0,3,119,104,50485,39091,138,91,53025,37602
258,24,0,2,1,0,0,3,83,90,50485,39093,96,95,53025,37605
259,24,1,1,2,1,2,1,113,122,50486,39094,143,81,53026,37606
260,24,0,0,2,1,2,1,123,74,50486,39094,137,114,53027,37607
261,24,0,0,2,1,2,1,14,9,50486,39094,19,37,53028,37608
262,24,3,0,0,3,1,0,37,43,50489,39094,45,28,53031,37608
263,24,2,1,0,3,1,0,99,82,50491,39095,110,80,53034,37608
264,25,0,4,1,0,0,3,81,68,50491,39099,93,102,53034,37611
265,25,1,0,0,3,1,0,50,38,50492,39099,56,62,53037,37611
266,25,0,0,2,1,2,1,184,153,50492,39099,210,66,53038,37612
267,25,1,1,2,1,2,1,176,129,50493,39100,178,12,53039,37613
268,25,1,2,1,0,0,3,97,95,50494,39102,106,87,53039,37616
269,25,2,0,0,3,1,0,140,96,50496,39102,126,26,53042,37616
270,25,2,1,0,3,1,0,36,31,50498,39103,54,27,53045,37616
271,25,1,1,2,1,2,1,159,142,50499,39104,160,50,53046,37617
272,25,0,2,1,0,0,3,130,98,50499,39106,150,137,53046,37620
273,25,1,0,0,3,1,0,63,68,50500,39106,76,139,53049,37620
274,25,1,1,2,1,2,1,119,60,50501,39107,149,62,53050,37621
275,26,1,1,2,1,2,1,38,44,50502,39108,46,63,53051,37622
276,26,3,1,0,3,1,0,76,42,50505,39109,62,95,53054,37622
277,26,1,0,0,3,1,0,183,164,50506,39109,203,36,53057,37622
278,26,0,1,1,0,0,3,119,105,50506,39110,138,82,53057,37625
279,26,3,0,0,3,1,0,17,9,50509,39110,22,108,53060,37625
280,26,1,1,2,1,2,1,204,197,50510,39111,215,92,53061,37626
281,26,0,2,1,0,0,3,73,64,50510,39113,83,83,53061,37629
282,26,6,0,0,3,1,0,182,129,50516,39113,181,37,53064,37629
283,26,0,1,1,0,0,3,113,123,50516,39114,143,54,53064,37632
284,26,1,0,0,3,1,0,100,82,50517,39114,113,28,53067,37632
285,26,3,0,0,3,1,0,126,74,50520,39114,140,81,53070,37632
286,27,2,0,0,3,1,0,161,142,50522,39114,163,102,53073,37632
287,27,0,1,1,0,0,3,140,97,50522,39115,126,90,53073,37635
288,27,0,0,2,1,2,1,36,31,50522,39115,55,63,53074,37636
289,27,2,1,0,3,1,0,186,154,50524,39116,213,114,53077,37636
290,27,1,2,1,0,0,3,120,62,50525,39118,149,142,53077,37639
291,27,0,0,2,1,2,1,81,68,50525,39118,94,67,53078,37640
292,27,1,0,0,3,1,0,98,95,50526,39118,109,50,53081,37640
293,27,0,0,2,1,2,1,130,98,50526,39118,151,13,53082,37641
294,27,1,3,1,0,0,3,51,41,50527,39121,56,29,53082,37644
295,27,0,2,1,0,0,3,83,92,50527,39123,96,30,53082,37647
296,27,0,0,2,1,2,1,63,68,50527,39123,77,138,53083,37648
297,28,1,0,0,3,1,0,114,123,50528,39123,146,83,53086,37648
298,28,2,2,2,1,2,1,102,84,50530,39125,114,64,53087,37649
299,28,2,2,2,1,2,1,78,44,50532,39127,63,30,53088,37650
300,28,1,2,1,0,0,3,120,107,50533,39129,138,98,53088,37653
301,28,3,0,0,3,1,0,186,164,50536,39129,206,92,53091,37653
302,28,0,1,1,0,0,3,17,10,50536,39130,22,39,53091,37656
303,28,0,1,1,0,0,3,182,130,50536,39131,181,84,53091,37659
304,28,0,0,2,1,2,1,186,154,50536,39131,214,38,53092,37660
305,28,3,2,0,3,1,0,207,199,50539,39133,218,82,53095,37660
306,28,1,1,2,1,2,1,74,65,50540,39134,84,29,53096,37661
307,28,1,0,0,3,1,0,127,74,50541,39134,143,54,53099,37661
308,29,0,0,2,1,2,1,120,62,50541,39134,150,139,53100,37662
309,29,1,0,0,3,1,0,37,31,50542,39134,58,142,53103,37662
310,29,4,0,0,3,1,0,85,68,50546,39134,97,114,53106,37662
311,29,0,1,1,0,0,3,130,99,50546,39135,151,111,53106,37665
312,29,1,1,2,1,2,1,84,93,50547,39136,97,64,53107,37666
313,29,1,0,0,3,1,0,141,97,50548,39136,129,50,53110,37666
314,29,2,0,0,3,1,0,100,95,50550,39136,112,102,53113,37666
315,29,2,2,2,1,2,1,163,144,50552,39138,164,68,53114,37667
316,29,1,0,0,3,1,0,39,44,50553,39138,49,90,53117,37667
317,29,1,1,2,1,2,1,52,42,50554,39139,57,31,53118,37668
318,29,2,0,0,3,1,0,65,68,50556,39139,80,13,53121,37668
319,30,0,2,1,0,0,3,114,125,50556,39141,146,32,53121,37671
320,30,3,2,0,3,1,0,20,12,50559,39143,25,92,53124,37671
321,30,2,3,1,0,0,3,104,87,50561,39146,114,34,53124,37674
322,30,0,0,2,1,2,1,207,199,50561,39146,219,99,53125,37675
323,30,5,0,0,3,1,0,191,154,50566,39146,217,39,53128,37675
324,30,4,2,0,3,1,0,78,67,50570,39148,87,64,53131,37675
325,30,1,1,2,1,2,1,131,100,50571,39149,152,39,53132,37676
326,30,0,1,1,0,0,3,182,131,50571,39150,181,57,53132,37679
327,30,2,0,0,3,1,0,122,107,50573,39150,141,30,53135,37679
328,30,1,1,2,1,2,1,187,165,50574,39151,207,83,53136,37680
329,30,0,1,1,0,0,3,127,75,50574,39152,143,86,53136,37683
330,31,2,1,0,3,1,0,143,98,50576,39153,132,102,53139,37683
331,31,1,4,1,0,0,3,38,35,50577,39157,58,142,53139,37686
332,31,0,0,2,1,2,1,120,62,50577,39157,151,14,53140,37687
333,31,2,0,0,3,1,0,54,42,50579,39157,60,90,53143,37687
334,31,3,2,0,3,1,0,88,70,50582,39159,100,84,53146,37687
335,31,1,3,1,0,0,3,66,71,50583,39162,80,114,53146,37690
336,31,0,1,1,0,0,3,84,94,50583,39163,97,145,53146,37693
337,31,0,0,2,1,2,1,100,95,50583,39163,113,69,53147,37694
338,31,3,1,0,3,1,0,166,145,50586,39164,167,114,53150,37694
339,31,5,0,0,3,1,0,44,44,50591,39164,52,50,53153,37694
340,31,1,2,1,0,0,3,79,46,50592,39166,63,67,53153,37697
341,32,1,1,2,1,2,1,132,101,50593,39167,153,58,53154,37698
342,32,0,0,2,1,2,1,78,67,50593,39167,88,35,53155,37699
343,32,0,0,2,1,2,1,122,107,50593,39167,142,91,53156,37700
344,32,0,0,2,1,2,1,187,165,50593,39167,208,100,53157,37701
345,32,1,1,2,1,2,1,208,200,50594,39168,220,31,53158,37702
346,32,0,1,1,0,0,3,127,76,50594,39169,143,35,53158,37705
347,32,2,1,0,3,1,0,193,155,50596,39170,220,92,53161,37705
348,32,1,1,2,1,2,1,21,13,50597,39171,26,84,53162,37706
349,32,3,1,0,3,1,0,185,132,50600,39172,184,86,53165,37706
350,32,1,0,0,3,1,0,89,70,50601,39172,103,39,53168,37706
351,32,2,2,2,1,2,1,116,127,50603,39174,147,65,53169,37707
352,33,2,0,0,3,1,0,68,71,50605,39174,83,39,53172,37707
353,33,0,2,1,0,0,3,79,48,50605,39176,63,148,53172,37710
354,33,2,0,0,3,1,0,122,62,50607,39176,154,114,53175,37710
355,33,1,0,0,3,1,0,85,94,50608,39176,100,142,53178,37710
356,33,2,1,0,3,1,0,56,43,50610,39177,63,67,53181,37710
357,33,3,0,0,3,1,0,146,98,50613,39177,135,69,53184,37710
358,33,0,0,2,1,2,1,100,95,50613,39177,114,115,53185,37711
359,33,1,2,1,0,0,3,167,147,50614,39179,167,87,53185,37714
360,33,2,0,0,3,1,0,46,44,50616,39179,55,102,53188,37714
361,33,1,0,0,3,1,0,105,87,50617,39179,117,50,53191,37714
362,33,2,1,0,3,1,0,40,36,50619,39180,61,14,53194,37714
363,34,4,0,0,3,1,0,189,132,50623,39180,187,35,53197,37714
364,34,2,2,2,1,2,1,129,78,50625,39182,144,66,53198,37715
365,34,2,1,0,3,1,0,195,156,50627,39183,223,84,53201,37715
366,34,2,0,0,3,1,0,91,70,50629,39183,106,92,53204,37715
367,34,2,0,0,3,1,0,210,200,50631,39183,223,91,53207,37715
368,34,0,3,1,0,0,3,21,16,50631,39186,26,103,53207,37718
369,34,3,1,0,3,1,0,135,102,50634,39187,156,86,53210,37718
370,34,3,1,0,3,1,0,71,72,50637,39188,86,39,53213,37718
371,34,1,2,1,0,0,3,188,167,50638,39190,208,34,53213,37721
372,34,2,2,2,1,2,1,118,129,50640,39192,148,36,53214,37722
373,34,2,0,0,3,1,0,80,67,50642,39192,91,67,53217,37722
374,35,0,1,1,0,0,3,100,96,50642,39193,114,90,53217,37725
375,35,3,0,0,3,1,0,59,43,50645,39193,66,50,53220,37725
376,35,0,1,1,0,0,3,79,49,50645,39194,63,145,53220,37728
377,35,2,1,0,3,1,0,148,99,50647,39195,138,115,53223,37728
378,35,2,1,0,3,1,0,42,37,50649,39196,64,114,53226,37728
379,35,0,3,1,0,0,3,122,110,50649,39199,142,151,53226,37731
380,35,0,2,1,0,0,3,105,89,50649,39201,117,105,53226,37734
381,35,0,0,2,1,2,1,167,147,50649,39201,168,59,53227,37735
382,35,3,2,0,3,1,0,49,46,50652,39203,58,69,53230,37735
383,35,1,0,0,3,1,0,86,94,50653,39203,103,14,53233,37735
384,35,3,1,0,3,1,0,125,63,50656,39204,157,39,53236,37735
385,36,2,0,0,3,1,0,169,147,50658,39204,171,39,53239,37735
386,36,1,0,0,3,1,0,119,129,50659,39204,151,67,53242,37735
387,36,0,3,1,0,0,3,210,203,50659,39207,223,53,53242,37738
388,36,1,1,2,1,2,1,136,103,50660,39208,157,36,53243,37739
389,36,0,2,1,0,0,3,195,158,50660,39210,223,106,53243,37742
390,36,0,0,2,1,2,1,188,167,50660,39210,209,92,53244,37743
391,36,2,1,0,3,1,0,93,71,50662,39211,109,84,53247,37743
392,36,1,0,0,3,1,0,22,16,50663,39211,29,34,53250,37743
393,36,0,0,2,1,2,1,129,78,50663,39211,145,37,53251,37744
394,36,2,0,0,3,1,0,191,132,50665,39211,190,66,53254,37744
395,36,1,1,2,1,2,1,72,73,50666,39212,87,87,53255,37745
396,37,2,1,0,3,1,0,82,68,50668,39213,94,105,53258,37745
397,37,1,0,0,3,1,0,126,63,50669,39213,160,92,53261,37745
398,37,2,2,2,1,2,1,61,45,50671,39215,67,152,53262,37746
399,37,0,1,1,0,0,3,148,100,50671,39216,138,93,53262,37749
400,37,2,3,1,0,0,3,102,99,50673,39219,114,62,53262,37752
401,37,1,2,1,0,0,3,87,96,50674,39221,103,117,53262,37755
402,37,1,1,2,1,2,1,80,50,50675,39222,64,15,53263,37756
403,37,0,2,1,0,0,3,122,112,50675,39224,142,148,53263,37759
404,37,0,0,2,1,2,1,105,89,50675,39224,118,70,53264,37760
405,37,0,1,1,0,0,3,49,47,50675,39225,58,118,53264,37763
406,37,2,2,2,1,2,1,44,39,50677,39227,65,40,53265,37764
407,38,2,1,0,3,1,0,171,148,50679,39228,174,84,53268,37764
408,38,1,1,2,1,2,1,192,133,50680,39229,191,38,53269,37765
409,38,1,1,2,1,2,1,130,79,50681,39230,146,68,53270,37766
410,38,2,1,0,3,1,0,95,72,50683,39231,112,106,53273,37766
411,38,1,0,0,3,1,0,127,63,50684,39231,163,39,53276,37766
412,38,0,0,2,1,2,1,188,167,50684,39231,210,54,53277,37767
413,38,1,0,0,3,1,0,196,158,50685,39231,226,34,53280,37767
414,38,1,2,1,0,0,3,137,105,50686,39233,157,69,53280,37770
415,38,5,0,0,3,1,0,77,73,50691,39233,90,36,53283,37770
416,38,1,1,2,1,2,1,120,130,50692,39234,152,153,53284,37771
417,38,3,1,0,3,1,0,25,17,50695,39235,32,92,53287,37771
418,39,0,0,2,1,2,1,122,112,50695,39235,143,16,53288,37772
419,39,2,2,2,1,2,1,89,98,50697,39237,104,41,53289,37773
420,39,1,1,2,1,2,1,45,40,50698,39238,66,93,53290,37774
421,39,1,2,1,0,0,3,103,101,50699,39240,114,90,53290,37777
422,39,0,1,1,0,0,3,49,48,50699,39241,58,96,53290,37780
423,39,4,0,0,3,1,0,152,100,50703,39241,141,62,53293,37780
424,39,1,1,2,1,2,1,211,204,50704,39242,224,149,53294,37781
425,39,0,1,1,0,0,3,61,46,50704,39243,67,108,53294,37784
426,39,1,0,0,3,1,0,106,89,50705,39243,121,118,53297,37784
427,39,3,2,0,3,1,0,83,52,50708,39245,67,117,53300,37784
428,39,0,1,1,0,0,3,82,69,50708,39246,94,73,53300,37787
429,40,1,0,0,3,1,0,172,148,50709,39246,177,106,53303,37787
430,40,2,0,0,3,1,0,139,105,50711,39246,160,38,53306,37787
431,40,1,1,2,1,2,1,193,134,50712,39247,192,69,53307,37788
432,40,1,1,2,1,2,1,104,102,50713,39248,115,40,53308,37789
433,40,1,1,2,1,2,1,78,74,50714,39249,91,70,53309,37790
434,40,0,1,1,0,0,3,25,18,50714,39250,32,57,53309,37793
435,40,1,0,0,3,1,0,96,72,50715,39250,115,34,53312,37793
436,40,2,1,0,3,1,0,132,80,50717,39251,149,153,53315,37793
437,40,1,0,0,3,1,0,189,167,50718,39251,213,108,53318,37793
438,40,2,3,1,0,0,3,198,161,50720,39254,226,95,53318,37796
439,40,2,0,0,3,1,0,129,63,50722,39254,166,36,53321,37796
440,41,1,0,0,3,1,0,190,167,50723,39254,216,40,53324,37796
441,41,3,1,0,3,1,0,123,131,50726,39255,155,73,53327,37796
442,41,1,0,0,3,1,0,212,204,50727,39255,227,16,53330,37796
443,41,1,2,1,0,0,3,83,71,50728,39257,94,121,53330,37799
444,41,2,0,0,3,1,0,124,112,50730,39257,146,117,53333,37799
445,41,1,1,2,1,2,1,107,90,50731,39258,122,97,53334,37800
446,41,2,1,0,3,1,0,85,53,50733,39259,70,41,53337,37800
447,41,1,1,2,1,2,1,90,99,50734,39260,105,94,53338,37801
448,41,4,3,0,3,1,0,156,103,50738,39263,144,90,53341,37801
449,41,0,1,1,0,0,3,45,41,50738,39264,66,87,53341,37804
450,41,0,1,1,0,0,3,49,49,50738,39265,58,65,53341,37807
451,42,2,3,1,0,0,3,27,21,50740,39268,32,111,53341,37810
452,42,3,1,0,3,1,0,196,135,50743,39269,195,153,53344,37810
453,42,3,2,0,3,1,0,201,163,50746,39271,229,57,53347,37810
454,42,0,0,2,1,2,1,139,105,50746,39271,161,70,53348,37811
455,42,0,0,2,1,2,1,96,72,50746,39271,116,96,53349,37812
456,42,3,0,0,3,1,0,175,148,50749,39271,180,34,53352,37812
457,42,1,2,1,0,0,3,105,104,50750,39273,115,109,53352,37815
458,42,1,0,0,3,1,0,62,46,50751,39273,70,36,53355,37815
459,42,1,0,0,3,1,0,79,74,50752,39273,94,38,53358,37815
460,42,1,1,2,1,2,1,133,81,50753,39274,150,150,53359,37816
461,42,1,0,0,3,1,0,130,63,50754,39274,169,70,53362,37816
0,1,2,0,0,3,1,0,153,159,50756,39274,182,109,53365,37816
1,1,0,0,2,1,2,1,107,90,50756,39274,123,71,53366,37817
2,1,2,1,0,3,1,0,180,146,50758,39275,210,70,53369,37817
3,1,2,0,0,3,1,0,203,163,50760,39275,232,0,53372,37817
4,1,1,2,1,0,0,3,134,83,50761,39277,150,97,53372,37820
5,1,1,1,2,1,2,1,78,85,50762,39278,102,112,53373,37821
6,1,0,0,2,1,2,1,45,41,50762,39278,67,41,53374,37822
7,1,2,3,1,0,0,3,98,75,50764,39281,116,195,53374,37825
8,1,1,0,0,3,1,0,197,135,50765,39281,198,43,53377,37825
9,1,2,3,1,0,0,3,22,28,50767,39284,22,93,53377,37828
10,1,1,0,0,3,1,0,84,71,50768,39284,97,34,53380,37828
11,2,3,1,0,3,1,0,159,104,50771,39285,147,41,53383,37828
12,2,1,1,2,1,2,1,91,100,50772,39286,106,109,53384,37829
13,2,1,0,0,3,1,0,63,46,50773,39286,73,130,53387,37829
14,2,1,2,1,0,0,3,131,65,50774,39288,169,124,53387,37832
15,2,1,2,1,0,0,3,60,67,50775,39290,76,39,53387,37835
16,2,1,1,2,1,2,1,50,50,50776,39291,59,11,53388,37836
17,2,2,0,0,3,1,0,2,0,50778,39291,3,58,53391,37836
18,2,2,1,0,3,1,0,177,149,50780,39292,183,57,53394,37836
19,2,2,1,0,3,1,0,285,242,50782,39293,304,73,53397,37836
20,2,0,0,2,1,2,1,123,131,50782,39293,156,97,53398,37837
21,2,1,1,2,1,2,1,125,113,50783,39294,147,118,53399,37838
22,3,2,0,0,3,1,0,109,90,50785,39294,126,0,53402,37838
23,3,1,1,2,1,2,1,23,29,50786,39295,23,98,53403,37839
24,3,1,3,1,0,0,3,154,162,50787,39298,182,115,53403,37842
25,3,0,3,1,0,0,3,98,78,50787,39301,116,76,53403,37845
26,3,2,0,0,3,1,0,199,135,50789,39301,201,34,53406,37845
27,3,4,1,0,3,1,0,88,72,50793,39302,100,195,53409,37845
28,3,1,2,1,0,0,3,46,43,50794,39304,67,96,53409,37848
29,3,3,1,0,3,1,0,183,147,50797,39305,213,43,53412,37848
30,3,4,1,0,3,1,0,163,105,50801,39306,150,71,53415,37848
31,3,3,1,0,3,1,0,81,86,50804,39307,105,70,53418,37848
32,3,3,0,0,3,1,0,206,163,50807,39307,235,41,53421,37848
33,4,1,3,1,0,0,3,135,86,50808,39310,150,60,53421,37851
34,4,1,2,1,0,0,3,126,115,50809,39312,147,100,53421,37854
35,4,2,3,1,0,0,3,125,134,50811,39315,156,112,53421,37857
36,4,1,2,1,0,0,3,61,69,50812,39317,76,121,53421,37860
37,4,0,0,2,1,2,1,2,0,50812,39317,4,110,53422,37861
38,4,1,1,2,1,2,1,178,150,50813,39318,184,125,53423,37862
39,4,1,1,2,1,2,1,92,101,50814,39319,107,42,53424,37863
40,4,0,0,2,1,2,1,63,46,50814,39319,74,59,53425,37864
41,4,0,1,1,0,0,3,285,243,50814,39320,304,14,53425,37867
42,4,0,1,1,0,0,3,131,66,50814,39321,169,133,53425,37870
43,4,1,0,0,3,1,0,51,50,50815,39321,62,39,53428,37870
44,5,0,0,2,1,2,1,109,90,50815,39321,127,42,53429,37871
45,5,0,1,1,0,0,3,163,106,50815,39322,150,3,53429,37874
46,5,0,2,1,0,0,3,46,45,50815,39324,67,101,53429,37877
47,5,1,0,0,3,1,0,93,101,50816,39324,110,115,53432,37877
48,5,4,1,0,3,1,0,210,164,50820,39325,238,96,53435,37877
49,5,1,0,0,3,1,0,99,78,50821,39325,119,60,53438,37877
50,5,6,4,0,3,1,0,160,166,50827,39329,185,70,53441,37877
51,5,1,3,1,0,0,3,200,138,50828,39332,201,198,53441,37880
52,5,2,2,2,1,2,1,83,88,50830,39334,106,44,53442,37881
53,5,2,1,0,3,1,0,185,148,50832,39335,216,34,53445,37881
54,5,0,1,1,0,0,3,23,30,50832,39336,23,79,53445,37884
55,6,0,1,1,0,0,3,2,1,50832,39337,4,74,53445,37887
56,6,4,3,0,3,1,0,67,49,50836,39340,77,110,53448,37887
57,6,3,1,0,3,1,0,128,135,50839,39341,159,42,53451,37887
58,6,3,0,0,3,1,0,64,69,50842,39341,79,100,53454,37887
59,6,2,1,0,3,1,0,53,51,50844,39342,65,121,53457,37887
60,6,3,3,2,1,2,1,129,118,50847,39345,148,113,53458,37888
61,6,1,1,2,1,2,1,179,151,50848,39346,185,134,53459,37889
62,6,2,2,2,1,2,1,137,88,50850,39348,151,126,53460,37890
63,6,1,0,0,3,1,0,132,66,50851,39348,172,59,53463,37890
64,6,2,0,0,3,1,0,287,243,50853,39348,307,39,53466,37890
65,6,1,0,0,3,1,0,89,72,50854,39348,103,14,53469,37890
66,7,0,0,2,1,2,1,128,135,50854,39348,160,4,53470,37891
67,7,0,1,1,0,0,3,163,107,50854,39349,150,45,53470,37894
68,7,3,0,0,3,1,0,203,138,50857,39349,204,60,53473,37894
69,7,0,2,1,0,0,3,160,168,50857,39351,185,47,53473,37897
70,7,1,1,2,1,2,1,211,165,50858,39352,239,102,53474,37898
71,7,0,0,2,1,2,1,185,148,50858,39352,217,199,53475,37899
72,7,2,1,0,3,1,0,111,91,50860,39353,130,96,53478,37899
73,7,6,1,0,3,1,0,105,79,50866,39354,122,14,53481,37899
74,7,2,0,0,3,1,0,95,101,50868,39354,113,70,53484,37899
75,7,2,0,0,3,1,0,85,88,50870,39354,109,34,53487,37899
76,7,2,0,0,3,1,0,48,45,50872,39354,70,79,53490,37899
77,8,2,0,0,3,1,0,131,118,50874,39354,151,115,53493,37899
78,8,1,0,0,3,1,0,90,72,50875,39354,106,39,53496,37899
79,8,0,0,2,1,2,1,64,69,50875,39354,80,114,53497,37900
80,8,2,0,0,3,1,0,134,66,50877,39354,175,110,53500,37900
81,8,0,1,1,0,0,3,23,31,50877,39355,23,129,53500,37903
82,8,0,2,1,0,0,3,53,53,50877,39357,65,103,53500,37906
83,8,0,1,1,0,0,3,137,89,50877,39358,151,137,53500,37909
84,8,0,0,2,1,2,1,287,243,50877,39358,308,122,53501,37910
85,8,2,1,0,3,1,0,181,152,50879,39359,188,59,53504,37910
86,8,3,3,2,1,2,1,70,52,50882,39362,78,75,53505,37911
87,8,0,1,1,0,0,3,2,2,50882,39363,4,45,53505,37914
88,9,0,0,2,1,2,1,185,148,50882,39363,218,61,53506,37915
89,9,1,0,0,3,1,0,129,135,50883,39363,163,45,53509,37915
90,9,3,2,0,3,1,0,51,47,50886,39365,73,14,53512,37915
91,9,2,1,0,3,1,0,97,102,50888,39366,116,47,53515,37915
92,9,3,2,0,3,1,0,163,170,50891,39368,188,34,53518,37915
93,9,0,2,1,0,0,3,105,81,50891,39370,122,132,53518,37918
94,9,1,1,2,1,2,1,112,92,50892,39371,131,103,53519,37919
95,9,1,4,1,0,0,3,3,6,50893,39375,4,73,53519,37922
96,9,1,0,0,3,1,0,86,88,50894,39375,112,199,53522,37922
97,9,2,0,0,3,1,0,213,165,50896,39375,242,79,53525,37922
98,9,4,1,0,3,1,0,167,108,50900,39376,153,96,53528,37922
99,10,1,0,0,3,1,0,132,118,50901,39376,154,45,53531,37922
100,10,1,1,2,1,2,1,65,70,50902,39377,81,116,53532,37923
101,10,3,2,0,3,1,0,290,245,50905,39379,311,103,53535,37923
102,10,2,2,2,1,2,1,92,74,50907,39381,107,123,53536,37924
103,10,3,4,1,0,0,3,26,35,50910,39385,23,140,53536,37927
104,10,1,1,2,1,2,1,71,53,50911,39386,79,5,53537,37928
105,10,2,0,0,3,1,0,183,152,50913,39386,191,110,53540,37928
106,10,3,0,0,3,1,0,206,138,50916,39386,207,39,53543,37928
107,10,1,3,1,0,0,3,135,69,50917,39389,175,78,53543,37931
108,10,2,0,0,3,1,0,55,53,50919,39389,68,114,53546,37931
109,10,1,1,2,1,2,1,138,90,50920,39390,152,60,53547,37932
110,11,2,1,0,3,1,0,134,119,50922,39391,157,45,53550,37932
111,11,1,1,2,1,2,1,130,136,50923,39392,164,97,53551,37933
112,11,0,0,2,1,2,1,167,108,50923,39392,154,104,53552,37934
113,11,0,2,1,0,0,3,3,8,50923,39394,4,50,53552,37937
114,11,2,1,0,3,1,0,215,166,50925,39395,245,14,53555,37937
115,11,3,2,0,3,1,0,108,83,50928,39397,125,39,53558,37937
116,11,3,2,0,3,1,0,166,172,50931,39399,191,199,53561,37937
117,11,2,1,0,3,1,0,187,149,50933,39400,221,132,53564,37937
118,11,0,3,1,0,0,3,112,95,50933,39403,131,82,53564,37940
119,11,1,1,2,1,2,1,87,89,50934,39404,113,62,53565,37941
120,11,2,3,1,0,0,3,99,105,50936,39407,116,37,53565,37944
121,12,0,0,2,1,2,1,51,47,50936,39407,74,141,53566,37945
122,12,1,0,0,3,1,0,27,35,50937,39407,26,60,53569,37945
123,12,1,0,0,3,1,0,291,245,50938,39407,314,114,53572,37945
124,12,0,0,2,1,2,1,138,90,50938,39407,153,111,53573,37946
125,12,1,2,1,0,0,3,207,140,50939,39409,207,126,53573,37949
126,12,2,0,0,3,1,0,137,69,50941,39409,178,5,53576,37949
127,12,3,1,0,3,1,0,186,153,50944,39410,194,78,53579,37949
128,12,2,1,0,3,1,0,73,54,50946,39411,82,45,53582,37949
129,12,3,3,2,1,2,1,95,77,50949,39414,108,104,53583,37950
130,12,0,1,1,0,0,3,65,71,50949,39415,81,76,53583,37953
131,12,1,1,2,1,2,1,56,54,50950,39416,69,117,53584,37954
132,13,1,2,1,0,0,3,88,91,50951,39418,113,135,53584,37957
133,13,1,1,2,1,2,1,135,120,50952,39419,158,98,53585,37958
134,13,0,0,2,1,2,1,130,136,50952,39419,165,105,53586,37959
135,13,1,1,2,1,2,1,168,109,50953,39420,155,83,53587,37960
136,13,0,0,2,1,2,1,108,83,50953,39420,126,142,53588,37961
137,13,0,1,1,0,0,3,166,173,50953,39421,191,65,53588,37964
138,13,0,0,2,1,2,1,215,166,50953,39421,246,40,53589,37965
139,13,0,0,2,1,2,1,73,54,50953,39421,83,51,53590,37966
140,13,4,1,0,3,1,0,116,96,50957,39422,134,14,53593,37966
141,13,2,0,0,3,1,0,5,8,50959,39422,7,37,53596,37966
142,13,2,2,2,1,2,1,101,107,50961,39424,117,200,53597,37967
143,14,4,4,2,1,2,1,99,81,50965,39428,109,115,53598,37968
144,14,3,1,0,3,1,0,68,72,50968,39429,84,45,53601,37968
145,14,0,0,2,1,2,1,186,153,50968,39429,195,6,53602,37969
146,14,2,0,0,3,1,0,140,90,50970,39429,156,78,53605,37969
147,14,0,0,2,1,2,1,56,54,50970,39429,70,77,53606,37970
148,14,1,2,1,0,0,3,188,151,50971,39431,221,129,53606,37973
149,14,2,0,0,3,1,0,209,140,50973,39431,210,104,53609,37973
150,14,1,0,0,3,1,0,52,47,50974,39431,77,60,53612,37973
151,14,1,2,1,0,0,3,292,247,50975,39433,314,120,53612,37976
152,14,2,0,0,3,1,0,29,35,50977,39433,29,111,53615,37976
153,14,1,0,0,3,1,0,138,69,50978,39433,181,45,53618,37976
154,15,0,2,1,0,0,3,130,138,50978,39435,165,86,53618,37979
155,15,0,0,2,1,2,1,166,173,50978,39435,192,136,53619,37980
156,15,0,2,1,0,0,3,5,10,50978,39437,7,203,53619,37983
157,15,1,0,0,3,1,0,89,91,50979,39437,116,142,53622,37983
158,15,0,1,1,0,0,3,135,121,50979,39438,158,108,53622,37986
159,15,0,1,1,0,0,3,68,73,50979,39439,84,101,53622,37989
160,15,1,2,1,0,0,3,169,111,50980,39441,155,17,53622,37992
161,15,0,1,1,0,0,3,116,97,50980,39442,134,43,53622,37995
162,15,4,1,0,3,1,0,105,108,50984,39443,120,65,53625,37995
163,15,1,0,0,3,1,0,74,54,50985,39443,86,37,53628,37995
164,15,2,2,2,1,2,1,110,85,50987,39445,127,130,53629,37996
165,16,3,2,0,3,1,0,143,92,50990,39447,159,6,53632,37996
166,16,1,0,0,3,1,0,53,47,50991,39447,80,111,53635,37996
167,16,2,1,0,3,1,0,101,82,50993,39448,112,120,53638,37996
168,16,1,0,0,3,1,0,216,166,50994,39448,249,60,53641,37996
169,16,0,1,1,0,0,3,209,141,50994,39449,210,118,53641,37999
170,16,3,2,0,3,1,0,141,71,50997,39451,184,45,53644,37999
171,16,2,1,0,3,1,0,188,154,50999,39452,198,45,53647,37999
172,16,1,0,0,3,1,0,189,151,51000,39452,224,104,53650,37999
173,16,1,0,0,3,1,0,57,54,51001,39452,73,51,53653,37999
174,16,1,0,0,3,1,0,293,247,51002,39452,317,77,53656,37999
175,16,2,2,2,1,2,1,31,37,51004,39454,30,79,53657,38000
176,17,1,1,2,1,2,1,69,74,51005,39455,85,109,53658,38001
177,17,1,3,1,0,0,3,170,114,51006,39458,155,46,53658,38004
178,17,0,1,1,0,0,3,74,55,51006,39459,86,206,53658,38007
179,17,2,4,1,0,0,3,118,101,51008,39463,134,133,53658,38010
180,17,2,1,0,3,1,0,168,174,51010,39464,195,142,53661,38010
181,17,1,1,2,1,2,1,136,122,51011,39465,159,87,53662,38011
182,17,3,1,0,3,1,0,8,11,51014,39466,10,65,53665,38011
183,17,2,1,0,3,1,0,107,109,51016,39467,123,136,53668,38011
184,17,2,1,0,3,1,0,132,139,51018,39468,168,17,53671,38011
185,17,0,0,2,1,2,1,141,71,51018,39468,185,38,53672,38012
186,17,1,2,1,0,0,3,111,87,51019,39470,127,63,53672,38015
187,18,2,2,2,1,2,1,211,143,51021,39472,211,121,53673,38016
188,18,3,1,0,3,1,0,104,83,51024,39473,115,77,53676,38016
189,18,1,1,2,1,2,1,54,48,51025,39474,81,80,53677,38017
190,18,1,0,0,3,1,0,58,54,51026,39474,76,45,53680,38017
191,18,6,6,2,1,2,1,149,98,51032,39480,160,46,53681,38018
192,18,2,0,0,3,1,0,295,247,51034,39480,320,51,53684,38018
193,18,0,2,1,0,0,3,31,39,51034,39482,30,9,53684,38021
194,18,2,1,0,3,1,0,190,155,51036,39483,201,101,53687,38021
195,18,2,0,0,3,1,0,91,91,51038,39483,119,104,53690,38021
196,18,7,0,0,3,1,0,196,151,51045,39483,227,118,53693,38021
197,18,1,2,1,0,0,3,217,168,51046,39485,249,114,53693,38024
198,19,1,3,1,0,0,3,133,142,51047,39488,168,49,53693,38027
199,19,2,0,0,3,1,0,138,122,51049,39488,162,17,53696,38027
200,19,1,2,1,0,0,3,9,13,51050,39490,10,139,53696,38030
201,19,2,1,0,3,1,0,170,175,51052,39491,198,63,53699,38030
202,19,0,2,1,0,0,3,170,116,51052,39493,155,136,53699,38033
203,19,0,2,1,0,0,3,107,111,51052,39495,123,145,53699,38036
204,19,0,0,2,1,2,1,74,55,51052,39495,87,66,53700,38037
205,19,1,0,0,3,1,0,112,87,51053,39495,130,104,53703,38037
206,19,0,0,2,1,2,1,141,71,51053,39495,186,207,53704,38038
207,19,1,1,2,1,2,1,59,55,51054,39496,77,110,53705,38039
208,19,1,1,2,1,2,1,70,75,51055,39497,86,88,53706,38040
209,20,2,0,0,3,1,0,93,91,51057,39497,122,118,53709,38040
210,20,3,0,0,3,1,0,34,39,51060,39497,33,46,53712,38040
211,20,0,0,2,1,2,1,211,143,51060,39497,212,78,53713,38041
212,20,1,1,2,1,2,1,119,102,51061,39498,135,115,53714,38042
213,20,3,1,0,3,1,0,298,248,51064,39499,323,38,53717,38042
214,20,5,3,0,3,1,0,222,171,51069,39502,252,80,53720,38042
215,20,2,2,2,1,2,1,151,100,51071,39504,161,102,53721,38043
216,20,2,2,2,1,2,1,114,89,51073,39506,131,111,53722,38044
217,20,1,0,0,3,1,0,55,48,51074,39506,84,9,53725,38044
218,20,2,0,0,3,1,0,198,151,51076,39506,230,121,53728,38044
219,20,1,1,2,1,2,1,105,84,51077,39507,116,52,53729,38045
220,21,0,0,2,1,2,1,170,175,51077,39507,199,46,53730,38046
221,21,1,2,1,0,0,3,75,57,51078,39509,87,142,53730,38049
222,21,1,0,0,3,1,0,71,75,51079,39509,89,17,53733,38049
223,21,1,1,2,1,2,1,134,143,51080,39510,169,137,53734,38050
224,21,1,2,1,0,0,3,191,157,51081,39512,201,210,53734,38053
225,21,2,0,0,3,1,0,140,122,51083,39512,165,49,53737,38053
226,21,2,0,0,3,1,0,11,13,51085,39512,13,145,53740,38053
227,21,3,1,0,3,1,0,173,117,51088,39513,158,104,53743,38053
228,21,2,0,0,3,1,0,109,111,51090,39513,126,63,53746,38053
229,21,0,0,2,1,2,1,59,55,51090,39513,78,89,53747,38054
230,21,1,1,2,1,2,1,142,72,51091,39514,187,67,53748,38055
231,22,2,0,0,3,1,0,136,143,51093,39514,172,63,53751,38055
232,22,2,0,0,3,1,0,300,248,51095,39514,326,46,53754,38055
233,22,2,0,0,3,1,0,111,111,51097,39514,129,104,53757,38055
234,22,0,1,1,0,0,3,59,56,51097,39515,78,70,53757,38058
235,22,1,5,1,0,0,3,141,127,51098,39520,165,148,53757,38061
236,22,0,1,1,0,0,3,173,118,51098,39521,158,118,53757,38064
237,22,3,0,0,3,1,0,194,157,51101,39521,204,89,53760,38064
238,22,2,3,1,0,0,3,144,75,51103,39524,187,20,53760,38067
239,22,0,1,1,0,0,3,71,76,51103,39525,89,145,53760,38070
240,22,0,0,2,1,2,1,11,13,51103,39525,14,138,53761,38071
241,22,1,1,2,1,2,1,76,58,51104,39526,88,50,53762,38072
242,23,3,2,0,3,1,0,37,41,51107,39528,36,38,53765,38072
243,23,1,4,1,0,0,3,115,93,51108,39532,131,121,53765,38075
244,23,0,2,1,0,0,3,105,86,51108,39534,116,114,53765,38078
245,23,1,1,2,1,2,1,152,101,51109,39535,162,211,53766,38079
246,23,2,0,0,3,1,0,95,91,51111,39535,125,9,53769,38079
247,23,0,2,1,0,0,3,55,50,51111,39537,84,55,53769,38082
248,23,2,1,0,3,1,0,224,172,51113,39538,255,78,53772,38082
249,23,0,0,2,1,2,1,119,102,51113,39538,136,122,53773,38083
250,23,3,0,0,3,1,0,214,143,51116,39538,215,102,53776,38083
251,23,0,0,2,1,2,1,198,151,51116,39538,231,47,53777,38084
252,23,0,1,1,0,0,3,170,176,51116,39539,199,83,53777,38087
253,24,4,0,0,3,1,0,115,111,51120,39539,132,121,53780,38087
254,24,1,4,1,0,0,3,72,80,51121,39543,89,151,53780,38090
255,24,1,0,0,3,1,0,12,13,51122,39543,17,104,53783,38090
256,24,2,2,2,1,2,1,146,77,51124,39545,188,51,53784,38091
257,24,2,1,0,3,1,0,78,59,51126,39546,91,138,53787,38091
258,24,0,2,1,0,0,3,141,129,51126,39548,165,66,53787,38094
259,24,2,1,0,3,1,0,196,158,51128,39549,207,20,53790,38094
260,24,3,0,0,3,1,0,155,101,51131,39549,165,46,53793,38094
261,24,1,1,2,1,2,1,301,249,51132,39550,327,71,53794,38095
262,24,0,1,1,0,0,3,59,57,51132,39551,78,148,53794,38098
263,24,3,0,0,3,1,0,139,143,51135,39551,175,118,53797,38098
264,25,0,1,1,0,0,3,170,177,51135,39552,199,12,53797,38101
265,25,0,0,2,1,2,1,119,102,51135,39552,137,79,53798,38102
266,25,0,0,2,1,2,1,173,118,51135,39552,159,123,53799,38103
267,25,1,1,2,1,2,1,56,51,51136,39553,85,39,53800,38104
268,25,0,0,2,1,2,1,214,143,51136,39553,216,115,53801,38105
269,25,1,0,0,3,1,0,199,151,51137,39553,234,102,53804,38105
270,25,1,2,1,0,0,3,106,88,51138,39555,116,92,53804,38108
271,25,0,0,2,1,2,1,115,93,51138,39555,132,84,53805,38109
272,25,0,0,2,1,2,1,37,41,51138,39555,37,212,53806,38110
273,25,1,0,0,3,1,0,225,172,51139,39555,258,55,53809,38110
274,25,2,0,0,3,1,0,97,91,51141,39555,128,47,53812,38110
275,26,1,2,1,0,0,3,73,82,51142,39557,89,69,53812,38113
276,26,3,0,0,3,1,0,144,129,51145,39557,168,118,53815,38113
277,26,0,0,2,1,2,1,146,77,51145,39557,189,139,53816,38114
278,26,2,1,0,3,1,0,303,250,51147,39558,330,148,53819,38114
279,26,2,1,0,3,1,0,80,60,51149,39559,94,104,53822,38114
280,26,3,0,0,3,1,0,109,88,51152,39559,119,46,53825,38114
281,26,1,0,0,3,1,0,13,13,51153,39559,20,121,53828,38114
282,26,4,1,0,3,1,0,200,159,51157,39560,210,51,53831,38114
283,26,4,0,0,3,1,0,143,143,51161,39560,178,84,53834,38114
284,26,2,0,0,3,1,0,61,57,51163,39560,81,151,53837,38114
285,26,1,1,2,1,2,1,156,102,51164,39561,166,21,53838,38115
286,27,0,2,1,0,0,3,170,179,51164,39563,199,50,53838,38118
287,27,2,1,0,3,1,0,117,94,51166,39564,135,123,53841,38118
288,27,3,0,0,3,1,0,202,151,51169,39564,237,115,53844,38118
289,27,2,4,1,0,0,3,175,122,51171,39568,159,82,53844,38121
290,27,1,1,2,1,2,1,226,173,51172,39569,259,40,53845,38122
291,27,1,0,0,3,1,0,120,102,51173,39569,140,55,53848,38122
292,27,2,1,0,3,1,0,39,42,51175,39570,40,71,53851,38122
293,27,2,1,0,3,1,0,216,144,51177,39571,219,92,53854,38122
294,27,0,0,2,1,2,1,56,51,51177,39571,86,213,53855,38123
295,27,2,2,2,1,2,1,117,113,51179,39573,133,13,53856,38124
296,27,1,2,1,0,0,3,98,93,51180,39575,128,105,53856,38127
297,28,1,0,0,3,1,0,157,102,51181,39575,169,51,53859,38127
298,28,3,2,0,3,1,0,83,62,51184,39577,97,121,53862,38127
299,28,2,0,0,3,1,0,75,82,51186,39577,92,118,53865,38127
300,28,1,0,0,3,1,0,62,57,51187,39577,84,69,53868,38127
301,28,0,0,2,1,2,1,39,42,51187,39577,41,47,53869,38128
302,28,4,0,0,3,1,0,307,250,51191,39577,333,151,53872,38128
303,28,3,1,0,3,1,0,16,14,51194,39578,23,123,53875,38128
304,28,3,0,0,3,1,0,112,88,51197,39578,122,148,53878,38128
305,28,3,2,0,3,1,0,147,131,51200,39580,171,84,53881,38128
306,28,1,1,2,1,2,1,201,160,51201,39581,211,140,53882,38129
307,28,1,1,2,1,2,1,147,78,51202,39582,190,105,53883,38130
308,29,1,1,2,1,2,1,171,180,51203,39583,200,106,53884,38131
309,29,1,1,2,1,2,1,118,95,51204,39584,136,14,53885,38132
310,29,2,0,0,3,1,0,145,143,51206,39584,181,82,53888,38132
311,29,0,1,1,0,0,3,98,94,51206,39585,128,118,53888,38135
312,29,0,0,2,1,2,1,117,113,51206,39585,134,51,53889,38136
313,29,1,1,2,1,2,1,121,103,51207,39586,141,41,53890,38137
314,29,4,0,0,3,1,0,206,151,51211,39586,240,92,53893,38137
315,29,0,3,1,0,0,3,226,176,51211,39589,259,216,53893,38140
316,29,2,1,0,3,1,0,58,52,51213,39590,89,71,53896,38140
317,29,2,2,2,1,2,1,218,146,51215,39592,220,22,53897,38141
318,29,1,1,2,1,2,1,176,123,51216,39593,160,56,53898,38142
319,30,0,1,1,0,0,3,147,132,51216,39594,171,17,53898,38145
320,30,3,1,0,3,1,0,150,79,51219,39595,193,121,53901,38145
321,30,1,3,1,0,0,3,308,253,51220,39598,333,72,53901,38148
322,30,4,2,0,3,1,0,161,104,51224,39600,172,140,53904,38148
323,30,0,0,2,1,2,1,39,42,51224,39600,42,52,53905,38149
324,30,0,2,1,0,0,3,75,84,51224,39602,92,87,53905,38152
325,30,3,2,0,3,1,0,86,64,51227,39604,100,123,53908,38152
326,30,1,1,2,1,2,1,202,161,51228,39605,212,106,53909,38153
327,30,0,0,2,1,2,1,218,146,51228,39605,221,48,53910,38154
328,30,2,0,0,3,1,0,114,88,51230,39605,125,151,53913,38154
329,30,2,1,0,3,1,0,64,58,51232,39606,87,118,53916,38154
330,31,0,0,2,1,2,1,98,94,51232,39606,129,93,53917,38155
331,31,3,2,0,3,1,0,19,16,51235,39608,26,51,53920,38155
332,31,2,1,0,3,1,0,147,144,51237,39609,184,56,53923,38155
333,31,0,1,1,0,0,3,206,152,51237,39610,240,25,53923,38158
334,31,0,1,1,0,0,3,121,104,51237,39611,141,219,53923,38161
335,31,4,2,0,3,1,0,230,178,51241,39613,262,71,53926,38161
336,31,0,0,2,1,2,1,171,180,51241,39613,201,119,53927,38162
337,31,0,1,1,0,0,3,58,53,51241,39614,89,151,53927,38165
338,31,1,1,2,1,2,1,118,114,51242,39615,135,107,53928,38166
339,31,2,2,2,1,2,1,178,125,51244,39617,161,42,53929,38167
340,31,1,1,2,1,2,1,119,96,51245,39618,137,83,53930,38168
341,32,0,0,2,1,2,1,58,53,51245,39618,90,49,53931,38169
342,32,2,1,0,3,1,0,220,147,51247,39619,224,151,53934,38169
343,32,4,0,0,3,1,0,90,64,51251,39619,103,83,53937,38169
344,32,1,0,0,3,1,0,40,42,51252,39619,45,140,53940,38169
345,32,3,0,0,3,1,0,311,253,51255,39619,336,118,53943,38169
346,32,1,1,2,1,2,1,115,89,51256,39620,126,73,53944,38170
347,32,0,0,2,1,2,1,202,161,51256,39620,213,122,53945,38171
348,32,1,2,1,0,0,3,162,106,51257,39622,172,109,53945,38174
349,32,0,2,1,0,0,3,75,86,51257,39624,92,20,53945,38177
350,32,1,1,2,1,2,1,65,59,51258,39625,88,88,53946,38178
351,32,0,1,1,0,0,3,150,80,51258,39626,193,126,53946,38181
352,33,2,3,1,0,0,3,149,135,51260,39629,171,59,53946,38184
353,33,2,1,0,3,1,0,121,97,51262,39630,140,51,53949,38184
354,33,1,1,2,1,2,1,119,115,51263,39631,136,120,53950,38185
355,33,2,1,0,3,1,0,208,153,51265,39632,243,52,53953,38185
356,33,0,0,2,1,2,1,19,16,51265,39632,27,108,53954,38186
357,33,1,0,0,3,1,0,148,144,51266,39632,187,42,53957,38186
358,33,2,0,0,3,1,0,232,178,51268,39632,265,151,53960,38186
359,33,0,1,1,0,0,3,121,105,51268,39633,141,74,53960,38189
360,33,1,2,1,0,0,3,179,127,51269,39635,161,222,53960,38192
361,33,1,1,2,1,2,1,172,181,51270,39636,202,94,53961,38193
362,33,2,0,0,3,1,0,100,94,51272,39636,132,25,53964,38193
363,34,2,1,0,3,1,0,222,148,51274,39637,227,73,53967,38193
364,34,1,0,0,3,1,0,203,161,51275,39637,216,126,53970,38193
365,34,1,0,0,3,1,0,116,89,51276,39637,129,118,53973,38193
366,34,2,1,0,3,1,0,60,54,51278,39638,93,140,53976,38193
367,34,1,0,0,3,1,0,76,86,51279,39638,95,51,53979,38193
368,34,3,1,0,3,1,0,43,43,51282,39639,48,109,53982,38193
369,34,4,0,0,3,1,0,315,253,51286,39639,339,88,53985,38193
370,34,0,0,2,1,2,1,150,80,51286,39639,194,84,53986,38194
371,34,1,0,0,3,1,0,163,106,51287,39639,175,122,53989,38194
372,34,0,0,2,1,2,1,208,153,51287,39639,244,50,53990,38195
373,34,0,0,2,1,2,1,65,59,51287,39639,89,21,53991,38196
374,35,0,0,2,1,2,1,90,64,51287,39639,104,109,53992,38197
375,35,2,1,0,3,1,0,174,182,51289,39640,205,25,53995,38197
376,35,1,2,1,0,0,3,149,146,51290,39642,187,225,53995,38200
377,35,2,1,0,3,1,0,181,128,51292,39643,164,74,53998,38200
378,35,2,1,0,3,1,0,151,136,51294,39644,174,42,54001,38200
379,35,1,1,2,1,2,1,233,179,51295,39645,266,152,54002,38201
380,35,3,2,0,3,1,0,124,99,51298,39647,143,59,54005,38201
381,35,0,0,2,1,2,1,19,16,51298,39647,28,121,54006,38202
382,35,0,3,1,0,0,3,121,108,51298,39650,141,154,54006,38205
383,35,1,0,0,3,1,0,120,115,51299,39650,139,94,54009,38205
384,35,0,0,2,1,2,1,100,94,51299,39650,133,53,54010,38206
385,36,2,0,0,3,1,0,152,80,51301,39650,197,59,54013,38206
386,36,1,0,0,3,1,0,164,106,51302,39650,178,126,54016,38206
387,36,2,2,2,1,2,1,317,255,51304,39652,340,22,54017,38207
388,36,3,0,0,3,1,0,225,148,51307,39652,230,118,54020,38207
389,36,2,0,0,3,1,0,235,179,51309,39652,269,50,54023,38207
390,36,1,1,2,1,2,1,117,90,51310,39653,130,89,54024,38208
391,36,1,0,0,3,1,0,204,161,51311,39653,219,84,54027,38208
392,36,2,0,0,3,1,0,210,153,51313,39653,247,73,54030,38208
393,36,1,1,2,1,2,1,66,60,51314,39654,90,52,54031,38209
394,36,2,1,0,3,1,0,45,44,51316,39655,51,122,54034,38209
395,36,2,1,0,3,1,0,62,55,51318,39656,96,109,54037,38209
396,37,2,4,1,0,0,3,183,132,51320,39660,164,157,54037,38212
397,37,0,1,1,0,0,3,124,100,51320,39661,143,112,54037,38215
398,37,1,2,1,0,0,3,91,66,51321,39663,104,124,54037,38218
399,37,0,3,1,0,0,3,121,111,51321,39666,141,155,54037,38221
400,37,2,1,0,3,1,0,102,95,51323,39667,136,140,54040,38221
401,37,1,2,1,0,0,3,152,138,51324,39669,174,228,54040,38224
402,37,0,0,2,1,2,1,19,16,51324,39669,29,95,54041,38225
403,37,2,0,0,3,1,0,176,182,51326,39669,208,53,54044,38225
404,37,3,1,0,3,1,0,123,116,51329,39670,142,25,54047,38225
405,37,1,0,0,3,1,0,77,86,51330,39670,98,42,54050,38225
406,37,2,1,0,3,1,0,151,147,51332,39671,190,74,54053,38225
407,38,1,1,2,1,2,1,103,96,51333,39672,137,51,54054,38226
408,38,2,3,1,0,0,3,47,47,51335,39675,51,129,54054,38229
409,38,3,1,0,3,1,0,207,162,51338,39676,222,59,54057,38229
410,38,1,1,2,1,2,1,211,154,51339,39677,248,119,54058,38230
411,38,1,2,1,0,0,3,165,108,51340,39679,178,87,54058,38233
412,38,2,3,1,0,0,3,64,58,51342,39682,96,125,54058,38236
413,38,3,0,0,3,1,0,238,179,51345,39682,272,109,54061,38236
414,38,1,1,2,1,2,1,226,149,51346,39683,231,90,54062,38237
415,38,0,1,1,0,0,3,117,91,51346,39684,130,25,54062,38240
416,38,5,1,0,3,1,0,322,256,51351,39685,343,52,54065,38240
417,38,1,1,2,1,2,1,67,61,51352,39686,91,113,54066,38241
418,39,1,3,1,0,0,3,184,135,51353,39689,164,158,54066,38244
419,39,1,2,1,0,0,3,177,184,51354,39691,208,143,54066,38247
420,39,0,0,2,1,2,1,152,80,51354,39691,198,125,54067,38248
421,39,1,0,0,3,1,0,153,138,51355,39691,177,74,54070,38248
422,39,1,0,0,3,1,0,122,111,51356,39691,144,73,54073,38248
423,39,1,1,2,1,2,1,92,67,51357,39692,105,96,54074,38249
424,39,0,3,1,0,0,3,151,150,51357,39695,190,160,54074,38252
425,39,1,3,1,0,0,3,125,103,51358,39698,143,45,54074,38255
426,39,0,1,1,0,0,3,123,117,51358,39699,142,56,54074,38258
427,39,2,4,1,0,0,3,79,90,51360,39703,98,231,54074,38261
428,39,2,3,1,0,0,3,21,19,51362,39706,29,28,54074,38264
429,40,3,1,0,3,1,0,125,112,51365,39707,147,51,54077,38264
430,40,3,0,0,3,1,0,67,58,51368,39707,99,129,54080,38264
431,40,1,0,0,3,1,0,118,91,51369,39707,133,52,54083,38264
432,40,1,1,2,1,2,1,104,97,51370,39708,138,120,54084,38265
433,40,4,3,0,3,1,0,242,182,51374,39711,275,125,54087,38265
434,40,1,0,0,3,1,0,227,149,51375,39711,234,25,54090,38265
435,40,2,0,0,3,1,0,209,162,51377,39711,225,45,54093,38265
436,40,0,2,1,0,0,3,165,110,51377,39713,178,62,54093,38268
437,40,1,3,1,0,0,3,212,157,51378,39716,248,93,54093,38271
438,40,3,0,0,3,1,0,325,256,51381,39716,346,113,54096,38271
439,40,4,2,0,3,1,0,51,49,51385,39718,54,87,54099,38271
440,41,2,0,0,3,1,0,211,162,51387,39718,228,51,54102,38271
441,41,2,0,0,3,1,0,69,61,51389,39718,94,231,54105,38271
442,41,1,1,2,1,2,1,153,81,51390,39719,199,97,54106,38272
443,41,0,1,1,0,0,3,79,91,51390,39720,98,77,54106,38275
444,41,1,1,2,1,2,1,93,68,51391,39721,106,29,54107,38276
445,41,0,1,1,0,0,3,153,139,51391,39722,177,163,54107,38279
446,41,0,1,1,0,0,3,21,20,51391,39723,29,59,54107,38282
447,41,0,2,1,0,0,3,151,152,51391,39725,190,161,54107,38285
448,41,0,2,1,0,0,3,123,119,51391,39727,142,146,54107,38288
449,41,2,0,0,3,1,0,179,184,51393,39727,211,109,54110,38288
450,41,2,5,1,0,0,3,186,140,51395,39732,164,76,54110,38291
451,42,1,1,2,1,2,1,119,92,51396,39733,134,114,54111,38292
452,42,0,1,1,0,0,3,51,50,51396,39734,54,65,54111,38295
453,42,1,1,2,1,2,1,228,150,51397,39735,235,53,54112,38296
454,42,2,0,0,3,1,0,69,58,51399,39735,102,87,54115,38296
455,42,2,4,1,0,0,3,214,161,51401,39739,248,28,54115,38299
456,42,3,2,0,3,1,0,245,184,51404,39741,278,129,54118,38299
457,42,2,0,0,3,1,0,127,112,51406,39741,150,125,54121,38299
458,42,2,2,2,1,2,1,127,105,51408,39743,144,121,54122,38300
459,42,0,3,1,0,0,3,325,259,51408,39746,346,128,54122,38303
460,42,2,2,2,1,2,1,106,99,51410,39748,139,94,54123,38304
461,42,3,3,2,1,2,1,168,113,51413,39751,179,46,54124,38305
0,1,0,2,1,0,0,3,21,22,51413,39753,29,124,54124,38308
1,1,2,0,0,3,1,0,155,81,51415,39753,202,87,54127,38308
2,1,2,3,1,0,0,3,114,114,51417,39756,127,132,54127,38311
3,1,1,0,0,3,1,0,140,105,51418,39756,164,161,54130,38311
4,1,1,1,2,1,2,1,70,59,51419,39757,103,95,54131,38312
5,1,2,2,2,1,2,1,2,2,51421,39759,1,54,54132,38313
6,1,3,2,0,3,1,0,144,132,51424,39761,144,76,54135,38313
7,1,2,0,0,3,1,0,121,92,51426,39761,137,131,54138,38313
8,1,6,3,0,3,1,0,174,116,51432,39764,182,46,54141,38313
9,1,2,2,2,1,2,1,39,44,51434,39766,48,30,54142,38314
10,1,0,1,1,0,0,3,0,1,51434,39767,0,166,54142,38317
11,2,1,0,0,3,1,0,94,68,51435,39767,109,28,54145,38317
12,2,3,1,0,3,1,0,109,100,51438,39768,142,97,54148,38317
13,2,1,1,2,1,2,1,52,51,51439,39769,55,85,54149,38318
14,2,2,3,1,0,0,3,230,153,51441,39772,235,100,54149,38321
15,2,3,2,0,3,1,0,126,121,51444,39774,145,105,54152,38321
16,2,1,0,0,3,1,0,180,184,51445,39774,214,59,54155,38321
17,2,2,0,0,3,1,0,153,152,51447,39774,193,0,54158,38321
18,2,1,2,1,0,0,3,70,63,51448,39776,94,36,54158,38324
19,2,2,1,0,3,1,0,144,120,51450,39777,187,0,54161,38324
20,2,1,0,0,3,1,0,154,139,51451,39777,180,77,54164,38324
21,2,2,0,0,3,1,0,216,161,51453,39777,251,114,54167,38324
22,3,1,1,2,1,2,1,71,60,51454,39778,104,55,54168,38325
23,3,1,1,2,1,2,1,115,115,51455,39779,128,47,54169,38326
24,3,1,0,0,3,1,0,40,44,51456,39779,51,166,54172,38326
25,3,0,0,2,1,2,1,174,116,51456,39779,183,132,54173,38327
26,3,3,1,0,3,1,0,3,2,51459,39780,3,87,54176,38327
27,3,3,0,0,3,1,0,24,22,51462,39780,32,132,54179,38327
28,3,3,1,0,3,1,0,5,3,51465,39781,4,30,54182,38327
29,3,3,0,0,3,1,0,124,92,51468,39781,140,161,54185,38327
30,3,1,3,1,0,0,3,141,108,51469,39784,164,117,54185,38330
31,3,1,1,2,1,2,1,110,101,51470,39785,143,96,54186,38331
32,3,2,1,0,3,1,0,146,133,51472,39786,147,124,54189,38331
33,4,2,1,0,3,1,0,182,185,51474,39787,217,76,54192,38331
34,4,2,3,1,0,0,3,155,155,51476,39790,193,62,54192,38334
35,4,1,0,0,3,1,0,145,120,51477,39790,190,36,54195,38334
36,4,1,0,0,3,1,0,217,161,51478,39790,254,0,54198,38334
37,4,0,1,1,0,0,3,126,122,51478,39791,145,100,54198,38337
38,4,0,0,2,1,2,1,230,153,51478,39791,236,86,54199,38338
39,4,1,0,0,3,1,0,95,68,51479,39791,112,105,54202,38338
40,4,1,0,0,3,1,0,53,51,51480,39791,58,28,54205,38338
41,4,0,0,2,1,2,1,154,139,51480,39791,181,101,54206,38339
42,4,1,0,0,3,1,0,156,81,51481,39791,205,77,54209,38339
43,4,0,2,1,0,0,3,70,65,51481,39793,94,3,54209,38342
44,5,1,2,1,0,0,3,6,5,51482,39795,4,169,54209,38345
45,5,0,0,2,1,2,1,110,101,51482,39795,144,56,54210,38346
46,5,1,1,2,1,2,1,72,61,51483,39796,105,31,54211,38347
47,5,0,2,1,0,0,3,24,24,51483,39798,32,50,54211,38350
48,5,1,0,0,3,1,0,4,2,51484,39798,6,117,54214,38350
49,5,0,1,1,0,0,3,126,123,51484,39799,145,127,54214,38353
50,5,0,2,1,0,0,3,146,135,51484,39801,147,135,54214,38356
51,5,1,3,1,0,0,3,116,118,51485,39804,128,135,54214,38359
52,5,1,0,0,3,1,0,41,44,51486,39804,54,87,54217,38359
53,5,2,2,2,1,2,1,176,118,51488,39806,184,162,54218,38360
54,5,1,0,0,3,1,0,142,108,51489,39806,167,77,54221,38360
55,6,0,0,2,1,2,1,95,68,51489,39806,113,97,54222,38361
56,6,0,1,1,0,0,3,154,140,51489,39807,181,89,54222,38364
57,6,1,1,2,1,2,1,157,82,51490,39808,206,102,54223,38365
58,6,1,0,0,3,1,0,125,92,51491,39808,143,0,54226,38365
59,6,0,0,2,1,2,1,182,185,51491,39808,218,101,54227,38366
60,6,1,1,2,1,2,1,146,121,51492,39809,191,4,54228,38367
61,6,0,0,2,1,2,1,155,155,51492,39809,194,77,54229,38368
62,6,3,0,0,3,1,0,73,65,51495,39809,97,62,54232,38368
63,6,2,2,2,1,2,1,232,155,51497,39811,237,29,54233,38369
64,6,0,0,2,1,2,1,217,161,51497,39811,255,37,54234,38370
65,6,3,0,0,3,1,0,56,51,51500,39811,61,105,54237,38370
66,7,0,2,1,0,0,3,41,46,51500,39813,54,120,54237,38373
67,7,2,2,2,1,2,1,148,137,51502,39815,148,51,54238,38374
68,7,1,0,0,3,1,0,177,118,51503,39815,187,77,54241,38374
69,7,1,0,0,3,1,0,143,108,51504,39815,170,0,54244,38374
70,7,1,0,0,3,1,0,127,123,51505,39815,148,135,54247,38374
71,7,1,1,2,1,2,1,7,6,51506,39816,5,88,54248,38375
72,7,4,0,0,3,1,0,186,185,51510,39816,221,56,54251,38375
73,7,3,2,0,3,1,0,113,103,51513,39818,147,31,54254,38375
74,7,1,0,0,3,1,0,73,61,51514,39818,108,169,54257,38375
75,7,4,1,0,3,1,0,28,25,51518,39819,35,135,54260,38375
76,7,1,1,2,1,2,1,117,119,51519,39820,129,163,54261,38376
77,8,0,0,2,1,2,1,73,65,51519,39820,98,78,54262,38377
78,8,1,4,1,0,0,3,147,125,51520,39824,191,65,54262,38380
79,8,2,2,2,1,2,1,127,94,51522,39826,144,38,54263,38381
80,8,0,0,2,1,2,1,4,2,51522,39826,7,103,54264,38382
81,8,3,0,0,3,1,0,158,155,51525,39826,197,127,54267,38382
82,8,2,3,1,0,0,3,219,164,51527,39829,255,7,54267,38385
83,8,1,2,1,0,0,3,96,70,51528,39831,113,104,54267,38388
84,8,1,3,1,0,0,3,57,54,51529,39834,61,100,54267,38391
85,8,1,0,0,3,1,0,155,140,51530,39834,184,29,54270,38391
86,8,0,1,1,0,0,3,157,83,51530,39835,206,92,54270,38394
87,8,1,1,2,1,2,1,233,156,51531,39836,238,106,54271,38395
88,9,2,2,2,1,2,1,115,105,51533,39838,148,170,54272,38396
89,9,2,2,2,1,2,1,75,63,51535,39840,109,89,54273,38397
90,9,3,2,0,3,1,0,10,8,51538,39842,8,120,54276,38397
91,9,2,1,0,3,1,0,43,47,51540,39843,57,0,54279,38397
92,9,1,0,0,3,1,0,187,185,51541,39843,224,31,54282,38397
93,9,2,3,1,0,0,3,150,140,51543,39846,148,138,54282,38400
94,9,1,0,0,3,1,0,97,70,51544,39846,116,135,54285,38400
95,9,3,1,0,3,1,0,31,26,51547,39847,38,163,54288,38400
96,9,1,1,2,1,2,1,118,120,51548,39848,130,78,54289,38401
97,9,3,2,0,3,1,0,146,110,51551,39850,173,103,54292,38401
98,9,2,0,0,3,1,0,129,123,51553,39850,151,51,54295,38401
99,10,3,2,0,3,1,0,161,157,51556,39852,200,104,54298,38401
100,10,0,0,2,1,2,1,147,125,51556,39852,192,79,54299,38402
101,10,6,1,0,3,1,0,163,84,51562,39853,209,29,54302,38402
102,10,0,0,2,1,2,1,4,2,51562,39853,8,93,54303,38403
103,10,0,0,2,1,2,1,233,156,51562,39853,239,101,54304,38404
104,10,1,0,0,3,1,0,156,140,51563,39853,187,106,54307,38404
105,10,2,0,0,3,1,0,59,54,51565,39853,64,56,54310,38404
106,10,2,1,0,3,1,0,221,165,51567,39854,258,65,54313,38404
107,10,4,2,0,3,1,0,131,96,51571,39856,147,7,54316,38404
108,10,1,1,2,1,2,1,178,119,51572,39857,188,39,54317,38405
109,10,2,2,2,1,2,1,75,67,51574,39859,99,128,54318,38406
110,11,2,0,0,3,1,0,99,70,51576,39859,119,51,54321,38406
111,11,0,1,1,0,0,3,31,27,51576,39860,38,81,54321,38409
112,11,2,0,0,3,1,0,120,120,51578,39860,133,103,54324,38409
113,11,2,0,0,3,1,0,148,110,51580,39860,176,39,54327,38409
114,11,3,0,0,3,1,0,78,63,51583,39860,112,120,54330,38409
115,11,2,0,0,3,1,0,131,123,51585,39860,154,138,54333,38409
116,11,1,1,2,1,2,1,162,158,51586,39861,201,32,54334,38410
117,11,0,1,1,0,0,3,187,186,51586,39862,224,173,54334,38413
118,11,0,0,2,1,2,1,115,105,51586,39862,149,90,54335,38414
119,11,0,0,2,1,2,1,10,8,51586,39862,9,1,54336,38415
120,11,1,1,2,1,2,1,151,141,51587,39863,149,164,54337,38416
121,12,2,0,0,3,1,0,77,67,51589,39863,102,135,54340,38416
122,12,1,1,2,1,2,1,222,166,51590,39864,259,80,54341,38417
123,12,2,2,2,1,2,1,133,98,51592,39866,148,66,54342,38418
124,12,0,0,2,1,2,1,156,140,51592,39866,188,102,54343,38419
125,12,2,1,0,3,1,0,149,126,51594,39867,195,128,54346,38419
126,12,2,0,0,3,1,0,61,54,51596,39867,67,104,54349,38419
127,12,0,1,1,0,0,3,233,157,51596,39868,239,59,54349,38422
128,12,1,0,0,3,1,0,179,119,51597,39868,191,7,54352,38422
129,12,2,0,0,3,1,0,45,47,51599,39868,60,93,54355,38422
130,12,0,0,2,1,2,1,163,84,51599,39868,210,107,54356,38423
131,12,2,0,0,3,1,0,6,2,51601,39868,11,29,54359,38423
132,13,1,2,1,0,0,3,62,56,51602,39870,67,54,54359,38426
133,13,1,0,0,3,1,0,163,158,51603,39870,204,173,54362,38426
134,13,3,0,0,3,1,0,118,105,51606,39870,152,120,54365,38426
135,13,3,0,0,3,1,0,81,63,51609,39870,115,1,54368,38426
136,13,1,1,2,1,2,1,100,71,51610,39871,120,139,54369,38427
137,13,0,2,1,0,0,3,131,125,51610,39873,154,167,54369,38430
138,13,1,1,2,1,2,1,152,142,51611,39874,150,82,54370,38431
139,13,2,1,0,3,1,0,33,28,51613,39875,41,103,54373,38431
140,13,2,0,0,3,1,0,12,8,51615,39875,12,39,54376,38431
141,13,1,1,2,1,2,1,149,111,51616,39876,177,94,54377,38432
142,13,2,1,0,3,1,0,189,187,51618,39877,227,90,54380,38432
143,14,1,1,2,1,2,1,157,141,51619,39878,189,60,54381,38433
144,14,0,0,2,1,2,1,6,2,51619,39878,12,108,54382,38434
145,14,2,2,2,1,2,1,181,121,51621,39880,192,67,54383,38435
146,14,0,1,1,0,0,3,120,121,51621,39881,133,10,54383,38438
147,14,0,1,1,0,0,3,149,127,51621,39882,195,138,54383,38441
148,14,0,1,1,0,0,3,222,167,51621,39883,259,131,54383,38444
149,14,1,1,2,1,2,1,78,68,51622,39884,103,105,54384,38445
150,14,3,0,0,3,1,0,236,157,51625,39884,242,32,54387,38445
151,14,1,0,0,3,1,0,134,98,51626,39884,151,80,54390,38445
152,14,2,0,0,3,1,0,47,47,51628,39884,63,29,54393,38445
153,14,1,0,0,3,1,0,164,84,51629,39884,213,102,54396,38445
154,15,1,0,0,3,1,0,119,105,51630,39884,155,1,54399,38445
155,15,1,2,1,0,0,3,190,189,51631,39886,227,123,54399,38448
156,15,1,1,2,1,2,1,153,143,51632,39887,151,104,54400,38449
157,15,2,0,0,3,1,0,35,28,51634,39887,44,94,54403,38449
158,15,1,0,0,3,1,0,164,158,51635,39887,207,90,54406,38449
159,15,1,1,2,1,2,1,101,72,51636,39888,121,168,54407,38450
160,15,1,1,2,1,2,1,79,69,51637,39889,104,174,54408,38451
161,15,1,0,0,3,1,0,63,56,51638,39889,70,139,54411,38451
162,15,2,0,0,3,1,0,133,125,51640,39889,157,82,54414,38451
163,15,0,1,1,0,0,3,81,64,51640,39890,115,42,54414,38454
164,15,2,1,0,3,1,0,151,112,51642,39891,180,10,54417,38454
165,16,0,0,2,1,2,1,149,127,51642,39891,196,55,54418,38455
166,16,1,2,1,0,0,3,223,169,51643,39893,259,141,54418,38458
167,16,1,1,2,1,2,1,165,85,51644,39894,214,61,54419,38459
168,16,2,2,2,1,2,1,49,49,51646,39896,64,109,54420,38460
169,16,3,0,0,3,1,0,137,98,51649,39896,154,131,54423,38460
170,16,2,0,0,3,1,0,159,141,51651,39896,192,32,54426,38460
171,16,1,2,1,0,0,3,182,123,51652,39898,192,83,54426,38463
172,16,1,2,1,0,0,3,121,123,51653,39900,133,70,54426,38466
173,16,2,1,0,3,1,0,14,9,51655,39901,15,29,54429,38466
174,16,1,2,1,0,0,3,237,159,51656,39903,242,108,54429,38469
175,16,0,1,1,0,0,3,6,3,51656,39904,12,105,54429,38472
176,17,0,1,1,0,0,3,237,160,51656,39905,242,142,54429,38475
177,17,1,1,2,1,2,1,165,159,51657,39906,208,124,54430,38476
178,17,3,1,0,3,1,0,104,73,51660,39907,124,82,54433,38476
179,17,2,0,0,3,1,0,153,112,51662,39907,183,29,54436,38476
180,17,2,1,0,3,1,0,81,70,51664,39908,107,90,54439,38476
181,17,2,2,2,1,2,1,135,127,51666,39910,158,105,54440,38477
182,17,0,1,1,0,0,3,63,57,51666,39911,70,171,54440,38480
183,17,1,0,0,3,1,0,120,105,51667,39911,158,42,54443,38480
184,17,1,2,1,0,0,3,154,145,51668,39913,151,97,54443,38483
185,17,1,1,2,1,2,1,191,190,51669,39914,228,2,54444,38484
186,17,1,2,1,0,0,3,82,66,51670,39916,115,13,54444,38487
187,18,2,1,0,3,1,0,151,128,51672,39917,199,108,54447,38487
188,18,1,1,2,1,2,1,160,142,51673,39918,193,175,54448,38488
189,18,0,1,1,0,0,3,137,99,51673,39919,154,144,54448,38491
190,18,3,1,0,3,1,0,52,50,51676,39920,67,105,54451,38491
191,18,1,3,1,0,0,3,183,126,51677,39923,192,134,54451,38494
192,18,4,1,0,3,1,0,227,170,51681,39924,262,55,54454,38494
193,18,1,0,0,3,1,0,166,85,51682,39924,217,32,54457,38494
194,18,1,1,2,1,2,1,122,124,51683,39925,134,84,54458,38495
195,18,0,0,2,1,2,1,35,28,51683,39925,45,71,54459,38496
196,18,1,0,0,3,1,0,15,9,51684,39925,18,109,54462,38496
197,18,1,1,2,1,2,1,7,4,51685,39926,13,62,54463,38497
198,19,1,1,2,1,2,1,192,191,51686,39927,229,43,54464,38498
199,19,3,0,0,3,1,0,168,159,51689,39927,211,2,54467,38498
200,19,1,1,2,1,2,1,152,129,51690,39928,200,91,54468,38499
201,19,1,2,1,0,0,3,154,114,51691,39930,183,74,54468,38502
202,19,2,2,2,1,2,1,65,59,51693,39932,71,83,54469,38503
203,19,2,3,1,0,0,3,106,76,51695,39935,124,108,54469,38506
204,19,1,1,2,1,2,1,121,106,51696,39936,159,14,54470,38507
205,19,2,1,0,3,1,0,156,146,51698,39937,154,29,54473,38507
206,19,3,3,2,1,2,1,138,130,51701,39940,159,98,54474,38508
207,19,1,0,0,3,1,0,238,160,51702,39940,245,171,54477,38508
208,19,1,2,1,0,0,3,82,72,51703,39942,107,127,54477,38511
209,20,1,1,2,1,2,1,228,171,51704,39943,263,143,54478,38512
210,20,1,0,0,3,1,0,167,85,51705,39943,220,175,54481,38512
211,20,1,2,1,0,0,3,53,52,51706,39945,67,65,54481,38515
212,20,1,1,2,1,2,1,83,67,51707,39946,116,110,54482,38516
213,20,0,1,1,0,0,3,183,127,51707,39947,192,147,54482,38519
214,20,1,0,0,3,1,0,16,9,51708,39947,21,105,54485,38519
215,20,0,1,1,0,0,3,137,100,51708,39948,154,58,54485,38522
216,20,0,1,1,0,0,3,7,5,51708,39949,13,35,54485,38525
217,20,0,1,1,0,0,3,122,125,51708,39950,134,137,54485,38528
218,20,0,1,1,0,0,3,35,29,51708,39951,45,87,54485,38531
219,20,3,1,0,3,1,0,157,115,51711,39952,186,91,54488,38531
220,21,2,0,0,3,1,0,154,129,51713,39952,203,127,54491,38531
221,21,2,0,0,3,1,0,84,72,51715,39952,110,2,54494,38531
222,21,0,2,1,0,0,3,65,61,51715,39954,71,111,54494,38534
223,21,1,0,0,3,1,0,139,130,51716,39954,162,29,54497,38534
224,21,0,0,2,1,2,1,192,191,51716,39954,230,15,54498,38535
225,21,0,1,1,0,0,3,160,143,51716,39955,193,174,54498,38538
226,21,4,0,0,3,1,0,242,160,51720,39955,248,83,54501,38538
227,21,1,3,1,0,0,3,169,162,51721,39958,211,46,54501,38541
228,21,1,1,2,1,2,1,107,77,51722,39959,125,99,54502,38542
229,21,4,0,0,3,1,0,125,106,51726,39959,162,74,54505,38542
230,21,0,1,1,0,0,3,156,147,51726,39960,154,111,54505,38545
231,22,2,2,2,1,2,1,109,79,51728,39962,126,16,54506,38546
232,22,1,0,0,3,1,0,170,162,51729,39962,214,99,54509,38546
233,22,2,1,0,3,1,0,244,161,51731,39963,251,2,54512,38546
234,22,1,0,0,3,1,0,161,143,51732,39963,196,127,54515,38546
235,22,2,1,0,3,1,0,127,107,51734,39964,165,110,54518,38546
236,22,2,0,0,3,1,0,230,171,51736,39964,266,111,54521,38546
237,22,1,2,1,0,0,3,140,132,51737,39966,162,77,54521,38549
238,22,3,0,0,3,1,0,195,191,51740,39966,233,29,54524,38549
239,22,1,1,2,1,2,1,66,62,51741,39967,72,47,54525,38550
240,22,0,0,2,1,2,1,84,72,51741,39967,111,112,54526,38551
241,22,1,0,0,3,1,0,155,129,51742,39967,206,83,54529,38551
242,23,2,3,1,0,0,3,159,118,51744,39970,186,90,54529,38554
243,23,0,0,2,1,2,1,35,29,51744,39970,46,66,54530,38555
244,23,3,1,0,3,1,0,125,126,51747,39971,137,35,54533,38555
245,23,0,0,2,1,2,1,167,85,51747,39971,221,175,54534,38556
246,23,1,1,2,1,2,1,17,10,51748,39972,22,148,54535,38557
247,23,2,1,0,3,1,0,158,148,51750,39973,157,105,54538,38557
248,23,2,1,0,3,1,0,55,53,51752,39974,70,58,54541,38557
249,23,1,1,2,1,2,1,184,128,51753,39975,193,176,54542,38558
250,23,0,1,1,0,0,3,7,6,51753,39976,13,146,54542,38561
251,23,0,2,1,0,0,3,137,102,51753,39978,154,94,54542,38564
252,23,4,0,0,3,1,0,87,67,51757,39978,119,137,54545,38564
253,24,1,0,0,3,1,0,141,132,51758,39978,165,90,54548,38564
254,24,2,2,2,1,2,1,68,64,51760,39980,73,17,54549,38565
255,24,1,1,2,1,2,1,85,73,51761,39981,112,100,54550,38566
256,24,0,0,2,1,2,1,230,171,51761,39981,267,84,54551,38567
257,24,0,0,2,1,2,1,155,129,51761,39981,207,113,54552,38568
258,24,3,3,2,1,2,1,170,88,51764,39984,222,112,54553,38569
259,24,1,4,1,0,0,3,110,83,51765,39988,126,80,54553,38572
260,24,1,0,0,3,1,0,171,162,51766,39988,217,29,54556,38572
261,24,1,1,2,1,2,1,245,162,51767,39989,252,48,54557,38573
262,24,2,3,1,0,0,3,163,146,51769,39992,196,5,54557,38576
263,24,0,0,2,1,2,1,195,191,51769,39992,234,111,54558,38577
264,25,0,2,1,0,0,3,158,150,51769,39994,157,69,54558,38580
265,25,1,0,0,3,1,0,56,53,51770,39994,73,146,54561,38580
266,25,0,1,1,0,0,3,7,7,51770,39995,13,178,54561,38583
267,25,0,0,2,1,2,1,137,102,51770,39995,155,128,54562,38584
268,25,0,0,2,1,2,1,87,67,51770,39995,120,149,54563,38585
269,25,0,2,1,0,0,3,159,120,51770,39997,186,108,54563,38588
270,25,2,0,0,3,1,0,129,107,51772,39997,168,137,54566,38588
271,25,2,0,0,3,1,0,37,29,51774,39997,49,35,54569,38588
272,25,1,0,0,3,1,0,18,10,51775,39997,25,58,54572,38588
273,25,0,1,1,0,0,3,125,127,51775,39998,137,179,54572,38591
274,25,2,0,0,3,1,0,186,128,51777,39998,196,94,54575,38591
275,26,1,2,1,0,0,3,111,85,51778,40000,126,93,54575,38594
276,26,1,1,2,1,2,1,69,65,51779,40001,74,81,54576,38595
277,26,2,2,2,1,2,1,165,148,51781,40003,197,49,54577,38596
278,26,1,0,0,3,1,0,171,88,51782,40003,225,5,54580,38596
279,26,1,3,1,0,0,3,138,105,51783,40006,155,115,54580,38599
280,26,1,1,2,1,2,1,172,163,51784,40007,218,112,54581,38600
281,26,3,1,0,3,1,0,88,74,51787,40008,115,29,54584,38600
282,26,1,1,2,1,2,1,246,163,51788,40009,253,18,54585,38601
283,26,1,1,2,1,2,1,156,130,51789,40010,208,101,54586,38602
284,26,2,2,2,1,2,1,232,173,51791,40012,268,114,54587,38603
285,26,1,1,2,1,2,1,196,192,51792,40013,235,109,54588,38604
286,27,0,1,1,0,0,3,37,30,51792,40014,49,182,54588,38607
287,27,1,1,2,1,2,1,187,129,51793,40015,197,129,54589,38608
288,27,4,2,0,3,1,0,11,9,51797,40017,16,84,54592,38608
289,27,0,1,1,0,0,3,159,121,51797,40018,186,140,54592,38611
290,27,2,0,0,3,1,0,131,107,51799,40018,171,149,54595,38611
291,27,3,1,0,3,1,0,144,133,51802,40019,168,69,54598,38611
292,27,1,0,0,3,1,0,159,150,51803,40019,160,35,54601,38611
293,27,1,2,1,0,0,3,88,69,51804,40021,120,61,54601,38614
294,27,1,1,2,1,2,1,57,54,51805,40022,74,179,54602,38615
295,27,3,0,0,3,1,0,21,10,51808,40022,28,146,54605,38615
296,27,1,2,1,0,0,3,126,129,51809,40024,137,97,54605,38618
297,28,2,0,0,3,1,0,248,163,51811,40024,256,81,54608,38618
298,28,1,1,2,1,2,1,157,131,51812,40025,209,30,54609,38619
299,28,1,0,0,3,1,0,166,148,51813,40025,200,18,54612,38619
300,28,1,2,1,0,0,3,12,11,51814,40027,16,118,54612,38622
301,28,2,0,0,3,1,0,113,85,51816,40027,129,140,54615,38622
302,28,0,0,2,1,2,1,172,163,51816,40027,219,110,54616,38623
303,28,0,0,2,1,2,1,88,74,51816,40027,116,113,54617,38624
304,28,0,1,1,0,0,3,232,174,51816,40028,268,104,54617,38627
305,28,1,1,2,1,2,1,172,89,51817,40029,226,50,54618,38628
306,28,1,0,0,3,1,0,139,105,51818,40029,158,114,54621,38628
307,28,0,3,1,0,0,3,69,68,51818,40032,74,96,54621,38631
308,29,1,0,0,3,1,0,145,133,51819,40032,171,35,54624,38631
309,29,1,0,0,3,1,0,160,150,51820,40032,163,182,54627,38631
310,29,1,2,1,0,0,3,89,71,51821,40034,120,149,54627,38634
311,29,3,2,0,3,1,0,190,131,51824,40036,200,5,54630,38634
312,29,2,4,1,0,0,3,23,14,51826,40040,28,182,54630,38637
313,29,3,1,0,3,1,0,199,193,51829,40041,238,149,54633,38637
314,29,1,2,1,0,0,3,160,123,51830,40043,186,72,54633,38640
315,29,3,0,0,3,1,0,40,30,51833,40043,52,97,54636,38640
316,29,1,0,0,3,1,0,127,129,51834,40043,140,129,54639,38640
317,29,1,1,2,1,2,1,58,55,51835,40044,75,85,54640,38641
318,29,0,1,1,0,0,3,131,108,51835,40045,171,64,54640,38644
319,30,0,0,2,1,2,1,172,163,51835,40045,220,73,54641,38645
320,30,3,1,0,3,1,0,72,69,51838,40046,77,140,54644,38645
321,30,3,0,0,3,1,0,235,174,51841,40046,271,30,54647,38645
322,30,1,0,0,3,1,0,173,89,51842,40046,229,18,54650,38645
323,30,0,0,2,1,2,1,157,131,51842,40046,210,114,54651,38646
324,30,0,0,2,1,2,1,88,74,51842,40046,117,111,54652,38647
325,30,1,1,2,1,2,1,249,164,51843,40047,257,97,54653,38648
326,30,1,1,2,1,2,1,167,149,51844,40048,201,82,54654,38649
327,30,2,1,0,3,1,0,141,106,51846,40049,161,104,54657,38649
328,30,0,4,1,0,0,3,12,15,51846,40053,16,53,54657,38652
329,30,1,1,2,1,2,1,191,132,51847,40054,201,119,54658,38653
330,31,0,0,2,1,2,1,199,193,51847,40054,239,65,54659,38654
331,31,0,0,2,1,2,1,131,108,51847,40054,172,150,54660,38655
332,31,1,2,1,0,0,3,128,131,51848,40056,140,8,54660,38658
333,31,1,0,0,3,1,0,59,55,51849,40056,78,114,54663,38658
334,31,3,0,0,3,1,0,26,14,51852,40056,31,85,54666,38658
335,31,1,2,1,0,0,3,161,125,51853,40058,186,152,54666,38661
336,31,2,1,0,3,1,0,115,86,51855,40059,132,35,54669,38661
337,31,0,3,1,0,0,3,145,136,51855,40062,171,185,54669,38664
338,31,1,1,2,1,2,1,161,151,51856,40063,164,98,54670,38665
339,31,4,1,0,3,1,0,93,72,51860,40064,123,182,54673,38665
340,31,4,0,0,3,1,0,44,30,51864,40064,55,129,54676,38665
341,32,2,1,0,3,1,0,159,132,51866,40065,213,111,54679,38665
342,32,3,0,0,3,1,0,170,149,51869,40065,204,97,54682,38665
343,32,1,0,0,3,1,0,174,89,51870,40065,232,82,54685,38665
344,32,1,0,0,3,1,0,142,106,51871,40065,164,30,54688,38665
345,32,4,4,2,1,2,1,63,59,51875,40069,79,120,54689,38666
346,32,1,0,0,3,1,0,89,74,51876,40069,120,73,54692,38666
347,32,0,0,2,1,2,1,249,164,51876,40069,258,141,54693,38667
348,32,1,1,2,1,2,1,236,175,51877,40070,272,115,54694,38668
349,32,3,2,0,3,1,0,194,134,51880,40072,204,104,54697,38668
350,32,0,1,1,0,0,3,72,70,51880,40073,77,155,54697,38671
351,32,2,1,0,3,1,0,14,16,51882,40074,19,18,54700,38671
352,33,1,1,2,1,2,1,162,152,51883,40075,165,130,54701,38672
353,33,1,1,2,1,2,1,116,87,51884,40076,133,186,54702,38673
354,33,1,0,0,3,1,0,94,72,51885,40076,126,85,54705,38673
355,33,2,1,0,3,1,0,46,31,51887,40077,58,8,54708,38673
356,33,4,0,0,3,1,0,135,108,51891,40077,175,182,54711,38673
357,33,2,1,0,3,1,0,147,137,51893,40078,174,98,54714,38673
358,33,2,3,1,0,0,3,163,128,51895,40081,186,38,54714,38676
359,33,2,2,2,1,2,1,174,165,51897,40083,221,66,54715,38677
360,33,1,0,0,3,1,0,27,14,51898,40083,34,114,54718,38677
361,33,2,0,0,3,1,0,130,131,51900,40083,143,53,54721,38677
362,33,0,0,2,1,2,1,199,193,51900,40083,240,151,54722,38678
363,34,1,0,0,3,1,0,250,164,51901,40083,261,155,54725,38678
364,34,2,0,0,3,1,0,161,132,51903,40083,216,73,54728,38678
365,34,1,1,2,1,2,1,15,17,51904,40084,20,83,54729,38679
366,34,1,1,2,1,2,1,195,135,51905,40085,205,31,54730,38680
367,34,1,2,1,0,0,3,237,177,51906,40087,272,114,54730,38683
368,34,0,0,2,1,2,1,63,59,51906,40087,80,19,54731,38684
369,34,1,0,0,3,1,0,90,74,51907,40087,123,38,54734,38684
370,34,2,0,0,3,1,0,176,89,51909,40087,235,97,54737,38684
371,34,1,3,1,0,0,3,143,109,51910,40090,164,118,54737,38687
372,34,0,2,1,0,0,3,130,133,51910,40092,143,123,54737,38690
373,34,1,1,2,1,2,1,171,150,51911,40093,205,142,54738,38691
374,35,0,3,1,0,0,3,72,73,51911,40096,77,189,54738,38694
375,35,3,0,0,3,1,0,138,108,51914,40096,178,85,54741,38694
376,35,1,1,2,1,2,1,47,32,51915,40097,59,54,54742,38695
377,35,0,1,1,0,0,3,27,15,51915,40098,34,107,54742,38698
378,35,0,0,2,1,2,1,174,165,51915,40098,222,152,54743,38699
379,35,1,0,0,3,1,0,200,193,51916,40098,243,182,54746,38699
380,35,0,0,2,1,2,1,163,128,51916,40098,187,67,54747,38700
381,35,2,1,0,3,1,0,118,88,51918,40099,136,98,54750,38700
382,35,3,2,0,3,1,0,165,154,51921,40101,168,8,54753,38700
383,35,0,2,1,0,0,3,94,74,51921,40103,126,117,54753,38703
384,35,3,1,0,3,1,0,150,138,51924,40104,177,130,54756,38703
385,36,0,1,1,0,0,3,176,90,51924,40105,235,145,54756,38706
386,36,2,0,0,3,1,0,197,135,51926,40105,208,118,54759,38706
387,36,3,1,0,3,1,0,133,134,51929,40106,146,31,54762,38706
388,36,0,0,2,1,2,1,171,150,51929,40106,206,156,54763,38707
389,36,1,0,0,3,1,0,28,15,51930,40106,37,123,54766,38707
390,36,1,0,0,3,1,0,251,164,51931,40106,264,67,54769,38707
391,36,1,1,2,1,2,1,162,133,51932,40107,217,39,54770,38708
392,36,1,1,2,1,2,1,238,178,51933,40108,273,74,54771,38709
393,36,3,2,0,3,1,0,66,61,51936,40110,83,83,54774,38709
394,36,1,1,2,1,2,1,144,110,51937,40111,165,115,54775,38710
395,36,1,2,1,0,0,3,16,19,51938,40113,20,100,54775,38713
396,37,1,2,1,0,0,3,119,90,51939,40115,136,133,54775,38716
397,37,0,0,2,1,2,1,200,193,51939,40115,244,86,54776,38717
398,37,1,2,1,0,0,3,166,156,51940,40117,168,57,54776,38720
399,37,2,0,0,3,1,0,49,32,51942,40117,62,19,54779,38720
400,37,1,1,2,1,2,1,91,75,51943,40118,124,153,54780,38721
401,37,2,1,0,3,1,0,176,166,51945,40119,225,182,54783,38721
402,37,1,0,0,3,1,0,164,128,51946,40119,190,189,54786,38721
403,37,1,0,0,3,1,0,73,73,51947,40119,80,98,54789,38721
404,37,2,0,0,3,1,0,152,138,51949,40119,180,8,54792,38721
405,37,2,2,2,1,2,1,140,110,51951,40121,179,118,54793,38722
406,37,1,0,0,3,1,0,95,74,51952,40121,129,107,54796,38722
407,38,1,0,0,3,1,0,172,150,51953,40121,209,67,54799,38722
408,38,1,0,0,3,1,0,239,178,51954,40121,276,39,54802,38722
409,38,2,2,2,1,2,1,199,137,51956,40123,209,116,54803,38723
410,38,4,1,0,3,1,0,32,16,51960,40124,40,83,54806,38723
411,38,0,0,2,1,2,1,66,61,51960,40124,84,101,54807,38724
412,38,1,1,2,1,2,1,163,134,51961,40125,218,190,54808,38725
413,38,0,1,1,0,0,3,176,91,51961,40126,235,159,54808,38728
414,38,2,1,0,3,1,0,146,111,51963,40127,168,74,54811,38728
415,38,0,0,2,1,2,1,16,19,51963,40127,21,146,54812,38729
416,38,2,1,0,3,1,0,135,135,51965,40128,149,118,54815,38729
417,38,1,0,0,3,1,0,50,32,51966,40128,65,123,54818,38729
418,39,3,1,0,3,1,0,167,129,51969,40129,193,153,54821,38729
419,39,1,0,0,3,1,0,252,164,51970,40129,267,98,54824,38729
420,39,3,1,0,3,1,0,94,76,51973,40130,127,182,54827,38729
421,39,0,2,1,0,0,3,73,75,51973,40132,80,136,54827,38732
422,39,2,3,1,0,0,3,142,113,51975,40135,179,110,54827,38735
423,39,0,1,1,0,0,3,152,139,51975,40136,180,60,54827,38738
424,39,2,0,0,3,1,0,178,166,51977,40136,228,86,54830,38738
425,39,2,0,0,3,1,0,121,90,51979,40136,139,8,54833,38738
426,39,3,2,0,3,1,0,203,195,51982,40138,247,118,54836,38738
427,39,0,0,2,1,2,1,95,74,51982,40138,130,32,54837,38739
428,39,3,1,0,3,1,0,169,157,51985,40139,171,19,54840,38739
429,40,2,1,0,3,1,0,174,151,51987,40140,212,153,54843,38739
430,40,0,0,2,1,2,1,239,178,51987,40140,277,191,54844,38740
431,40,2,1,0,3,1,0,178,92,51989,40141,238,67,54847,38740
432,40,2,1,0,3,1,0,148,112,51991,40142,171,39,54850,38740
433,40,1,0,0,3,1,0,200,137,51992,40142,212,74,54853,38740
434,40,1,0,0,3,1,0,67,61,51993,40142,87,146,54856,38740
435,40,0,0,2,1,2,1,50,32,51993,40142,66,119,54857,38741
436,40,0,3,1,0,0,3,95,77,51993,40145,130,126,54857,38744
437,40,2,3,1,0,0,3,18,22,51995,40148,21,162,54857,38747
438,40,1,1,2,1,2,1,136,136,51996,40149,150,117,54858,38748
439,40,0,1,1,0,0,3,32,17,51996,40150,40,104,54858,38751
440,41,0,1,1,0,0,3,174,152,51996,40151,212,129,54858,38754
441,41,2,2,2,1,2,1,165,136,51998,40153,219,183,54859,38755
442,41,2,0,0,3,1,0,254,164,52000,40153,270,136,54862,38755
443,41,1,1,2,1,2,1,95,77,52001,40154,128,87,54863,38756
444,41,2,1,0,3,1,0,75,76,52003,40155,83,8,54866,38756
445,41,2,0,0,3,1,0,180,166,52005,40155,231,118,54869,38756
446,41,0,3,1,0,0,3,121,93,52005,40158,139,63,54869,38759
447,41,2,3,1,0,0,3,205,198,52007,40161,247,113,54869,38762
448,41,1,0,0,3,1,0,153,139,52008,40161,183,19,54872,38762
449,41,2,0,0,3,1,0,144,113,52010,40161,182,32,54875,38762
450,41,2,1,0,3,1,0,171,158,52012,40162,174,83,54878,38762
451,42,2,0,0,3,1,0,20,22,52014,40162,24,67,54881,38762
452,42,2,0,0,3,1,0,202,137,52016,40162,215,39,54884,38762
453,42,1,0,0,3,1,0,137,136,52017,40162,153,74,54887,38762
454,42,1,3,1,0,0,3,240,181,52018,40165,277,101,54887,38765
455,42,4,1,0,3,1,0,182,93,52022,40166,241,153,54890,38765
456,42,0,1,1,0,0,3,148,113,52022,40167,171,194,54890,38768
457,42,1,1,2,1,2,1,68,62,52023,40168,88,163,54891,38769
458,42,0,5,1,0,0,3,32,22,52023,40173,40,149,54891,38772
459,42,6,2,0,3,1,0,56,34,52029,40175,69,117,54894,38772
460,42,0,1,1,0,0,3,95,78,52029,40176,130,107,54894,38775
461,42,1,1,2,1,2,1,168,130,52030,40177,194,120,54895,38776
0,1,1,1,2,1,2,1,96,79,52031,40178,131,172,54896,38777
1,1,1,1,2,1,2,1,172,159,52032,40179,175,20,54897,38778
2,1,0,1,1,0,0,3,174,153,52032,40180,212,3,54897,38781
3,1,2,1,0,3,1,0,167,137,52034,40181,222,143,54900,38781
4,1,0,0,2,1,2,1,182,93,52034,40181,242,114,54901,38782
5,1,1,0,0,3,1,0,169,130,52035,40181,197,67,54904,38782
6,1,2,2,2,1,2,1,70,64,52037,40183,89,75,54905,38783
7,1,0,1,1,0,0,3,202,138,52037,40184,215,165,54905,38786
8,1,3,3,2,1,2,1,3,3,52040,40187,1,195,54906,38787
9,1,1,0,0,3,1,0,241,181,52041,40187,280,19,54909,38787
10,1,3,1,0,3,1,0,156,140,52044,40188,186,0,54912,38787
11,2,0,0,2,1,2,1,233,191,52044,40188,281,119,54913,38788
12,2,1,1,2,1,2,1,96,78,52045,40189,129,1,54914,38789
13,2,1,1,2,1,2,1,1,1,52046,40190,1,84,54915,38790
14,2,2,0,0,3,1,0,34,22,52048,40190,43,120,54918,38790
15,2,3,1,0,3,1,0,257,165,52051,40191,273,153,54921,38790
16,2,3,3,2,1,2,1,124,96,52054,40194,140,118,54922,38791
17,2,1,1,2,1,2,1,1,1,52055,40195,1,130,54923,38792
18,2,1,1,2,1,2,1,138,137,52056,40196,154,64,54924,38793
19,2,2,0,0,3,1,0,254,237,52058,40196,281,136,54927,38793
20,2,0,0,2,1,2,1,207,199,52058,40196,198,184,54928,38794
21,2,1,1,2,1,2,1,15,24,52059,40197,17,102,54929,38795
22,3,1,1,2,1,2,1,4,4,52060,40198,2,1,54930,38796
23,3,3,3,2,1,2,1,172,133,52063,40201,198,76,54931,38797
24,3,3,2,0,3,1,0,99,81,52066,40203,134,20,54934,38797
25,3,1,1,2,1,2,1,234,192,52067,40204,282,4,54935,38798
26,3,3,0,0,3,1,0,175,159,52070,40204,178,143,54938,38798
27,3,2,1,0,3,1,0,243,182,52072,40205,283,195,54941,38798
28,3,3,1,0,3,1,0,170,138,52075,40206,225,67,54944,38798
29,3,1,1,2,1,2,1,203,139,52076,40207,216,137,54945,38799
30,3,1,1,2,1,2,1,71,65,52077,40208,90,166,54946,38800
31,3,0,0,2,1,2,1,174,153,52077,40208,213,20,54947,38801
32,3,1,0,0,3,1,0,157,140,52078,40208,189,114,54950,38801
33,4,1,0,0,3,1,0,125,96,52079,40208,143,1,54953,38801
34,4,1,1,2,1,2,1,2,2,52080,40209,2,120,54954,38802
35,4,1,0,0,3,1,0,97,78,52081,40209,132,184,54957,38802
36,4,4,2,0,3,1,0,258,239,52085,40211,284,118,54960,38802
37,4,1,0,0,3,1,0,208,199,52086,40211,201,102,54963,38802
38,4,0,0,2,1,2,1,34,22,52086,40211,44,85,54964,38803
39,4,3,0,0,3,1,0,18,24,52089,40211,20,172,54967,38803
40,4,1,1,2,1,2,1,2,2,52090,40212,2,154,54968,38804
41,4,3,0,0,3,1,0,141,137,52093,40212,157,130,54971,38804
42,4,1,0,0,3,1,0,183,93,52094,40212,245,64,54974,38804
43,4,3,3,2,1,2,1,260,168,52097,40215,274,121,54975,38805
44,5,1,0,0,3,1,0,204,139,52098,40215,219,64,54978,38805
45,5,1,0,0,3,1,0,3,2,52099,40215,5,20,54981,38805
46,5,0,1,1,0,0,3,243,183,52099,40216,283,4,54981,38808
47,5,0,3,1,0,0,3,170,141,52099,40219,225,79,54981,38811
48,5,1,0,0,3,1,0,173,133,52100,40219,201,166,54984,38811
49,5,2,0,0,3,1,0,159,140,52102,40219,192,137,54987,38811
50,5,0,1,1,0,0,3,175,160,52102,40220,178,70,54987,38814
51,5,2,1,0,3,1,0,101,82,52104,40221,137,143,54990,38814
52,5,2,1,0,3,1,0,236,193,52106,40222,285,20,54993,38814
53,5,2,0,0,3,1,0,6,4,52108,40222,5,114,54996,38814
54,5,1,0,0,3,1,0,175,153,52109,40222,216,195,54999,38814
55,6,1,0,0,3,1,0,126,96,52110,40222,146,184,55002,38814
56,6,0,1,1,0,0,3,183,94,52110,40223,245,133,55002,38817
57,6,1,0,0,3,1,0,19,24,52111,40223,23,120,55005,38817
58,6,0,0,2,1,2,1,71,65,52111,40223,91,119,55006,38818
59,6,0,3,1,0,0,3,141,140,52111,40226,157,157,55006,38821
60,6,1,0,0,3,1,0,259,239,52112,40226,287,1,55009,38821
61,6,4,0,0,3,1,0,6,2,52116,40226,5,121,55012,38821
62,6,0,1,1,0,0,3,34,23,52116,40227,44,7,55012,38824
63,6,2,0,0,3,1,0,210,199,52118,40227,204,172,55015,38824
64,6,1,1,2,1,2,1,261,169,52119,40228,275,86,55016,38825
65,6,0,0,2,1,2,1,97,78,52119,40228,133,103,55017,38826
66,7,1,1,2,1,2,1,7,5,52120,40229,6,138,55018,38827
67,7,1,2,1,0,0,3,244,185,52121,40231,283,117,55018,38830
68,7,0,0,2,1,2,1,175,160,52121,40231,179,80,55019,38831
69,7,2,0,0,3,1,0,175,133,52123,40231,204,64,55022,38831
70,7,0,1,1,0,0,3,170,142,52123,40232,225,169,55022,38834
71,7,0,2,1,0,0,3,19,26,52123,40234,23,23,55022,38837
72,7,3,2,0,3,1,0,104,84,52126,40236,140,70,55025,38837
73,7,0,2,1,0,0,3,236,195,52126,40238,285,198,55025,38840
74,7,0,0,2,1,2,1,175,153,52126,40238,217,5,55026,38841
75,7,2,1,0,3,1,0,206,140,52128,40239,222,119,55029,38841
76,7,1,1,2,1,2,1,4,3,52129,40240,6,144,55030,38842
77,8,2,0,0,3,1,0,143,140,52131,40240,160,121,55033,38842
78,8,3,1,0,3,1,0,129,97,52134,40241,149,103,55036,38842
79,8,1,0,0,3,1,0,184,94,52135,40241,248,157,55039,38842
80,8,1,1,2,1,2,1,72,66,52136,40242,92,2,55040,38843
81,8,1,1,2,1,2,1,160,141,52137,40243,193,134,55041,38844
82,8,2,2,2,1,2,1,8,4,52139,40245,6,87,55042,38845
83,8,1,0,0,3,1,0,262,169,52140,40245,278,7,55045,38845
84,8,3,2,0,3,1,0,262,241,52143,40247,290,184,55048,38845
85,8,2,2,2,1,2,1,36,25,52145,40249,45,121,55049,38846
86,8,0,0,2,1,2,1,97,78,52145,40249,134,173,55050,38847
87,8,3,0,0,3,1,0,213,199,52148,40249,207,20,55053,38847
88,9,0,0,2,1,2,1,4,3,52148,40249,7,71,55054,38848
89,9,2,0,0,3,1,0,238,195,52150,40249,288,5,55057,38848
90,9,2,0,0,3,1,0,246,185,52152,40249,286,138,55060,38848
91,9,4,4,2,1,2,1,174,146,52156,40253,226,65,55061,38849
92,9,1,1,2,1,2,1,207,141,52157,40254,223,135,55062,38850
93,9,2,1,0,3,1,0,9,6,52159,40255,9,119,55065,38850
94,9,2,0,0,3,1,0,38,25,52161,40255,48,144,55068,38850
95,9,2,2,2,1,2,1,106,86,52163,40257,141,81,55069,38851
96,9,0,0,2,1,2,1,19,26,52163,40257,24,199,55070,38852
97,9,3,0,0,3,1,0,178,153,52166,40257,220,117,55073,38852
98,9,2,2,2,1,2,1,177,162,52168,40259,180,170,55074,38853
99,10,0,1,1,0,0,3,129,98,52168,40260,149,176,55074,38856
100,10,0,0,2,1,2,1,262,169,52168,40260,279,24,55075,38857
101,10,3,0,0,3,1,0,146,140,52171,40260,163,87,55078,38857
102,10,0,0,2,1,2,1,184,94,52171,40260,249,122,55079,38858
103,10,2,1,0,3,1,0,264,242,52173,40261,293,103,55082,38858
104,10,1,3,1,0,0,3,161,144,52174,40264,193,160,55082,38861
105,10,0,1,1,0,0,3,175,134,52174,40265,204,5,55082,38864
106,10,3,3,2,1,2,1,216,202,52177,40268,208,122,55083,38865
107,10,0,2,1,0,0,3,8,6,52177,40270,6,10,55083,38868
108,10,1,2,1,0,0,3,73,68,52178,40272,92,187,55083,38871
109,10,1,1,2,1,2,1,98,79,52179,40273,135,21,55084,38872
110,11,1,1,2,1,2,1,175,147,52180,40274,227,136,55085,38873
111,11,2,1,0,3,1,0,6,4,52182,40275,10,81,55088,38873
112,11,1,1,2,1,2,1,239,196,52183,40276,289,118,55089,38874
113,11,1,2,1,0,0,3,208,143,52184,40278,223,8,55089,38877
114,11,1,0,0,3,1,0,217,202,52185,40278,211,199,55092,38877
115,11,1,0,0,3,1,0,179,153,52186,40278,223,138,55095,38877
116,11,0,0,2,1,2,1,246,185,52186,40278,287,120,55096,38878
117,11,3,0,0,3,1,0,180,162,52189,40278,183,65,55099,38878
118,11,2,2,2,1,2,1,21,28,52191,40280,25,6,55100,38879
119,11,0,3,1,0,0,3,106,89,52191,40283,141,173,55100,38882
120,11,2,0,0,3,1,0,40,25,52193,40283,51,71,55103,38882
121,12,2,1,0,3,1,0,148,141,52195,40284,166,10,55106,38882
122,12,3,2,0,3,1,0,101,81,52198,40286,138,144,55109,38882
123,12,2,1,0,3,1,0,163,145,52200,40287,196,122,55112,38882
124,12,1,1,2,1,2,1,176,135,52201,40288,205,188,55113,38883
125,12,3,0,0,3,1,0,265,169,52204,40288,282,122,55116,38883
126,12,2,0,0,3,1,0,11,6,52206,40288,12,160,55119,38883
127,12,0,1,1,0,0,3,129,99,52206,40289,149,24,55119,38886
128,12,0,1,1,0,0,3,8,7,52206,40290,6,27,55119,38889
129,12,1,0,0,3,1,0,185,94,52207,40290,252,87,55122,38889
130,12,2,2,2,1,2,1,75,70,52209,40292,93,104,55123,38890
131,12,1,1,2,1,2,1,265,243,52210,40293,294,177,55124,38891
132,13,1,0,0,3,1,0,22,28,52211,40293,28,118,55127,38891
133,13,1,1,2,1,2,1,266,170,52212,40294,283,72,55128,38892
134,13,2,0,0,3,1,0,248,185,52214,40294,290,8,55131,38892
135,13,0,1,1,0,0,3,217,203,52214,40295,211,9,55131,38895
136,13,2,2,2,1,2,1,181,155,52216,40297,224,121,55132,38896
137,13,0,1,1,0,0,3,106,90,52216,40298,141,68,55132,38899
138,13,2,2,2,1,2,1,210,145,52218,40300,224,161,55133,38900
139,13,3,1,0,3,1,0,183,163,52221,40301,186,136,55136,38900
140,13,1,1,2,1,2,1,41,26,52222,40302,52,82,55137,38901
141,13,1,0,0,3,1,0,240,196,52223,40302,292,138,55140,38901
142,13,0,1,1,0,0,3,6,5,52223,40303,10,176,55140,38904
143,14,0,2,1,0,0,3,176,137,52223,40305,205,107,55140,38907
144,14,2,0,0,3,1,0,177,147,52225,40305,230,188,55143,38907
145,14,1,0,0,3,1,0,76,70,52226,40305,96,177,55146,38907
146,14,4,0,0,3,1,0,152,141,52230,40305,169,27,55149,38907
147,14,1,1,2,1,2,1,102,82,52231,40306,139,123,55150,38908
148,14,1,0,0,3,1,0,186,94,52232,40306,255,10,55153,38908
149,14,0,0,2,1,2,1,265,243,52232,40306,295,25,55154,38909
150,14,1,0,0,3,1,0,130,99,52233,40306,152,144,55157,38909
151,14,1,0,0,3,1,0,12,6,52234,40306,15,122,55160,38909
152,14,0,1,1,0,0,3,8,8,52234,40307,6,202,55160,38912
153,14,2,0,0,3,1,0,165,145,52236,40307,199,87,55163,38912
154,15,2,1,0,3,1,0,185,164,52238,40308,189,161,55166,38912
155,15,2,1,0,3,1,0,212,146,52240,40309,227,188,55169,38912
156,15,2,2,2,1,2,1,183,157,52242,40311,225,9,55170,38913
157,15,2,0,0,3,1,0,43,26,52244,40311,55,176,55173,38913
158,15,3,1,0,3,1,0,269,171,52247,40312,286,82,55176,38913
159,15,1,0,0,3,1,0,7,5,52248,40312,13,68,55179,38913
160,15,1,0,0,3,1,0,241,196,52249,40312,295,121,55182,38913
161,15,2,1,0,3,1,0,104,83,52251,40313,142,9,55185,38913
162,15,2,2,2,1,2,1,219,205,52253,40315,212,119,55186,38914
163,15,4,1,0,3,1,0,26,29,52257,40316,31,138,55189,38914
164,15,1,1,2,1,2,1,107,91,52258,40317,142,137,55190,38915
165,16,1,0,0,3,1,0,77,70,52259,40317,99,25,55193,38915
166,16,1,3,1,0,0,3,131,102,52260,40320,152,75,55193,38918
167,16,3,2,0,3,1,0,11,10,52263,40322,9,123,55196,38918
168,16,5,1,0,3,1,0,191,95,52268,40323,258,27,55199,38918
169,16,0,0,2,1,2,1,248,185,52268,40323,291,123,55200,38919
170,16,2,2,2,1,2,1,167,147,52270,40325,200,11,55201,38920
171,16,1,0,0,3,1,0,178,147,52271,40325,233,107,55204,38920
172,16,1,2,1,0,0,3,153,143,52272,40327,169,205,55204,38923
173,16,1,3,1,0,0,3,177,140,52273,40330,205,180,55204,38926
174,16,1,0,0,3,1,0,13,6,52274,40330,18,87,55207,38926
175,16,1,0,0,3,1,0,266,243,52275,40330,298,144,55210,38926
176,17,2,0,0,3,1,0,243,196,52277,40330,298,9,55213,38926
177,17,1,2,1,0,0,3,12,12,52278,40332,9,85,55213,38929
178,17,1,0,0,3,1,0,108,91,52279,40332,145,161,55216,38929
179,17,1,0,0,3,1,0,213,146,52280,40332,230,123,55219,38929
180,17,3,0,0,3,1,0,29,29,52283,40332,34,121,55222,38929
181,17,2,1,0,3,1,0,271,172,52285,40333,289,176,55225,38929
182,17,2,0,0,3,1,0,221,205,52287,40333,215,138,55228,38929
183,17,1,0,0,3,1,0,44,26,52288,40333,58,68,55231,38929
184,17,1,1,2,1,2,1,105,84,52289,40334,143,120,55232,38930
185,17,0,3,1,0,0,3,183,160,52289,40337,225,191,55232,38933
186,17,1,2,1,0,0,3,8,7,52290,40339,13,140,55232,38936
187,18,0,1,1,0,0,3,13,7,52290,40340,18,14,55232,38939
188,18,0,1,1,0,0,3,77,71,52290,40341,99,147,55232,38942
189,18,5,2,0,3,1,0,158,145,52295,40343,172,9,55235,38942
190,18,2,2,2,1,2,1,180,149,52297,40345,234,181,55236,38943
191,18,1,0,0,3,1,0,267,243,52298,40345,301,75,55239,38943
192,18,2,1,0,3,1,0,187,165,52300,40346,192,107,55242,38943
193,18,1,3,1,0,0,3,178,143,52301,40349,205,28,55242,38946
194,18,3,1,0,3,1,0,134,103,52304,40350,155,123,55245,38946
195,18,2,1,0,3,1,0,193,96,52306,40351,261,205,55248,38946
196,18,5,0,0,3,1,0,253,185,52311,40351,294,87,55251,38946
197,18,2,1,0,3,1,0,169,148,52313,40352,203,27,55254,38946
198,19,0,1,1,0,0,3,8,8,52313,40353,13,164,55254,38949
199,19,3,1,0,3,1,0,246,197,52316,40354,301,191,55257,38949
200,19,1,1,2,1,2,1,135,104,52317,40355,156,121,55258,38950
201,19,2,0,0,3,1,0,107,84,52319,40355,146,138,55261,38950
202,19,1,2,1,0,0,3,45,28,52320,40357,58,143,55261,38953
203,19,4,2,0,3,1,0,275,174,52324,40359,292,68,55264,38953
204,19,1,2,1,0,0,3,222,207,52325,40361,215,124,55264,38956
205,19,2,1,0,3,1,0,110,92,52327,40362,148,123,55267,38956
206,19,3,1,0,3,1,0,216,147,52330,40363,233,107,55270,38956
207,19,4,1,0,3,1,0,33,30,52334,40364,37,9,55273,38956
208,19,0,2,1,0,0,3,12,14,52334,40366,9,179,55273,38959
209,20,1,0,0,3,1,0,254,185,52335,40366,297,14,55276,38959
210,20,0,1,1,0,0,3,187,166,52335,40367,192,184,55276,38962
211,20,0,0,2,1,2,1,216,147,52335,40367,234,122,55277,38963
212,20,2,0,0,3,1,0,185,160,52337,40367,228,87,55280,38963
213,20,1,0,0,3,1,0,268,243,52338,40367,304,85,55283,38963
214,20,0,0,2,1,2,1,178,143,52338,40367,206,148,55284,38964
215,20,0,0,2,1,2,1,193,96,52338,40367,262,10,55285,38965
216,20,1,1,2,1,2,1,78,72,52339,40368,100,76,55286,38966
217,20,0,2,1,0,0,3,169,150,52339,40370,203,208,55286,38969
218,20,2,3,1,0,0,3,182,152,52341,40373,234,31,55286,38972
219,20,5,3,0,3,1,0,18,10,52346,40376,21,27,55289,38972
220,21,0,1,1,0,0,3,33,31,52346,40377,37,194,55289,38975
221,21,1,1,2,1,2,1,223,208,52347,40378,216,10,55290,38976
222,21,1,1,2,1,2,1,13,15,52348,40379,10,69,55291,38977
223,21,2,1,0,3,1,0,47,29,52350,40380,61,164,55294,38977
224,21,0,3,1,0,0,3,110,95,52350,40383,148,126,55294,38980
225,21,1,0,0,3,1,0,108,84,52351,40383,149,124,55297,38980
226,21,1,1,2,1,2,1,247,198,52352,40384,302,108,55298,38981
227,21,1,0,0,3,1,0,9,8,52353,40384,16,123,55301,38981
228,21,0,2,1,0,0,3,158,147,52353,40386,172,182,55301,38984
229,21,1,0,0,3,1,0,136,104,52354,40386,159,138,55304,38984
230,21,2,0,0,3,1,0,277,174,52356,40386,295,143,55307,38984
231,22,1,0,0,3,1,0,48,29,52357,40386,64,194,55310,38984
232,22,1,1,2,1,2,1,224,209,52358,40387,217,165,55311,38985
233,22,2,0,0,3,1,0,110,84,52360,40387,152,143,55314,38985
234,22,2,3,1,0,0,3,138,107,52362,40390,159,72,55314,38988
235,22,0,1,1,0,0,3,158,148,52362,40391,172,141,55314,38991
236,22,1,0,0,3,1,0,14,15,52363,40391,13,124,55317,38991
237,22,1,0,0,3,1,0,269,243,52364,40391,307,126,55320,38991
238,22,1,1,2,1,2,1,10,9,52365,40392,17,109,55321,38992
239,22,1,1,2,1,2,1,248,199,52366,40393,303,88,55322,38993
240,22,2,0,0,3,1,0,279,174,52368,40393,298,10,55325,38993
241,22,1,0,0,3,1,0,34,31,52369,40393,40,123,55328,38993
242,23,1,0,0,3,1,0,183,152,52370,40393,237,208,55331,38993
243,23,0,0,2,1,2,1,18,10,52370,40393,22,77,55332,38994
244,23,1,1,2,1,2,1,111,96,52371,40394,149,15,55333,38995
245,23,0,0,2,1,2,1,78,72,52371,40394,101,123,55334,38996
246,23,2,0,0,3,1,0,195,96,52373,40394,265,182,55337,38996
247,23,2,1,0,3,1,0,256,186,52375,40395,300,148,55340,38996
248,23,2,0,0,3,1,0,218,147,52377,40395,237,184,55343,38996
249,23,1,1,2,1,2,1,179,144,52378,40396,207,11,55344,38997
250,23,0,0,2,1,2,1,185,160,52378,40396,229,32,55345,38998
251,23,3,0,0,3,1,0,190,166,52381,40396,195,27,55348,38998
252,23,1,1,2,1,2,1,170,151,52382,40397,204,86,55349,38999
253,24,1,0,0,3,1,0,15,15,52383,40397,16,10,55352,38999
254,24,2,3,1,0,0,3,197,99,52385,40400,265,129,55352,39002
255,24,2,1,0,3,1,0,36,32,52387,40401,43,88,55355,39002
256,24,2,0,0,3,1,0,112,84,52389,40401,155,165,55358,39002
257,24,1,0,0,3,1,0,139,107,52390,40401,162,143,55361,39002
258,24,2,3,1,0,0,3,160,151,52392,40404,172,127,55361,39005
259,24,2,1,0,3,1,0,50,30,52394,40405,67,109,55364,39005
260,24,1,0,0,3,1,0,225,209,52395,40405,220,123,55367,39005
261,24,1,1,2,1,2,1,11,10,52396,40406,18,185,55368,39006
262,24,2,1,0,3,1,0,271,244,52398,40407,310,72,55371,39006
263,24,2,1,0,3,1,0,281,175,52400,40408,301,194,55374,39006
264,25,1,1,2,1,2,1,19,11,52401,40409,23,87,55375,39007
265,25,0,0,2,1,2,1,190,166,52401,40409,196,209,55376,39008
266,25,0,1,1,0,0,3,170,152,52401,40410,204,185,55376,39011
267,25,1,1,2,1,2,1,79,73,52402,40411,102,142,55377,39012
268,25,3,2,0,3,1,0,251,201,52405,40413,306,32,55380,39012
269,25,0,2,1,0,0,3,179,146,52405,40415,207,126,55380,39015
270,25,0,0,2,1,2,1,256,186,52405,40415,301,78,55381,39016
271,25,1,0,0,3,1,0,219,147,52406,40415,240,15,55384,39016
272,25,0,2,1,0,0,3,111,98,52406,40417,149,30,55384,39019
273,25,1,1,2,1,2,1,184,153,52407,40418,238,12,55385,39020
274,25,2,1,0,3,1,0,187,161,52409,40419,232,148,55388,39020
275,26,1,2,1,0,0,3,140,109,52410,40421,162,168,55388,39023
276,26,1,3,1,0,0,3,16,18,52411,40424,16,197,55388,39026
277,26,1,0,0,3,1,0,113,84,52412,40424,158,123,55391,39026
278,26,3,1,0,3,1,0,274,245,52415,40425,313,143,55394,39026
279,26,2,0,0,3,1,0,81,73,52417,40425,105,129,55397,39026
280,26,1,0,0,3,1,0,282,175,52418,40425,304,109,55400,39026
281,26,2,1,0,3,1,0,162,152,52420,40426,175,10,55403,39026
282,26,0,0,2,1,2,1,36,32,52420,40426,44,16,55404,39027
283,26,2,1,0,3,1,0,52,31,52422,40427,70,185,55407,39027
284,26,1,2,1,0,0,3,226,211,52423,40429,220,91,55407,39030
285,26,1,1,2,1,2,1,198,100,52424,40430,266,128,55408,39031
286,27,1,1,2,1,2,1,12,11,52425,40431,19,31,55409,39032
287,27,1,0,0,3,1,0,180,146,52426,40431,210,142,55412,39032
288,27,0,2,1,0,0,3,111,100,52426,40433,149,212,55412,39035
289,27,1,4,1,0,0,3,188,165,52427,40437,232,81,55412,39038
290,27,1,1,2,1,2,1,185,154,52428,40438,239,127,55413,39039
291,27,1,0,0,3,1,0,252,201,52429,40438,309,148,55416,39039
292,27,0,3,1,0,0,3,219,150,52429,40441,240,35,55416,39042
293,27,2,3,1,0,0,3,192,169,52431,40444,196,15,55416,39045
294,27,1,1,2,1,2,1,257,187,52432,40445,302,88,55417,39046
295,27,1,1,2,1,2,1,20,12,52433,40446,24,186,55418,39047
296,27,1,2,1,0,0,3,171,154,52434,40448,204,75,55418,39050
297,28,1,1,2,1,2,1,114,85,52435,40449,159,92,55419,39051
298,28,0,0,2,1,2,1,198,100,52435,40449,267,11,55420,39052
299,28,0,0,2,1,2,1,226,211,52435,40449,221,17,55421,39053
300,28,5,1,0,3,1,0,287,176,52440,40450,307,185,55424,39053
301,28,2,1,0,3,1,0,54,32,52442,40451,73,35,55427,39053
302,28,1,1,2,1,2,1,17,19,52443,40452,17,110,55428,39054
303,28,1,0,0,3,1,0,163,152,52444,40452,178,197,55431,39054
304,28,1,2,1,0,0,3,141,111,52445,40454,162,126,55431,39057
305,28,2,1,0,3,1,0,276,246,52447,40455,316,168,55434,39057
306,28,2,1,0,3,1,0,83,74,52449,40456,108,143,55437,39057
307,28,3,0,0,3,1,0,174,154,52452,40456,207,129,55440,39057
308,29,0,0,2,1,2,1,185,154,52452,40456,240,143,55441,39058
309,29,1,1,2,1,2,1,189,166,52453,40457,233,89,55442,39059
310,29,0,0,2,1,2,1,219,150,52453,40457,241,32,55443,39060
311,29,1,1,2,1,2,1,112,101,52454,40458,150,16,55444,39061
312,29,0,4,1,0,0,3,257,191,52454,40462,302,189,55444,39064
313,29,2,1,0,3,1,0,182,147,52456,40463,213,128,55447,39064
314,29,0,0,2,1,2,1,192,169,52456,40463,197,128,55448,39065
315,29,2,2,2,1,2,1,22,14,52458,40465,25,76,55449,39066
316,29,1,0,0,3,1,0,37,32,52459,40465,47,148,55452,39066
317,29,1,2,1,0,0,3,13,13,52460,40467,19,215,55452,39069
318,29,2,2,2,1,2,1,254,203,52462,40469,310,82,55453,39070
319,30,1,3,1,0,0,3,84,77,52463,40472,108,171,55453,39073
320,30,0,0,2,1,2,1,182,147,52463,40472,214,130,55454,39074
321,30,2,0,0,3,1,0,19,19,52465,40472,20,185,55457,39074
322,30,2,1,0,3,1,0,143,112,52467,40473,165,92,55460,39074
323,30,2,1,0,3,1,0,165,153,52469,40474,181,110,55463,39074
324,30,1,2,1,0,0,3,175,156,52470,40476,207,14,55463,39077
325,30,1,0,0,3,1,0,277,246,52471,40476,319,126,55466,39077
326,30,1,2,1,0,0,3,199,102,52472,40478,267,200,55466,39080
327,30,0,1,1,0,0,3,114,86,52472,40479,159,20,55466,39083
328,30,1,2,1,0,0,3,288,178,52473,40481,307,38,55466,39086
329,30,2,0,0,3,1,0,228,211,52475,40481,224,32,55469,39086
330,31,1,2,1,0,0,3,258,193,52476,40483,302,79,55469,39089
331,31,0,0,2,1,2,1,219,150,52476,40483,242,149,55470,39090
332,31,3,1,0,3,1,0,195,170,52479,40484,200,143,55473,39090
333,31,1,1,2,1,2,1,190,167,52480,40485,234,190,55474,39091
334,31,2,0,0,3,1,0,56,32,52482,40485,76,215,55477,39091
335,31,2,0,0,3,1,0,256,203,52484,40485,313,89,55480,39091
336,31,0,1,1,0,0,3,37,33,52484,40486,47,85,55480,39094
337,31,0,0,2,1,2,1,13,13,52484,40486,20,17,55481,39095
338,31,1,3,1,0,0,3,113,104,52485,40489,150,131,55481,39098
339,31,1,0,0,3,1,0,23,14,52486,40489,28,143,55484,39098
340,31,0,3,1,0,0,3,185,157,52486,40492,240,131,55484,39101
341,32,1,0,0,3,1,0,200,102,52487,40492,270,110,55487,39101
342,32,2,1,0,3,1,0,279,247,52489,40493,322,92,55490,39101
343,32,1,1,2,1,2,1,20,20,52490,40494,21,39,55491,39102
344,32,0,0,2,1,2,1,165,153,52490,40494,182,186,55492,39103
345,32,1,3,1,0,0,3,289,181,52491,40497,307,152,55492,39106
346,32,0,1,1,0,0,3,84,78,52491,40498,108,129,55492,39109
347,32,1,0,0,3,1,0,144,112,52492,40498,168,20,55495,39109
348,32,1,0,0,3,1,0,115,86,52493,40498,162,32,55498,39109
349,32,1,0,0,3,1,0,183,147,52494,40498,217,171,55501,39109
350,32,1,1,2,1,2,1,176,157,52495,40499,208,201,55502,39110
351,32,1,1,2,1,2,1,24,15,52496,40500,29,131,55503,39111
352,33,2,0,0,3,1,0,115,104,52498,40500,153,143,55506,39111
353,33,0,0,2,1,2,1,190,167,52498,40500,235,80,55507,39112
354,33,1,1,2,1,2,1,38,34,52499,40501,48,90,55508,39113
355,33,2,0,0,3,1,0,258,203,52501,40501,316,190,55511,39113
356,33,1,1,2,1,2,1,229,212,52502,40502,225,86,55512,39114
357,33,2,1,0,3,1,0,260,194,52504,40503,305,143,55515,39114
358,33,3,2,0,3,1,0,188,159,52507,40505,243,14,55518,39114
359,33,0,2,1,0,0,3,219,152,52507,40507,242,218,55518,39117
360,33,2,0,0,3,1,0,58,32,52509,40507,79,17,55521,39117
361,33,0,1,1,0,0,3,13,14,52509,40508,20,134,55521,39120
362,33,2,2,2,1,2,1,197,172,52511,40510,201,132,55522,39121
363,34,1,3,1,0,0,3,189,162,52512,40513,243,134,55522,39124
364,34,3,3,2,1,2,1,118,89,52515,40516,163,219,55523,39125
365,34,4,1,0,3,1,0,88,79,52519,40517,111,92,55526,39125
366,34,1,1,2,1,2,1,166,154,52520,40518,183,40,55527,39126
367,34,6,2,0,3,1,0,30,17,52526,40520,32,201,55530,39126
368,34,0,3,1,0,0,3,200,105,52526,40523,270,189,55530,39129
369,34,0,1,1,0,0,3,20,21,52526,40524,21,155,55530,39132
370,34,1,0,0,3,1,0,184,147,52527,40524,220,129,55533,39132
371,34,2,1,0,3,1,0,146,113,52529,40525,171,32,55536,39132
372,34,1,0,0,3,1,0,177,157,52530,40525,211,110,55539,39132
373,34,0,0,2,1,2,1,279,247,52530,40525,323,21,55540,39133
374,35,1,1,2,1,2,1,59,33,52531,40526,80,135,55541,39134
375,35,2,1,0,3,1,0,262,195,52533,40527,308,171,55544,39134
376,35,2,0,0,3,1,0,231,212,52535,40527,228,90,55547,39134
377,35,1,1,2,1,2,1,39,35,52536,40528,49,191,55548,39135
378,35,1,1,2,1,2,1,259,204,52537,40529,317,81,55549,39136
379,35,1,2,1,0,0,3,290,183,52538,40531,307,20,55549,39139
380,35,1,1,2,1,2,1,220,153,52539,40532,243,87,55550,39140
381,35,0,1,1,0,0,3,115,105,52539,40533,153,135,55550,39143
382,35,1,1,2,1,2,1,191,168,52540,40534,236,144,55551,39144
383,35,0,0,2,1,2,1,13,14,52540,40534,21,144,55552,39145
384,35,2,1,0,3,1,0,199,173,52542,40535,204,14,55555,39145
385,36,2,3,1,0,0,3,191,165,52544,40538,243,132,55555,39148
386,36,1,0,0,3,1,0,21,21,52545,40538,24,87,55558,39148
387,36,1,0,0,3,1,0,280,247,52546,40538,326,32,55561,39148
388,36,1,1,2,1,2,1,263,196,52547,40539,309,135,55562,39149
389,36,1,2,1,0,0,3,178,159,52548,40541,211,192,55562,39152
390,36,0,2,1,0,0,3,200,107,52548,40543,270,43,55562,39155
391,36,1,2,1,0,0,3,147,115,52549,40545,171,222,55562,39158
392,36,1,1,2,1,2,1,185,148,52550,40546,221,93,55563,39159
393,36,2,3,1,0,0,3,32,20,52552,40549,32,113,55563,39162
394,36,2,0,0,3,1,0,168,154,52554,40549,186,155,55566,39162
395,36,0,1,1,0,0,3,88,80,52554,40550,111,24,55566,39165
396,37,0,1,1,0,0,3,59,34,52554,40551,80,147,55566,39168
397,37,1,0,0,3,1,0,192,168,52555,40551,239,171,55569,39168
398,37,1,0,0,3,1,0,221,153,52556,40551,246,20,55572,39168
399,37,2,1,0,3,1,0,233,213,52558,40552,231,191,55575,39168
400,37,3,1,0,3,1,0,293,184,52561,40553,310,135,55578,39168
401,37,2,1,0,3,1,0,120,90,52563,40554,166,90,55581,39168
402,37,0,1,1,0,0,3,115,106,52563,40555,153,17,55581,39171
403,37,0,0,2,1,2,1,39,35,52563,40555,50,82,55582,39172
404,37,2,0,0,3,1,0,261,204,52565,40555,320,144,55585,39172
405,37,0,3,1,0,0,3,199,176,52565,40558,204,204,55585,39175
406,37,1,0,0,3,1,0,14,14,52566,40558,24,135,55588,39175
407,38,2,1,0,3,1,0,34,21,52568,40559,35,192,55591,39175
408,38,1,1,2,1,2,1,179,160,52569,40560,212,44,55592,39176
409,38,2,1,0,3,1,0,265,197,52571,40561,312,113,55595,39176
410,38,2,2,2,1,2,1,170,156,52573,40563,187,88,55596,39177
411,38,0,1,1,0,0,3,191,166,52573,40564,243,96,55596,39180
412,38,2,1,0,3,1,0,282,248,52575,40565,329,222,55599,39180
413,38,2,0,0,3,1,0,202,107,52577,40565,273,155,55602,39180
414,38,1,0,0,3,1,0,186,148,52578,40565,224,24,55605,39180
415,38,2,0,0,3,1,0,201,176,52580,40565,207,135,55608,39180
416,38,2,2,2,1,2,1,90,82,52582,40567,112,33,55609,39181
417,38,0,0,2,1,2,1,147,115,52582,40567,172,21,55610,39182
418,39,2,0,0,3,1,0,235,213,52584,40567,234,82,55613,39182
419,39,2,0,0,3,1,0,263,204,52586,40567,323,171,55616,39182
420,39,3,1,0,3,1,0,24,22,52589,40568,27,135,55619,39182
421,39,0,0,2,1,2,1,120,90,52589,40568,167,192,55620,39183
422,39,0,0,2,1,2,1,293,184,52589,40568,311,148,55621,39184
423,39,2,1,0,3,1,0,16,15,52591,40569,27,17,55624,39184
424,39,1,0,0,3,1,0,193,168,52592,40569,242,132,55627,39184
425,39,0,0,2,1,2,1,59,34,52592,40569,81,136,55628,39185
426,39,1,1,2,1,2,1,40,36,52593,40570,51,145,55629,39186
427,39,2,2,2,1,2,1,117,108,52595,40572,154,205,55630,39187
428,39,0,1,1,0,0,3,221,154,52595,40573,246,93,55630,39190
429,40,3,1,0,3,1,0,285,249,52598,40574,332,21,55633,39190
430,40,1,0,0,3,1,0,171,156,52599,40574,190,93,55636,39190
431,40,3,3,2,1,2,1,37,24,52602,40577,36,45,55637,39191
432,40,1,0,0,3,1,0,266,197,52603,40577,315,192,55640,39191
433,40,2,0,0,3,1,0,203,176,52605,40577,210,96,55643,39191
434,40,1,3,1,0,0,3,203,110,52606,40580,273,91,55643,39194
435,40,1,1,2,1,2,1,180,161,52607,40581,213,156,55644,39195
436,40,3,1,0,3,1,0,93,83,52610,40582,115,222,55647,39195
437,40,1,1,2,1,2,1,192,167,52611,40583,244,25,55648,39196
438,40,0,0,2,1,2,1,193,168,52611,40583,243,136,55649,39197
439,40,4,2,0,3,1,0,190,150,52615,40585,227,33,55652,39197
440,41,1,0,0,3,1,0,148,115,52616,40585,175,192,55655,39197
441,41,0,0,2,1,2,1,171,156,52616,40585,191,137,55656,39198
442,41,0,1,1,0,0,3,24,23,52616,40586,27,151,55656,39201
443,41,0,1,1,0,0,3,120,91,52616,40587,167,85,55656,39204
444,41,0,0,2,1,2,1,293,184,52616,40587,312,137,55657,39205
445,41,1,2,1,0,0,3,236,215,52617,40589,234,148,55657,39208
446,41,1,0,0,3,1,0,60,34,52618,40589,84,17,55660,39208
447,41,2,1,0,3,1,0,42,37,52620,40590,54,171,55663,39208
448,41,2,0,0,3,1,0,18,15,52622,40590,30,205,55666,39208
449,41,4,0,0,3,1,0,267,204,52626,40590,326,132,55669,39208
450,41,2,2,2,1,2,1,119,110,52628,40592,155,114,55670,39209
451,42,1,2,1,0,0,3,38,26,52629,40594,36,159,55670,39212
452,42,1,2,1,0,0,3,286,251,52630,40596,332,138,55670,39215
453,42,3,0,0,3,1,0,206,110,52633,40596,276,93,55673,39215
454,42,1,0,0,3,1,0,94,83,52634,40596,118,21,55676,39215
455,42,1,2,1,0,0,3,181,163,52635,40598,213,94,55676,39218
456,42,2,1,0,3,1,0,192,151,52637,40599,230,222,55679,39218
457,42,0,2,1,0,0,3,192,169,52637,40601,244,36,55679,39221
458,42,1,0,0,3,1,0,267,197,52638,40601,318,45,55682,39221
459,42,1,0,0,3,1,0,204,176,52639,40601,213,25,55685,39221
460,42,3,3,2,1,2,1,196,171,52642,40604,244,193,55686,39222
461,42,0,2,1,0,0,3,221,156,52642,40606,246,99,55686,39225
0,1,2,0,0,3,1,0,2,0,52644,40606,3,0,55689,39225
1,1,1,0,0,3,1,0,121,91,52645,40606,170,137,55692,39225
2,1,1,1,2,1,2,1,206,199,52646,40607,248,18,55693,39226
3,1,0,0,2,1,2,1,206,110,52646,40607,277,129,55694,39227
4,1,1,0,0,3,1,0,222,156,52647,40607,249,138,55697,39227
5,1,1,2,1,0,0,3,193,153,52648,40609,230,48,55697,39230
6,1,1,2,1,0,0,3,268,199,52649,40611,318,128,55697,39233
7,1,2,3,1,0,0,3,62,37,52651,40614,84,162,55697,39236
8,1,0,1,1,0,0,3,94,84,52651,40615,118,135,55697,39239
9,1,0,0,2,1,2,1,213,194,52651,40615,246,40,55698,39240
10,1,0,0,2,1,2,1,148,115,52651,40615,176,26,55699,39241
11,2,0,3,1,0,0,3,75,79,52651,40618,83,151,55699,39244
12,2,2,1,0,3,1,0,2,1,52653,40619,3,149,55702,39244
13,2,2,0,0,3,1,0,173,156,52655,40619,194,0,55705,39244
14,2,1,2,1,0,0,3,39,28,52656,40621,36,208,55705,39247
15,2,2,2,2,1,2,1,238,217,52658,40623,235,138,55706,39248
16,2,1,1,2,1,2,1,205,177,52659,40624,214,37,55707,39249
17,2,2,0,0,3,1,0,213,162,52661,40624,231,93,55710,39249
18,2,1,1,2,1,2,1,182,164,52662,40625,214,138,55711,39250
19,2,1,1,2,1,2,1,19,16,52663,40626,31,86,55712,39251
20,2,0,0,2,1,2,1,42,37,52663,40626,55,152,55713,39252
21,2,0,3,1,0,0,3,186,143,52663,40629,164,97,55713,39255
22,3,2,2,2,1,2,1,215,196,52665,40631,247,129,55714,39256
23,3,0,1,1,0,0,3,148,116,52665,40632,176,51,55714,39259
24,3,1,0,0,3,1,0,223,156,52666,40632,252,135,55717,39259
25,3,1,1,2,1,2,1,207,200,52667,40633,249,139,55718,39260
26,3,0,0,2,1,2,1,2,0,52667,40633,4,163,55719,39261
27,3,0,4,1,0,0,3,94,88,52667,40637,118,132,55719,39264
28,3,3,0,0,3,1,0,65,37,52670,40637,87,26,55722,39264
29,3,1,2,1,0,0,3,40,30,52671,40639,36,3,55722,39267
30,3,2,0,0,3,1,0,270,199,52673,40639,321,97,55725,39267
31,3,1,2,1,0,0,3,194,155,52674,40641,230,140,55725,39270
32,3,1,0,0,3,1,0,207,110,52675,40641,280,40,55728,39270
33,4,2,0,0,3,1,0,44,37,52677,40641,58,86,55731,39270
34,4,0,0,2,1,2,1,173,156,52677,40641,195,19,55732,39271
35,4,1,1,2,1,2,1,214,163,52678,40642,232,38,55733,39272
36,4,4,0,0,3,1,0,190,143,52682,40642,167,151,55736,39272
37,4,2,1,0,3,1,0,207,178,52684,40643,217,0,55739,39272
38,4,2,2,2,1,2,1,123,93,52686,40645,171,139,55740,39273
39,4,0,1,1,0,0,3,182,165,52686,40646,214,155,55740,39276
40,4,4,4,2,1,2,1,6,5,52690,40650,4,209,55741,39277
41,4,0,1,1,0,0,3,75,80,52690,40651,83,96,55741,39280
42,4,0,3,1,0,0,3,238,220,52690,40654,235,152,55741,39283
43,4,1,0,0,3,1,0,20,16,52691,40654,34,138,55744,39283
44,5,2,1,0,3,1,0,150,117,52693,40655,179,140,55747,39283
45,5,2,1,0,3,1,0,272,200,52695,40656,324,139,55750,39283
46,5,0,0,2,1,2,1,40,30,52695,40656,37,164,55751,39284
47,5,1,1,2,1,2,1,3,1,52696,40657,5,27,55752,39285
48,5,2,1,0,3,1,0,209,201,52698,40658,252,135,55755,39285
49,5,3,0,0,3,1,0,226,156,52701,40658,255,132,55758,39285
50,5,3,2,0,3,1,0,9,7,52704,40660,7,139,55761,39285
51,5,1,1,2,1,2,1,208,111,52705,40661,281,130,55762,39286
52,5,1,0,0,3,1,0,66,37,52706,40661,90,51,55765,39286
53,5,3,1,0,3,1,0,97,89,52709,40662,121,40,55768,39286
54,5,2,0,0,3,1,0,196,155,52711,40662,233,97,55771,39286
55,6,3,0,0,3,1,0,210,178,52714,40662,220,19,55774,39286
56,6,0,0,2,1,2,1,20,16,52714,40662,35,153,55775,39287
57,6,1,0,0,3,1,0,215,163,52715,40662,235,0,55778,39287
58,6,3,1,0,3,1,0,218,197,52718,40663,250,151,55781,39287
59,6,4,0,0,3,1,0,127,93,52722,40663,174,155,55784,39287
60,6,1,0,0,3,1,0,174,156,52723,40663,198,209,55787,39287
61,6,3,1,0,3,1,0,241,221,52726,40664,238,3,55790,39287
62,6,2,1,0,3,1,0,77,81,52728,40665,86,38,55793,39287
63,6,0,0,2,1,2,1,44,37,52728,40665,59,139,55794,39288
64,6,1,1,2,1,2,1,183,166,52729,40666,215,87,55795,39289
65,6,1,2,1,0,0,3,191,145,52730,40668,167,99,55795,39292
66,7,0,0,2,1,2,1,9,7,52730,40668,8,136,55796,39293
67,7,4,1,0,3,1,0,276,201,52734,40669,327,151,55799,39293
68,7,5,1,0,3,1,0,231,157,52739,40670,258,40,55802,39293
69,7,3,0,0,3,1,0,6,1,52742,40670,8,51,55805,39293
70,7,1,2,1,0,0,3,209,113,52743,40672,281,142,55805,39296
71,7,2,1,0,3,1,0,176,157,52745,40673,201,164,55808,39296
72,7,2,0,0,3,1,0,211,201,52747,40673,255,132,55811,39296
73,7,1,0,0,3,1,0,151,117,52748,40673,182,97,55814,39296
74,7,0,1,1,0,0,3,40,31,52748,40674,37,30,55814,39299
75,7,2,2,2,1,2,1,68,39,52750,40676,91,141,55815,39300
76,7,0,0,2,1,2,1,97,89,52750,40676,122,131,55816,39301
77,8,3,0,0,3,1,0,218,163,52753,40676,238,19,55819,39301
78,8,0,3,1,0,0,3,210,181,52753,40679,220,142,55819,39304
79,8,1,1,2,1,2,1,21,17,52754,40680,36,4,55820,39305
80,8,2,0,0,3,1,0,129,93,52756,40680,177,87,55823,39305
81,8,0,2,1,0,0,3,44,39,52756,40682,59,156,55823,39308
82,8,2,1,0,3,1,0,79,82,52758,40683,89,0,55826,39308
83,8,4,1,0,3,1,0,245,222,52762,40684,241,209,55829,39308
84,8,1,1,2,1,2,1,192,146,52763,40685,168,39,55830,39309
85,8,3,0,0,3,1,0,199,155,52766,40685,236,155,55833,39309
86,8,2,0,0,3,1,0,220,197,52768,40685,253,99,55836,39309
87,8,3,0,0,3,1,0,186,166,52771,40685,218,139,55839,39309
88,9,1,1,2,1,2,1,177,158,52772,40686,202,31,55840,39310
89,9,0,2,1,0,0,3,9,9,52772,40688,8,135,55840,39313
90,9,1,0,0,3,1,0,232,157,52773,40688,261,131,55843,39313
91,9,2,0,0,3,1,0,99,89,52775,40688,125,142,55846,39313
92,9,1,1,2,1,2,1,69,40,52776,40689,92,98,55847,39314
93,9,0,0,2,1,2,1,40,31,52776,40689,38,52,55848,39315
94,9,0,2,1,0,0,3,6,3,52776,40691,8,144,55848,39318
95,9,2,0,0,3,1,0,153,117,52778,40691,185,151,55851,39318
96,9,4,0,0,3,1,0,280,201,52782,40691,330,155,55854,39318
97,9,1,0,0,3,1,0,212,201,52783,40691,258,40,55857,39318
98,9,1,0,0,3,1,0,246,222,52784,40691,244,136,55860,39318
99,10,1,1,2,1,2,1,219,164,52785,40692,239,143,55861,39319
100,10,2,2,2,1,2,1,46,41,52787,40694,60,5,55862,39320
101,10,1,0,0,3,1,0,193,146,52788,40694,171,0,55865,39320
102,10,2,0,0,3,1,0,222,197,52790,40694,256,39,55868,39320
103,10,1,1,2,1,2,1,130,94,52791,40695,178,140,55869,39321
104,10,0,2,1,0,0,3,21,19,52791,40697,36,167,55869,39324
105,10,2,1,0,3,1,0,81,83,52793,40698,92,19,55872,39324
106,10,1,1,2,1,2,1,211,182,52794,40699,221,210,55873,39325
107,10,1,5,1,0,0,3,200,160,52795,40704,236,90,55873,39328
108,10,1,1,2,1,2,1,187,167,52796,40705,219,157,55874,39329
109,10,0,1,1,0,0,3,209,114,52796,40706,281,102,55874,39332
110,11,2,2,2,1,2,1,214,203,52798,40708,259,132,55875,39333
111,11,1,0,0,3,1,0,178,158,52799,40708,205,52,55878,39333
112,11,1,3,1,0,0,3,233,160,52800,40711,261,145,55878,39336
113,11,2,2,2,1,2,1,8,5,52802,40713,9,99,55879,39337
114,11,2,2,2,1,2,1,42,33,52804,40715,39,145,55880,39338
115,11,2,0,0,3,1,0,71,40,52806,40715,95,151,55883,39338
116,11,2,2,2,1,2,1,282,203,52808,40717,331,103,55884,39339
117,11,1,1,2,1,2,1,247,223,52809,40718,245,136,55885,39340
118,11,0,3,1,0,0,3,99,92,52809,40721,125,158,55885,39343
119,11,0,1,1,0,0,3,211,183,52809,40722,221,34,55885,39346
120,11,0,0,2,1,2,1,9,9,52809,40722,9,41,55886,39347
121,12,0,0,2,1,2,1,187,167,52809,40722,220,6,55887,39348
122,12,1,0,0,3,1,0,154,117,52810,40722,188,90,55890,39348
123,12,0,0,2,1,2,1,46,41,52810,40722,61,168,55891,39349
124,12,0,0,2,1,2,1,81,83,52810,40722,93,144,55892,39350
125,12,2,0,0,3,1,0,221,164,52812,40722,242,136,55895,39350
126,12,1,1,2,1,2,1,194,147,52813,40723,172,20,55896,39351
127,12,1,1,2,1,2,1,201,161,52814,40724,237,141,55897,39352
128,12,2,0,0,3,1,0,211,114,52816,40724,284,39,55900,39352
129,12,2,2,2,1,2,1,23,21,52818,40726,37,211,55901,39353
130,12,0,0,2,1,2,1,130,94,52818,40726,179,158,55902,39354
131,12,4,1,0,3,1,0,226,198,52822,40727,259,0,55905,39354
132,13,1,0,0,3,1,0,234,160,52823,40727,264,158,55908,39354
133,13,1,1,2,1,2,1,248,224,52824,40728,246,42,55909,39355
134,13,1,1,2,1,2,1,43,34,52825,40729,40,100,55910,39356
135,13,1,0,0,3,1,0,9,5,52826,40729,12,151,55913,39356
136,13,1,0,0,3,1,0,24,21,52827,40729,40,136,55916,39356
137,13,3,2,0,3,1,0,74,42,52830,40731,98,103,55919,39356
138,13,1,1,2,1,2,1,10,10,52831,40732,10,133,55920,39357
139,13,0,0,2,1,2,1,214,203,52831,40732,260,146,55921,39358
140,13,0,3,1,0,0,3,282,206,52831,40735,331,93,55921,39361
141,13,0,2,1,0,0,3,211,185,52831,40737,221,55,55921,39364
142,13,3,1,0,3,1,0,181,159,52834,40738,208,145,55924,39364
143,14,0,1,1,0,0,3,201,162,52834,40739,237,161,55924,39367
144,14,1,1,2,1,2,1,212,115,52835,40740,285,1,55925,39368
145,14,2,0,0,3,1,0,83,83,52837,40740,96,136,55928,39368
146,14,3,2,0,3,1,0,190,169,52840,40742,223,168,55931,39368
147,14,2,0,0,3,1,0,132,94,52842,40742,182,6,55934,39368
148,14,0,2,1,0,0,3,194,149,52842,40744,172,147,55934,39371
149,14,1,2,1,0,0,3,227,200,52843,40746,259,23,55934,39374
150,14,1,2,1,0,0,3,100,94,52844,40748,125,42,55934,39377
151,14,0,1,1,0,0,3,154,118,52844,40749,188,144,55934,39380
152,14,1,1,2,1,2,1,222,165,52845,40750,243,212,55935,39381
153,14,1,0,0,3,1,0,47,41,52846,40750,64,34,55938,39381
154,15,3,0,0,3,1,0,214,185,52849,40750,224,145,55941,39381
155,15,3,0,0,3,1,0,184,159,52852,40750,211,100,55944,39381
156,15,1,2,1,0,0,3,10,7,52853,40752,12,106,55944,39384
157,15,3,1,0,3,1,0,285,207,52856,40753,334,42,55947,39384
158,15,1,1,2,1,2,1,25,22,52857,40754,41,43,55948,39385
159,15,1,2,1,0,0,3,235,162,52858,40756,264,96,55948,39388
160,15,1,0,0,3,1,0,249,224,52859,40756,249,133,55951,39388
161,15,1,1,2,1,2,1,44,35,52860,40757,41,152,55952,39389
162,15,2,3,1,0,0,3,216,206,52862,40760,260,161,55952,39392
163,15,1,1,2,1,2,1,11,11,52863,40761,11,147,55953,39393
164,15,0,3,1,0,0,3,222,168,52863,40764,243,58,55953,39396
165,16,2,2,2,1,2,1,134,96,52865,40766,183,169,55954,39397
166,16,1,0,0,3,1,0,48,41,52866,40766,67,212,55957,39397
167,16,0,2,1,0,0,3,100,96,52866,40768,125,4,55957,39400
168,16,3,1,0,3,1,0,77,43,52869,40769,101,144,55960,39400
169,16,0,0,2,1,2,1,212,115,52869,40769,286,24,55961,39401
170,16,0,0,2,1,2,1,190,169,52869,40769,224,35,55962,39402
171,16,1,1,2,1,2,1,195,150,52870,40770,173,137,55963,39403
172,16,2,0,0,3,1,0,229,200,52872,40770,262,147,55966,39403
173,16,2,2,2,1,2,1,203,164,52874,40772,238,7,55967,39404
174,16,1,0,0,3,1,0,155,118,52875,40772,191,161,55970,39404
175,16,2,2,2,1,2,1,85,85,52877,40774,97,137,55971,39405
176,17,3,1,0,3,1,0,187,160,52880,40775,214,152,55974,39405
177,17,2,1,0,3,1,0,27,23,52882,40776,44,133,55977,39405
178,17,1,0,0,3,1,0,250,224,52883,40776,252,147,55980,39405
179,17,0,2,1,0,0,3,10,9,52883,40778,12,45,55980,39408
180,17,2,2,2,1,2,1,13,13,52885,40780,12,162,55981,39409
181,17,2,3,1,0,0,3,287,210,52887,40783,334,147,55981,39412
182,17,2,0,0,3,1,0,50,41,52889,40783,70,43,55984,39412
183,17,1,1,2,1,2,1,45,36,52890,40784,42,107,55985,39413
184,17,2,1,0,3,1,0,216,186,52892,40785,227,100,55988,39413
185,17,0,1,1,0,0,3,222,169,52892,40786,243,148,55988,39416
186,17,0,2,1,0,0,3,216,208,52892,40788,260,99,55988,39419
187,18,3,2,0,3,1,0,232,202,52895,40790,265,137,55991,39419
188,18,2,1,0,3,1,0,197,151,52897,40791,176,137,55994,39419
189,18,2,1,0,3,1,0,87,86,52899,40792,100,212,55997,39419
190,18,1,1,2,1,2,1,213,116,52900,40793,287,148,55998,39420
191,18,1,0,0,3,1,0,236,162,52901,40793,267,4,56001,39420
192,18,0,2,1,0,0,3,190,171,52901,40795,224,61,56001,39423
193,18,2,2,2,1,2,1,205,166,52903,40797,239,170,56002,39424
194,18,3,1,0,3,1,0,158,119,52906,40798,194,7,56005,39424
195,18,2,1,0,3,1,0,102,97,52908,40799,128,24,56008,39424
196,18,1,0,0,3,1,0,78,43,52909,40799,104,161,56011,39424
197,18,3,0,0,3,1,0,137,96,52912,40799,186,35,56014,39424
198,19,3,1,0,3,1,0,53,42,52915,40800,73,133,56017,39424
199,19,2,2,2,1,2,1,218,210,52917,40802,261,148,56018,39425
200,19,0,0,2,1,2,1,27,23,52917,40802,45,148,56019,39426
201,19,3,0,0,3,1,0,290,210,52920,40802,337,4,56022,39426
202,19,1,0,0,3,1,0,217,186,52921,40802,230,152,56025,39426
203,19,0,0,2,1,2,1,87,86,52921,40802,101,149,56026,39427
204,19,0,1,1,0,0,3,45,37,52921,40803,42,48,56026,39430
205,19,3,0,0,3,1,0,190,160,52924,40803,217,107,56029,39430
206,19,3,0,0,3,1,0,225,169,52927,40803,246,100,56032,39430
207,19,2,0,0,3,1,0,15,13,52929,40803,15,99,56035,39430
208,19,2,1,0,3,1,0,252,225,52931,40804,255,162,56038,39430
209,20,0,1,1,0,0,3,197,152,52931,40805,176,46,56038,39433
210,20,3,2,0,3,1,0,293,212,52934,40807,340,149,56041,39433
211,20,0,1,1,0,0,3,10,10,52934,40808,12,164,56041,39436
212,20,2,1,0,3,1,0,234,203,52936,40809,268,137,56044,39436
213,20,5,0,0,3,1,0,210,166,52941,40809,242,35,56047,39436
214,20,3,0,0,3,1,0,239,162,52944,40809,270,24,56050,39436
215,20,1,1,2,1,2,1,138,97,52945,40810,187,62,56051,39437
216,20,1,2,1,0,0,3,159,121,52946,40812,194,173,56051,39440
217,20,2,0,0,3,1,0,215,116,52948,40812,290,137,56054,39440
218,20,1,2,1,0,0,3,103,99,52949,40814,128,151,56054,39443
219,20,3,0,0,3,1,0,81,43,52952,40814,107,7,56057,39443
220,21,3,2,0,3,1,0,228,171,52955,40816,249,152,56060,39443
221,21,1,0,0,3,1,0,54,42,52956,40816,76,148,56063,39443
222,21,2,3,1,0,0,3,254,228,52958,40819,255,102,56063,39446
223,21,1,1,2,1,2,1,28,24,52959,40820,46,163,56064,39447
224,21,1,1,2,1,2,1,191,172,52960,40821,225,134,56065,39448
225,21,3,2,0,3,1,0,48,39,52963,40823,45,4,56068,39448
226,21,4,2,0,3,1,0,222,212,52967,40825,264,212,56071,39448
227,21,1,2,1,0,0,3,88,88,52968,40827,101,103,56071,39451
228,21,1,1,2,1,2,1,191,161,52969,40828,218,49,56072,39452
229,21,2,2,2,1,2,1,17,15,52971,40830,16,149,56073,39453
230,21,1,0,0,3,1,0,218,186,52972,40830,233,107,56076,39453
231,22,2,2,2,1,2,1,256,230,52974,40832,256,50,56077,39454
232,22,0,1,1,0,0,3,197,153,52974,40833,176,215,56077,39457
233,22,1,1,2,1,2,1,219,187,52975,40834,234,103,56078,39458
234,22,3,0,0,3,1,0,231,171,52978,40834,252,163,56081,39458
235,22,0,1,1,0,0,3,28,25,52978,40835,46,110,56081,39461
236,22,1,0,0,3,1,0,192,172,52979,40835,228,103,56084,39461
237,22,2,1,0,3,1,0,193,162,52981,40836,221,149,56087,39461
238,22,2,0,0,3,1,0,56,42,52983,40836,79,152,56090,39461
239,22,2,1,0,3,1,0,19,16,52985,40837,19,4,56093,39461
240,22,2,1,0,3,1,0,90,89,52987,40838,104,148,56096,39461
241,22,0,1,1,0,0,3,48,40,52987,40839,45,167,56096,39464
242,23,2,1,0,3,1,0,236,204,52989,40840,271,149,56099,39464
243,23,1,0,0,3,1,0,294,212,52990,40840,343,24,56102,39464
244,23,2,1,0,3,1,0,83,44,52992,40841,110,137,56105,39464
245,23,1,0,0,3,1,0,211,166,52993,40841,245,46,56108,39464
246,23,2,3,1,0,0,3,12,13,52995,40844,12,154,56108,39467
247,23,3,1,0,3,1,0,162,122,52998,40845,197,137,56111,39467
248,23,1,0,0,3,1,0,216,116,52999,40845,293,62,56114,39467
249,23,2,1,0,3,1,0,224,213,53001,40846,267,7,56117,39467
250,23,0,0,2,1,2,1,239,162,53001,40846,271,174,56118,39468
251,23,1,2,1,0,0,3,104,101,53002,40848,128,38,56118,39471
252,23,1,3,1,0,0,3,139,100,53003,40851,187,137,56118,39474
253,24,1,0,0,3,1,0,193,172,53004,40851,231,152,56121,39474
254,24,3,0,0,3,1,0,200,153,53007,40851,179,148,56124,39474
255,24,5,1,0,3,1,0,261,231,53012,40852,259,4,56127,39474
256,24,0,0,2,1,2,1,28,25,53012,40852,47,51,56128,39475
257,24,2,0,0,3,1,0,92,89,53014,40852,107,163,56131,39475
258,24,1,1,2,1,2,1,57,43,53015,40853,80,111,56132,39476
259,24,2,1,0,3,1,0,21,17,53017,40854,22,24,56135,39476
260,24,2,0,0,3,1,0,233,171,53019,40854,255,103,56138,39476
261,24,1,0,0,3,1,0,194,162,53020,40854,224,167,56141,39476
262,24,0,0,2,1,2,1,219,187,53020,40854,235,150,56142,39477
263,24,0,0,2,1,2,1,139,100,53020,40854,188,216,56143,39478
264,25,1,1,2,1,2,1,225,214,53021,40855,268,175,56144,39479
265,25,0,0,2,1,2,1,104,101,53021,40855,129,63,56145,39480
266,25,3,2,0,3,1,0,297,214,53024,40857,346,7,56148,39480
267,25,1,1,2,1,2,1,217,117,53025,40858,294,150,56149,39481
268,25,1,2,1,0,0,3,13,15,53026,40860,12,140,56149,39484
269,25,2,1,0,3,1,0,238,205,53028,40861,274,103,56152,39484
270,25,1,1,2,1,2,1,163,123,53029,40862,198,47,56153,39485
271,25,0,1,1,0,0,3,48,41,53029,40863,45,157,56153,39488
272,25,1,0,0,3,1,0,240,162,53030,40863,274,38,56156,39488
273,25,2,1,0,3,1,0,85,45,53032,40864,113,137,56159,39488
274,25,1,2,1,0,0,3,212,168,53033,40866,245,140,56159,39491
275,26,1,0,0,3,1,0,239,205,53034,40866,277,216,56162,39491
276,26,2,0,0,3,1,0,235,171,53036,40866,258,150,56165,39491
277,26,2,1,0,3,1,0,59,44,53038,40867,83,51,56168,39491
278,26,0,1,1,0,0,3,200,154,53038,40868,179,166,56168,39494
279,26,0,1,1,0,0,3,219,188,53038,40869,235,170,56168,39497
280,26,0,1,1,0,0,3,92,90,53038,40870,107,106,56168,39500
281,26,1,0,0,3,1,0,195,162,53039,40870,227,7,56171,39500
282,26,2,0,0,3,1,0,263,231,53041,40870,262,24,56174,39500
283,26,3,0,0,3,1,0,31,25,53044,40870,50,4,56177,39500
284,26,5,1,0,3,1,0,144,101,53049,40871,191,152,56180,39500
285,26,2,0,0,3,1,0,195,172,53051,40871,234,111,56183,39500
286,27,3,2,0,3,1,0,300,216,53054,40873,349,157,56186,39500
287,27,0,0,2,1,2,1,225,214,53054,40873,269,39,56187,39501
288,27,0,0,2,1,2,1,85,45,53054,40873,114,48,56188,39502
289,27,1,1,2,1,2,1,218,118,53055,40874,295,104,56189,39503
290,27,0,0,2,1,2,1,13,15,53055,40874,13,138,56190,39504
291,27,0,2,1,0,0,3,104,103,53055,40876,129,153,56190,39507
292,27,0,3,1,0,0,3,48,44,53055,40879,45,143,56190,39510
293,27,1,2,1,0,0,3,213,170,53056,40881,245,151,56190,39513
294,27,2,3,1,0,0,3,23,20,53058,40884,22,178,56190,39516
295,27,1,0,0,3,1,0,241,162,53059,40884,277,63,56193,39516
296,27,1,2,1,0,0,3,164,125,53060,40886,198,143,56193,39519
297,28,2,0,0,3,1,0,237,171,53062,40886,261,170,56196,39519
298,28,1,1,2,1,2,1,201,155,53063,40887,180,107,56197,39520
299,28,3,0,0,3,1,0,266,231,53066,40887,265,157,56200,39520
300,28,2,1,0,3,1,0,221,189,53068,40888,238,7,56203,39520
301,28,0,0,2,1,2,1,59,44,53068,40888,84,5,56204,39521
302,28,2,1,0,3,1,0,215,171,53070,40889,248,216,56207,39521
303,28,2,1,0,3,1,0,197,173,53072,40890,237,51,56210,39521
304,28,2,0,0,3,1,0,33,25,53074,40890,53,24,56213,39521
305,28,1,0,0,3,1,0,93,90,53075,40890,110,150,56216,39521
306,28,2,0,0,3,1,0,241,205,53077,40890,280,166,56219,39521
307,28,3,1,0,3,1,0,147,102,53080,40891,194,111,56222,39521
308,29,0,0,2,1,2,1,85,45,53080,40891,115,144,56223,39522
309,29,1,2,1,0,0,3,242,164,53081,40893,277,156,56223,39525
310,29,2,0,0,3,1,0,25,20,53083,40893,25,39,56226,39525
311,29,1,0,0,3,1,0,226,214,53084,40893,272,63,56229,39525
312,29,2,1,0,3,1,0,166,126,53086,40894,201,151,56232,39525
313,29,1,2,1,0,0,3,14,17,53087,40896,13,51,56232,39528
314,29,1,2,1,0,0,3,105,105,53088,40898,129,107,56232,39531
315,29,0,1,1,0,0,3,48,45,53088,40899,45,141,56232,39534
316,29,1,2,1,0,0,3,219,120,53089,40901,295,155,56232,39537
317,29,1,1,2,1,2,1,301,217,53090,40902,350,179,56233,39538
318,29,2,2,2,1,2,1,197,164,53092,40904,228,144,56234,39539
319,30,3,1,0,3,1,0,150,103,53095,40905,197,51,56237,39539
320,30,0,1,1,0,0,3,241,206,53095,40906,280,110,56237,39542
321,30,0,1,1,0,0,3,221,190,53095,40907,238,182,56237,39545
322,30,0,0,2,1,2,1,219,120,53095,40907,296,217,56238,39546
323,30,4,1,0,3,1,0,63,45,53099,40908,87,24,56241,39546
324,30,3,1,0,3,1,0,200,174,53102,40909,240,5,56244,39546
325,30,2,2,2,1,2,1,203,157,53104,40911,181,151,56245,39547
326,30,4,0,0,3,1,0,241,171,53108,40911,264,7,56248,39547
327,30,0,0,2,1,2,1,93,90,53108,40911,111,171,56249,39548
328,30,1,0,0,3,1,0,216,171,53109,40911,251,111,56252,39548
329,30,0,0,2,1,2,1,33,25,53109,40911,54,158,56253,39549
330,31,1,2,1,0,0,3,49,47,53110,40913,45,54,56253,39552
331,31,1,2,1,0,0,3,227,216,53111,40915,272,159,56253,39555
332,31,1,1,2,1,2,1,15,18,53112,40916,14,145,56254,39556
333,31,2,1,0,3,1,0,168,127,53114,40917,204,166,56257,39556
334,31,0,1,1,0,0,3,25,21,53114,40918,25,66,56257,39559
335,31,2,1,0,3,1,0,303,218,53116,40919,353,144,56260,39559
336,31,3,2,0,3,1,0,269,233,53119,40921,268,39,56263,39559
337,31,2,1,0,3,1,0,87,46,53121,40922,118,151,56266,39559
338,31,0,2,1,0,0,3,105,107,53121,40924,129,158,56266,39562
339,31,2,0,0,3,1,0,244,164,53123,40924,280,107,56269,39562
340,31,0,2,1,0,0,3,197,166,53123,40926,228,144,56269,39565
341,32,0,0,2,1,2,1,93,90,53123,40926,112,8,56270,39566
342,32,0,0,2,1,2,1,168,127,53123,40926,205,218,56271,39567
343,32,1,1,2,1,2,1,217,172,53124,40927,252,52,56272,39568
344,32,1,0,0,3,1,0,34,25,53125,40927,57,144,56275,39568
345,32,1,0,0,3,1,0,242,171,53126,40927,267,182,56278,39568
346,32,1,0,0,3,1,0,220,120,53127,40927,299,110,56281,39568
347,32,0,1,1,0,0,3,200,175,53127,40928,240,27,56281,39571
348,32,0,2,1,0,0,3,203,159,53127,40930,181,174,56281,39574
349,32,2,0,0,3,1,0,152,103,53129,40930,200,5,56284,39574
350,32,1,0,0,3,1,0,242,206,53130,40930,283,151,56287,39574
351,32,1,1,2,1,2,1,64,46,53131,40931,88,159,56288,39575
352,33,2,1,0,3,1,0,246,165,53133,40932,283,158,56291,39575
353,33,0,1,1,0,0,3,25,22,53133,40933,25,162,56291,39578
354,33,1,0,0,3,1,0,304,218,53134,40933,356,39,56294,39578
355,33,0,1,1,0,0,3,87,47,53134,40934,118,169,56294,39581
356,33,3,1,0,3,1,0,52,48,53137,40935,48,145,56297,39581
357,33,3,2,0,3,1,0,18,20,53140,40937,17,151,56300,39581
358,33,0,1,1,0,0,3,227,217,53140,40938,272,110,56300,39584
359,33,1,3,1,0,0,3,222,193,53141,40941,238,147,56300,39587
360,33,1,1,2,1,2,1,270,234,53142,40942,269,67,56301,39588
361,33,3,0,0,3,1,0,108,107,53145,40942,132,111,56304,39588
362,33,0,0,2,1,2,1,197,166,53145,40942,229,55,56305,39589
363,34,0,0,2,1,2,1,64,46,53145,40942,89,145,56306,39590
364,34,0,1,1,0,0,3,203,160,53145,40943,181,11,56306,39593
365,34,1,1,2,1,2,1,243,207,53146,40944,284,175,56307,39594
366,34,1,0,0,3,1,0,201,175,53147,40944,243,159,56310,39594
367,34,0,1,1,0,0,3,220,121,53147,40945,299,154,56310,39597
368,34,0,1,1,0,0,3,93,91,53147,40946,112,185,56310,39600
369,34,1,0,0,3,1,0,109,107,53148,40946,135,218,56313,39600
370,34,0,1,1,0,0,3,168,128,53148,40947,205,55,56313,39603
371,34,2,1,0,3,1,0,244,172,53150,40948,270,39,56316,39603
372,34,1,0,0,3,1,0,218,172,53151,40948,255,5,56319,39603
373,34,2,0,0,3,1,0,154,103,53153,40948,203,27,56322,39603
374,35,1,0,0,3,1,0,35,25,53154,40948,60,67,56325,39603
375,35,1,1,2,1,2,1,19,21,53155,40949,18,170,56326,39604
376,35,2,0,0,3,1,0,248,165,53157,40949,286,111,56329,39604
377,35,3,2,0,3,1,0,28,24,53160,40951,28,110,56332,39604
378,35,1,1,2,1,2,1,228,218,53161,40952,273,159,56333,39605
379,35,0,1,1,0,0,3,304,219,53161,40953,356,150,56333,39608
380,35,1,1,2,1,2,1,223,194,53162,40954,239,56,56334,39609
381,35,2,1,0,3,1,0,272,235,53164,40955,272,162,56337,39609
382,35,0,0,2,1,2,1,52,48,53164,40955,49,152,56338,39610
383,35,1,0,0,3,1,0,88,47,53165,40955,121,110,56341,39610
384,35,2,1,0,3,1,0,199,167,53167,40956,232,145,56344,39610
385,36,1,2,1,0,0,3,89,49,53168,40958,121,221,56344,39613
386,36,3,0,0,3,1,0,221,172,53171,40958,258,27,56347,39613
387,36,2,1,0,3,1,0,203,176,53173,40959,246,145,56350,39613
388,36,0,0,2,1,2,1,109,107,53173,40959,136,155,56351,39614
389,36,0,1,1,0,0,3,93,92,53173,40960,112,42,56351,39617
390,36,2,4,1,0,0,3,156,107,53175,40964,203,162,56351,39620
391,36,0,0,2,1,2,1,220,121,53175,40964,300,176,56352,39621
392,36,2,3,1,0,0,3,205,163,53177,40967,181,188,56352,39624
393,36,0,0,2,1,2,1,64,46,53177,40967,90,151,56353,39625
394,36,1,1,2,1,2,1,169,129,53178,40968,206,6,56354,39626
395,36,3,3,2,1,2,1,246,210,53181,40971,285,12,56355,39627
396,37,1,1,2,1,2,1,36,26,53182,40972,61,163,56356,39628
397,37,1,1,2,1,2,1,305,220,53183,40973,357,68,56357,39629
398,37,1,0,0,3,1,0,224,194,53184,40973,242,145,56360,39629
399,37,1,0,0,3,1,0,53,48,53185,40973,52,170,56363,39629
400,37,1,1,2,1,2,1,229,219,53186,40974,274,112,56364,39630
401,37,2,1,0,3,1,0,201,168,53188,40975,235,152,56367,39630
402,37,3,0,0,3,1,0,251,165,53191,40975,289,55,56370,39630
403,37,2,1,0,3,1,0,246,173,53193,40976,273,56,56373,39630
404,37,3,1,0,3,1,0,275,236,53196,40977,275,110,56376,39630
405,37,2,1,0,3,1,0,30,25,53198,40978,31,159,56379,39630
406,37,1,0,0,3,1,0,20,21,53199,40978,21,110,56382,39630
407,38,0,0,2,1,2,1,220,121,53199,40978,301,13,56383,39631
408,38,2,4,1,0,0,3,223,176,53201,40982,258,165,56383,39634
409,38,0,1,1,0,0,3,251,166,53201,40983,289,224,56383,39637
410,38,2,1,0,3,1,0,205,177,53203,40984,249,151,56386,39637
411,38,0,1,1,0,0,3,205,164,53203,40985,181,45,56386,39640
412,38,0,0,2,1,2,1,156,107,53203,40985,204,146,56387,39641
413,38,0,2,1,0,0,3,109,109,53203,40987,136,179,56387,39644
414,38,2,0,0,3,1,0,91,49,53205,40987,124,6,56390,39644
415,38,1,1,2,1,2,1,94,93,53206,40988,113,69,56391,39645
416,38,1,0,0,3,1,0,170,129,53207,40988,209,27,56394,39645
417,38,0,2,1,0,0,3,246,212,53207,40990,285,191,56394,39648
418,39,2,1,0,3,1,0,22,22,53209,40991,24,155,56397,39648
419,39,3,2,0,3,1,0,308,222,53212,40993,360,56,56400,39648
420,39,2,3,1,0,0,3,248,176,53214,40996,273,148,56400,39651
421,39,1,1,2,1,2,1,37,27,53215,40997,62,111,56401,39652
422,39,2,1,0,3,1,0,231,220,53217,40998,277,55,56404,39652
423,39,1,1,2,1,2,1,31,26,53218,40999,32,113,56405,39653
424,39,1,1,2,1,2,1,202,169,53219,41000,236,171,56406,39654
425,39,1,2,1,0,0,3,276,238,53220,41002,275,162,56406,39657
426,39,1,0,0,3,1,0,54,48,53221,41002,55,110,56409,39657
427,39,2,0,0,3,1,0,226,194,53223,41002,245,152,56412,39657
428,39,2,0,0,3,1,0,66,46,53225,41002,93,163,56415,39657
429,40,1,0,0,3,1,0,157,107,53226,41002,207,151,56418,39657
430,40,5,3,0,3,1,0,114,112,53231,41005,139,13,56421,39657
431,40,2,1,0,3,1,0,93,50,53233,41006,127,27,56424,39657
432,40,1,0,0,3,1,0,247,212,53234,41006,288,45,56427,39657
433,40,1,5,1,0,0,3,23,27,53235,41011,24,227,56427,39660
434,40,3,1,0,3,1,0,208,165,53238,41012,184,69,56430,39660
435,40,1,1,2,1,2,1,252,167,53239,41013,290,180,56431,39661
436,40,4,1,0,3,1,0,209,178,53243,41014,252,56,56434,39661
437,40,4,0,0,3,1,0,224,121,53247,41014,304,191,56437,39661
438,40,2,0,0,3,1,0,225,176,53249,41014,261,146,56440,39661
439,40,0,2,1,0,0,3,170,131,53249,41016,209,168,56440,39664
440,41,3,2,0,3,1,0,212,180,53252,41018,255,227,56443,39664
441,41,0,0,2,1,2,1,94,93,53252,41018,114,149,56444,39665
442,41,1,1,2,1,2,1,67,47,53253,41019,94,112,56445,39666
443,41,2,1,0,3,1,0,250,177,53255,41020,276,152,56448,39666
444,41,1,2,1,0,0,3,38,29,53256,41022,62,165,56448,39669
445,41,0,0,2,1,2,1,226,194,53256,41022,246,172,56449,39670
446,41,1,0,0,3,1,0,277,238,53257,41022,278,113,56452,39670
447,41,0,1,1,0,0,3,202,170,53257,41023,236,113,56452,39673
448,41,2,0,0,3,1,0,33,26,53259,41023,35,55,56455,39673
449,41,2,1,0,3,1,0,56,49,53261,41024,58,155,56458,39673
450,41,1,0,0,3,1,0,232,220,53262,41024,280,6,56461,39673
451,42,2,1,0,3,1,0,25,28,53264,41025,27,27,56464,39673
452,42,0,2,1,0,0,3,208,167,53264,41027,184,166,56464,39676
453,42,1,1,2,1,2,1,158,108,53265,41028,208,57,56465,39677
454,42,2,1,0,3,1,0,249,213,53267,41029,291,69,56468,39677
455,42,3,0,0,3,1,0,228,176,53270,41029,264,151,56471,39677
456,42,3,0,0,3,1,0,227,121,53273,41029,307,45,56474,39677
457,42,1,1,2,1,2,1,171,132,53274,41030,210,147,56475,39678
458,42,2,0,0,3,1,0,116,112,53276,41030,142,191,56478,39678
459,42,2,1,0,3,1,0,95,51,53278,41031,130,168,56481,39678
460,42,2,1,0,3,1,0,254,168,53280,41032,293,13,56484,39678
461,42,2,0,0,3,1,0,310,222,53282,41032,363,180,56487,39678
0,1,1,0,0,3,1,0,68,47,53283,41032,97,147,56490,39678
1,1,1,1,2,1,2,1,95,94,53284,41033,115,154,56491,39679
2,1,0,0,2,1,2,1,192,169,53284,41033,245,153,56492,39680
3,1,1,2,1,0,0,3,172,134,53285,41035,210,139,56492,39683
4,1,1,1,2,1,2,1,228,122,53286,41036,308,152,56493,39684
5,1,3,3,2,1,2,1,231,179,53289,41039,265,156,56494,39685
6,1,1,0,0,3,1,0,197,171,53290,41039,247,180,56497,39685
7,1,1,1,2,1,2,1,96,52,53291,41040,131,1,56498,39686
8,1,2,1,0,3,1,0,214,181,53293,41041,258,0,56501,39686
9,1,2,0,0,3,1,0,247,184,53295,41041,281,45,56504,39686
10,1,1,1,2,1,2,1,117,113,53296,41042,143,113,56505,39687
11,2,1,0,0,3,1,0,220,176,53297,41042,237,172,56508,39687
12,2,0,1,1,0,0,3,0,1,53297,41043,0,157,56508,39690
13,2,0,0,2,1,2,1,38,29,53297,41043,63,167,56509,39691
14,2,1,1,2,1,2,1,255,169,53298,41044,294,70,56510,39692
15,2,1,1,2,1,2,1,248,185,53299,41045,282,58,56511,39693
16,2,2,4,1,0,0,3,233,183,53301,41049,265,58,56511,39696
17,2,2,0,0,3,1,0,252,177,53303,41049,279,113,56514,39696
18,2,1,1,2,1,2,1,233,221,53304,41050,281,172,56515,39697
19,2,1,1,2,1,2,1,250,214,53305,41051,292,114,56516,39698
20,2,1,1,2,1,2,1,227,195,53306,41052,247,114,56517,39699
21,2,0,1,1,0,0,3,0,1,53306,41053,0,117,56517,39702
22,3,1,0,0,3,1,0,229,122,53307,41053,311,117,56520,39702
23,3,3,2,0,3,1,0,175,136,53310,41055,213,156,56523,39702
24,3,0,2,1,0,0,3,192,171,53310,41057,245,48,56523,39705
25,3,1,1,2,1,2,1,215,182,53311,41058,259,147,56524,39706
26,3,1,1,2,1,2,1,69,48,53312,41059,98,59,56525,39707
27,3,2,2,2,1,2,1,160,110,53314,41061,209,158,56526,39708
28,3,0,1,1,0,0,3,117,114,53314,41062,143,3,56526,39711
29,3,2,0,0,3,1,0,254,177,53316,41062,282,1,56529,39711
30,3,3,0,0,3,1,0,98,94,53319,41062,118,165,56532,39711
31,3,2,0,0,3,1,0,252,214,53321,41062,295,180,56535,39711
32,3,0,1,1,0,0,3,227,196,53321,41063,247,142,56535,39714
33,4,4,0,0,3,1,0,252,185,53325,41063,285,113,56538,39714
34,4,1,0,0,3,1,0,198,171,53326,41063,250,70,56541,39714
35,4,3,1,0,3,1,0,236,222,53329,41064,284,147,56544,39714
36,4,1,0,0,3,1,0,221,176,53330,41064,240,114,56547,39714
37,4,0,4,1,0,0,3,96,56,53330,41068,131,170,56547,39717
38,4,1,2,1,0,0,3,39,31,53331,41070,63,61,56547,39720
39,4,1,0,0,3,1,0,256,169,53332,41070,297,172,56550,39720
40,4,1,3,1,0,0,3,1,4,53333,41073,0,156,56550,39723
41,4,0,0,2,1,2,1,233,183,53333,41073,266,173,56551,39724
42,4,1,0,0,3,1,0,213,204,53334,41073,230,152,56554,39724
43,4,1,0,0,3,1,0,1,1,53335,41073,3,114,56557,39724
44,5,1,0,0,3,1,0,118,114,53336,41073,146,180,56560,39724
45,5,3,0,0,3,1,0,224,176,53339,41073,243,165,56563,39724
46,5,0,1,1,0,0,3,160,111,53339,41074,209,51,56563,39727
47,5,1,0,0,3,1,0,230,122,53340,41074,314,158,56566,39727
48,5,1,1,2,1,2,1,193,172,53341,41075,246,118,56567,39728
49,5,0,2,1,0,0,3,175,138,53341,41077,213,62,56567,39731
50,5,1,2,1,0,0,3,2,6,53342,41079,0,150,56567,39734
51,5,2,1,0,3,1,0,229,197,53344,41080,250,170,56570,39734
52,5,3,0,0,3,1,0,255,214,53347,41080,298,3,56573,39734
53,5,1,1,2,1,2,1,255,178,53348,41081,283,157,56574,39735
54,5,1,1,2,1,2,1,99,95,53349,41082,119,71,56575,39736
55,6,1,0,0,3,1,0,237,222,53350,41082,287,152,56578,39736
56,6,1,4,1,0,0,3,2,5,53351,41086,3,4,56578,39739
57,6,0,2,1,0,0,3,215,184,53351,41088,259,117,56578,39742
58,6,1,1,2,1,2,1,234,184,53352,41089,267,115,56579,39743
59,6,1,3,1,0,0,3,199,174,53353,41092,250,64,56579,39746
60,6,1,1,2,1,2,1,97,57,53354,41093,132,173,56580,39747
61,6,1,0,0,3,1,0,253,185,53355,41093,288,142,56583,39747
62,6,1,1,2,1,2,1,40,32,53356,41094,64,114,56584,39748
63,6,0,2,1,0,0,3,256,171,53356,41096,297,150,56584,39751
64,6,0,2,1,0,0,3,69,50,53356,41098,98,176,56584,39754
65,6,2,1,0,3,1,0,215,205,53358,41099,233,156,56587,39754
66,7,2,2,2,1,2,1,101,97,53360,41101,120,171,56588,39755
67,7,1,1,2,1,2,1,176,139,53361,41102,214,119,56589,39756
68,7,4,2,0,3,1,0,259,216,53365,41104,301,165,56592,39756
69,7,1,0,0,3,1,0,256,178,53366,41104,286,150,56595,39756
70,7,1,0,0,3,1,0,161,111,53367,41104,212,71,56598,39756
71,7,2,0,0,3,1,0,232,122,53369,41104,317,62,56601,39756
72,7,1,0,0,3,1,0,225,176,53370,41104,246,3,56604,39756
73,7,2,0,0,3,1,0,231,197,53372,41104,253,51,56607,39756
74,7,0,0,2,1,2,1,237,222,53372,41104,288,158,56608,39757
75,7,2,2,2,1,2,1,4,8,53374,41106,1,174,56609,39758
76,7,1,3,1,0,0,3,119,117,53375,41109,146,161,56609,39761
77,8,4,1,0,3,1,0,203,175,53379,41110,253,115,56612,39761
78,8,1,0,0,3,1,0,257,171,53380,41110,300,4,56615,39761
79,8,1,0,0,3,1,0,235,184,53381,41110,270,150,56618,39761
80,8,0,0,2,1,2,1,253,185,53381,41110,289,177,56619,39762
81,8,1,2,1,0,0,3,41,34,53382,41112,64,159,56619,39765
82,8,1,0,0,3,1,0,98,57,53383,41112,135,64,56622,39765
83,8,1,1,2,1,2,1,216,206,53384,41113,234,143,56623,39766
84,8,2,1,0,3,1,0,195,173,53386,41114,249,117,56626,39766
85,8,1,1,2,1,2,1,70,51,53387,41115,99,115,56627,39767
86,8,2,1,0,3,1,0,4,6,53389,41116,6,152,56630,39767
87,8,1,1,2,1,2,1,216,185,53390,41117,260,181,56631,39768
88,9,2,1,0,3,1,0,227,177,53392,41118,249,64,56634,39768
89,9,2,1,0,3,1,0,6,9,53394,41119,4,71,56637,39768
90,9,4,0,0,3,1,0,220,206,53398,41119,237,174,56640,39768
91,9,3,1,0,3,1,0,240,223,53401,41120,291,165,56643,39768
92,9,1,1,2,1,2,1,257,179,53402,41121,287,52,56644,39769
93,9,3,0,0,3,1,0,234,197,53405,41121,256,150,56647,39769
94,9,1,0,0,3,1,0,258,171,53406,41121,303,171,56650,39769
95,9,0,0,2,1,2,1,161,111,53406,41121,213,118,56651,39770
96,9,1,0,0,3,1,0,5,6,53407,41121,9,62,56654,39770
97,9,1,0,0,3,1,0,260,216,53408,41121,304,119,56657,39770
98,9,1,3,1,0,0,3,120,120,53409,41124,146,180,56657,39773
99,10,2,0,0,3,1,0,197,173,53411,41124,252,143,56660,39773
100,10,2,1,0,3,1,0,100,58,53413,41125,138,181,56663,39773
101,10,1,0,0,3,1,0,233,122,53414,41125,320,159,56666,39773
102,10,3,0,0,3,1,0,256,185,53417,41125,292,158,56669,39773
103,10,1,1,2,1,2,1,236,185,53418,41126,271,162,56670,39774
104,10,1,1,2,1,2,1,204,176,53419,41127,254,5,56671,39775
105,10,1,0,0,3,1,0,177,139,53420,41127,217,115,56674,39775
106,10,1,1,2,1,2,1,102,98,53421,41128,121,151,56675,39776
107,10,2,1,0,3,1,0,43,35,53423,41129,67,3,56678,39776
108,10,1,1,2,1,2,1,217,186,53424,41130,261,116,56679,39777
109,10,0,0,2,1,2,1,70,51,53424,41130,100,153,56680,39778
110,11,0,0,2,1,2,1,257,179,53424,41130,288,166,56681,39779
111,11,2,0,0,3,1,0,222,206,53426,41130,240,52,56684,39779
112,11,1,0,0,3,1,0,261,216,53427,41130,307,151,56687,39779
113,11,2,2,2,1,2,1,206,178,53429,41132,255,151,56688,39780
114,11,3,2,0,3,1,0,164,113,53432,41134,216,180,56691,39780
115,11,1,2,1,0,0,3,178,141,53433,41136,217,74,56691,39783
116,11,2,1,0,3,1,0,122,121,53435,41137,149,62,56694,39783
117,11,1,1,2,1,2,1,6,7,53436,41138,10,182,56695,39784
118,11,1,2,1,0,0,3,7,11,53437,41140,4,67,56695,39787
119,11,2,0,0,3,1,0,199,173,53439,41140,255,171,56698,39787
120,11,2,0,0,3,1,0,229,177,53441,41140,252,158,56701,39787
121,12,2,0,0,3,1,0,104,98,53443,41140,124,115,56704,39787
122,12,0,0,2,1,2,1,43,35,53443,41140,68,119,56705,39788
123,12,2,0,0,3,1,0,260,171,53445,41140,306,116,56708,39788
124,12,2,1,0,3,1,0,242,224,53447,41141,294,143,56711,39788
125,12,4,2,0,3,1,0,240,187,53451,41143,274,5,56714,39788
126,12,1,1,2,1,2,1,257,186,53452,41144,293,163,56715,39789
127,12,5,1,0,3,1,0,75,52,53457,41145,103,174,56718,39789
128,12,1,1,2,1,2,1,101,59,53458,41146,139,120,56719,39790
129,12,2,0,0,3,1,0,235,122,53460,41146,323,3,56722,39790
130,12,2,1,0,3,1,0,236,198,53462,41147,259,153,56725,39790
131,12,0,2,1,0,0,3,217,188,53462,41149,261,162,56725,39793
132,13,2,0,0,3,1,0,77,52,53464,41149,106,52,56728,39793
133,13,2,3,1,0,0,3,9,14,53466,41152,4,185,56728,39796
134,13,0,1,1,0,0,3,178,142,53466,41153,217,183,56728,39799
135,13,4,0,0,3,1,0,226,206,53470,41153,243,62,56731,39799
136,13,0,0,2,1,2,1,199,173,53470,41153,256,152,56732,39800
137,13,0,0,2,1,2,1,261,216,53470,41153,308,159,56733,39801
138,13,2,0,0,3,1,0,8,7,53472,41153,13,151,56736,39801
139,13,3,0,0,3,1,0,209,178,53475,41153,258,166,56739,39801
140,13,2,2,2,1,2,1,259,181,53477,41155,289,144,56740,39802
141,13,0,0,2,1,2,1,164,113,53477,41155,217,68,56741,39803
142,13,1,3,1,0,0,3,123,124,53478,41158,149,174,56741,39806
143,14,2,2,2,1,2,1,259,188,53480,41160,294,163,56742,39807
144,14,2,0,0,3,1,0,231,177,53482,41160,255,115,56745,39807
145,14,2,0,0,3,1,0,244,224,53484,41160,297,116,56748,39807
146,14,1,4,1,0,0,3,44,39,53485,41164,68,8,56748,39810
147,14,2,2,2,1,2,1,219,190,53487,41166,262,121,56749,39811
148,14,2,1,0,3,1,0,103,60,53489,41167,142,153,56752,39811
149,14,1,2,1,0,0,3,261,173,53490,41169,306,6,56752,39814
150,14,1,3,1,0,0,3,241,190,53491,41172,274,77,56752,39817
151,14,1,0,0,3,1,0,105,98,53492,41172,127,119,56755,39817
152,14,1,0,0,3,1,0,236,122,53493,41172,326,174,56758,39817
153,14,1,1,2,1,2,1,237,199,53494,41173,260,164,56759,39818
154,15,1,2,1,0,0,3,262,218,53495,41175,308,156,56759,39821
155,15,2,2,2,1,2,1,125,126,53497,41177,150,152,56760,39822
156,15,2,0,0,3,1,0,228,206,53499,41177,246,185,56763,39822
157,15,2,1,0,3,1,0,180,143,53501,41178,220,166,56766,39822
158,15,4,1,0,3,1,0,81,53,53505,41179,109,152,56769,39822
159,15,1,0,0,3,1,0,210,178,53506,41179,261,159,56772,39822
160,15,1,0,0,3,1,0,10,14,53507,41179,7,144,56775,39822
161,15,3,0,0,3,1,0,106,60,53510,41179,145,52,56778,39822
162,15,0,1,1,0,0,3,199,174,53510,41180,256,71,56778,39825
163,15,2,1,0,3,1,0,166,114,53512,41181,220,6,56781,39825
164,15,2,0,0,3,1,0,238,122,53514,41181,329,174,56784,39825
165,16,0,1,1,0,0,3,219,191,53514,41182,262,80,56784,39828
166,16,1,1,2,1,2,1,242,191,53515,41183,275,175,56785,39829
167,16,0,1,1,0,0,3,231,178,53515,41184,255,166,56785,39832
168,16,0,2,1,0,0,3,44,41,53515,41186,68,124,56785,39835
169,16,1,1,2,1,2,1,238,200,53516,41187,261,9,56786,39836
170,16,2,1,0,3,1,0,261,182,53518,41188,292,116,56789,39836
171,16,0,0,2,1,2,1,8,7,53518,41188,14,165,56790,39837
172,16,1,0,0,3,1,0,245,224,53519,41188,300,119,56793,39837
173,16,2,1,0,3,1,0,107,99,53521,41189,130,183,56796,39837
174,16,3,0,0,3,1,0,264,173,53524,41189,309,115,56799,39837
175,16,0,0,2,1,2,1,259,188,53524,41189,295,63,56800,39838
176,17,0,0,2,1,2,1,166,114,53524,41189,221,10,56801,39839
177,17,2,2,2,1,2,1,230,208,53526,41191,247,160,56802,39840
178,17,0,1,1,0,0,3,125,127,53526,41192,150,169,56802,39843
179,17,2,2,2,1,2,1,109,101,53528,41194,131,186,56803,39844
180,17,1,2,1,0,0,3,211,180,53529,41196,261,147,56803,39847
181,17,1,2,1,0,0,3,107,62,53530,41198,145,155,56803,39850
182,17,0,1,1,0,0,3,238,123,53530,41199,329,55,56803,39853
183,17,1,0,0,3,1,0,82,53,53531,41199,112,6,56806,39853
184,17,0,0,2,1,2,1,199,174,53531,41199,257,157,56807,39854
185,17,4,2,0,3,1,0,184,145,53535,41201,223,152,56810,39854
186,17,0,0,2,1,2,1,219,191,53535,41201,263,167,56811,39855
187,18,1,0,0,3,1,0,232,178,53536,41201,258,80,56814,39855
188,18,1,0,0,3,1,0,263,218,53537,41201,311,63,56817,39855
189,18,1,2,1,0,0,3,265,175,53538,41203,309,74,56817,39858
190,18,1,1,2,1,2,1,45,42,53539,41204,69,168,56818,39859
191,18,1,0,0,3,1,0,262,182,53540,41204,295,124,56821,39859
192,18,1,3,1,0,0,3,9,10,53541,41207,14,178,56821,39862
193,18,2,1,0,3,1,0,247,225,53543,41208,303,183,56824,39862
194,18,0,1,1,0,0,3,10,15,53543,41209,7,118,56824,39865
195,18,1,1,2,1,2,1,260,189,53544,41210,296,117,56825,39866
196,18,1,1,2,1,2,1,239,201,53545,41211,262,120,56826,39867
197,18,3,1,0,3,1,0,233,209,53548,41212,250,174,56829,39867
198,19,1,1,2,1,2,1,167,115,53549,41213,222,170,56830,39868
199,19,2,0,0,3,1,0,213,180,53551,41213,264,118,56833,39868
200,19,0,0,2,1,2,1,184,145,53551,41213,224,158,56834,39869
201,19,0,0,2,1,2,1,107,62,53551,41213,146,148,56835,39870
202,19,2,1,0,3,1,0,221,192,53553,41214,266,10,56838,39870
203,19,2,2,2,1,2,1,201,176,53555,41216,258,156,56839,39871
204,19,4,1,0,3,1,0,246,192,53559,41217,278,152,56842,39871
205,19,3,0,0,3,1,0,85,53,53562,41217,115,165,56845,39871
206,19,0,1,1,0,0,3,45,43,53562,41218,69,189,56845,39874
207,19,1,0,0,3,1,0,110,101,53563,41218,134,6,56848,39874
208,19,1,1,2,1,2,1,239,124,53564,41219,330,161,56849,39875
209,20,1,1,2,1,2,1,264,219,53565,41220,312,75,56850,39876
210,20,2,1,0,3,1,0,169,116,53567,41221,225,178,56853,39876
211,20,1,2,1,0,0,3,263,184,53568,41223,295,177,56853,39879
212,20,3,0,0,3,1,0,13,15,53571,41223,10,183,56856,39879
213,20,2,0,0,3,1,0,241,201,53573,41223,265,124,56859,39879
214,20,0,0,2,1,2,1,233,209,53573,41223,251,121,56860,39880
215,20,2,1,0,3,1,0,249,226,53575,41224,306,80,56863,39880
216,20,1,0,0,3,1,0,126,127,53576,41224,153,168,56866,39880
217,20,0,3,1,0,0,3,232,181,53576,41227,258,58,56866,39883
218,20,2,3,1,0,0,3,267,178,53578,41230,309,66,56866,39886
219,20,0,0,2,1,2,1,9,10,53578,41230,15,153,56867,39887
220,21,0,0,2,1,2,1,85,53,53578,41230,116,171,56868,39888
221,21,1,1,2,1,2,1,111,102,53579,41231,135,159,56869,39889
222,21,4,1,0,3,1,0,264,190,53583,41232,299,189,56872,39889
223,21,1,1,2,1,2,1,46,44,53584,41233,70,162,56873,39890
224,21,1,0,0,3,1,0,108,62,53585,41233,149,117,56876,39890
225,21,1,0,0,3,1,0,214,180,53586,41233,267,165,56879,39890
226,21,1,1,2,1,2,1,247,193,53587,41234,279,7,56880,39891
227,21,0,0,2,1,2,1,239,124,53587,41234,331,157,56881,39892
228,21,1,1,2,1,2,1,185,146,53588,41235,225,11,56882,39893
229,21,0,2,1,0,0,3,221,194,53588,41237,266,151,56882,39896
230,21,1,0,0,3,1,0,202,176,53589,41237,261,118,56885,39896
231,22,0,0,2,1,2,1,241,201,53589,41237,266,81,56886,39897
232,22,2,2,2,1,2,1,11,12,53591,41239,16,178,56887,39898
233,22,3,2,0,3,1,0,270,180,53594,41241,312,168,56890,39898
234,22,0,1,1,0,0,3,46,45,53594,41242,70,156,56890,39901
235,22,2,1,0,3,1,0,234,182,53596,41243,261,121,56893,39901
236,22,2,0,0,3,1,0,251,226,53598,41243,309,124,56896,39901
237,22,2,0,0,3,1,0,265,184,53600,41243,298,183,56899,39901
238,22,2,0,0,3,1,0,235,209,53602,41243,254,75,56902,39901
239,22,2,0,0,3,1,0,171,116,53604,41243,228,118,56905,39901
240,22,0,2,1,0,0,3,13,17,53604,41245,10,69,56905,39904
241,22,2,1,0,3,1,0,266,220,53606,41246,315,178,56908,39904
242,23,2,0,0,3,1,0,223,194,53608,41246,269,69,56911,39904
243,23,0,1,1,0,0,3,241,202,53608,41247,266,192,56911,39907
244,23,1,1,2,1,2,1,203,177,53609,41248,262,163,56912,39908
245,23,3,2,0,3,1,0,188,148,53612,41250,228,7,56915,39908
246,23,1,1,2,1,2,1,86,54,53613,41251,117,125,56916,39909
247,23,0,0,2,1,2,1,171,116,53613,41251,229,152,56917,39910
248,23,1,0,0,3,1,0,112,102,53614,41251,138,58,56920,39910
249,23,0,0,2,1,2,1,266,220,53614,41251,316,12,56921,39911
250,23,2,1,0,3,1,0,241,125,53616,41252,334,168,56924,39911
251,23,1,2,1,0,0,3,266,186,53617,41254,298,168,56924,39914
252,23,0,0,2,1,2,1,126,127,53617,41254,154,157,56925,39915
253,24,1,1,2,1,2,1,235,183,53618,41255,262,158,56926,39916
254,24,3,0,0,3,1,0,273,180,53621,41255,315,121,56929,39916
255,24,1,0,0,3,1,0,12,12,53622,41255,19,118,56932,39916
256,24,1,3,1,0,0,3,248,196,53623,41258,279,78,56932,39919
257,24,0,0,2,1,2,1,235,209,53623,41258,255,118,56933,39920
258,24,2,0,0,3,1,0,216,180,53625,41258,270,183,56936,39920
259,24,2,1,0,3,1,0,110,63,53627,41259,152,81,56939,39920
260,24,0,1,1,0,0,3,46,46,53627,41260,70,181,56939,39923
261,24,1,0,0,3,1,0,252,226,53628,41260,312,171,56942,39923
262,24,0,3,1,0,0,3,13,20,53628,41263,10,162,56942,39926
263,24,1,1,2,1,2,1,265,191,53629,41264,300,179,56943,39927
264,25,0,2,1,0,0,3,266,188,53629,41266,298,195,56943,39930
265,25,1,0,0,3,1,0,127,127,53630,41266,157,58,56946,39930
266,25,1,2,1,0,0,3,204,179,53631,41268,262,72,56946,39933
267,25,1,1,2,1,2,1,14,21,53632,41269,11,8,56947,39934
268,25,0,2,1,0,0,3,171,118,53632,41271,229,171,56947,39937
269,25,1,2,1,0,0,3,189,150,53633,41273,228,182,56947,39940
270,25,1,2,1,0,0,3,242,127,53634,41275,334,84,56947,39943
271,25,2,0,0,3,1,0,114,102,53636,41275,141,125,56950,39943
272,25,1,0,0,3,1,0,242,202,53637,41275,269,163,56953,39943
273,25,0,1,1,0,0,3,266,221,53637,41276,316,171,56953,39946
274,25,0,0,2,1,2,1,235,183,53637,41276,263,158,56954,39947
275,26,0,1,1,0,0,3,46,47,53637,41277,70,161,56954,39950
276,26,1,2,1,0,0,3,249,198,53638,41279,279,174,56954,39953
277,26,1,1,2,1,2,1,236,210,53639,41280,256,119,56955,39954
278,26,2,0,0,3,1,0,206,179,53641,41280,265,12,56958,39954
279,26,0,0,2,1,2,1,223,194,53641,41280,270,79,56959,39955
280,26,1,0,0,3,1,0,111,63,53642,41280,155,183,56962,39955
281,26,2,0,0,3,1,0,88,54,53644,41280,120,118,56965,39955
282,26,3,0,0,3,1,0,219,180,53647,41280,273,121,56968,39955
283,26,1,1,2,1,2,1,274,181,53648,41281,316,196,56969,39956
284,26,0,1,1,0,0,3,12,13,53648,41282,19,155,56969,39959
285,26,1,0,0,3,1,0,266,191,53649,41282,303,162,56972,39959
286,27,1,0,0,3,1,0,267,221,53650,41282,319,58,56975,39959
287,27,2,2,2,1,2,1,173,120,53652,41284,230,126,56976,39960
288,27,0,0,2,1,2,1,114,102,53652,41284,142,73,56977,39961
289,27,2,3,1,0,0,3,129,130,53654,41287,157,87,56977,39964
290,27,2,0,0,3,1,0,244,127,53656,41287,337,158,56980,39964
291,27,1,0,0,3,1,0,253,226,53657,41287,315,182,56983,39964
292,27,2,3,1,0,0,3,268,191,53659,41290,298,11,56983,39967
293,27,3,1,0,3,1,0,245,203,53662,41291,272,171,56986,39967
294,27,0,0,2,1,2,1,235,183,53662,41291,264,172,56987,39968
295,27,2,2,2,1,2,1,191,152,53664,41293,229,182,56988,39969
296,27,0,1,1,0,0,3,14,22,53664,41294,11,166,56988,39972
297,28,0,1,1,0,0,3,46,48,53664,41295,70,121,56988,39975
298,28,1,0,0,3,1,0,89,54,53665,41295,123,79,56991,39975
299,28,1,1,2,1,2,1,250,199,53666,41296,280,156,56992,39976
300,28,1,0,0,3,1,0,254,226,53667,41296,318,119,56995,39976
301,28,1,1,2,1,2,1,220,181,53668,41297,274,183,56996,39977
302,28,1,2,1,0,0,3,275,183,53669,41299,316,165,56996,39980
303,28,0,3,1,0,0,3,12,16,53669,41302,19,177,56996,39983
304,28,1,1,2,1,2,1,112,64,53670,41303,156,122,56997,39984
305,28,1,1,2,1,2,1,267,192,53671,41304,304,13,56998,39985
306,28,1,2,1,0,0,3,224,196,53672,41306,270,164,56998,39988
307,28,2,2,2,1,2,1,238,212,53674,41308,257,184,56999,39989
308,29,1,0,0,3,1,0,192,152,53675,41308,232,58,57002,39989
309,29,1,0,0,3,1,0,221,181,53676,41308,277,73,57005,39989
310,29,1,0,0,3,1,0,269,191,53677,41308,301,164,57008,39989
311,29,1,0,0,3,1,0,130,130,53678,41308,160,79,57011,39989
312,29,1,0,0,3,1,0,207,179,53679,41308,268,87,57014,39989
313,29,2,0,0,3,1,0,14,16,53681,41308,22,184,57017,39989
314,29,3,0,0,3,1,0,17,22,53684,41308,14,171,57020,39989
315,29,1,0,0,3,1,0,268,221,53685,41308,322,182,57023,39989
316,29,1,1,2,1,2,1,174,121,53686,41309,231,167,57024,39990
317,29,0,1,1,0,0,3,238,213,53686,41310,257,161,57024,39993
318,29,1,2,1,0,0,3,236,185,53687,41312,264,199,57024,39996
319,30,0,1,1,0,0,3,46,49,53687,41313,70,175,57024,39999
320,30,1,0,0,3,1,0,115,102,53688,41313,145,13,57027,39999
321,30,1,1,2,1,2,1,90,55,53689,41314,124,123,57028,40000
322,30,1,1,2,1,2,1,245,128,53690,41315,338,122,57029,40001
323,30,1,0,0,3,1,0,225,196,53691,41315,273,183,57032,40001
324,30,2,0,0,3,1,0,114,64,53693,41315,159,119,57035,40001
325,30,1,2,1,0,0,3,251,201,53694,41317,280,168,57035,40004
326,30,0,0,2,1,2,1,245,203,53694,41317,273,178,57036,40005
327,30,3,0,0,3,1,0,257,226,53697,41317,321,11,57039,40005
328,30,1,2,1,0,0,3,268,194,53698,41319,304,129,57039,40008
329,30,1,1,2,1,2,1,276,184,53699,41320,317,157,57040,40009
330,31,1,0,0,3,1,0,18,22,53700,41320,17,58,57043,40009
331,31,0,0,2,1,2,1,238,213,53700,41320,258,165,57044,40010
332,31,3,2,0,3,1,0,177,123,53703,41322,234,199,57047,40010
333,31,3,1,0,3,1,0,210,180,53706,41323,271,184,57050,40010
334,31,0,3,1,0,0,3,192,155,53706,41326,232,82,57050,40013
335,31,4,0,0,3,1,0,18,16,53710,41326,25,167,57053,40013
336,31,0,1,1,0,0,3,130,131,53710,41327,160,160,57053,40016
337,31,1,1,2,1,2,1,91,56,53711,41328,125,172,57054,40017
338,31,1,1,2,1,2,1,269,222,53712,41329,323,162,57055,40018
339,31,1,0,0,3,1,0,270,191,53713,41329,304,73,57058,40018
340,31,3,0,0,3,1,0,224,181,53716,41329,280,182,57061,40018
341,32,0,1,1,0,0,3,46,50,53716,41330,70,90,57061,40021
342,32,1,1,2,1,2,1,237,186,53717,41331,265,169,57062,40022
343,32,2,2,2,1,2,1,247,205,53719,41333,274,12,57063,40023
344,32,2,1,0,3,1,0,278,185,53721,41334,320,178,57066,40023
345,32,2,2,2,1,2,1,117,104,53723,41336,146,123,57067,40024
346,32,3,2,0,3,1,0,254,203,53726,41338,283,129,57070,40024
347,32,1,0,0,3,1,0,258,226,53727,41338,324,13,57073,40024
348,32,0,0,2,1,2,1,245,128,53727,41338,339,124,57074,40025
349,32,1,1,2,1,2,1,115,65,53728,41339,160,176,57075,40026
350,32,0,1,1,0,0,3,268,195,53728,41340,304,186,57075,40029
351,32,3,0,0,3,1,0,228,196,53731,41340,276,119,57078,40029
352,33,1,0,0,3,1,0,225,181,53732,41340,283,58,57081,40029
353,33,0,1,1,0,0,3,177,124,53732,41341,234,172,57081,40032
354,33,0,2,1,0,0,3,238,215,53732,41343,258,15,57081,40035
355,33,1,0,0,3,1,0,270,222,53733,41343,326,160,57084,40035
356,33,1,0,0,3,1,0,19,22,53734,41343,20,165,57087,40035
357,33,1,1,2,1,2,1,116,66,53735,41344,161,163,57088,40036
358,33,0,1,1,0,0,3,245,129,53735,41345,339,85,57088,40039
359,33,2,2,2,1,2,1,194,157,53737,41347,233,200,57089,40040
360,33,2,0,0,3,1,0,132,131,53739,41347,163,167,57092,40040
361,33,1,0,0,3,1,0,211,180,53740,41347,274,172,57095,40040
362,33,3,3,2,1,2,1,94,59,53743,41350,126,183,57096,40041
363,34,0,1,1,0,0,3,46,51,53743,41351,70,76,57096,40044
364,34,1,0,0,3,1,0,271,191,53744,41351,307,178,57099,40044
365,34,1,2,1,0,0,3,238,188,53745,41353,265,16,57099,40047
366,34,2,1,0,3,1,0,260,227,53747,41354,327,176,57102,40047
367,34,3,0,0,3,1,0,250,205,53750,41354,277,119,57105,40047
368,34,1,3,1,0,0,3,19,19,53751,41357,25,126,57105,40050
369,34,1,1,2,1,2,1,118,105,53752,41358,147,187,57106,40051
370,34,1,1,2,1,2,1,279,186,53753,41359,321,130,57107,40052
371,34,0,4,1,0,0,3,254,207,53753,41363,283,127,57107,40055
372,34,0,3,1,0,0,3,268,198,53753,41366,304,93,57107,40058
373,34,0,2,1,0,0,3,228,198,53753,41368,276,187,57107,40061
374,35,1,0,0,3,1,0,229,198,53754,41368,279,58,57110,40061
375,35,1,4,1,0,0,3,246,133,53755,41372,339,163,57110,40064
376,35,1,2,1,0,0,3,195,159,53756,41374,233,181,57110,40067
377,35,4,2,0,3,1,0,122,107,53760,41376,150,163,57113,40067
378,35,0,0,2,1,2,1,132,131,53760,41376,164,173,57114,40068
379,35,2,0,0,3,1,0,227,181,53762,41376,286,15,57117,40068
380,35,2,1,0,3,1,0,96,60,53764,41377,129,167,57120,40068
381,35,1,2,1,0,0,3,239,217,53765,41379,258,19,57120,40071
382,35,3,3,2,1,2,1,119,69,53768,41382,162,173,57121,40072
383,35,1,3,1,0,0,3,178,127,53769,41385,234,168,57121,40075
384,35,1,2,1,0,0,3,212,182,53770,41387,274,203,57121,40078
385,36,0,1,1,0,0,3,46,52,53770,41388,70,190,57121,40081
386,36,1,2,1,0,0,3,280,188,53771,41390,321,179,57121,40084
387,36,0,1,1,0,0,3,238,189,53771,41391,265,133,57121,40087
388,36,0,1,1,0,0,3,250,206,53771,41392,277,79,57121,40090
389,36,2,0,0,3,1,0,262,227,53773,41392,330,85,57124,40090
390,36,1,0,0,3,1,0,20,22,53774,41392,23,126,57127,40090
391,36,1,1,2,1,2,1,20,20,53775,41393,26,94,57128,40091
392,36,1,1,2,1,2,1,272,192,53776,41394,308,188,57129,40092
393,36,2,0,0,3,1,0,272,222,53778,41394,329,119,57132,40092
394,36,4,1,0,3,1,0,272,199,53782,41395,307,127,57135,40092
395,36,0,3,1,0,0,3,254,210,53782,41398,283,186,57135,40095
396,37,1,0,0,3,1,0,255,210,53783,41398,286,58,57138,40095
397,37,0,0,2,1,2,1,246,133,53783,41398,340,204,57139,40096
398,37,0,1,1,0,0,3,229,199,53783,41399,279,182,57139,40099
399,37,0,1,1,0,0,3,132,132,53783,41400,164,22,57139,40102
400,37,2,1,0,3,1,0,180,128,53785,41401,237,163,57142,40102
401,37,4,2,0,3,1,0,199,161,53789,41403,236,168,57145,40102
402,37,2,1,0,3,1,0,229,182,53791,41404,289,173,57148,40102
403,37,0,0,2,1,2,1,122,107,53791,41404,151,168,57149,40103
404,37,2,1,0,3,1,0,214,183,53793,41405,277,15,57152,40103
405,37,1,1,2,1,2,1,120,70,53794,41406,163,182,57153,40104
406,37,1,1,2,1,2,1,97,61,53795,41407,130,164,57154,40105
407,38,1,0,0,3,1,0,263,227,53796,41407,333,58,57157,40105
408,38,2,1,0,3,1,0,274,223,53798,41408,332,126,57160,40105
409,38,0,0,2,1,2,1,272,192,53798,41408,309,128,57161,40106
410,38,2,1,0,3,1,0,134,133,53800,41409,167,133,57164,40106
411,38,0,3,1,0,0,3,20,25,53800,41412,23,189,57164,40109
412,38,2,0,0,3,1,0,282,188,53802,41412,324,190,57167,40109
413,38,5,3,0,3,1,0,255,209,53807,41415,280,188,57170,40109
414,38,2,3,1,0,0,3,22,23,53809,41418,26,88,57170,40112
415,38,1,1,2,1,2,1,240,218,53810,41419,259,95,57171,40113
416,38,1,0,0,3,1,0,273,199,53811,41419,310,173,57174,40113
417,38,3,0,0,3,1,0,241,189,53814,41419,268,79,57177,40113
418,39,0,1,1,0,0,3,46,53,53814,41420,70,167,57177,40116
419,39,4,2,0,3,1,0,233,201,53818,41422,282,173,57180,40116
420,39,0,1,1,0,0,3,246,134,53818,41423,340,25,57180,40119
421,39,3,0,0,3,1,0,217,183,53821,41423,280,126,57183,40119
422,39,1,0,0,3,1,0,230,182,53822,41423,292,168,57186,40119
423,39,1,0,0,3,1,0,121,70,53823,41423,166,168,57189,40119
424,39,0,0,2,1,2,1,97,61,53823,41423,131,205,57190,40120
425,39,3,2,0,3,1,0,276,201,53826,41425,313,15,57193,40120
426,39,4,3,0,3,1,0,259,213,53830,41428,289,119,57196,40120
427,39,1,0,0,3,1,0,200,161,53831,41428,239,182,57199,40120
428,39,0,1,1,0,0,3,122,108,53831,41429,151,185,57199,40123
429,40,1,0,0,3,1,0,283,188,53832,41429,327,58,57202,40123
430,40,3,1,0,3,1,0,244,190,53835,41430,271,189,57205,40123
431,40,0,0,2,1,2,1,22,23,53835,41430,27,174,57206,40124
432,40,0,2,1,0,0,3,272,194,53835,41432,309,91,57206,40127
433,40,2,0,0,3,1,0,265,227,53837,41432,336,163,57209,40127
434,40,0,0,2,1,2,1,255,209,53837,41432,281,191,57210,40128
435,40,3,3,2,1,2,1,137,136,53840,41435,168,189,57211,40129
436,40,2,1,0,3,1,0,182,129,53842,41436,240,79,57214,40129
437,40,1,1,2,1,2,1,275,224,53843,41437,333,96,57215,40130
438,40,0,0,2,1,2,1,20,25,53843,41437,24,129,57216,40131
439,40,1,0,0,3,1,0,241,218,53844,41437,262,133,57219,40131
440,41,0,1,1,0,0,3,46,54,53844,41438,70,176,57219,40134
441,41,2,3,1,0,0,3,261,216,53846,41441,289,208,57219,40137
442,41,0,1,1,0,0,3,246,135,53846,41442,340,122,57219,40140
443,41,0,0,2,1,2,1,276,201,53846,41442,314,169,57220,40141
444,41,1,2,1,0,0,3,123,110,53847,41444,151,170,57220,40144
445,41,0,1,1,0,0,3,97,62,53847,41445,131,28,57220,40147
446,41,0,0,2,1,2,1,200,161,53847,41445,240,127,57221,40148
447,41,0,0,2,1,2,1,217,183,53847,41445,281,183,57222,40149
448,41,1,1,2,1,2,1,231,183,53848,41446,293,186,57223,40150
449,41,4,3,0,3,1,0,125,73,53852,41449,169,15,57226,40150
450,41,0,0,2,1,2,1,233,201,53852,41449,283,169,57227,40151
451,42,1,0,0,3,1,0,23,23,53853,41449,30,58,57230,40151
452,42,0,0,2,1,2,1,20,25,53853,41449,25,134,57231,40152
453,42,1,0,0,3,1,0,266,227,53854,41449,339,79,57234,40152
454,42,3,0,0,3,1,0,258,209,53857,41449,284,91,57237,40152
455,42,2,1,0,3,1,0,277,225,53859,41450,336,191,57240,40152
456,42,1,0,0,3,1,0,273,194,53860,41450,312,96,57243,40152
457,42,2,0,0,3,1,0,243,218,53862,41450,265,174,57246,40152
458,42,3,0,0,3,1,0,247,190,53865,41450,274,189,57249,40152
459,42,1,1,2,1,2,1,138,137,53866,41451,169,130,57250,40153
460,42,1,1,2,1,2,1,284,189,53867,41452,328,164,57251,40154
461,42,1,0,0,3,1,0,183,129,53868,41452,243,189,57254,40154
0,1,0,1,1,0,0,3,79,92,53868,41453,98,173,57254,40157
1,1,0,0,2,1,2,1,200,161,53868,41453,241,29,57255,40158
2,1,3,0,0,3,1,0,261,209,53871,41453,287,91,57258,40158
3,1,0,2,1,0,0,3,217,185,53871,41455,281,3,57258,40161
4,1,2,2,2,1,2,1,279,240,53873,41457,279,100,57259,40162
5,1,2,0,0,3,1,0,235,201,53875,41457,286,127,57262,40162
6,1,3,2,0,3,1,0,246,220,53878,41459,268,79,57265,40162
7,1,0,1,1,0,0,3,284,190,53878,41460,328,194,57265,40165
8,1,1,1,2,1,2,1,294,185,53879,41461,313,177,57266,40166
9,1,3,1,0,3,1,0,100,63,53882,41462,134,87,57269,40166
10,1,0,1,1,0,0,3,276,202,53882,41463,314,171,57269,40169
11,2,1,0,0,3,1,0,124,110,53883,41463,154,222,57272,40169
12,2,1,1,2,1,2,1,126,74,53884,41464,170,131,57273,40170
13,2,1,1,2,1,2,1,80,93,53885,41465,99,170,57274,40171
14,2,1,2,1,0,0,3,120,112,53886,41467,155,99,57274,40174
15,2,1,2,1,0,0,3,247,137,53887,41469,340,192,57274,40177
16,2,1,1,2,1,2,1,248,191,53888,41470,275,165,57275,40178
17,2,1,1,2,1,2,1,149,114,53889,41471,172,190,57276,40179
18,2,1,1,2,1,2,1,274,195,53890,41472,313,192,57277,40180
19,2,3,1,0,3,1,0,205,171,53893,41473,239,183,57280,40180
20,2,3,2,0,3,1,0,186,131,53896,41475,246,169,57283,40180
21,2,1,2,1,0,0,3,21,27,53897,41477,25,6,57283,40183
22,3,1,0,0,3,1,0,236,201,53898,41477,289,192,57286,40183
23,3,2,0,0,3,1,0,286,190,53900,41477,331,100,57289,40183
24,3,2,1,0,3,1,0,2,1,53902,41478,3,79,57292,40183
25,3,1,0,0,3,1,0,262,209,53903,41478,290,171,57295,40183
26,3,2,2,2,1,2,1,278,204,53905,41480,315,66,57296,40184
27,3,2,4,1,0,0,3,202,165,53907,41484,241,197,57296,40187
28,3,3,1,0,3,1,0,282,241,53910,41485,282,183,57299,40187
29,3,2,0,0,3,1,0,276,195,53912,41485,316,91,57302,40187
30,3,1,0,0,3,1,0,295,185,53913,41485,316,173,57305,40187
31,3,4,0,0,3,1,0,153,114,53917,41485,175,127,57308,40187
32,3,2,1,0,3,1,0,102,64,53919,41486,137,29,57311,40187
33,4,1,2,1,0,0,3,81,95,53920,41488,99,102,57311,40190
34,4,0,1,1,0,0,3,246,221,53920,41489,268,94,57311,40193
35,4,0,1,1,0,0,3,248,192,53920,41490,275,173,57311,40196
36,4,0,0,2,1,2,1,21,27,53920,41490,26,170,57312,40197
37,4,1,1,2,1,2,1,3,2,53921,41491,4,88,57313,40198
38,4,0,0,2,1,2,1,186,131,53921,41491,247,166,57314,40199
39,4,1,0,0,3,1,0,206,171,53922,41491,242,177,57317,40199
40,4,3,1,0,3,1,0,298,186,53925,41492,319,192,57320,40199
41,4,1,1,2,1,2,1,218,186,53926,41493,282,132,57321,40200
42,4,2,1,0,3,1,0,122,113,53928,41494,158,79,57324,40200
43,4,0,3,1,0,0,3,247,140,53928,41497,340,193,57324,40203
44,5,2,0,0,3,1,0,284,241,53930,41497,285,66,57327,40203
45,5,1,1,2,1,2,1,123,114,53931,41498,159,174,57328,40204
46,5,1,0,0,3,1,0,287,190,53932,41498,334,171,57331,40204
47,5,0,3,1,0,0,3,278,207,53932,41501,315,176,57331,40207
48,5,2,0,0,3,1,0,104,64,53934,41501,140,222,57334,40207
49,5,1,1,2,1,2,1,154,115,53935,41502,176,198,57335,40208
50,5,0,4,1,0,0,3,124,114,53935,41506,154,130,57335,40211
51,5,0,2,1,0,0,3,126,76,53935,41508,170,195,57335,40214
52,5,3,1,0,3,1,0,239,202,53938,41509,292,29,57338,40214
53,5,2,0,0,3,1,0,204,165,53940,41509,244,6,57341,40214
54,5,1,1,2,1,2,1,277,196,53941,41510,317,184,57342,40215
55,6,1,1,2,1,2,1,249,193,53942,41511,276,193,57343,40216
56,6,3,1,0,3,1,0,265,210,53945,41512,293,222,57346,40216
57,6,4,0,0,3,1,0,85,95,53949,41512,102,100,57349,40216
58,6,3,0,0,3,1,0,250,140,53952,41512,343,102,57352,40216
59,6,0,1,1,0,0,3,206,172,53952,41513,242,97,57352,40219
60,6,2,2,2,1,2,1,206,167,53954,41515,245,89,57353,40220
61,6,3,3,2,1,2,1,249,224,53957,41518,269,171,57354,40221
62,6,1,1,2,1,2,1,219,187,53958,41519,283,131,57355,40222
63,6,1,1,2,1,2,1,127,77,53959,41520,171,30,57356,40223
64,6,1,0,0,3,1,0,279,207,53960,41520,318,177,57359,40223
65,6,2,1,0,3,1,0,5,3,53962,41521,7,193,57362,40223
66,7,2,2,2,1,2,1,125,116,53964,41523,160,199,57363,40224
67,7,0,0,2,1,2,1,104,64,53964,41523,141,185,57364,40225
68,7,0,0,2,1,2,1,239,202,53964,41523,293,133,57365,40226
69,7,1,1,2,1,2,1,285,242,53965,41524,286,177,57366,40227
70,7,1,0,0,3,1,0,125,114,53966,41524,157,174,57369,40227
71,7,2,1,0,3,1,0,156,116,53968,41525,179,79,57372,40227
72,7,1,0,0,3,1,0,299,186,53969,41525,322,166,57375,40227
73,7,1,1,2,1,2,1,288,191,53970,41526,335,196,57376,40228
74,7,1,1,2,1,2,1,278,197,53971,41527,318,67,57377,40229
75,7,0,1,1,0,0,3,21,28,53971,41528,26,174,57377,40232
76,7,0,1,1,0,0,3,186,132,53971,41529,247,9,57377,40235
77,8,3,2,0,3,1,0,282,209,53974,41531,321,97,57380,40235
78,8,2,2,2,1,2,1,7,5,53976,41533,8,194,57381,40236
79,8,0,2,1,0,0,3,250,142,53976,41535,343,33,57381,40239
80,8,1,0,0,3,1,0,207,172,53977,41535,245,222,57384,40239
81,8,1,0,0,3,1,0,220,187,53978,41535,286,89,57387,40239
82,8,0,0,2,1,2,1,85,95,53978,41535,103,172,57388,40240
83,8,0,0,2,1,2,1,249,193,53978,41535,277,178,57389,40241
84,8,1,2,1,0,0,3,266,212,53979,41537,293,105,57389,40244
85,8,2,2,2,1,2,1,129,79,53981,41539,172,194,57390,40245
86,8,1,1,2,1,2,1,250,225,53982,41540,270,101,57391,40246
87,8,1,4,1,0,0,3,207,171,53983,41544,245,134,57391,40249
88,9,0,0,2,1,2,1,125,114,53983,41544,158,68,57392,40250
89,9,2,0,0,3,1,0,23,28,53985,41544,29,196,57395,40250
90,9,1,0,0,3,1,0,289,191,53986,41544,338,9,57398,40250
91,9,1,1,2,1,2,1,286,243,53987,41545,287,200,57399,40251
92,9,1,0,0,3,1,0,105,64,53988,41545,144,174,57402,40251
93,9,1,1,2,1,2,1,126,117,53989,41546,161,134,57403,40252
94,9,0,2,1,0,0,3,156,118,53989,41548,179,169,57403,40255
95,9,0,1,1,0,0,3,186,133,53989,41549,247,82,57403,40258
96,9,4,2,0,3,1,0,282,199,53993,41551,321,177,57406,40258
97,9,2,2,2,1,2,1,241,204,53995,41553,294,175,57407,40259
98,9,3,1,0,3,1,0,302,187,53998,41554,325,185,57410,40259
99,10,0,1,1,0,0,3,250,143,53998,41555,343,100,57410,40262
100,10,0,2,1,0,0,3,207,173,53998,41557,245,172,57410,40265
101,10,1,1,2,1,2,1,221,188,53999,41558,287,195,57411,40266
102,10,2,0,0,3,1,0,158,118,54001,41558,182,101,57414,40266
103,10,1,2,1,0,0,3,187,135,54002,41560,247,36,57414,40269
104,10,2,0,0,3,1,0,9,5,54004,41560,11,178,57417,40269
105,10,1,1,2,1,2,1,130,80,54005,41561,173,173,57418,40270
106,10,0,2,1,0,0,3,241,206,54005,41563,294,108,57418,40273
107,10,0,0,2,1,2,1,250,225,54005,41563,271,178,57419,40274
108,10,2,0,0,3,1,0,209,172,54007,41563,248,175,57422,40274
109,10,0,3,1,0,0,3,85,98,54007,41566,103,225,57422,40277
110,11,2,1,0,3,1,0,288,244,54009,41567,290,134,57425,40277
111,11,0,2,1,0,0,3,302,189,54009,41569,325,199,57425,40280
112,11,0,0,2,1,2,1,266,212,54009,41569,294,135,57426,40281
113,11,1,3,1,0,0,3,283,202,54010,41572,321,203,57426,40284
114,11,1,1,2,1,2,1,24,29,54011,41573,30,90,57427,40285
115,11,1,2,1,0,0,3,250,195,54012,41575,277,111,57427,40288
116,11,2,1,0,3,1,0,128,118,54014,41576,164,9,57430,40288
117,11,0,1,1,0,0,3,289,192,54014,41577,338,197,57430,40291
118,11,1,2,1,0,0,3,126,116,54015,41579,158,85,57430,40294
119,11,1,1,2,1,2,1,210,173,54016,41580,249,69,57431,40295
120,11,3,0,0,3,1,0,285,209,54019,41580,324,185,57434,40295
121,12,2,0,0,3,1,0,107,64,54021,41580,147,172,57437,40295
122,12,2,2,2,1,2,1,252,145,54023,41582,344,179,57438,40296
123,12,1,1,2,1,2,1,159,119,54024,41583,183,174,57439,40297
124,12,0,1,1,0,0,3,221,189,54024,41584,287,181,57439,40300
125,12,3,2,0,3,1,0,210,175,54027,41586,248,174,57442,40300
126,12,0,3,1,0,0,3,24,32,54027,41589,30,198,57442,40303
127,12,0,1,1,0,0,3,9,6,54027,41590,11,103,57442,40306
128,12,0,2,1,0,0,3,250,227,54027,41592,271,178,57442,40309
129,12,4,2,0,3,1,0,134,82,54031,41594,176,225,57445,40309
130,12,3,3,2,1,2,1,190,138,54034,41597,248,70,57446,40310
131,12,1,2,1,0,0,3,242,208,54035,41599,294,104,57446,40313
132,13,1,0,0,3,1,0,127,116,54036,41599,161,111,57449,40313
133,13,1,3,1,0,0,3,289,247,54037,41602,290,93,57449,40316
134,13,0,0,2,1,2,1,128,118,54037,41602,165,135,57450,40317
135,13,1,1,2,1,2,1,86,99,54038,41603,104,186,57451,40318
136,13,2,1,0,3,1,0,252,196,54040,41604,280,85,57454,40318
137,13,3,1,0,3,1,0,292,193,54043,41605,341,135,57457,40318
138,13,0,0,2,1,2,1,302,189,54043,41605,326,204,57458,40319
139,13,4,0,0,3,1,0,287,202,54047,41605,324,197,57461,40319
140,13,2,0,0,3,1,0,212,173,54049,41605,252,199,57464,40319
141,13,1,3,1,0,0,3,286,212,54050,41608,324,12,57464,40322
142,13,3,2,0,3,1,0,269,214,54053,41610,297,36,57467,40322
143,14,1,0,0,3,1,0,293,193,54054,41610,344,103,57470,40322
144,14,3,1,0,3,1,0,110,65,54057,41611,150,181,57473,40322
145,14,1,0,0,3,1,0,160,119,54058,41611,186,178,57476,40322
146,14,0,0,2,1,2,1,134,82,54058,41611,177,180,57477,40323
147,14,1,1,2,1,2,1,10,7,54059,41612,12,187,57478,40324
148,14,1,0,0,3,1,0,253,145,54060,41612,347,70,57481,40324
149,14,0,0,2,1,2,1,190,138,54060,41612,249,175,57482,40325
150,14,1,3,1,0,0,3,25,35,54061,41615,30,228,57482,40328
151,14,1,0,0,3,1,0,211,175,54062,41615,251,198,57485,40328
152,14,3,0,0,3,1,0,245,208,54065,41615,297,172,57488,40328
153,14,4,2,0,3,1,0,225,191,54069,41617,290,104,57491,40328
154,15,1,0,0,3,1,0,303,189,54070,41617,329,135,57494,40328
155,15,3,1,0,3,1,0,215,174,54073,41618,255,85,57497,40328
156,15,2,0,0,3,1,0,130,118,54075,41618,168,36,57500,40328
157,15,0,1,1,0,0,3,127,117,54075,41619,161,138,57500,40331
158,15,0,1,1,0,0,3,287,203,54075,41620,324,177,57500,40334
159,15,1,1,2,1,2,1,287,213,54076,41621,325,205,57501,40335
160,15,1,3,1,0,0,3,251,230,54077,41624,271,202,57501,40338
161,15,1,1,2,1,2,1,270,215,54078,41625,298,198,57502,40339
162,15,0,0,2,1,2,1,252,196,54078,41625,281,13,57503,40340
163,15,2,2,2,1,2,1,88,101,54080,41627,105,94,57504,40341
164,15,1,1,2,1,2,1,290,248,54081,41628,291,112,57505,40342
165,16,3,2,0,3,1,0,13,9,54084,41630,15,175,57508,40342
166,16,2,0,0,3,1,0,27,35,54086,41630,33,187,57511,40342
167,16,1,1,2,1,2,1,226,192,54087,41631,291,181,57512,40343
168,16,2,2,2,1,2,1,295,195,54089,41633,345,199,57513,40344
169,16,0,1,1,0,0,3,245,209,54089,41634,297,106,57513,40347
170,16,1,1,2,1,2,1,161,120,54090,41635,187,229,57514,40348
171,16,1,0,0,3,1,0,254,145,54091,41635,350,178,57517,40348
172,16,0,0,2,1,2,1,134,82,54091,41635,178,182,57518,40349
173,16,1,1,2,1,2,1,212,176,54092,41636,252,71,57519,40350
174,16,2,1,0,3,1,0,132,119,54094,41637,171,172,57522,40350
175,16,1,1,2,1,2,1,191,139,54095,41638,250,113,57523,40351
176,17,0,2,1,0,0,3,287,205,54095,41640,324,138,57523,40354
177,17,0,1,1,0,0,3,290,249,54095,41641,291,201,57523,40357
178,17,3,0,0,3,1,0,91,101,54098,41641,108,36,57526,40357
179,17,0,0,2,1,2,1,251,230,54098,41641,272,206,57527,40358
180,17,2,0,0,3,1,0,217,174,54100,41641,258,94,57530,40358
181,17,2,0,0,3,1,0,272,215,54102,41641,301,177,57533,40358
182,17,1,2,1,0,0,3,128,119,54103,41643,161,107,57533,40361
183,17,3,3,2,1,2,1,255,199,54106,41646,282,203,57534,40362
184,17,2,0,0,3,1,0,305,189,54108,41646,332,13,57537,40362
185,17,3,1,0,3,1,0,290,214,54111,41647,328,85,57540,40362
186,17,2,1,0,3,1,0,112,66,54113,41648,153,138,57543,40362
187,18,0,0,2,1,2,1,295,195,54113,41648,346,179,57544,40363
188,18,0,2,1,0,0,3,254,147,54113,41650,350,178,57544,40366
189,18,0,0,2,1,2,1,132,119,54113,41650,172,183,57545,40367
190,18,1,1,2,1,2,1,162,121,54114,41651,188,107,57546,40368
191,18,1,3,1,0,0,3,192,142,54115,41654,250,184,57546,40371
192,18,3,3,2,1,2,1,248,212,54118,41657,298,230,57547,40372
193,18,1,0,0,3,1,0,14,9,54119,41657,18,113,57550,40372
194,18,2,1,0,3,1,0,136,83,54121,41658,181,199,57553,40372
195,18,2,0,0,3,1,0,228,192,54123,41658,294,71,57556,40372
196,18,0,0,2,1,2,1,212,176,54123,41658,253,188,57557,40373
197,18,0,1,1,0,0,3,27,36,54123,41659,33,175,57557,40376
198,19,1,1,2,1,2,1,129,120,54124,41660,162,37,57558,40377
199,19,2,2,2,1,2,1,93,103,54126,41662,109,14,57559,40378
200,19,1,3,1,0,0,3,255,150,54127,41665,350,88,57559,40381
201,19,2,0,0,3,1,0,257,199,54129,41665,285,138,57562,40381
202,19,0,2,1,0,0,3,217,176,54129,41667,258,202,57562,40384
203,19,1,0,0,3,1,0,288,205,54130,41667,327,94,57565,40384
204,19,3,1,0,3,1,0,275,216,54133,41668,304,107,57568,40384
205,19,3,1,0,3,1,0,308,190,54136,41669,335,138,57571,40384
206,19,1,3,1,0,0,3,252,233,54137,41672,272,204,57571,40387
207,19,3,1,0,3,1,0,293,215,54140,41673,331,177,57574,40387
208,19,0,0,2,1,2,1,112,66,54140,41673,154,204,57575,40388
209,20,2,0,0,3,1,0,297,195,54142,41673,349,230,57578,40388
210,20,2,0,0,3,1,0,134,119,54144,41673,175,178,57581,40388
211,20,2,0,0,3,1,0,164,121,54146,41673,191,188,57584,40388
212,20,0,0,2,1,2,1,192,142,54146,41673,251,207,57585,40389
213,20,2,0,0,3,1,0,250,212,54148,41673,301,71,57588,40389
214,20,0,0,2,1,2,1,27,36,54148,41673,34,180,57589,40390
215,20,0,2,1,0,0,3,136,85,54148,41675,181,116,57589,40393
216,20,2,3,1,0,0,3,230,195,54150,41678,294,178,57589,40396
217,20,1,2,1,0,0,3,213,178,54151,41680,253,186,57589,40399
218,20,2,2,2,1,2,1,16,11,54153,41682,19,185,57590,40400
219,20,1,0,0,3,1,0,291,249,54154,41682,294,107,57593,40400
220,21,2,1,0,3,1,0,254,234,54156,41683,275,138,57596,40400
221,21,0,1,1,0,0,3,129,121,54156,41684,162,207,57596,40403
222,21,1,1,2,1,2,1,258,200,54157,41685,286,139,57597,40404
223,21,1,1,2,1,2,1,294,216,54158,41686,332,203,57598,40405
224,21,0,1,1,0,0,3,288,206,54158,41687,327,40,57598,40408
225,21,1,1,2,1,2,1,94,104,54159,41688,110,89,57599,40409
226,21,2,4,1,0,0,3,114,70,54161,41692,154,180,57599,40412
227,21,2,3,1,0,0,3,277,219,54163,41695,304,97,57599,40415
228,21,2,1,0,3,1,0,219,177,54165,41696,261,204,57602,40415
229,21,1,1,2,1,2,1,256,151,54166,41697,351,15,57603,40416
230,21,0,3,1,0,0,3,308,193,54166,41700,335,110,57603,40419
231,22,0,0,2,1,2,1,27,36,54166,41700,35,208,57604,40420
232,22,0,0,2,1,2,1,16,11,54166,41700,20,179,57605,40421
233,22,0,0,2,1,2,1,164,121,54166,41700,192,117,57606,40422
234,22,0,4,1,0,0,3,213,182,54166,41704,253,188,57606,40425
235,22,4,2,0,3,1,0,196,144,54170,41706,254,107,57609,40425
236,22,1,1,2,1,2,1,231,196,54171,41707,295,179,57610,40426
237,22,0,0,2,1,2,1,134,119,54171,41707,176,72,57611,40427
238,22,0,1,1,0,0,3,297,196,54171,41708,349,191,57611,40430
239,22,1,0,0,3,1,0,292,249,54172,41708,297,230,57614,40430
240,22,1,1,2,1,2,1,137,86,54173,41709,182,181,57615,40431
241,22,2,0,0,3,1,0,252,212,54175,41709,304,186,57618,40431
242,23,1,0,0,3,1,0,289,206,54176,41709,330,207,57621,40431
243,23,1,1,2,1,2,1,130,122,54177,41710,163,16,57622,40432
244,23,1,0,0,3,1,0,259,200,54178,41710,289,97,57625,40432
245,23,0,1,1,0,0,3,294,217,54178,41711,332,207,57625,40435
246,23,2,2,2,1,2,1,258,153,54180,41713,352,181,57626,40436
247,23,2,1,0,3,1,0,221,178,54182,41714,264,138,57629,40436
248,23,1,0,0,3,1,0,293,249,54183,41714,300,139,57632,40436
249,23,3,3,2,1,2,1,117,73,54186,41717,155,111,57633,40437
250,23,2,1,0,3,1,0,256,235,54188,41718,278,72,57636,40437
251,23,3,1,0,3,1,0,311,194,54191,41719,338,40,57639,40437
252,23,2,0,0,3,1,0,279,219,54193,41719,307,89,57642,40437
253,24,0,0,2,1,2,1,16,11,54193,41719,21,182,57643,40438
254,24,2,0,0,3,1,0,299,196,54195,41719,352,186,57646,40438
255,24,1,0,0,3,1,0,214,182,54196,41719,256,107,57649,40438
256,24,1,1,2,1,2,1,165,122,54197,41720,193,204,57650,40439
257,24,1,1,2,1,2,1,232,197,54198,41721,296,209,57651,40440
258,24,1,0,0,3,1,0,257,235,54199,41721,281,117,57654,40440
259,24,1,1,2,1,2,1,138,87,54200,41722,183,180,57655,40441
260,24,1,1,2,1,2,1,95,105,54201,41723,111,180,57656,40442
261,24,1,2,1,0,0,3,28,38,54202,41725,35,191,57656,40445
262,24,1,0,0,3,1,0,197,144,54203,41725,257,230,57659,40445
263,24,1,1,2,1,2,1,135,120,54204,41726,177,208,57660,40446
264,25,1,0,0,3,1,0,118,73,54205,41726,158,72,57663,40446
265,25,2,1,0,3,1,0,223,179,54207,41727,267,139,57666,40446
266,25,1,0,0,3,1,0,290,206,54208,41727,333,16,57669,40446
267,25,0,0,2,1,2,1,294,217,54208,41727,333,139,57670,40447
268,25,1,0,0,3,1,0,253,212,54209,41727,307,181,57673,40447
269,25,2,2,2,1,2,1,261,202,54211,41729,290,112,57674,40448
270,25,0,1,1,0,0,3,130,123,54211,41730,163,194,57674,40451
271,25,0,2,1,0,0,3,279,221,54211,41732,307,210,57674,40454
272,25,3,1,0,3,1,0,261,154,54214,41733,355,97,57677,40454
273,25,1,1,2,1,2,1,294,250,54215,41734,301,41,57678,40455
274,25,1,1,2,1,2,1,312,195,54216,41735,339,90,57679,40456
275,26,2,1,0,3,1,0,199,145,54218,41736,260,186,57682,40456
276,26,1,0,0,3,1,0,29,38,54219,41736,38,139,57685,40456
277,26,2,1,0,3,1,0,259,236,54221,41737,284,180,57688,40456
278,26,3,1,0,3,1,0,168,123,54224,41738,196,180,57691,40456
279,26,2,0,0,3,1,0,234,197,54226,41738,299,182,57694,40456
280,26,0,1,1,0,0,3,16,12,54226,41739,21,233,57694,40459
281,26,1,1,2,1,2,1,119,74,54227,41740,159,209,57695,40460
282,26,0,0,2,1,2,1,135,120,54227,41740,178,205,57696,40461
283,26,1,1,2,1,2,1,300,197,54228,41741,353,192,57697,40462
284,26,3,1,0,3,1,0,141,88,54231,41742,186,107,57700,40462
285,26,1,1,2,1,2,1,96,106,54232,41743,112,210,57701,40463
286,27,0,1,1,0,0,3,279,222,54232,41744,307,75,57701,40466
287,27,2,4,1,0,0,3,31,42,54234,41748,38,142,57701,40469
288,27,1,0,0,3,1,0,313,195,54235,41748,342,180,57704,40469
289,27,1,2,1,0,0,3,295,219,54236,41750,333,120,57704,40472
290,27,0,0,2,1,2,1,253,212,54236,41750,308,17,57705,40473
291,27,1,1,2,1,2,1,131,124,54237,41751,164,98,57706,40474
292,27,0,1,1,0,0,3,261,155,54237,41752,355,197,57706,40477
293,27,2,2,2,1,2,1,292,208,54239,41754,334,113,57707,40478
294,27,2,2,2,1,2,1,216,184,54241,41756,257,211,57708,40479
295,27,1,1,2,1,2,1,295,251,54242,41757,302,91,57709,40480
296,27,2,1,0,3,1,0,263,203,54244,41758,293,181,57712,40480
297,28,2,2,2,1,2,1,261,238,54246,41760,285,234,57713,40481
298,28,3,2,0,3,1,0,226,181,54249,41762,270,192,57716,40481
299,28,1,1,2,1,2,1,301,198,54250,41763,354,181,57717,40482
300,28,1,2,1,0,0,3,142,90,54251,41765,186,213,57717,40485
301,28,1,2,1,0,0,3,235,199,54252,41767,299,212,57717,40488
302,28,0,1,1,0,0,3,16,13,54252,41768,21,142,57717,40491
303,28,1,1,2,1,2,1,136,121,54253,41769,179,108,57718,40492
304,28,0,1,1,0,0,3,119,75,54253,41770,159,185,57718,40495
305,28,0,0,2,1,2,1,168,123,54253,41770,197,42,57719,40496
306,28,0,2,1,0,0,3,96,108,54253,41772,112,189,57719,40499
307,28,0,0,2,1,2,1,199,145,54253,41772,261,206,57720,40500
308,29,1,0,0,3,1,0,293,208,54254,41772,337,120,57723,40500
309,29,1,1,2,1,2,1,262,156,54255,41773,356,182,57724,40501
310,29,0,0,2,1,2,1,279,222,54255,41773,308,18,57725,40502
311,29,2,0,0,3,1,0,315,195,54257,41773,345,98,57728,40502
312,29,1,0,0,3,1,0,200,145,54258,41773,264,211,57731,40502
313,29,2,1,0,3,1,0,133,125,54260,41774,167,181,57734,40502
314,29,1,0,0,3,1,0,217,184,54261,41774,260,91,57737,40502
315,29,3,1,0,3,1,0,256,213,54264,41775,311,197,57740,40502
316,29,3,2,0,3,1,0,34,44,54267,41777,41,113,57743,40502
317,29,2,0,0,3,1,0,265,203,54269,41777,296,75,57746,40502
318,29,2,0,0,3,1,0,297,251,54271,41777,305,180,57749,40502
319,30,1,1,2,1,2,1,296,220,54272,41778,334,186,57750,40503
320,30,2,2,2,1,2,1,228,183,54274,41780,271,43,57751,40504
321,30,1,0,0,3,1,0,169,123,54275,41780,200,189,57754,40504
322,30,2,1,0,3,1,0,121,76,54277,41781,162,192,57757,40504
323,30,1,1,2,1,2,1,134,126,54278,41782,168,207,57758,40505
324,30,2,2,2,1,2,1,98,110,54280,41784,113,213,57759,40506
325,30,1,1,2,1,2,1,137,122,54281,41785,180,235,57760,40507
326,30,0,0,2,1,2,1,261,238,54281,41785,286,143,57761,40508
327,30,2,0,0,3,1,0,237,199,54283,41785,302,181,57764,40508
328,30,1,0,0,3,1,0,143,90,54284,41785,189,142,57767,40508
329,30,3,4,1,0,0,3,19,17,54287,41789,21,216,57767,40511
330,31,1,1,2,1,2,1,218,185,54288,41790,261,121,57768,40512
331,31,1,2,1,0,0,3,35,46,54289,41792,41,94,57768,40515
332,31,1,1,2,1,2,1,316,196,54290,41793,346,109,57769,40516
333,31,2,0,0,3,1,0,230,183,54292,41793,274,18,57772,40516
334,31,1,2,1,0,0,3,302,200,54293,41795,354,78,57772,40519
335,31,4,0,0,3,1,0,283,222,54297,41795,311,197,57775,40519
336,31,2,3,1,0,0,3,299,254,54299,41798,305,214,57775,40522
337,31,0,1,1,0,0,3,265,204,54299,41799,296,216,57775,40525
338,31,1,2,1,0,0,3,263,158,54300,41801,356,116,57775,40528
339,31,4,0,0,3,1,0,297,208,54304,41801,340,182,57778,40528
340,31,1,0,0,3,1,0,201,145,54305,41801,267,98,57781,40528
341,32,1,1,2,1,2,1,238,200,54306,41802,303,44,57782,40529
342,32,1,0,0,3,1,0,20,17,54307,41802,24,142,57785,40529
343,32,1,3,1,0,0,3,266,207,54308,41805,296,183,57785,40532
344,32,0,0,2,1,2,1,143,90,54308,41805,190,99,57786,40533
345,32,1,2,1,0,0,3,99,112,54309,41807,113,146,57786,40536
346,32,0,0,2,1,2,1,296,220,54309,41807,335,236,57787,40537
347,32,1,3,1,0,0,3,257,216,54310,41810,311,219,57787,40540
348,32,0,0,2,1,2,1,261,238,54310,41810,287,190,57788,40541
349,32,2,1,0,3,1,0,139,123,54312,41811,183,181,57791,40541
350,32,0,1,1,0,0,3,134,127,54312,41812,168,195,57791,40544
351,32,1,1,2,1,2,1,122,77,54313,41813,163,208,57792,40545
352,33,2,1,0,3,1,0,171,124,54315,41814,203,214,57795,40545
353,33,0,0,2,1,2,1,201,145,54315,41814,268,187,57796,40546
354,33,1,3,1,0,0,3,219,188,54316,41817,261,219,57796,40549
355,33,0,0,2,1,2,1,316,196,54316,41817,347,79,57797,40550
356,33,0,1,1,0,0,3,283,223,54316,41818,311,185,57797,40553
357,33,0,1,1,0,0,3,35,47,54316,41819,41,112,57797,40556
358,33,2,2,2,1,2,1,145,92,54318,41821,191,198,57798,40557
359,33,1,0,0,3,1,0,300,254,54319,41821,308,18,57801,40557
360,33,1,2,1,0,0,3,231,185,54320,41823,274,119,57801,40560
361,33,1,2,1,0,0,3,303,202,54321,41825,354,124,57801,40563
362,33,0,2,1,0,0,3,263,160,54321,41827,356,193,57801,40566
363,34,1,0,0,3,1,0,239,200,54322,41827,306,236,57804,40566
364,34,3,3,2,1,2,1,264,241,54325,41830,288,209,57805,40567
365,34,1,0,0,3,1,0,297,220,54326,41830,338,146,57808,40567
366,34,0,2,1,0,0,3,257,218,54326,41832,311,198,57808,40570
367,34,1,1,2,1,2,1,267,208,54327,41833,297,45,57809,40571
368,34,1,2,1,0,0,3,140,125,54328,41835,183,102,57809,40574
369,34,1,2,1,0,0,3,100,114,54329,41837,113,145,57809,40577
370,34,2,2,2,1,2,1,136,129,54331,41839,169,184,57810,40578
371,34,1,1,2,1,2,1,123,78,54332,41840,164,220,57811,40579
372,34,2,0,0,3,1,0,22,17,54334,41840,27,181,57814,40579
373,34,0,1,1,0,0,3,297,209,54334,41841,340,97,57814,40582
374,35,0,0,2,1,2,1,219,188,54334,41841,262,188,57815,40583
375,35,0,1,1,0,0,3,239,201,54334,41842,306,201,57815,40586
376,35,1,2,1,0,0,3,36,49,54335,41844,41,222,57815,40589
377,35,2,0,0,3,1,0,318,196,54337,41844,350,181,57818,40589
378,35,1,1,2,1,2,1,232,186,54338,41845,275,125,57819,40590
379,35,4,1,0,3,1,0,205,146,54342,41846,271,119,57822,40590
380,35,0,0,2,1,2,1,136,129,54342,41846,170,186,57823,40591
381,35,1,1,2,1,2,1,172,125,54343,41847,204,80,57824,40592
382,35,0,1,1,0,0,3,283,224,54343,41848,311,223,57824,40595
383,35,1,1,2,1,2,1,301,255,54344,41849,309,194,57825,40596
384,35,0,0,2,1,2,1,145,92,54344,41849,192,19,57826,40597
385,36,2,1,0,3,1,0,266,242,54346,41850,291,102,57829,40597
386,36,0,2,1,0,0,3,123,80,54346,41852,164,148,57829,40600
387,36,1,1,2,1,2,1,298,221,54347,41853,339,215,57830,40601
388,36,1,2,1,0,0,3,101,116,54348,41855,113,115,57830,40604
389,36,2,2,2,1,2,1,142,127,54350,41857,184,199,57831,40605
390,36,2,0,0,3,1,0,299,209,54352,41857,343,146,57834,40605
391,36,2,0,0,3,1,0,269,208,54354,41857,300,236,57837,40605
392,36,1,0,0,3,1,0,304,202,54355,41857,357,97,57840,40605
393,36,1,1,2,1,2,1,23,18,54356,41858,28,46,57841,40606
394,36,3,2,0,3,1,0,266,162,54359,41860,359,209,57844,40606
395,36,0,1,1,0,0,3,257,219,54359,41861,311,187,57844,40609
396,37,1,1,2,1,2,1,206,147,54360,41862,272,202,57845,40610
397,37,0,0,2,1,2,1,239,201,54360,41862,307,126,57846,40611
398,37,1,0,0,3,1,0,284,224,54361,41862,314,194,57849,40611
399,37,3,1,0,3,1,0,222,189,54364,41863,265,181,57852,40611
400,37,1,0,0,3,1,0,146,92,54365,41863,195,119,57855,40611
401,37,3,1,0,3,1,0,39,50,54368,41864,44,80,57858,40611
402,37,0,3,1,0,0,3,172,128,54368,41867,204,22,57858,40614
403,37,1,0,0,3,1,0,233,186,54369,41867,278,186,57861,40614
404,37,1,1,2,1,2,1,137,130,54370,41868,171,224,57862,40615
405,37,0,0,2,1,2,1,301,255,54370,41868,310,189,57863,40616
406,37,1,0,0,3,1,0,319,196,54371,41868,353,222,57866,40616
407,38,1,2,1,0,0,3,102,118,54372,41870,113,218,57866,40619
408,38,1,0,0,3,1,0,305,202,54373,41870,360,46,57869,40619
409,38,1,2,1,0,0,3,285,226,54374,41872,314,151,57869,40622
410,38,2,0,0,3,1,0,125,80,54376,41872,167,97,57872,40622
411,38,2,2,2,1,2,1,25,20,54378,41874,29,120,57873,40623
412,38,2,1,0,3,1,0,268,243,54380,41875,294,187,57876,40623
413,38,3,0,0,3,1,0,301,221,54383,41875,342,102,57879,40623
414,38,0,0,2,1,2,1,269,208,54383,41875,301,116,57880,40624
415,38,2,2,2,1,2,1,268,164,54385,41877,360,147,57881,40625
416,38,0,0,2,1,2,1,299,209,54385,41877,344,237,57882,40626
417,38,2,4,1,0,0,3,259,223,54387,41881,311,212,57882,40629
418,39,1,0,0,3,1,0,143,127,54388,41881,187,218,57885,40629
419,39,1,0,0,3,1,0,26,20,54389,41881,32,80,57888,40629
420,39,0,1,1,0,0,3,39,51,54389,41882,44,129,57888,40632
421,39,1,0,0,3,1,0,270,208,54390,41882,304,202,57891,40632
422,39,2,1,0,3,1,0,148,93,54392,41883,198,186,57894,40632
423,39,2,1,0,3,1,0,235,187,54394,41884,281,224,57897,40632
424,39,0,1,1,0,0,3,172,129,54394,41885,204,150,57897,40635
425,39,1,1,2,1,2,1,138,131,54395,41886,172,195,57898,40636
426,39,3,2,0,3,1,0,304,257,54398,41888,313,181,57901,40636
427,39,1,0,0,3,1,0,320,196,54399,41888,356,199,57904,40636
428,39,1,1,2,1,2,1,207,148,54400,41889,273,223,57905,40637
429,40,1,0,0,3,1,0,103,118,54401,41889,116,187,57908,40637
430,40,1,0,0,3,1,0,302,221,54402,41889,345,120,57911,40637
431,40,0,1,1,0,0,3,125,81,54402,41890,167,25,57911,40640
432,40,2,3,1,0,0,3,270,246,54404,41893,294,49,57911,40643
433,40,2,2,2,1,2,1,224,191,54406,41895,266,238,57912,40644
434,40,1,0,0,3,1,0,306,202,54407,41895,363,102,57915,40644
435,40,2,4,1,0,0,3,261,227,54409,41899,311,100,57915,40647
436,40,3,2,0,3,1,0,288,228,54412,41901,317,212,57918,40647
437,40,2,1,0,3,1,0,301,210,54414,41902,347,189,57921,40647
438,40,0,0,2,1,2,1,268,164,54414,41902,361,152,57922,40648
439,40,2,0,0,3,1,0,241,201,54416,41902,310,116,57925,40648
440,41,4,1,0,3,1,0,142,132,54420,41903,175,223,57928,40648
441,41,2,0,0,3,1,0,41,51,54422,41903,47,195,57931,40648
442,41,3,1,0,3,1,0,29,21,54425,41904,35,218,57934,40648
443,41,2,1,0,3,1,0,322,197,54427,41905,359,129,57937,40648
444,41,3,0,0,3,1,0,238,187,54430,41905,284,181,57940,40648
445,41,1,0,0,3,1,0,144,127,54431,41905,190,202,57943,40648
446,41,2,0,0,3,1,0,272,208,54433,41905,307,224,57946,40648
447,41,2,1,0,3,1,0,174,130,54435,41906,207,199,57949,40648
448,41,1,0,0,3,1,0,149,93,54436,41906,201,80,57952,40648
449,41,2,2,2,1,2,1,306,259,54438,41908,314,187,57953,40649
450,41,1,2,1,0,0,3,208,150,54439,41910,273,153,57953,40652
451,42,5,1,0,3,1,0,307,222,54444,41911,348,49,57956,40652
452,42,2,0,0,3,1,0,270,164,54446,41911,364,238,57959,40652
453,42,0,0,2,1,2,1,288,228,54446,41911,318,190,57960,40653
454,42,0,1,1,0,0,3,125,82,54446,41912,167,119,57960,40656
455,42,2,1,0,3,1,0,243,202,54448,41913,313,100,57963,40656
456,42,2,1,0,3,1,0,226,192,54450,41914,269,120,57966,40656
457,42,2,1,0,3,1,0,308,203,54452,41915,366,152,57969,40656
458,42,1,2,1,0,0,3,104,120,54453,41917,116,215,57969,40659
459,42,0,1,1,0,0,3,301,211,54453,41918,347,190,57969,40662
460,42,2,1,0,3,1,0,263,228,54455,41919,314,102,57972,40662
461,42,2,1,0,3,1,0,272,247,54457,41920,297,25,57975,40662
0,1,1,2,1,0,0,3,175,132,54458,41922,207,3,57975,40665
1,1,1,0,0,3,1,0,145,113,54459,41922,185,187,57978,40665
2,1,1,0,0,3,1,0,302,211,54460,41922,350,0,57981,40665
3,1,3,0,0,3,1,0,251,236,54463,41922,289,119,57984,40665
4,1,0,0,2,1,2,1,149,93,54463,41922,202,34,57985,40666
5,1,0,1,1,0,0,3,231,184,54463,41923,293,218,57985,40669
6,1,2,0,0,3,1,0,31,21,54465,41923,38,153,57988,40669
7,1,0,0,2,1,2,1,144,127,54465,41923,191,225,57989,40670
8,1,2,0,0,3,1,0,210,150,54467,41923,276,190,57992,40670
9,1,2,2,2,1,2,1,265,230,54469,41925,315,239,57993,40671
10,1,1,2,1,0,0,3,128,107,54470,41927,144,202,57993,40674
11,2,1,1,2,1,2,1,145,128,54471,41928,192,101,57994,40675
12,2,0,1,1,0,0,3,0,1,54471,41929,0,193,57994,40678
13,2,2,0,0,3,1,0,272,164,54473,41929,367,152,57997,40678
14,2,2,1,0,3,1,0,308,260,54475,41930,317,51,58000,40678
15,2,2,1,0,3,1,0,228,193,54477,41931,272,107,58003,40678
16,2,0,0,2,1,2,1,251,236,54477,41931,290,135,58004,40679
17,2,0,2,1,0,0,3,142,134,54477,41933,175,105,58004,40682
18,2,0,1,1,0,0,3,56,54,54477,41934,63,198,58004,40685
19,2,3,3,2,1,2,1,310,225,54480,41937,349,26,58005,40686
20,2,1,0,0,3,1,0,289,228,54481,41937,321,223,58008,40686
21,2,2,0,0,3,1,0,324,197,54483,41937,362,0,58011,40686
22,3,2,2,2,1,2,1,267,232,54485,41939,316,188,58012,40687
23,3,1,1,2,1,2,1,1,1,54486,41940,1,4,58013,40688
24,3,1,0,0,3,1,0,273,208,54487,41940,310,225,58016,40688
25,3,2,0,0,3,1,0,304,211,54489,41940,353,239,58019,40688
26,3,1,0,0,3,1,0,32,21,54490,41940,41,119,58022,40688
27,3,0,2,1,0,0,3,228,195,54490,41942,272,205,58022,40691
28,3,1,0,0,3,1,0,232,184,54491,41942,296,51,58025,40691
29,3,3,0,0,3,1,0,178,132,54494,41942,210,218,58028,40691
30,3,0,2,1,0,0,3,149,95,54494,41944,202,173,58028,40694
31,3,1,2,1,0,0,3,211,152,54495,41946,276,123,58028,40697
32,3,3,1,0,3,1,0,148,114,54498,41947,188,34,58031,40697
33,4,0,1,1,0,0,3,145,129,54498,41948,192,108,58031,40700
34,4,0,3,1,0,0,3,272,167,54498,41951,367,226,58031,40703
35,4,1,1,2,1,2,1,143,135,54499,41952,176,102,58032,40704
36,4,2,0,0,3,1,0,234,184,54501,41952,299,152,58035,40704
37,4,2,1,0,3,1,0,312,226,54503,41953,352,0,58038,40704
38,4,4,0,0,3,1,0,312,260,54507,41953,320,193,58041,40704
39,4,0,1,1,0,0,3,324,198,54507,41954,362,29,58041,40707
40,4,0,1,1,0,0,3,128,108,54507,41955,144,176,58041,40710
41,4,0,1,1,0,0,3,289,229,54507,41956,321,201,58041,40713
42,4,2,0,0,3,1,0,2,1,54509,41956,3,107,58044,40713
43,4,2,1,0,3,1,0,58,55,54511,41957,66,153,58047,40713
44,5,0,2,1,0,0,3,128,110,54511,41959,144,126,58047,40716
45,5,1,0,0,3,1,0,252,236,54512,41959,293,225,58050,40716
46,5,1,0,0,3,1,0,2,1,54513,41959,4,205,58053,40716
47,5,1,0,0,3,1,0,212,152,54514,41959,279,218,58056,40716
48,5,1,1,2,1,2,1,33,22,54515,41960,42,5,58057,40717
49,5,0,1,1,0,0,3,228,196,54515,41961,272,138,58057,40720
50,5,0,1,1,0,0,3,148,115,54515,41962,188,242,58057,40723
51,5,0,0,2,1,2,1,273,208,54515,41962,311,189,58058,40724
52,5,1,0,0,3,1,0,268,232,54516,41962,319,119,58061,40724
53,5,0,2,1,0,0,3,178,134,54516,41964,210,37,58061,40727
54,5,1,0,0,3,1,0,150,95,54517,41964,205,201,58064,40727
55,6,3,0,0,3,1,0,146,135,54520,41964,179,51,58067,40727
56,6,1,1,2,1,2,1,59,56,54521,41965,67,30,58068,40728
57,6,2,0,0,3,1,0,314,226,54523,41965,355,205,58071,40728
58,6,0,1,1,0,0,3,2,2,54523,41966,3,156,58071,40731
59,6,0,1,1,0,0,3,2,2,54523,41967,4,110,58071,40734
60,6,1,0,0,3,1,0,313,260,54524,41967,323,176,58074,40734
61,6,0,0,2,1,2,1,145,129,54524,41967,193,139,58075,40735
62,6,1,2,1,0,0,3,269,234,54525,41969,319,196,58075,40738
63,6,1,0,0,3,1,0,325,198,54526,41969,365,102,58078,40738
64,6,1,1,2,1,2,1,305,212,54527,41970,354,153,58079,40739
65,6,0,1,1,0,0,3,272,168,54527,41971,367,111,58079,40742
66,7,2,0,0,3,1,0,254,236,54529,41971,296,126,58082,40742
67,7,2,1,0,3,1,0,316,227,54531,41972,358,5,58085,40742
68,7,3,0,0,3,1,0,231,196,54534,41972,275,242,58088,40742
69,7,1,0,0,3,1,0,179,134,54535,41972,213,153,58091,40742
70,7,1,1,2,1,2,1,290,230,54536,41973,322,38,58092,40743
71,7,0,0,2,1,2,1,33,22,54536,41973,43,1,58093,40744
72,7,1,0,0,3,1,0,149,115,54537,41973,191,226,58096,40744
73,7,0,0,2,1,2,1,234,184,54537,41973,300,120,58097,40745
74,7,0,0,2,1,2,1,150,95,54537,41973,206,219,58098,40746
75,7,1,0,0,3,1,0,274,208,54538,41973,314,201,58101,40746
76,7,1,1,2,1,2,1,129,111,54539,41974,145,226,58102,40747
77,8,2,3,1,0,0,3,4,5,54541,41977,4,159,58102,40750
78,8,3,0,0,3,1,0,62,56,54544,41977,70,189,58105,40750
79,8,3,0,0,3,1,0,293,230,54547,41977,325,30,58108,40750
80,8,0,1,1,0,0,3,2,3,54547,41978,3,245,58108,40753
81,8,2,1,0,3,1,0,307,213,54549,41979,357,111,58111,40753
82,8,2,1,0,3,1,0,151,116,54551,41980,194,102,58114,40753
83,8,0,0,2,1,2,1,212,152,54551,41980,280,177,58115,40754
84,8,2,1,0,3,1,0,148,136,54553,41981,182,219,58118,40754
85,8,1,1,2,1,2,1,275,209,54554,41982,315,127,58119,40755
86,8,0,0,2,1,2,1,269,234,54554,41982,320,52,58120,40756
87,8,0,2,1,0,0,3,272,170,54554,41984,367,142,58120,40759
88,9,2,1,0,3,1,0,327,199,54556,41985,368,38,58123,40759
89,9,1,1,2,1,2,1,149,137,54557,41986,183,190,58124,40760
90,9,1,2,1,0,0,3,3,5,54558,41988,3,208,58124,40763
91,9,2,0,0,3,1,0,256,236,54560,41988,299,111,58127,40763
92,9,2,3,1,0,0,3,152,98,54562,41991,206,4,58127,40766
93,9,1,2,1,0,0,3,273,172,54563,41993,367,204,58127,40769
94,9,3,1,0,3,1,0,237,185,54566,41994,303,196,58130,40769
95,9,1,0,0,3,1,0,146,129,54567,41994,196,226,58133,40769
96,9,1,1,2,1,2,1,213,153,54568,41995,281,160,58134,40770
97,9,2,0,0,3,1,0,315,260,54570,41995,326,30,58137,40770
98,9,1,0,0,3,1,0,130,111,54571,41995,148,110,58140,40770
99,10,3,1,0,3,1,0,65,57,54574,41996,73,120,58143,40770
100,10,1,2,1,0,0,3,317,229,54575,41998,358,105,58143,40773
101,10,1,0,0,3,1,0,152,116,54576,41998,197,127,58146,40773
102,10,0,0,2,1,2,1,269,234,54576,41998,321,143,58147,40774
103,10,1,1,2,1,2,1,34,23,54577,41999,44,154,58148,40775
104,10,0,3,1,0,0,3,179,137,54577,42002,213,55,58148,40778
105,10,1,0,0,3,1,0,232,196,54578,42002,278,219,58151,40778
106,10,0,0,2,1,2,1,293,230,54578,42002,326,246,58152,40779
107,10,1,0,0,3,1,0,5,5,54579,42002,7,226,58155,40779
108,10,1,0,0,3,1,0,308,213,54580,42002,360,5,58158,40779
109,10,0,3,1,0,0,3,275,212,54580,42005,315,180,58158,40782
110,11,0,0,2,1,2,1,149,137,54580,42005,184,111,58159,40783
111,11,0,1,1,0,0,3,65,58,54580,42006,73,7,58159,40786
112,11,1,0,0,3,1,0,147,129,54581,42006,199,204,58162,40786
113,11,2,1,0,3,1,0,258,237,54583,42007,302,160,58165,40786
114,11,1,2,1,0,0,3,131,113,54584,42009,148,199,58165,40789
115,11,0,3,1,0,0,3,273,175,54584,42012,367,33,58165,40792
116,11,0,1,1,0,0,3,315,261,54584,42013,326,211,58165,40795
117,11,3,0,0,3,1,0,240,185,54587,42013,306,111,58168,40795
118,11,4,0,0,3,1,0,156,98,54591,42013,209,5,58171,40795
119,11,1,0,0,3,1,0,214,153,54592,42013,284,226,58174,40795
120,11,1,1,2,1,2,1,328,200,54593,42014,369,191,58175,40796
121,12,1,2,1,0,0,3,270,236,54594,42016,321,108,58175,40799
122,12,1,1,2,1,2,1,35,24,54595,42017,45,181,58176,40800
123,12,2,1,0,3,1,0,295,231,54597,42018,329,127,58179,40800
124,12,0,1,1,0,0,3,328,201,54597,42019,369,146,58179,40803
125,12,1,0,0,3,1,0,233,196,54598,42019,281,120,58182,40803
126,12,1,0,0,3,1,0,153,116,54599,42019,200,226,58185,40803
127,12,1,1,2,1,2,1,180,138,54600,42020,214,200,58186,40804
128,12,2,1,0,3,1,0,5,6,54602,42021,6,38,58189,40804
129,12,1,0,0,3,1,0,6,5,54603,42021,10,55,58192,40804
130,12,1,0,0,3,1,0,318,229,54604,42021,361,154,58195,40804
131,12,1,1,2,1,2,1,309,214,54605,42022,361,220,58196,40805
132,13,1,0,0,3,1,0,274,175,54606,42022,370,160,58199,40805
133,13,1,2,1,0,0,3,259,239,54607,42024,302,249,58199,40808
134,13,1,2,1,0,0,3,276,214,54608,42026,315,114,58199,40811
135,13,4,1,0,3,1,0,151,130,54612,42027,202,38,58202,40811
136,13,2,1,0,3,1,0,317,262,54614,42028,329,5,58205,40811
137,13,1,1,2,1,2,1,157,99,54615,42029,210,34,58206,40812
138,13,3,1,0,3,1,0,134,114,54618,42030,151,191,58209,40812
139,13,0,0,2,1,2,1,240,185,54618,42030,307,205,58210,40813
140,13,0,1,1,0,0,3,214,154,54618,42031,284,10,58210,40816
141,13,2,1,0,3,1,0,182,139,54620,42032,217,226,58213,40816
142,13,1,2,1,0,0,3,150,139,54621,42034,184,214,58213,40819
143,14,0,2,1,0,0,3,5,8,54621,42036,6,229,58213,40822
144,14,0,1,1,0,0,3,328,202,54621,42037,369,203,58213,40825
145,14,0,0,2,1,2,1,233,196,54621,42037,282,109,58214,40826
146,14,0,2,1,0,0,3,318,231,54621,42039,361,130,58214,40829
147,14,1,2,1,0,0,3,271,238,54622,42041,321,223,58214,40832
148,14,3,1,0,3,1,0,312,215,54625,42042,364,55,58217,40832
149,14,1,2,1,0,0,3,66,60,54626,42044,73,149,58217,40835
150,14,1,1,2,1,2,1,36,25,54627,42045,46,112,58218,40836
151,14,2,0,0,3,1,0,155,116,54629,42045,203,181,58221,40836
152,14,2,0,0,3,1,0,8,5,54631,42045,13,120,58224,40836
153,14,2,0,0,3,1,0,297,231,54633,42045,332,154,58227,40836
154,15,1,0,0,3,1,0,275,175,54634,42045,373,249,58230,40836
155,15,2,2,2,1,2,1,278,216,54636,42047,316,161,58231,40837
156,15,1,2,1,0,0,3,135,116,54637,42049,151,37,58231,40840
157,15,0,0,2,1,2,1,317,262,54637,42049,330,39,58232,40841
158,15,1,1,2,1,2,1,152,131,54638,42050,203,6,58233,40842
159,15,0,2,1,0,0,3,150,141,54638,42052,184,157,58233,40845
160,15,2,0,0,3,1,0,261,239,54640,42052,305,226,58236,40845
161,15,4,0,0,3,1,0,244,185,54644,42052,310,10,58239,40845
162,15,3,2,0,3,1,0,185,141,54647,42054,220,114,58242,40845
163,15,3,2,0,3,1,0,321,233,54650,42056,364,205,58245,40845
164,15,1,2,1,0,0,3,158,101,54651,42058,210,217,58245,40848
165,16,0,2,1,0,0,3,36,27,54651,42060,46,206,58245,40851
166,16,1,0,0,3,1,0,329,202,54652,42060,372,130,58248,40851
167,16,1,3,1,0,0,3,67,63,54653,42063,73,184,58248,40854
168,16,1,0,0,3,1,0,156,116,54654,42063,206,223,58251,40854
169,16,1,2,1,0,0,3,9,7,54655,42065,13,115,58251,40857
170,16,1,0,0,3,1,0,6,8,54656,42065,9,226,58254,40857
171,16,1,1,2,1,2,1,234,197,54657,42066,283,192,58255,40858
172,16,0,1,1,0,0,3,297,232,54657,42067,332,152,58255,40861
173,16,1,1,2,1,2,1,159,102,54658,42068,211,230,58256,40862
174,16,1,2,1,0,0,3,215,156,54659,42070,284,58,58256,40865
175,16,0,0,2,1,2,1,312,215,54659,42070,365,121,58257,40866
176,17,2,1,0,3,1,0,319,263,54661,42071,333,10,58260,40866
177,17,0,0,2,1,2,1,185,141,54661,42071,221,193,58261,40867
178,17,0,0,2,1,2,1,152,131,54661,42071,204,162,58262,40868
179,17,1,2,1,0,0,3,279,218,54662,42073,316,42,58262,40871
180,17,0,1,1,0,0,3,275,176,54662,42074,373,220,58262,40874
181,17,2,0,0,3,1,0,263,239,54664,42074,308,205,58265,40874
182,17,0,2,1,0,0,3,150,143,54664,42076,184,252,58265,40877
183,17,0,1,1,0,0,3,135,117,54664,42077,151,112,58265,40880
184,17,1,0,0,3,1,0,272,238,54665,42077,324,37,58268,40880
185,17,0,0,2,1,2,1,215,156,54665,42077,285,115,58269,40881
186,17,3,1,0,3,1,0,247,186,54668,42078,313,6,58272,40881
187,18,1,0,0,3,1,0,235,197,54669,42078,286,115,58275,40881
188,18,4,2,0,3,1,0,163,104,54673,42080,214,157,58278,40881
189,18,0,1,1,0,0,3,156,117,54673,42081,206,155,58278,40884
190,18,3,0,0,3,1,0,9,8,54676,42081,12,121,58281,40884
191,18,0,1,1,0,0,3,36,28,54676,42082,46,133,58281,40887
192,18,0,3,1,0,0,3,9,10,54676,42085,13,187,58281,40890
193,18,3,1,0,3,1,0,300,233,54679,42086,335,206,58284,40890
194,18,0,0,2,1,2,1,321,233,54679,42086,365,231,58285,40891
195,18,1,2,1,0,0,3,68,65,54680,42088,73,61,58285,40894
196,18,1,0,0,3,1,0,313,215,54681,42088,368,226,58288,40894
197,18,0,0,2,1,2,1,329,202,54681,42088,373,224,58289,40895
198,19,1,0,0,3,1,0,186,141,54682,42088,224,112,58292,40895
199,19,1,1,2,1,2,1,136,118,54683,42089,152,7,58293,40896
200,19,2,3,1,0,0,3,249,189,54685,42092,313,40,58293,40899
201,19,1,0,0,3,1,0,273,238,54686,42092,327,162,58296,40899
202,19,2,1,0,3,1,0,277,177,54688,42093,376,42,58299,40899
203,19,2,1,0,3,1,0,265,240,54690,42094,311,220,58302,40899
204,19,2,0,0,3,1,0,321,263,54692,42094,336,193,58305,40899
205,19,0,0,2,1,2,1,279,218,54692,42094,317,11,58306,40900
206,19,0,2,1,0,0,3,152,133,54692,42096,204,124,58306,40903
207,19,1,1,2,1,2,1,314,216,54693,42097,369,116,58307,40904
208,19,2,0,0,3,1,0,217,156,54695,42097,288,252,58310,40904
209,20,0,0,2,1,2,1,36,28,54695,42097,47,117,58311,40905
210,20,2,1,0,3,1,0,323,264,54697,42098,339,231,58314,40905
211,20,2,1,0,3,1,0,11,11,54699,42099,16,133,58317,40905
212,20,1,1,2,1,2,1,69,66,54700,42100,74,227,58318,40906
213,20,0,1,1,0,0,3,9,9,54700,42101,12,160,58318,40909
214,20,1,0,0,3,1,0,322,233,54701,42101,368,187,58321,40909
215,20,1,1,2,1,2,1,151,144,54702,42102,185,207,58322,40910
216,20,3,1,0,3,1,0,303,234,54705,42103,338,115,58325,40910
217,20,2,2,2,1,2,1,165,106,54707,42105,215,156,58326,40911
218,20,0,0,2,1,2,1,329,202,54707,42105,374,62,58327,40912
219,20,0,0,2,1,2,1,235,197,54707,42105,287,206,58328,40913
220,21,2,0,0,3,1,0,275,238,54709,42105,330,11,58331,40913
221,21,1,1,2,1,2,1,280,219,54710,42106,318,113,58332,40914
222,21,0,1,1,0,0,3,249,190,54710,42107,313,196,58332,40917
223,21,3,0,0,3,1,0,220,156,54713,42107,291,42,58335,40917
224,21,2,0,0,3,1,0,267,240,54715,42107,314,7,58338,40917
225,21,1,1,2,1,2,1,187,142,54716,42108,225,253,58339,40918
226,21,2,1,0,3,1,0,316,217,54718,42109,372,40,58342,40918
227,21,1,1,2,1,2,1,137,119,54719,42110,153,163,58343,40919
228,21,0,2,1,0,0,3,152,135,54719,42112,204,227,58343,40922
229,21,1,2,1,0,0,3,278,179,54720,42114,376,127,58343,40925
230,21,2,1,0,3,1,0,158,118,54722,42115,209,220,58346,40925
231,22,0,0,2,1,2,1,36,28,54722,42115,48,232,58347,40926
232,22,1,0,0,3,1,0,152,144,54723,42115,188,227,58350,40926
233,22,1,3,1,0,0,3,324,267,54724,42118,339,159,58350,40929
234,22,1,0,0,3,1,0,330,202,54725,42118,377,187,58353,40929
235,22,2,0,0,3,1,0,237,197,54727,42118,290,160,58356,40929
236,22,0,2,1,0,0,3,280,221,54727,42120,318,118,58356,40932
237,22,2,2,2,1,2,1,305,236,54729,42122,339,63,58357,40933
238,22,0,0,2,1,2,1,11,11,54729,42122,17,114,58358,40934
239,22,2,0,0,3,1,0,11,9,54731,42122,15,206,58361,40934
240,22,2,1,0,3,1,0,324,234,54733,42123,371,117,58364,40934
241,22,0,2,1,0,0,3,69,68,54733,42125,74,136,58364,40937
242,23,1,0,0,3,1,0,276,238,54734,42125,333,118,58367,40937
243,23,0,1,1,0,0,3,165,107,54734,42126,215,130,58367,40940
244,23,0,1,1,0,0,3,278,180,54734,42127,376,210,58367,40943
245,23,1,0,0,3,1,0,250,190,54735,42127,316,253,58370,40943
246,23,3,1,0,3,1,0,308,237,54738,42128,342,7,58373,40943
247,23,0,0,2,1,2,1,316,217,54738,42128,373,43,58374,40944
248,23,2,3,1,0,0,3,269,243,54740,42131,314,230,58374,40947
249,23,2,0,0,3,1,0,154,135,54742,42131,207,196,58377,40947
250,23,1,1,2,1,2,1,221,157,54743,42132,292,41,58378,40948
251,23,3,2,0,3,1,0,161,120,54746,42134,212,163,58381,40948
252,23,0,0,2,1,2,1,137,119,54746,42134,154,12,58382,40949
253,24,0,1,1,0,0,3,152,145,54746,42135,188,162,58382,40952
254,24,2,0,0,3,1,0,71,68,54748,42135,77,114,58385,40952
255,24,0,4,1,0,0,3,11,15,54748,42139,17,209,58385,40955
256,24,1,1,2,1,2,1,37,29,54749,42140,49,221,58386,40956
257,24,0,2,1,0,0,3,330,204,54749,42142,377,120,58386,40959
258,24,1,2,1,0,0,3,281,223,54750,42144,318,230,58386,40962
259,24,0,1,1,0,0,3,11,10,54750,42145,15,139,58386,40965
260,24,0,1,1,0,0,3,324,268,54750,42146,339,163,58386,40968
261,24,0,1,1,0,0,3,324,235,54750,42147,371,66,58386,40971
262,24,2,0,0,3,1,0,189,142,54752,42147,228,232,58389,40971
263,24,1,1,2,1,2,1,238,198,54753,42148,291,188,58390,40972
264,25,1,1,2,1,2,1,138,120,54754,42149,155,231,58391,40973
265,25,2,2,2,1,2,1,73,70,54756,42151,78,231,58392,40974
266,25,3,3,2,1,2,1,157,138,54759,42154,208,254,58393,40975
267,25,1,0,0,3,1,0,222,157,54760,42154,295,118,58396,40975
268,25,1,2,1,0,0,3,251,192,54761,42156,316,191,58396,40978
269,25,3,1,0,3,1,0,311,238,54764,42157,345,196,58399,40978
270,25,1,0,0,3,1,0,279,180,54765,42157,379,12,58402,40978
271,25,3,1,0,3,1,0,164,121,54768,42158,215,130,58405,40978
272,25,1,0,0,3,1,0,317,217,54769,42158,376,210,58408,40978
273,25,1,2,1,0,0,3,12,12,54770,42160,15,44,58408,40981
274,25,3,1,0,3,1,0,168,108,54773,42161,218,163,58411,40981
275,26,1,0,0,3,1,0,190,142,54774,42161,231,139,58414,40981
276,26,1,0,0,3,1,0,270,243,54775,42161,317,66,58417,40981
277,26,0,1,1,0,0,3,152,146,54775,42162,188,212,58417,40984
278,26,2,0,0,3,1,0,326,235,54777,42162,374,43,58420,40984
279,26,1,0,0,3,1,0,165,121,54778,42162,218,163,58423,40984
280,26,2,0,0,3,1,0,253,192,54780,42162,319,221,58426,40984
281,26,2,1,0,3,1,0,332,205,54782,42163,380,7,58429,40984
282,26,1,1,2,1,2,1,239,199,54783,42164,292,13,58430,40985
283,26,2,0,0,3,1,0,283,223,54785,42164,321,231,58433,40985
284,26,2,2,2,1,2,1,39,31,54787,42166,50,115,58434,40986
285,26,0,1,1,0,0,3,276,239,54787,42167,333,235,58434,40989
286,27,0,0,2,1,2,1,138,120,54787,42167,156,131,58435,40990
287,27,1,0,0,3,1,0,74,70,54788,42167,81,120,58438,40990
288,27,1,1,2,1,2,1,325,269,54789,42168,340,119,58439,40991
289,27,4,1,0,3,1,0,315,239,54793,42169,348,163,58442,40991
290,27,4,0,0,3,1,0,16,12,54797,42169,18,196,58445,40991
291,27,0,1,1,0,0,3,11,16,54797,42170,17,165,58445,40994
292,27,1,1,2,1,2,1,40,32,54798,42171,51,255,58446,40995
293,27,1,1,2,1,2,1,318,218,54799,42172,377,192,58447,40996
294,27,3,1,0,3,1,0,225,158,54802,42173,298,235,58450,40996
295,27,1,0,0,3,1,0,169,108,54803,42173,221,231,58453,40996
296,27,1,0,0,3,1,0,158,138,54804,42173,211,210,58456,40996
297,28,1,1,2,1,2,1,271,244,54805,42174,318,116,58457,40997
298,28,1,0,0,3,1,0,277,239,54806,42174,336,163,58460,40997
299,28,1,1,2,1,2,1,327,236,54807,42175,375,232,58461,40998
300,28,0,0,2,1,2,1,165,121,54807,42175,219,8,58462,40999
301,28,1,1,2,1,2,1,153,147,54808,42176,189,14,58463,41000
302,28,2,0,0,3,1,0,285,223,54810,42176,324,66,58466,41000
303,28,2,2,2,1,2,1,192,144,54812,42178,232,213,58467,41001
304,28,2,1,0,3,1,0,255,193,54814,42179,322,43,58470,41001
305,28,0,1,1,0,0,3,332,206,54814,42180,380,224,58470,41004
306,28,4,0,0,3,1,0,283,180,54818,42180,382,139,58473,41004
307,28,0,0,2,1,2,1,239,199,54818,42180,293,45,58474,41005
308,29,1,1,2,1,2,1,75,71,54819,42181,82,120,58475,41006
309,29,3,2,0,3,1,0,328,271,54822,42183,343,231,58478,41006
310,29,1,2,1,0,0,3,41,34,54823,42185,51,199,58478,41009
311,29,1,1,2,1,2,1,333,207,54824,42186,381,164,58479,41010
312,29,2,1,0,3,1,0,18,13,54826,42187,21,66,58482,41010
313,29,2,2,2,1,2,1,160,140,54828,42189,212,193,58483,41011
314,29,0,1,1,0,0,3,11,17,54828,42190,17,213,58483,41014
315,29,2,0,0,3,1,0,320,218,54830,42190,380,165,58486,41014
316,29,2,0,0,3,1,0,227,158,54832,42190,301,131,58489,41014
317,29,1,3,1,0,0,3,170,111,54833,42193,221,123,58489,41017
318,29,0,0,2,1,2,1,315,239,54833,42193,349,236,58490,41018
319,30,1,2,1,0,0,3,328,238,54834,42195,375,258,58490,41021
320,30,1,1,2,1,2,1,139,121,54835,42196,157,214,58491,41022
321,30,0,0,2,1,2,1,255,193,54835,42196,323,117,58492,41023
322,30,0,2,1,0,0,3,165,123,54835,42198,219,48,58492,41026
323,30,4,0,0,3,1,0,275,244,54839,42198,321,14,58495,41026
324,30,2,1,0,3,1,0,194,145,54841,42199,235,224,58498,41026
325,30,1,1,2,1,2,1,286,224,54842,42200,325,164,58499,41027
326,30,0,0,2,1,2,1,239,199,54842,42200,294,9,58500,41028
327,30,0,3,1,0,0,3,283,183,54842,42203,382,235,58500,41031
328,30,2,0,0,3,1,0,155,147,54844,42203,192,43,58503,41031
329,30,1,0,0,3,1,0,278,239,54845,42203,339,139,58506,41031
330,31,0,0,2,1,2,1,320,218,54845,42203,381,237,58507,41032
331,31,1,3,1,0,0,3,19,16,54846,42206,21,196,58507,41035
332,31,1,1,2,1,2,1,171,112,54847,42207,222,121,58508,41036
333,31,1,1,2,1,2,1,316,240,54848,42208,350,124,58509,41037
334,31,1,1,2,1,2,1,76,72,54849,42209,83,214,58510,41038
335,31,1,1,2,1,2,1,12,18,54850,42210,18,232,58511,41039
336,31,0,1,1,0,0,3,239,200,54850,42211,294,69,58511,41042
337,31,2,1,0,3,1,0,335,208,54852,42212,384,131,58514,41042
338,31,1,1,2,1,2,1,228,159,54853,42213,302,200,58515,41043
339,31,4,1,0,3,1,0,45,35,54857,42214,54,165,58518,41043
340,32,1,1,2,1,2,1,284,184,54858,42215,383,118,58519,41044
341,32,0,3,1,0,0,3,286,227,54858,42218,325,227,58519,41047
342,32,2,2,2,1,2,1,196,147,54860,42220,236,15,58520,41048
343,32,0,1,1,0,0,3,328,272,54860,42221,343,217,58520,41051
344,32,0,1,1,0,0,3,155,148,54860,42222,192,12,58520,41054
345,32,2,2,2,1,2,1,141,123,54862,42224,158,259,58521,41055
346,32,4,0,0,3,1,0,279,244,54866,42224,324,48,58524,41055
347,32,1,0,0,3,1,0,256,193,54867,42224,326,124,58527,41055
348,32,6,1,0,3,1,0,334,239,54873,42225,378,164,58530,41055
349,32,0,0,2,1,2,1,278,239,54873,42225,340,44,58531,41056
350,33,0,1,1,0,0,3,316,241,54873,42226,350,238,58531,41059
351,33,1,0,0,3,1,0,13,18,54874,42226,21,164,58534,41059
352,33,3,1,0,3,1,0,338,209,54877,42227,387,121,58537,41059
353,33,1,0,0,3,1,0,20,16,54878,42227,24,118,58540,41059
354,33,1,2,1,0,0,3,321,220,54879,42229,381,142,58540,41062
355,33,0,3,1,0,0,3,155,151,54879,42232,192,199,58540,41065
356,33,2,1,0,3,1,0,167,124,54881,42233,222,69,58543,41065
357,33,0,1,1,0,0,3,239,201,54881,42234,294,217,58543,41068
358,33,1,1,2,1,2,1,335,240,54882,42235,379,166,58544,41069
359,33,2,1,0,3,1,0,78,73,54884,42236,86,237,58547,41069
360,33,0,1,1,0,0,3,45,36,54884,42237,54,235,58547,41072
361,34,1,0,0,3,1,0,229,159,54885,42237,305,217,58550,41072
362,34,0,0,2,1,2,1,196,147,54885,42237,237,49,58551,41073
363,34,0,0,2,1,2,1,171,112,54885,42237,223,201,58552,41074
364,34,2,1,0,3,1,0,330,273,54887,42238,346,259,58555,41074
365,34,2,0,0,3,1,0,288,227,54889,42238,328,131,58558,41074
366,34,2,1,0,3,1,0,280,240,54891,42239,343,227,58561,41074
367,34,2,0,0,3,1,0,258,193,54893,42239,329,164,58564,41074
368,34,0,1,1,0,0,3,160,141,54893,42240,212,18,58564,41077
369,34,1,1,2,1,2,1,142,124,54894,42241,159,45,58565,41078
370,34,2,1,0,3,1,0,281,245,54896,42242,327,124,58568,41078
371,34,2,1,0,3,1,0,286,185,54898,42243,386,12,58571,41078
0,1,2,1,0,3,1,0,2,1,54900,42244,3,0,58574,41078
1,1,1,1,2,1,2,1,141,169,54901,42245,166,39,58575,41079
2,1,3,4,1,0,0,3,3,4,54904,42249,0,13,58575,41082
3,1,0,0,2,1,2,1,66,96,54904,42249,73,1,58576,41083
4,1,2,1,0,3,1,0,100,120,54906,42250,118,0,58579,41083
5,1,1,0,0,3,1,0,144,168,54907,42250,162,109,58582,41083
6,1,1,1,2,1,2,1,61,61,54908,42251,61,61,58583,41084
7,1,1,0,0,3,1,0,1,0,54909,42251,3,0,58586,41084
8,2,2,1,0,3,1,0,4,2,54911,42252,6,0,58589,41084
9,2,1,1,2,1,2,1,142,170,54912,42253,167,40,58590,41085
10,2,3,4,1,0,0,3,6,8,54915,42257,0,16,58590,41088
11,2,0,0,2,1,2,1,66,96,54915,42257,74,2,58591,41089
12,2,2,1,0,3,1,0,102,121,54917,42258,121,0,58594,41089
13,2,1,0,0,3,1,0,145,168,54918,42258,165,109,58597,41089
14,2,1,1,2,1,2,1,62,62,54919,42259,62,62,58598,41090
15,2,1,0,0,3,1,0,2,0,54920,42259,6,0,58601,41090
16,3,2,1,0,3,1,0,6,3,54922,42260,9,0,58604,41090
17,3,1,1,2,1,2,1,143,171,54923,42261,168,41,58605,41091
18,3,3,4,1,0,0,3,9,12,54926,42265,0,19,58605,41094
19,3,0,0,2,1,2,1,66,96,54926,42265,75,3,58606,41095
20,3,2,1,0,3,1,0,104,122,54928,42266,124,0,58609,41095
21,3,1,0,0,3,1,0,146,168,54929,42266,168,109,58612,41095
22,3,1,1,2,1,2,1,63,63,54930,42267,63,63,58613,41096
23,3,1,0,0,3,1,0,3,0,54931,42267,9,0,58616,41096
24,4,2,1,0,3,1,0,8,4,54933,42268,12,0,58619,41096
25,4,1,1,2,1,2,1,144,172,54934,42269,169,42,58620,41097
26,4,3,4,1,0,0,3,12,16,54937,42273,0,22,58620,41100
27,4,0,0,2,1,2,1,66,96,54937,42273,76,4,58621,41101
28,4,2,1,0,3,1,0,106,123,54939,42274,127,0,58624,41101
29,4,1,0,0,3,1,0,147,168,54940,42274,171,109,58627,41101
30,4,1,1,2,1,2,1,64,64,54941,42275,64,64,58628,41102
31,4,1,0,0,3,1,0,4,0,54942,42275,12,0,58631,41102
32,5,2,1,0,3,1,0,10,5,54944,42276,15,0,58634,41102
33,5,1,1,2,1,2,1,145,173,54945,42277,170,43,58635,41103
34,5,3,4,1,0,0,3,15,20,54948,42281,0,25,58635,41106
35,5,0,0,2,1,2,1,66,96,54948,42281,77,5,58636,41107
36,5,2,1,0,3,1,0,108,124,54950,42282,130,0,58639,41107
37,5,1,0,0,3,1,0,148,168,54951,42282,174,109,58642,41107
38,5,1,1,2,1,2,1,65,65,54952,42283,65,65,58643,41108
39,5,1,0,0,3,1,0,5,0,54953,42283,15,0,58646,41108
40,6,2,1,0,3,1,0,12,6,54955,42284,18,0,58649,41108
41,6,1,1,2,1,2,1,146,174,54956,42285,171,44,58650,41109
42,6,3,4,1,0,0,3,18,24,54959,42289,0,28,58650,41112
43,6,0,0,2,1,2,1,66,96,54959,42289,78,6,58651,41113
44,6,2,1,0,3,1,0,110,125,54961,42290,133,0,58654,41113
45,6,1,0,0,3,1,0,149,168,54962,42290,177,109,58657,41113
46,6,1,1,2,1,2,1,66,66,54963,42291,66,66,58658,41114
47,6,1,0,0,3,1,0,6,0,54964,42291,18,0,58661,41114
48,7,2,1,0,3,1,0,14,7,54966,42292,21,0,58664,41114
49,7,1,1,2,1,2,1,147,175,54967,42293,172,45,58665,41115
50,7,3,4,1,0,0,3,21,28,54970,42297,0,31,58665,41118
51,7,0,0,2,1,2,1,66,96,54970,42297,79,7,58666,41119
52,7,2,1,0,3,1,0,112,126,54972,42298,136,0,58669,41119
53,7,1,0,0,3,1,0,150,168,54973,42298,180,109,58672,41119
54,7,1,1,2,1,2,1,67,67,54974,42299,67,67,58673,41120
55,7,1,0,0,3,1,0,7,0,54975,42299,21,0,58676,41120
56,8,2,1,0,3,1,0,16,8,54977,42300,24,0,58679,41120
57,8,1,1,2,1,2,1,148,176,54978,42301,173,46,58680,41121
58,8,3,4,1,0,0,3,24,32,54981,42305,0,34,58680,41124
59,8,0,0,2,1,2,1,66,96,54981,42305,80,8,58681,41125
60,8,2,1,0,3,1,0,114,127,54983,42306,139,0,58684,41125
61,8,1,0,0,3,1,0,151,168,54984,42306,183,109,58687,41125
62,8,1,1,2,1,2,1,68,68,54985,42307,68,68,58688,41126
63,8,1,0,0,3,1,0,8,0,54986,42307,24,0,58691,41126
64,9,2,1,0,3,1,0,18,9,54988,42308,27,0,58694,41126
65,9,1,1,2,1,2,1,149,177,54989,42309,174,47,58695,41127
66,9,3,4,1,0,0,3,27,36,54992,42313,0,37,58695,41130
67,9,0,0,2,1,2,1,66,96,54992,42313,81,9,58696,41131
68,9,2,1,0,3,1,0,116,128,54994,42314,142,0,58699,41131
69,9,1,0,0,3,1,0,152,168,54995,42314,186,109,58702,41131
70,9,1,1,2,1,2,1,69,69,54996,42315,69,69,58703,41132
71,9,1,0,0,3,1,0,9,0,54997,42315,27,0,58706,41132
72,10,2,1,0,3,1,0,20,10,54999,42316,30,0,58709,41132
73,10,1,1,2,1,2,1,150,178,55000,42317,175,48,58710,41133
74,10,3,4,1,0,0,3,30,40,55003,42321,0,40,58710,41136
75,10,0,0,2,1,2,1,66,96,55003,42321,82,10,58711,41137
76,10,2,1,0,3,1,0,118,129,55005,42322,145,0,58714,41137
77,10,1,0,0,3,1,0,153,168,55006,42322,189,109,58717,41137
78,10,1,1,2,1,2,1,70,70,55007,42323,70,70,58718,41138
79,10,1,0,0,3,1,0,10,0,55008,42323,30,0,58721,41138
80,11,2,1,0,3,1,0,22,11,55010,42324,33,0,58724,41138
81,11,1,1,2,1,2,1,151,179,55011,42325,176,49,58725,41139
82,11,3,4,1,0,0,3,33,44,55014,42329,0,43,58725,41142
83,11,0,0,2,1,2,1,66,96,55014,42329,83,11,58726,41143
84,11,2,1,0,3,1,0,120,130,55016,42330,148,0,58729,41143
85,11,1,0,0,3,1,0,154,168,55017,42330,192,109,58732,41143
86,11,1,1,2,1,2,1,71,71,55018,42331,71,71,58733,41144
87,11,1,0,0,3,1,0,11,0,55019,42331,33,0,58736,41144
88,12,2,1,0,3,1,0,24,12,55021,42332,36,0,58739,41144
89,12,1,1,2,1,2,1,152,180,55022,42333,177,50,58740,41145
90,12,3,4,1,0,0,3,36,48,55025,42337,0,46,58740,41148
91,12,0,0,2,1,2,1,66,96,55025,42337,84,12,58741,41149
92,12,2,1,0,3,1,0,122,131,55027,42338,151,0,58744,41149
93,12,1,0,0,3,1,0,155,168,55028,42338,195,109,58747,41149
94,12,1,1,2,1,2,1,72,72,55029,42339,72,72,58748,41150
95,12,1,0,0,3,1,0,12,0,55030,42339,36,0,58751,41150
96,13,2,1,0,3,1,0,26,13,55032,42340,39,0,58754,41150
97,13,1,1,2,1,2,1,153,181,55033,42341,178,51,58755,41151
98,13,3,4,1,0,0,3,39,52,55036,42345,0,49,58755,41154
99,13,0,0,2,1,2,1,66,96,55036,42345,85,13,58756,41155
100,13,2,1,0,3,1,0,124,132,55038,42346,154,0,58759,41155
101,13,1,0,0,3,1,0,156,168,55039,42346,198,109,58762,41155
102,13,1,1,2,1,2,1,73,73,55040,42347,73,73,58763,41156
103,13,1,0,0,3,1,0,13,0,55041,42347,39,0,58766,41156
104,14,2,1,0,3,1,0,28,14,55043,42348,42,0,58769,41156
105,14,1,1,2,1,2,1,154,182,55044,42349,179,52,58770,41157
106,14,3,4,1,0,0,3,42,56,55047,42353,0,52,58770,41160
107,14,0,0,2,1,2,1,66,96,55047,42353,86,14,58771,41161
108,14,2,1,0,3,1,0,126,133,55049,42354,157,0,58774,41161
109,14,1,0,0,3,1,0,157,168,55050,42354,201,109,58777,41161
110,14,1,1,2,1,2,1,74,74,55051,42355,74,74,58778,41162
111,14,1,0,0,3,1,0,14,0,55052,42355,42,0,58781,41162
112,15,2,1,0,3,1,0,30,15,55054,42356,45,0,58784,41162
113,15,1,1,2,1,2,1,155,183,55055,42357,180,53,58785,41163
114,15,3,4,1,0,0,3,45,60,55058,42361,0,55,58785,41166
115,15,0,0,2,1,2,1,66,96,55058,42361,87,15,58786,41167
116,15,2,1,0,3,1,0,128,134,55060,42362,160,0,58789,41167
117,15,1,0,0,3,1,0,158,168,55061,42362,204,109,58792,41167
118,15,1,1,2,1,2,1,75,75,55062,42363,75,75,58793,41168
119,15,1,0,0,3,1,0,15,0,55063,42363,45,0,58796,41168
120,16,2,1,0,3,1,0,32,16,55065,42364,48,0,58799,41168
121,16,1,1,2,1,2,1,156,184,55066,42365,181,54,58800,41169
122,16,3,4,1,0,0,3,48,64,55069,42369,0,58,58800,41172
123,16,0,0,2,1,2,1,66,96,55069,42369,88,16,58801,41173
124,16,2,1,0,3,1,0,130,135,55071,42370,163,0,58804,41173
125,16,1,0,0,3,1,0,159,168,55072,42370,207,109,58807,41173
126,16,1,1,2,1,2,1,76,76,55073,42371,76,76,58808,41174
127,16,1,0,0,3,1,0,16,0,55074,42371,48,0,58811,41174
128,17,2,1,0,3,1,0,34,17,55076,42372,51,0,58814,41174
129,17,1,1,2,1,2,1,157,185,55077,42373,182,55,58815,41175
130,17,3,4,1,0,0,3,51,68,55080,42377,0,61,58815,41178
131,17,0,0,2,1,2,1,66,96,55080,42377,89,17,58816,41179
132,17,2,1,0,3,1,0,132,136,55082,42378,166,0,58819,41179
133,17,1,0,0,3,1,0,160,168,55083,42378,210,109,58822,41179
134,17,1,1,2,1,2,1,77,77,55084,42379,77,77,58823,41180
135,17,1,0,0,3,1,0,17,0,55085,42379,51,0,58826,41180
136,18,2,1,0,3,1,0,36,18,55087,42380,54,0,58829,41180
137,18,1,1,2,1,2,1,158,186,55088,42381,183,56,58830,41181
138,18,3,4,1,0,0,3,54,72,55091,42385,0,64,58830,41184
139,18,0,0,2,1,2,1,66,96,55091,42385,90,18,58831,41185
140,18,2,1,0,3,1,0,134,137,55093,42386,169,0,58834,41185
141,18,1,0,0,3,1,0,161,168,55094,42386,213,109,58837,41185
142,18,1,1,2,1,2,1,78,78,55095,42387,78,78,58838,41186
143,18,1,0,0,3,1,0,18,0,55096,42387,54,0,58841,41186
144,19,2,1,0,3,1,0,38,19,55098,42388,57,0,58844,41186
145,19,1,1,2,1,2,1,159,187,55099,42389,184,57,58845,41187
146,19,3,4,1,0,0,3,57,76,55102,42393,0,67,58845,41190
147,19,0,0,2,1,2,1,66,96,55102,42393,91,19,58846,41191
148,19,2,1,0,3,1,0,136,138,55104,42394,172,0,58849,41191
149,19,1,0,0,3,1,0,162,168,55105,42394,216,109,58852,41191
150,19,1,1,2,1,2,1,79,79,55106,42395,79,79,58853,41192
151,19,1,0,0,3,1,0,19,0,55107,42395,57,0,58856,41192
152,20,2,1,0,3,1,0,40,20,55109,42396,60,0,58859,41192
153,20,1,1,2,1,2,1,160,188,55110,42397,185,58,58860,41193
154,20,3,4,1,0,0,3,60,80,55113,42401,0,70,58860,41196
155,20,0,0,2,1,2,1,66,96,55113,42401,92,20,58861,41197
156,20,2,1,0,3,1,0,138,139,55115,42402,175,0,58864,41197
157,20,1,0,0,3,1,0,163,168,55116,42402,219,109,58867,41197
158,20,1,1,2,1,2,1,80,80,55117,42403,80,80,58868,41198
159,20,1,0,0,3,1,0,20,0,55118,42403,60,0,58871,41198
160,21,2,1,0,3,1,0,42,21,55120,42404,63,0,58874,41198
161,21,1,1,2,1,2,1,161,189,55121,42405,186,59,58875,41199
162,21,3,4,1,0,0,3,63,84,55124,42409,0,73,58875,41202
163,21,0,0,2,1,2,1,66,96,55124,42409,93,21,58876,41203
164,21,2,1,0,3,1,0,140,140,55126,42410,178,0,58879,41203
165,21,1,0,0,3,1,0,164,168,55127,42410,222,109,58882,41203
166,21,1,1,2,1,2,1,81,81,55128,42411,81,81,58883,41204
167,21,1,0,0,3,1,0,21,0,55129,42411,63,0,58886,41204
168,22,2,1,0,3,1,0,44,22,55131,42412,66,0,58889,41204
169,22,1,1,2,1,2,1,162,190,55132,42413,187,60,58890,41205
170,22,3,4,1,0,0,3,66,88,55135,42417,0,76,58890,41208
171,22,0,0,2,1,2,1,66,96,55135,42417,94,22,58891,41209
172,22,2,1,0,3,1,0,142,141,55137,42418,181,0,58894,41209
173,22,1,0,0,3,1,0,165,168,55138,42418,225,109,58897,41209
174,22,1,1,2,1,2,1,82,82,55139,42419,82,82,58898,41210
175,22,1,0,0,3,1,0,22,0,55140,42419,66,0,58901,41210
176,23,2,1,0,3,1,0,46,23,55142,42420,69,0,58904,41210
177,23,1,1,2,1,2,1,163,191,55143,42421,188,61,58905,41211
178,23,3,4,1,0,0,3,69,92,55146,42425,0,79,58905,41214
179,23,0,0,2,1,2,1,66,96,55146,42425,95,23,58906,41215
180,23,2,1,0,3,1,0,144,142,55148,42426,184,0,58909,41215
181,23,1,0,0,3,1,0,166,168,55149,42426,228,109,58912,41215
182,23,1,1,2,1,2,1,83,83,55150,42427,83,83,58913,41216
183,23,1,0,0,3,1,0,23,0,55151,42427,69,0,58916,41216
184,24,2,1,0,3,1,0,48,24,55153,42428,72,0,58919,41216
185,24,1,1,2,1,2,1,164,192,55154,42429,189,62,58920,41217
186,24,3,4,1,0,0,3,72,96,55157,42433,0,82,58920,41220
187,24,0,0,2,1,2,1,66,96,55157,42433,96,24,58921,41221
188,24,2,1,0,3,1,0,146,143,55159,42434,187,0,58924,41221
189,24,1,0,0,3,1,0,167,168,55160,42434,231,109,58927,41221
190,24,1,1,2,1,2,1,84,84,55161,42435,84,84,58928,41222
191,24,1,0,0,3,1,0,24,0,55162,42435,72,0,58931,41222
192,25,2,1,0,3,1,0,50,25,55164,42436,75,0,58934,41222
193,25,1,1,2,1,2,1,165,193,55165,42437,190,63,58935,41223
194,25,3,4,1,0,0,3,75,100,55168,42441,0,85,58935,41226
195,25,0,0,2,1,2,1,66,96,55168,42441,97,25,58936,41227
196,25,2,1,0,3,1,0,148,144,55170,42442,190,0,58939,41227
197,25,1,0,0,3,1,0,168,168,55171,42442,234,109,58942,41227
198,25,1,1,2,1,2,1,85,85,55172,42443,85,85,58943,41228
199,25,1,0,0,3,1,0,25,0,55173,42443,75,0,58946,41228
200,26,2,1,0,3,1,0,52,26,55175,42444,78,0,58949,41228
201,26,1,1,2,1,2,1,166,194,55176,42445,191,64,58950,41229
202,26,3,4,1,0,0,3,78,104,55179,42449,0,88,58950,41232
203,26,0,0,2,1,2,1,66,96,55179,42449,98,26,58951,41233
204,26,2,1,0,3,1,0,150,145,55181,42450,193,0,58954,41233
205,26,1,0,0,3,1,0,169,168,55182,42450,237,109,58957,41233
206,26,1,1,2,1,2,1,86,86,55183,42451,86,86,58958,41234
207,26,1,0,0,3,1,0,26,0,55184,42451,78,0,58961,41234
208,27,2,1,0,3,1,0,54,27,55186,42452,81,0,58964,41234
209,27,1,1,2,1,2,1,167,195,55187,42453,192,65,58965,41235
210,27,3,4,1,0,0,3,81,108,55190,42457,0,91,58965,41238
211,27,0,0,2,1,2,1,66,96,55190,42457,99,27,58966,41239
212,27,2,1,0,3,1,0,152,146,55192,42458,196,0,58969,41239
213,27,1,0,0,3,1,0,170,168,55193,42458,240,109,58972,41239
214,27,1,1,2,1,2,1,87,87,55194,42459,87,87,58973,41240
215,27,1,0,0,3,1,0,27,0,55195,42459,81,0,58976,41240
216,28,2,1,0,3,1,0,56,28,55197,42460,84,0,58979,41240
217,28,1,1,2,1,2,1,168,196,55198,42461,193,66,58980,41241
218,28,3,4,1,0,0,3,84,112,55201,42465,0,94,58980,41244
219,28,0,0,2,1,2,1,66,96,55201,42465,100,28,58981,41245
220,28,2,1,0,3,1,0,154,147,55203,42466,199,0,58984,41245
221,28,1,0,0,3,1,0,171,168,55204,42466,243,109,58987,41245
222,28,1,1,2,1,2,1,88,88,55205,42467,88,88,58988,41246
223,28,1,0,0,3,1,0,28,0,55206,42467,84,0,58991,41246
224,29,2,1,0,3,1,0,58,29,55208,42468,87,0,58994,41246
225,29,1,1,2,1,2,1,169,197,55209,42469,194,67,58995,41247
226,29,3,4,1,0,0,3,87,116,55212,42473,0,97,58995,41250
227,29,0,0,2,1,2,1,66,96,55212,42473,101,29,58996,41251
228,29,2,1,0,3,1,0,156,148,55214,42474,202,0,58999,41251
229,29,1,0,0,3,1,0,172,168,55215,42474,246,109,59002,41251
230,29,1,1,2,1,2,1,89,89,55216,42475,89,89,59003,41252
231,29,1,0,0,3,1,0,29,0,55217,42475,87,0,59006,41252
232,30,2,1,0,3,1,0,60,30,55219,42476,90,0,59009,41252
233,30,1,1,2,1,2,1,170,198,55220,42477,195,68,59010,41253
234,30,3,4,1,0,0,3,90,120,55223,42481,0,100,59010,41256
235,30,0,0,2,1,2,1,66,96,55223,42481,102,30,59011,41257
236,30,2,1,0,3,1,0,158,149,55225,42482,205,0,59014,41257
237,30,1,0,0,3,1,0,173,168,55226,42482,249,109,59017,41257
238,30,1,1,2,1,2,1,90,90,55227,42483,90,90,59018,41258
239,30,1,0,0,3,1,0,30,0,55228,42483,90,0,59021,41258
0,1,2,2,2,1,2,1,2,2,55230,42485,1,101,59022,41259
1,1,0,0,2,1,2,1,170,198,55230,42485,196,1,59023,41260
2,1,0,1,1,0,0,3,12,25,55230,42486,11,3,59023,41263
3,1,2,0,0,3,1,0,175,168,55232,42486,252,52,59026,41263
4,1,3,2,0,3,1,0,22,19,55235,42488,27,68,59029,41263
5,1,2,0,0,3,1,0,32,0,55237,42488,93,30,59032,41263
6,1,0,0,2,1,2,1,131,122,55237,42488,146,1,59033,41264
7,1,0,0,2,1,2,1,90,90,55237,42488,91,91,59034,41265
8,2,2,2,2,1,2,1,4,4,55239,42490,2,102,59035,41266
9,2,0,0,2,1,2,1,170,198,55239,42490,197,2,59036,41267
10,2,0,1,1,0,0,3,12,26,55239,42491,11,6,59036,41270
11,2,2,0,0,3,1,0,177,168,55241,42491,255,52,59039,41270
12,2,3,2,0,3,1,0,25,21,55244,42493,30,68,59042,41270
13,2,2,0,0,3,1,0,34,0,55246,42493,96,30,59045,41270
14,2,0,0,2,1,2,1,131,122,55246,42493,147,2,59046,41271
15,2,0,0,2,1,2,1,90,90,55246,42493,92,92,59047,41272
16,3,2,2,2,1,2,1,6,6,55248,42495,3,103,59048,41273
17,3,0,0,2,1,2,1,170,198,55248,42495,198,3,59049,41274
18,3,0,1,1,0,0,3,12,27,55248,42496,11,9,59049,41277
19,3,2,0,0,3,1,0,179,168,55250,42496,258,52,59052,41277
20,3,3,2,0,3,1,0,28,23,55253,42498,33,68,59055,41277
21,3,2,0,0,3,1,0,36,0,55255,42498,99,30,59058,41277
22,3,0,0,2,1,2,1,131,122,55255,42498,148,3,59059,41278
23,3,0,0,2,1,2,1,90,90,55255,42498,93,93,59060,41279
24,4,2,2,2,1,2,1,8,8,55257,42500,4,104,59061,41280
25,4,0,0,2,1,2,1,170,198,55257,42500,199,4,59062,41281
26,4,0,1,1,0,0,3,12,28,55257,42501,11,12,59062,41284
27,4,2,0,0,3,1,0,181,168,55259,42501,261,52,59065,41284
28,4,3,2,0,3,1,0,31,25,55262,42503,36,68,59068,41284
29,4,2,0,0,3,1,0,38,0,55264,42503,102,30,59071,41284
30,4,0,0,2,1,2,1,131,122,55264,42503,149,4,59072,41285
31,4,0,0,2,1,2,1,90,90,55264,42503,94,94,59073,41286
32,5,2,2,2,1,2,1,10,10,55266,42505,5,105,59074,41287
33,5,0,0,2,1,2,1,170,198,55266,42505,200,5,59075,41288
34,5,0,1,1,0,0,3,12,29,55266,42506,11,15,59075,41291
35,5,2,0,0,3,1,0,183,168,55268,42506,264,52,59078,41291
36,5,3,2,0,3,1,0,34,27,55271,42508,39,68,59081,41291
37,5,2,0,0,3,1,0,40,0,55273,42508,105,30,59084,41291
38,5,0,0,2,1,2,1,131,122,55273,42508,150,5,59085,41292
39,5,0,0,2,1,2,1,90,90,55273,42508,95,95,59086,41293
40,6,2,2,2,1,2,1,12,12,55275,42510,6,106,59087,41294
41,6,0,0,2,1,2,1,170,198,55275,42510,201,6,59088,41295
42,6,0,1,1,0,0,3,12,30,55275,42511,11,18,59088,41298
43,6,2,0,0,3,1,0,185,168,55277,42511,267,52,59091,41298
44,6,3,2,0,3,1,0,37,29,55280,42513,42,68,59094,41298
45,6,2,0,0,3,1,0,42,0,55282,42513,108,30,59097,41298
46,6,0,0,2,1,2,1,131,122,55282,42513,151,6,59098,41299
47,6,0,0,2,1,2,1,90,90,55282,42513,96,96,59099,41300
48,7,2,2,2,1,2,1,14,14,55284,42515,7,107,59100,41301
49,7,0,0,2,1,2,1,170,198,55284,42515,202,7,59101,41302
50,7,0,1,1,0,0,3,12,31,55284,42516,11,21,59101,41305
51,7,2,0,0,3,1,0,187,168,55286,42516,270,52,59104,41305
52,7,3,2,0,3,1,0,40,31,55289,42518,45,68,59107,41305
53,7,2,0,0,3,1,0,44,0,55291,42518,111,30,59110,41305
54,7,0,0,2,1,2,1,131,122,55291,42518,152,7,59111,41306
55,7,0,0,2,1,2,1,90,90,55291,42518,97,97,59112,41307
56,8,2,2,2,1,2,1,16,16,55293,42520,8,108,59113,41308
57,8,0,0,2,1,2,1,170,198,55293,42520,203,8,59114,41309
58,8,0,1,1,0,0,3,12,32,55293,42521,11,24,59114,41312
59,8,2,0,0,3,1,0,189,168,55295,42521,273,52,59117,41312
60,8,3,2,0,3,1,0,43,33,55298,42523,48,68,59120,41312
61,8,2,0,0,3,1,0,46,0,55300,42523,114,30,59123,41312
62,8,0,0,2,1,2,1,131,122,55300,42523,153,8,59124,41313
63,8,0,0,2,1,2,1,90,90,55300,42523,98,98,59125,41314
64,9,2,2,2,1,2,1,18,18,55302,42525,9,109,59126,41315
65,9,0,0,2,1,2,1,170,198,55302,42525,204,9,59127,41316
66,9,0,1,1,0,0,3,12,33,55302,42526,11,27,59127,41319
67,9,2,0,0,3,1,0,191,168,55304,42526,276,52,59130,41319
68,9,3,2,0,3,1,0,46,35,55307,42528,51,68,59133,41319
69,9,2,0,0,3,1,0,48,0,55309,42528,117,30,59136,41319
70,9,0,0,2,1,2,1,131,122,55309,42528,154,9,59137,41320
71,9,0,0,2,1,2,1,90,90,55309,42528,99,99,59138,41321
72,10,2,2,2,1,2,1,20,20,55311,42530,10,110,59139,41322
73,10,0,0,2,1,2,1,170,198,55311,42530,205,10,59140,41323
74,10,0,1,1,0,0,3,12,34,55311,42531,11,30,59140,41326
75,10,2,0,0,3,1,0,193,168,55313,42531,279,52,59143,41326
76,10,3,2,0,3,1,0,49,37,55316,42533,54,68,59146,41326
77,10,2,0,0,3,1,0,50,0,55318,42533,120,30,59149,41326
78,10,0,0,2,1,2,1,131,122,55318,42533,155,10,59150,41327
79,10,0,0,2,1,2,1,90,90,55318,42533,100,100,59151,41328
80,11,2,2,2,1,2,1,22,22,55320,42535,11,111,59152,41329
81,11,0,0,2,1,2,1,170,198,55320,42535,206,11,59153,41330
82,11,0,1,1,0,0,3,12,35,55320,42536,11,33,59153,41333
83,11,2,0,0,3,1,0,195,168,55322,42536,282,52,59156,41333
84,11,3,2,0,3,1,0,52,39,55325,42538,57,68,59159,41333
85,11,2,0,0,3,1,0,52,0,55327,42538,123,30,59162,41333
86,11,0,0,2,1,2,1,131,122,55327,42538,156,11,59163,41334
87,11,0,0,2,1,2,1,90,90,55327,42538,101,101,59164,41335
88,12,2,2,2,1,2,1,24,24,55329,42540,12,112,59165,41336
89,12,0,0,2,1,2,1,170,198,55329,42540,207,12,59166,41337
90,12,0,1,1,0,0,3,12,36,55329,42541,11,36,59166,41340
91,12,2,0,0,3,1,0,197,168,55331,42541,285,52,59169,41340
92,12,3,2,0,3,1,0,55,41,55334,42543,60,68,59172,41340
93,12,2,0,0,3,1,0,54,0,55336,42543,126,30,59175,41340
94,12,0,0,2,1,2,1,131,122,55336,42543,157,12,59176,41341
95,12,0,0,2,1,2,1,90,90,55336,42543,102,102,59177,41342
96,13,2,2,2,1,2,1,26,26,55338,42545,13,113,59178,41343
97,13,0,0,2,1,2,1,170,198,55338,42545,208,13,59179,41344
98,13,0,1,1,0,0,3,12,37,55338,42546,11,39,59179,41347
99,13,2,0,0,3,1,0,199,168,55340,42546,288,52,59182,41347
100,13,3,2,0,3,1,0,58,43,55343,42548,63,68,59185,41347
101,13,2,0,0,3,1,0,56,0,55345,42548,129,30,59188,41347
102,13,0,0,2,1,2,1,131,122,55345,42548,158,13,59189,41348
103,13,0,0,2,1,2,1,90,90,55345,42548,103,103,59190,41349
104,14,2,2,2,1,2,1,28,28,55347,42550,14,114,59191,41350
105,14,0,0,2,1,2,1,170,198,55347,42550,209,14,59192,41351
106,14,0,1,1,0,0,3,12,38,55347,42551,11,42,59192,41354
107,14,2,0,0,3,1,0,201,168,55349,42551,291,52,59195,41354
108,14,3,2,0,3,1,0,61,45,55352,42553,66,68,59198,41354
109,14,2,0,0,3,1,0,58,0,55354,42553,132,30,59201,41354
110,14,0,0,2,1,2,1,131,122,55354,42553,159,14,59202,41355
111,14,0,0,2,1,2,1,90,90,55354,42553,104,104,59203,41356
112,15,2,2,2,1,2,1,30,30,55356,42555,15,115,59204,41357
113,15,0,0,2,1,2,1,170,198,55356,42555,210,15,59205,41358
114,15,0,1,1,0,0,3,12,39,55356,42556,11,45,59205,41361
115,15,2,0,0,3,1,0,203,168,55358,42556,294,52,59208,41361
116,15,3,2,0,3,1,0,64,47,55361,42558,69,68,59211,41361
117,15,2,0,0,3,1,0,60,0,55363,42558,135,30,59214,41361
118,15,0,0,2,1,2,1,131,122,55363,42558,160,15,59215,41362
119,15,0,0,2,1,2,1,90,90,55363,42558,105,105,59216,41363
120,16,2,2,2,1,2,1,32,32,55365,42560,16,116,59217,41364
121,16,0,0,2,1,2,1,170,198,55365,42560,211,16,59218,41365
122,16,0,1,1,0,0,3,12,40,55365,42561,11,48,59218,41368
123,16,2,0,0,3,1,0,205,168,55367,42561,297,52,59221,41368
124,16,3,2,0,3,1,0,67,49,55370,42563,72,68,59224,41368
125,16,2,0,0,3,1,0,62,0,55372,42563,138,30,59227,41368
126,16,0,0,2,1,2,1,131,122,55372,42563,161,16,59228,41369
127,16,0,0,2,1,2,1,90,90,55372,42563,106,106,59229,41370
128,17,2,2,2,1,2,1,34,34,55374,42565,17,117,59230,41371
129,17,0,0,2,1,2,1,170,198,55374,42565,212,17,59231,41372
130,17,0,1,1,0,0,3,12,41,55374,42566,11,51,59231,41375
131,17,2,0,0,3,1,0,207,168,55376,42566,300,52,59234,41375
132,17,3,2,0,3,1,0,70,51,55379,42568,75,68,59237,41375
133,17,2,0,0,3,1,0,64,0,55381,42568,141,30,59240,41375
134,17,0,0,2,1,2,1,131,122,55381,42568,162,17,59241,41376
135,17,0,0,2,1,2,1,90,90,55381,42568,107,107,59242,41377
136,18,2,2,2,1,2,1,36,36,55383,42570,18,118,59243,41378
137,18,0,0,2,1,2,1,170,198,55383,42570,213,18,59244,41379
138,18,0,1,1,0,0,3,12,42,55383,42571,11,54,59244,41382
139,18,2,0,0,3,1,0,209,168,55385,42571,303,52,59247,41382
140,18,3,2,0,3,1,0,73,53,55388,42573,78,68,59250,41382
141,18,2,0,0,3,1,0,66,0,55390,42573,144,30,59253,41382
142,18,0,0,2,1,2,1,131,122,55390,42573,163,18,59254,41383
143,18,0,0,2,1,2,1,90,90,55390,42573,108,108,59255,41384
144,19,2,2,2,1,2,1,38,38,55392,42575,19,119,59256,41385
145,19,0,0,2,1,2,1,170,198,55392,42575,214,19,59257,41386
146,19,0,1,1,0,0,3,12,43,55392,42576,11,57,59257,41389
147,19,2,0,0,3,1,0,211,168,55394,42576,306,52,59260,41389
148,19,3,2,0,3,1,0,76,55,55397,42578,81,68,59263,41389
149,19,2,0,0,3,1,0,68,0,55399,42578,147,30,59266,41389
150,19,0,0,2,1,2,1,131,122,55399,42578,164,19,59267,41390
151,19,0,0,2,1,2,1,90,90,55399,42578,109,109,59268,41391
152,20,2,2,2,1,2,1,40,40,55401,42580,20,120,59269,41392
153,20,0,0,2,1,2,1,170,198,55401,42580,215,20,59270,41393
154,20,0,1,1,0,0,3,12,44,55401,42581,11,60,59270,41396
155,20,2,0,0,3,1,0,213,168,55403,42581,309,52,59273,41396
156,20,3,2,0,3,1,0,79,57,55406,42583,84,68,59276,41396
157,20,2,0,0,3,1,0,70,0,55408,42583,150,30,59279,41396
158,20,0,0,2,1,2,1,131,122,55408,42583,165,20,59280,41397
159,20,0,0,2,1,2,1,90,90,55408,42583,110,110,59281,41398
160,21,2,2,2,1,2,1,42,42,55410,42585,21,121,59282,41399
161,21,0,0,2,1,2,1,170,198,55410,42585,216,21,59283,41400
162,21,0,1,1,0,0,3,12,45,55410,42586,11,63,59283,41403
163,21,2,0,0,3,1,0,215,168,55412,42586,312,52,59286,41403
164,21,3,2,0,3,1,0,82,59,55415,42588,87,68,59289,41403
165,21,2,0,0,3,1,0,72,0,55417,42588,153,30,59292,41403
166,21,0,0,2,1,2,1,131,122,55417,42588,166,21,59293,41404
167,21,0,0,2,1,2,1,90,90,55417,42588,111,111,59294,41405
168,22,2,2,2,1,2,1,44,44,55419,42590,22,122,59295,41406
169,22,0,0,2,1,2,1,170,198,55419,42590,217,22,59296,41407
170,22,0,1,1,0,0,3,12,46,55419,42591,11,66,59296,41410
171,22,2,0,0,3,1,0,217,168,55421,42591,315,52,59299,41410
172,22,3,2,0,3,1,0,85,61,55424,42593,90,68,59302,41410
173,22,2,0,0,3,1,0,74,0,55426,42593,156,30,59305,41410
174,22,0,0,2,1,2,1,131,122,55426,42593,167,22,59306,41411
175,22,0,0,2,1,2,1,90,90,55426,42593,112,112,59307,41412
176,23,2,2,2,1,2,1,46,46,55428,42595,23,123,59308,41413
177,23,0,0,2,1,2,1,170,198,55428,42595,218,23,59309,41414
178,23,0,1,1,0,0,3,12,47,55428,42596,11,69,59309,41417
179,23,2,0,0,3,1,0,219,168,55430,42596,318,52,59312,41417
180,23,3,2,0,3,1,0,88,63,55433,42598,93,68,59315,41417
181,23,2,0,0,3,1,0,76,0,55435,42598,159,30,59318,41417
182,23,0,0,2,1,2,1,131,122,55435,42598,168,23,59319,41418
183,23,0,0,2,1,2,1,90,90,55435,42598,113,113,59320,41419
184,24,2,2,2,1,2,1,48,48,55437,42600,24,124,59321,41420
185,24,0,0,2,1,2,1,170,198,55437,42600,219,24,59322,41421
186,24,0,1,1,0,0,3,12,48,55437,42601,11,72,59322,41424
187,24,2,0,0,3,1,0,221,168,55439,42601,321,52,59325,41424
188,24,3,2,0,3,1,0,91,65,55442,42603,96,68,59328,41424
189,24,2,0,0,3,1,0,78,0,55444,42603,162,30,59331,41424
190,24,0,0,2,1,2,1,131,122,55444,42603,169,24,59332,41425
191,24,0,0,2,1,2,1,90,90,55444,42603,114,114,59333,41426
192,25,2,2,2,1,2,1,50,50,55446,42605,25,125,59334,41427
193,25,0,0,2,1,2,1,170,198,55446,42605,220,25,59335,41428
194,25,0,1,1,0,0,3,12,49,55446,42606,11,75,59335,41431
195,25,2,0,0,3,1,0,223,168,55448,42606,324,52,59338,41431
196,25,3,2,0,3,1,0,94,67,55451,42608,99,68,59341,41431
197,25,2,0,0,3,1,0,80,0,55453,42608,165,30,59344,41431
198,25,0,0,2,1,2,1,131,122,55453,42608,170,25,59345,41432
199,25,0,0,2,1,2,1,90,90,55453,42608,115,115,59346,41433
200,26,2,2,2,1,2,1,52,52,55455,42610,26,126,59347,41434
201,26,0,0,2,1,2,1,170,198,55455,42610,221,26,59348,41435
202,26,0,1,1,0,0,3,12,50,55455,42611,11,78,59348,41438
203,26,2,0,0,3,1,0,225,168,55457,42611,327,52,59351,41438
204,26,3,2,0,3,1,0,97,69,55460,42613,102,68,59354,41438
205,26,2,0,0,3,1,0,82,0,55462,42613,168,30,59357,41438
206,26,0,0,2,1,2,1,131,122,55462,42613,171,26,59358,41439
207,26,0,0,2,1,2,1,90,90,55462,42613,116,116,59359,41440
208,27,2,2,2,1,2,1,54,54,55464,42615,27,127,59360,41441
209,27,0,0,2,1,2,1,170,198,55464,42615,222,27,59361,41442
210,27,0,1,1,0,0,3,12,51,55464,42616,11,81,59361,41445
211,27,2,0,0,3,1,0,227,168,55466,42616,330,52,59364,41445
212,27,3,2,0,3,1,0,100,71,55469,42618,105,68,59367,41445
213,27,2,0,0,3,1,0,84,0,55471,42618,171,30,59370,41445
214,27,0,0,2,1,2,1,131,122,55471,42618,172,27,59371,41446
215,27,0,0,2,1,2,1,90,90,55471,42618,117,117,59372,41447
216,28,2,2,2,1,2,1,56,56,55473,42620,28,128,59373,41448
217,28,0,0,2,1,2,1,170,198,55473,42620,223,28,59374,41449
218,28,0,1,1,0,0,3,12,52,55473,42621,11,84,59374,41452
219,28,2,0,0,3,1,0,229,168,55475,42621,333,52,59377,41452
220,28,3,2,0,3,1,0,103,73,55478,42623,108,68,59380,41452
221,28,2,0,0,3,1,0,86,0,55480,42623,174,30,59383,41452
222,28,0,0,2,1,2,1,131,122,55480,42623,173,28,59384,41453
223,28,0,0,2,1,2,1,90,90,55480,42623,118,118,59385,41454
224,29,2,2,2,1,2,1,58,58,55482,42625,29,129,59386,41455
225,29,0,0,2,1,2,1,170,198,55482,42625,224,29,59387,41456
226,29,0,1,1,0,0,3,12,53,55482,42626,11,87,59387,41459
227,29,2,0,0,3,1,0,231,168,55484,42626,336,52,59390,41459
228,29,3,2,0,3,1,0,106,75,55487,42628,111,68,59393,41459
229,29,2,0,0,3,1,0,88,0,55489,42628,177,30,59396,41459
230,29,0,0,2,1,2,1,131,122,55489,42628,174,29,59397,41460
231,29,0,0,2,1,2,1,90,90,55489,42628,119,119,59398,41461
232,30,2,2,2,1,2,1,60,60,55491,42630,30,130,59399,41462
233,30,0,0,2,1,2,1,170,198,55491,42630,225,30,59400,41463
234,30,0,1,1,0,0,3,12,54,55491,42631,11,90,59400,41466
235,30,2,0,0,3,1,0,233,168,55493,42631,339,52,59403,41466
236,30,3,2,0,3,1,0,109,77,55496,42633,114,68,59406,41466
237,30,2,0,0,3,1,0,90,0,55498,42633,180,30,59409,41466
238,30,0,0,2,1,2,1,131,122,55498,42633,175,30,59410,41467
239,30,0,0,2,1,2,1,90,90,55498,42633,120,120,59411,41468
0,1,3,1,0,3,1,0,173,199,55501,42634,228,51,59414,41468
1,1,1,0,0,3,1,0,91,0,55502,42634,183,0,59417,41468
2,1,2,2,2,1,2,1,2,2,55504,42636,1,1,59418,41469
3,1,2,2,2,1,2,1,110,138,55506,42638,117,1,59419,41470
4,1,1,3,1,0,0,3,13,57,55507,42641,11,63,59419,41473
5,1,0,0,2,1,2,1,0,0,55507,42641,1,31,59420,41474
6,1,2,1,0,3,1,0,111,78,55509,42642,117,30,59423,41474
7,1,2,0,0,3,1,0,19,37,55511,42642,15,30,59426,41474
8,1,1,0,0,3,1,0,1,0,55512,42642,3,0,59429,41474
9,1,1,3,1,0,0,3,115,107,55513,42645,112,123,59429,41477
10,1,2,0,0,3,1,0,51,73,55515,42645,52,0,59432,41477
11,2,3,1,0,3,1,0,176,200,55518,42646,231,51,59435,41477
12,2,1,0,0,3,1,0,92,0,55519,42646,186,0,59438,41477
13,2,2,2,2,1,2,1,4,4,55521,42648,2,2,59439,41478
14,2,2,2,2,1,2,1,112,140,55523,42650,118,2,59440,41479
15,2,1,3,1,0,0,3,14,60,55524,42653,11,66,59440,41482
16,2,0,0,2,1,2,1,0,0,55524,42653,2,32,59441,41483
17,2,2,1,0,3,1,0,113,79,55526,42654,120,30,59444,41483
18,2,2,0,0,3,1,0,21,37,55528,42654,18,30,59447,41483
19,2,1,0,0,3,1,0,2,0,55529,42654,6,0,59450,41483
20,2,1,3,1,0,0,3,116,110,55530,42657,112,126,59450,41486
21,2,2,0,0,3,1,0,53,73,55532,42657,55,0,59453,41486
22,3,3,1,0,3,1,0,179,201,55535,42658,234,51,59456,41486
23,3,1,0,0,3,1,0,93,0,55536,42658,189,0,59459,41486
24,3,2,2,2,1,2,1,6,6,55538,42660,3,3,59460,41487
25,3,2,2,2,1,2,1,114,142,55540,42662,119,3,59461,41488
26,3,1,3,1,0,0,3,15,63,55541,42665,11,69,59461,41491
27,3,0,0,2,1,2,1,0,0,55541,42665,3,33,59462,41492
28,3,2,1,0,3,1,0,115,80,55543,42666,123,30,59465,41492
29,3,2,0,0,3,1,0,23,37,55545,42666,21,30,59468,41492
30,3,1,0,0,3,1,0,3,0,55546,42666,9,0,59471,41492
31,3,1,3,1,0,0,3,117,113,55547,42669,112,129,59471,41495
32,3,2,0,0,3,1,0,55,73,55549,42669,58,0,59474,41495
33,4,3,1,0,3,1,0,182,202,55552,42670,237,51,59477,41495
34,4,1,0,0,3,1,0,94,0,55553,42670,192,0,59480,41495
35,4,2,2,2,1,2,1,8,8,55555,42672,4,4,59481,41496
36,4,2,2,2,1,2,1,116,144,55557,42674,120,4,59482,41497
37,4,1,3,1,0,0,3,16,66,55558,42677,11,72,59482,41500
38,4,0,0,2,1,2,1,0,0,55558,42677,4,34,59483,41501
39,4,2,1,0,3,1,0,117,81,55560,42678,126,30,59486,41501
40,4,2,0,0,3,1,0,25,37,55562,42678,24,30,59489,41501
41,4,1,0,0,3,1,0,4,0,55563,42678,12,0,59492,41501
42,4,1,3,1,0,0,3,118,116,55564,42681,112,132,59492,41504
43,4,2,0,0,3,1,0,57,73,55566,42681,61,0,59495,41504
44,5,3,1,0,3,1,0,185,203,55569,42682,240,51,59498,41504
45,5,1,0,0,3,1,0,95,0,55570,42682,195,0,59501,41504
46,5,2,2,2,1,2,1,10,10,55572,42684,5,5,59502,41505
47,5,2,2,2,1,2,1,118,146,55574,42686,121,5,59503,41506
48,5,1,3,1,0,0,3,17,69,55575,42689,11,75,59503,41509
49,5,0,0,2,1,2,1,0,0,55575,42689,5,35,59504,41510
50,5,2,1,0,3,1,0,119,82,55577,42690,129,30,59507,41510
51,5,2,0,0,3,1,0,27,37,55579,42690,27,30,59510,41510
52,5,1,0,0,3,1,0,5,0,55580,42690,15,0,59513,41510
53,5,1,3,1,0,0,3,119,119,55581,42693,112,135,59513,41513
54,5,2,0,0,3,1,0,59,73,55583,42693,64,0,59516,41513
55,6,3,1,0,3,1,0,188,204,55586,42694,243,51,59519,41513
56,6,1,0,0,3,1,0,96,0,55587,42694,198,0,59522,41513
57,6,2,2,2,1,2,1,12,12,55589,42696,6,6,59523,41514
58,6,2,2,2,1,2,1,120,148,55591,42698,122,6,59524,41515
59,6,1,3,1,0,0,3,18,72,55592,42701,11,78,59524,41518
60,6,0,0,2,1,2,1,0,0,55592,42701,6,36,59525,41519
61,6,2,1,0,3,1,0,121,83,55594,42702,132,30,59528,41519
62,6,2,0,0,3,1,0,29,37,55596,42702,30,30,59531,41519
63,6,1,0,0,3,1,0,6,0,55597,42702,18,0,59534,41519
64,6,1,3,1,0,0,3,120,122,55598,42705,112,138,59534,41522
65,6,2,0,0,3,1,0,61,73,55600,42705,67,0,59537,41522
66,7,3,1,0,3,1,0,191,205,55603,42706,246,51,59540,41522
67,7,1,0,0,3,1,0,97,0,55604,42706,201,0,59543,41522
68,7,2,2,2,1,2,1,14,14,55606,42708,7,7,59544,41523
69,7,2,2,2,1,2,1,122,150,55608,42710,123,7,59545,41524
70,7,1,3,1,0,0,3,19,75,55609,42713,11,81,59545,41527
71,7,0,0,2,1,2,1,0,0,55609,42713,7,37,59546,41528
72,7,2,1,0,3,1,0,123,84,55611,42714,135,30,59549,41528
73,7,2,0,0,3,1,0,31,37,55613,42714,33,30,59552,41528
74,7,1,0,0,3,1,0,7,0,55614,42714,21,0,59555,41528
75,7,1,3,1,0,0,3,121,125,55615,42717,112,141,59555,41531
76,7,2,0,0,3,1,0,63,73,55617,42717,70,0,59558,41531
77,8,3,1,0,3,1,0,194,206,55620,42718,249,51,59561,41531
78,8,1,0,0,3,1,0,98,0,55621,42718,204,0,59564,41531
79,8,2,2,2,1,2,1,16,16,55623,42720,8,8,59565,41532
80,8,2,2,2,1,2,1,124,152,55625,42722,124,8,59566,41533
81,8,1,3,1,0,0,3,20,78,55626,42725,11,84,59566,41536
82,8,0,0,2,1,2,1,0,0,55626,42725,8,38,59567,41537
83,8,2,1,0,3,1,0,125,85,55628,42726,138,30,59570,41537
84,8,2,0,0,3,1,0,33,37,55630,42726,36,30,59573,41537
85,8,1,0,0,3,1,0,8,0,55631,42726,24,0,59576,41537
86,8,1,3,1,0,0,3,122,128,55632,42729,112,144,59576,41540
87,8,2,0,0,3,1,0,65,73,55634,42729,73,0,59579,41540
88,9,3,1,0,3,1,0,197,207,55637,42730,252,51,59582,41540
89,9,1,0,0,3,1,0,99,0,55638,42730,207,0,59585,41540
90,9,2,2,2,1,2,1,18,18,55640,42732,9,9,59586,41541
91,9,2,2,2,1,2,1,126,154,55642,42734,125,9,59587,41542
92,9,1,3,1,0,0,3,21,81,55643,42737,11,87,59587,41545
93,9,0,0,2,1,2,1,0,0,55643,42737,9,39,59588,41546
94,9,2,1,0,3,1,0,127,86,55645,42738,141,30,59591,41546
95,9,2,0,0,3,1,0,35,37,55647,42738,39,30,59594,41546
96,9,1,0,0,3,1,0,9,0,55648,42738,27,0,59597,41546
97,9,1,3,1,0,0,3,123,131,55649,42741,112,147,59597,41549
98,9,2,0,0,3,1,0,67,73,55651,42741,76,0,59600,41549
99,10,3,1,0,3,1,0,200,208,55654,42742,255,51,59603,41549
100,10,1,0,0,3,1,0,100,0,55655,42742,210,0,59606,41549
101,10,2,2,2,1,2,1,20,20,55657,42744,10,10,59607,41550
102,10,2,2,2,1,2,1,128,156,55659,42746,126,10,59608,41551
103,10,1,3,1,0,0,3,22,84,55660,42749,11,90,59608,41554
104,10,0,0,2,1,2,1,0,0,55660,42749,10,40,59609,41555
105,10,2,1,0,3,1,0,129,87,55662,42750,144,30,59612,41555
106,10,2,0,0,3,1,0,37,37,55664,42750,42,30,59615,41555
107,10,1,0,0,3,1,0,10,0,55665,42750,30,0,59618,41555
108,10,1,3,1,0,0,3,124,134,55666,42753,112,150,59618,41558
109,10,2,0,0,3,1,0,69,73,55668,42753,79,0,59621,41558
110,11,3,1,0,3,1,0,203,209,55671,42754,258,51,59624,41558
111,11,1,0,0,3,1,0,101,0,55672,42754,213,0,59627,41558
112,11,2,2,2,1,2,1,22,22,55674,42756,11,11,59628,41559
113,11,2,2,2,1,2,1,130,158,55676,42758,127,11,59629,41560
114,11,1,3,1,0,0,3,23,87,55677,42761,11,93,59629,41563
115,11,0,0,2,1,2,1,0,0,55677,42761,11,41,59630,41564
116,11,2,1,0,3,1,0,131,88,55679,42762,147,30,59633,41564
117,11,2,0,0,3,1,0,39,37,55681,42762,45,30,59636,41564
118,11,1,0,0,3,1,0,11,0,55682,42762,33,0,59639,41564
119,11,1,3,1,0,0,3,125,137,55683,42765,112,153,59639,41567
120,11,2,0,0,3,1,0,71,73,55685,42765,82,0,59642,41567
121,12,3,1,0,3,1,0,206,210,55688,42766,261,51,59645,41567
122,12,1,0,0,3,1,0,102,0,55689,42766,216,0,59648,41567
123,12,2,2,2,1,2,1,24,24,55691,42768,12,12,59649,41568
124,12,2,2,2,1,2,1,132,160,55693,42770,128,12,59650,41569
125,12,1,3,1,0,0,3,24,90,55694,42773,11,96,59650,41572
126,12,0,0,2,1,2,1,0,0,55694,42773,12,42,59651,41573
127,12,2,1,0,3,1,0,133,89,55696,42774,150,30,59654,41573
128,12,2,0,0,3,1,0,41,37,55698,42774,48,30,59657,41573
129,12,1,0,0,3,1,0,12,0,55699,42774,36,0,59660,41573
130,12,1,3,1,0,0,3,126,140,55700,42777,112,156,59660,41576
131,12,2,0,0,3,1,0,73,73,55702,42777,85,0,59663,41576
132,13,3,1,0,3,1,0,209,211,55705,42778,264,51,59666,41576
133,13,1,0,0,3,1,0,103,0,55706,42778,219,0,59669,41576
134,13,2,2,2,1,2,1,26,26,55708,42780,13,13,59670,41577
135,13,2,2,2,1,2,1,134,162,55710,42782,129,13,59671,41578
136,13,1,3,1,0,0,3,25,93,55711,42785,11,99,59671,41581
137,13,0,0,2,1,2,1,0,0,55711,42785,13,43,59672,41582
138,13,2,1,0,3,1,0,135,90,55713,42786,153,30,59675,41582
139,13,2,0,0,3,1,0,43,37,55715,42786,51,30,59678,41582
140,13,1,0,0,3,1,0,13,0,55716,42786,39,0,59681,41582
141,13,1,3,1,0,0,3,127,143,55717,42789,112,159,59681,41585
142,13,2,0,0,3,1,0,75,73,55719,42789,88,0,59684,41585
143,14,3,1,0,3,1,0,212,212,55722,42790,267,51,59687,41585
144,14,1,0,0,3,1,0,104,0,55723,42790,222,0,59690,41585
145,14,2,2,2,1,2,1,28,28,55725,42792,14,14,59691,41586
146,14,2,2,2,1,2,1,136,164,55727,42794,130,14,59692,41587
147,14,1,3,1,0,0,3,26,96,55728,42797,11,102,59692,41590
148,14,0,0,2,1,2,1,0,0,55728,42797,14,44,59693,41591
149,14,2,1,0,3,1,0,137,91,55730,42798,156,30,59696,41591
150,14,2,0,0,3,1,0,45,37,55732,42798,54,30,59699,41591
151,14,1,0,0,3,1,0,14,0,55733,42798,42,0,59702,41591
152,14,1,3,1,0,0,3,128,146,55734,42801,112,162,59702,41594
153,14,2,0,0,3,1,0,77,73,55736,42801,91,0,59705,41594
154,15,3,1,0,3,1,0,215,213,55739,42802,270,51,59708,41594
155,15,1,0,0,3,1,0,105,0,55740,42802,225,0,59711,41594
156,15,2,2,2,1,2,1,30,30,55742,42804,15,15,59712,41595
157,15,2,2,2,1,2,1,138,166,55744,42806,131,15,59713,41596
158,15,1,3,1,0,0,3,27,99,55745,42809,11,105,59713,41599
159,15,0,0,2,1,2,1,0,0,55745,42809,15,45,59714,41600
160,15,2,1,0,3,1,0,139,92,55747,42810,159,30,59717,41600
161,15,2,0,0,3,1,0,47,37,55749,42810,57,30,59720,41600
162,15,1,0,0,3,1,0,15,0,55750,42810,45,0,59723,41600
163,15,1,3,1,0,0,3,129,149,55751,42813,112,165,59723,41603
164,15,2,0,0,3,1,0,79,73,55753,42813,94,0,59726,41603
165,16,3,1,0,3,1,0,218,214,55756,42814,273,51,59729,41603
166,16,1,0,0,3,1,0,106,0,55757,42814,228,0,59732,41603
167,16,2,2,2,1,2,1,32,32,55759,42816,16,16,59733,41604
168,16,2,2,2,1,2,1,140,168,55761,42818,132,16,59734,41605
169,16,1,3,1,0,0,3,28,102,55762,42821,11,108,59734,41608
170,16,0,0,2,1,2,1,0,0,55762,42821,16,46,59735,41609
171,16,2,1,0,3,1,0,141,93,55764,42822,162,30,59738,41609
172,16,2,0,0,3,1,0,49,37,55766,42822,60,30,59741,41609
173,16,1,0,0,3,1,0,16,0,55767,42822,48,0,59744,41609
174,16,1,3,1,0,0,3,130,152,55768,42825,112,168,59744,41612
175,16,2,0,0,3,1,0,81,73,55770,42825,97,0,59747,41612
176,17,3,1,0,3,1,0,221,215,55773,42826,276,51,59750,41612
177,17,1,0,0,3,1,0,107,0,55774,42826,231,0,59753,41612
178,17,2,2,2,1,2,1,34,34,55776,42828,17,17,59754,41613
179,17,2,2,2,1,2,1,142,170,55778,42830,133,17,59755,41614
180,17,1,3,1,0,0,3,29,105,55779,42833,11,111,59755,41617
181,17,0,0,2,1,2,1,0,0,55779,42833,17,47,59756,41618
182,17,2,1,0,3,1,0,143,94,55781,42834,165,30,59759,41618
183,17,2,0,0,3,1,0,51,37,55783,42834,63,30,59762,41618
184,17,1,0,0,3,1,0,17,0,55784,42834,51,0,59765,41618
185,17,1,3,1,0,0,3,131,155,55785,42837,112,171,59765,41621
186,17,2,0,0,3,1,0,83,73,55787,42837,100,0,59768,41621
187,18,3,1,0,3,1,0,224,216,55790,42838,279,51,59771,41621
188,18,1,0,0,3,1,0,108,0,55791,42838,234,0,59774,41621
189,18,2,2,2,1,2,1,36,36,55793,42840,18,18,59775,41622
190,18,2,2,2,1,2,1,144,172,55795,42842,134,18,59776,41623
191,18,1,3,1,0,0,3,30,108,55796,42845,11,114,59776,41626
192,18,0,0,2,1,2,1,0,0,55796,42845,18,48,59777,41627
193,18,2,1,0,3,1,0,145,95,55798,42846,168,30,59780,41627
194,18,2,0,0,3,1,0,53,37,55800,42846,66,30,59783,41627
195,18,1,0,0,3,1,0,18,0,55801,42846,54,0,59786,41627
196,18,1,3,1,0,0,3,132,158,55802,42849,112,174,59786,41630
197,18,2,0,0,3,1,0,85,73,55804,42849,103,0,59789,41630
198,19,3,1,0,3,1,0,227,217,55807,42850,282,51,59792,41630
199,19,1,0,0,3,1,0,109,0,55808,42850,237,0,59795,41630
200,19,2,2,2,1,2,1,38,38,55810,42852,19,19,59796,41631
201,19,2,2,2,1,2,1,146,174,55812,42854,135,19,59797,41632
202,19,1,3,1,0,0,3,31,111,55813,42857,11,117,59797,41635
203,19,0,0,2,1,2,1,0,0,55813,42857,19,49,59798,41636
204,19,2,1,0,3,1,0,147,96,55815,42858,171,30,59801,41636
205,19,2,0,0,3,1,0,55,37,55817,42858,69,30,59804,41636
206,19,1,0,0,3,1,0,19,0,55818,42858,57,0,59807,41636
207,19,1,3,1,0,0,3,133,161,55819,42861,112,177,59807,41639
208,19,2,0,0,3,1,0,87,73,55821,42861,106,0,59810,41639
209,20,3,1,0,3,1,0,230,218,55824,42862,285,51,59813,41639
210,20,1,0,0,3,1,0,110,0,55825,42862,240,0,59816,41639
211,20,2,2,2,1,2,1,40,40,55827,42864,20,20,59817,41640
212,20,2,2,2,1,2,1,148,176,55829,42866,136,20,59818,41641
213,20,1,3,1,0,0,3,32,114,55830,42869,11,120,59818,41644
214,20,0,0,2,1,2,1,0,0,55830,42869,20,50,59819,41645
215,20,2,1,0,3,1,0,149,97,55832,42870,174,30,59822,41645
216,20,2,0,0,3,1,0,57,37,55834,42870,72,30,59825,41645
217,20,1,0,0,3,1,0,20,0,55835,42870,60,0,59828,41645
218,20,1,3,1,0,0,3,134,164,55836,42873,112,180,59828,41648
219,20,2,0,0,3,1,0,89,73,55838,42873,109,0,59831,41648
220,21,3,1,0,3,1,0,233,219,55841,42874,288,51,59834,41648
221,21,1,0,0,3,1,0,111,0,55842,42874,243,0,59837,41648
222,21,2,2,2,1,2,1,42,42,55844,42876,21,21,59838,41649
223,21,2,2,2,1,2,1,150,178,55846,42878,137,21,59839,41650
224,21,1,3,1,0,0,3,33,117,55847,42881,11,123,59839,41653
225,21,0,0,2,1,2,1,0,0,55847,42881,21,51,59840,41654
226,21,2,1,0,3,1,0,151,98,55849,42882,177,30,59843,41654
227,21,2,0,0,3,1,0,59,37,55851,42882,75,30,59846,41654
228,21,1,0,0,3,1,0,21,0,55852,42882,63,0,59849,41654
229,21,1,3,1,0,0,3,135,167,55853,42885,112,183,59849,41657
230,21,2,0,0,3,1,0,91,73,55855,42885,112,0,59852,41657
231,22,3,1,0,3,1,0,236,220,55858,42886,291,51,59855,41657
232,22,1,0,0,3,1,0,112,0,55859,42886,246,0,59858,41657
233,22,2,2,2,1,2,1,44,44,55861,42888,22,22,59859,41658
234,22,2,2,2,1,2,1,152,180,55863,42890,138,22,59860,41659
235,22,1,3,1,0,0,3,34,120,55864,42893,11,126,59860,41662
236,22,0,0,2,1,2,1,0,0,55864,42893,22,52,59861,41663
237,22,2,1,0,3,1,0,153,99,55866,42894,180,30,59864,41663
238,22,2,0,0,3,1,0,61,37,55868,42894,78,30,59867,41663
239,22,1,0,0,3,1,0,22,0,55869,42894,66,0,59870,41663
240,22,1,3,1,0,0,3,136,170,55870,42897,112,186,59870,41666
241,22,2,0,0,3,1,0,93,73,55872,42897,115,0,59873,41666
242,23,3,1,0,3,1,0,239,221,55875,42898,294,51,59876,41666
243,23,1,0,0,3,1,0,113,0,55876,42898,249,0,59879,41666
244,23,2,2,2,1,2,1,46,46,55878,42900,23,23,59880,41667
245,23,2,2,2,1,2,1,154,182,55880,42902,139,23,59881,41668
246,23,1,3,1,0,0,3,35,123,55881,42905,11,129,59881,41671
247,23,0,0,2,1,2,1,0,0,55881,42905,23,53,59882,41672
248,23,2,1,0,3,1,0,155,100,55883,42906,183,30,59885,41672
249,23,2,0,0,3,1,0,63,37,55885,42906,81,30,59888,41672
250,23,1,0,0,3,1,0,23,0,55886,42906,69,0,59891,41672
251,23,1,3,1,0,0,3,137,173,55887,42909,112,189,59891,41675
252,23,2,0,0,3,1,0,95,73,55889,42909,118,0,59894,41675
253,24,3,1,0,3,1,0,242,222,55892,42910,297,51,59897,41675
254,24,1,0,0,3,1,0,114,0,55893,42910,252,0,59900,41675
255,24,2,2,2,1,2,1,48,48,55895,42912,24,24,59901,41676
256,24,2,2,2,1,2,1,156,184,55897,42914,140,24,59902,41677
257,24,1,3,1,0,0,3,36,126,55898,42917,11,132,59902,41680
258,24,0,0,2,1,2,1,0,0,55898,42917,24,54,59903,41681
259,24,2,1,0,3,1,0,157,101,55900,42918,186,30,59906,41681
260,24,2,0,0,3,1,0,65,37,55902,42918,84,30,59909,41681
261,24,1,0,0,3,1,0,24,0,55903,42918,72,0,59912,41681
262,24,1,3,1,0,0,3,138,176,55904,42921,112,192,59912,41684
263,24,2,0,0,3,1,0,97,73,55906,42921,121,0,59915,41684
264,25,3,1,0,3,1,0,245,223,55909,42922,300,51,59918,41684
265,25,1,0,0,3,1,0,115,0,55910,42922,255,0,59921,41684
266,25,2,2,2,1,2,1,50,50,55912,42924,25,25,59922,41685
267,25,2,2,2,1,2,1,158,186,55914,42926,141,25,59923,41686
268,25,1,3,1,0,0,3,37,129,55915,42929,11,135,59923,41689
269,25,0,0,2,1,2,1,0,0,55915,42929,25,55,59924,41690
270,25,2,1,0,3,1,0,159,102,55917,42930,189,30,59927,41690
271,25,2,0,0,3,1,0,67,37,55919,42930,87,30,59930,41690
272,25,1,0,0,3,1,0,25,0,55920,42930,75,0,59933,41690
273,25,1,3,1,0,0,3,139,179,55921,42933,112,195,59933,41693
274,25,2,0,0,3,1,0,99,73,55923,42933,124,0,59936,41693
275,26,3,1,0,3,1,0,248,224,55926,42934,303,51,59939,41693
276,26,1,0,0,3,1,0,116,0,55927,42934,258,0,59942,41693
277,26,2,2,2,1,2,1,52,52,55929,42936,26,26,59943,41694
278,26,2,2,2,1,2,1,160,188,55931,42938,142,26,59944,41695
279,26,1,3,1,0,0,3,38,132,55932,42941,11,138,59944,41698
280,26,0,0,2,1,2,1,0,0,55932,42941,26,56,59945,41699
281,26,2,1,0,3,1,0,161,103,55934,42942,192,30,59948,41699
282,26,2,0,0,3,1,0,69,37,55936,42942,90,30,59951,41699
283,26,1,0,0,3,1,0,26,0,55937,42942,78,0,59954,41699
284,26,1,3,1,0,0,3,140,182,55938,42945,112,198,59954,41702
285,26,2,0,0,3,1,0,101,73,55940,42945,127,0,59957,41702
286,27,3,1,0,3,1,0,251,225,55943,42946,306,51,59960,41702
287,27,1,0,0,3,1,0,117,0,55944,42946,261,0,59963,41702
288,27,2,2,2,1,2,1,54,54,55946,42948,27,27,59964,41703
289,27,2,2,2,1,2,1,162,190,55948,42950,143,27,59965,41704
290,27,1,3,1,0,0,3,39,135,55949,42953,11,141,59965,41707
291,27,0,0,2,1,2,1,0,0,55949,42953,27,57,59966,41708
292,27,2,1,0,3,1,0,163,104,55951,42954,195,30,59969,41708
293,27,2,0,0,3,1,0,71,37,55953,42954,93,30,59972,41708
294,27,1,0,0,3,1,0,27,0,55954,42954,81,0,59975,41708
295,27,1,3,1,0,0,3,141,185,55955,42957,112,201,59975,41711
296,27,2,0,0,3,1,0,103,73,55957,42957,130,0,59978,41711
297,28,3,1,0,3,1,0,254,226,55960,42958,309,51,59981,41711
298,28,1,0,0,3,1,0,118,0,55961,42958,264,0,59984,41711
299,28,2,2,2,1,2,1,56,56,55963,42960,28,28,59985,41712
300,28,2,2,2,1,2,1,164,192,55965,42962,144,28,59986,41713
301,28,1,3,1,0,0,3,40,138,55966,42965,11,144,59986,41716
302,28,0,0,2,1,2,1,0,0,55966,42965,28,58,59987,41717
303,28,2,1,0,3,1,0,165,105,55968,42966,198,30,59990,41717
304,28,2,0,0,3,1,0,73,37,55970,42966,96,30,59993,41717
305,28,1,0,0,3,1,0,28,0,55971,42966,84,0,59996,41717
306,28,1,3,1,0,0,3,142,188,55972,42969,112,204,59996,41720
307,28,2,0,0,3,1,0,105,73,55974,42969,133,0,59999,41720
308,29,3,1,0,3,1,0,257,227,55977,42970,312,51,60002,41720
309,29,1,0,0,3,1,0,119,0,55978,42970,267,0,60005,41720
310,29,2,2,2,1,2,1,58,58,55980,42972,29,29,60006,41721
311,29,2,2,2,1,2,1,166,194,55982,42974,145,29,60007,41722
312,29,1,3,1,0,0,3,41,141,55983,42977,11,147,60007,41725
313,29,0,0,2,1,2,1,0,0,55983,42977,29,59,60008,41726
314,29,2,1,0,3,1,0,167,106,55985,42978,201,30,60011,41726
315,29,2,0,0,3,1,0,75,37,55987,42978,99,30,60014,41726
316,29,1,0,0,3,1,0,29,0,55988,42978,87,0,60017,41726
317,29,1,3,1,0,0,3,143,191,55989,42981,112,207,60017,41729
318,29,2,0,0,3,1,0,107,73,55991,42981,136,0,60020,41729
319,30,3,1,0,3,1,0,260,228,55994,42982,315,51,60023,41729
320,30,1,0,0,3,1,0,120,0,55995,42982,270,0,60026,41729
321,30,2,2,2,1,2,1,60,60,55997,42984,30,30,60027,41730
322,30,2,2,2,1,2,1,168,196,55999,42986,146,30,60028,41731
323,30,1,3,1,0,0,3,42,144,56000,42989,11,150,60028,41734
324,30,0,0,2,1,2,1,0,0,56000,42989,30,60,60029,41735
325,30,2,1,0,3,1,0,169,107,56002,42990,204,30,60032,41735
326,30,2,0,0,3,1,0,77,37,56004,42990,102,30,60035,41735
327,30,1,0,0,3,1,0,30,0,56005,42990,90,0,60038,41735
328,30,1,3,1,0,0,3,144,194,56006,42993,112,210,60038,41738
329,30,2,0,0,3,1,0,109,73,56008,42993,139,0,60041,41738
330,31,3,1,0,3,1,0,263,229,56011,42994,318,51,60044,41738
331,31,1,0,0,3,1,0,121,0,56012,42994,273,0,60047,41738
332,31,2,2,2,1,2,1,62,62,56014,42996,31,31,60048,41739
333,31,2,2,2,1,2,1,170,198,56016,42998,147,31,60049,41740
334,31,1,3,1,0,0,3,43,147,56017,43001,11,153,60049,41743
335,31,0,0,2,1,2,1,0,0,56017,43001,31,61,60050,41744
336,31,2,1,0,3,1,0,171,108,56019,43002,207,30,60053,41744
337,31,2,0,0,3,1,0,79,37,56021,43002,105,30,60056,41744
338,31,1,0,0,3,1,0,31,0,56022,43002,93,0,60059,41744
339,31,1,3,1,0,0,3,145,197,56023,43005,112,213,60059,41747
340,31,2,0,0,3,1,0,111,73,56025,43005,142,0,60062,41747
341,32,3,1,0,3,1,0,266,230,56028,43006,321,51,60065,41747
342,32,1,0,0,3,1,0,122,0,56029,43006,276,0,60068,41747
343,32,2,2,2,1,2,1,64,64,56031,43008,32,32,60069,41748
344,32,2,2,2,1,2,1,172,200,56033,43010,148,32,60070,41749
345,32,1,3,1,0,0,3,44,150,56034,43013,11,156,60070,41752
346,32,0,0,2,1,2,1,0,0,56034,43013,32,62,60071,41753
347,32,2,1,0,3,1,0,173,109,56036,43014,210,30,60074,41753
348,32,2,0,0,3,1,0,81,37,56038,43014,108,30,60077,41753
349,32,1,0,0,3,1,0,32,0,56039,43014,96,0,60080,41753
350,32,1,3,1,0,0,3,146,200,56040,43017,112,216,60080,41756
351,32,2,0,0,3,1,0,113,73,56042,43017,145,0,60083,41756
352,33,3,1,0,3,1,0,269,231,56045,43018,324,51,60086,41756
353,33,1,0,0,3,1,0,123,0,56046,43018,279,0,60089,41756
354,33,2,2,2,1,2,1,66,66,56048,43020,33,33,60090,41757
355,33,2,2,2,1,2,1,174,202,56050,43022,149,33,60091,41758
356,33,1,3,1,0,0,3,45,153,56051,43025,11,159,60091,41761
357,33,0,0,2,1,2,1,0,0,56051,43025,33,63,60092,41762
358,33,2,1,0,3,1,0,175,110,56053,43026,213,30,60095,41762
359,33,2,0,0,3,1,0,83,37,56055,43026,111,30,60098,41762
360,33,1,0,0,3,1,0,33,0,56056,43026,99,0,60101,41762
361,33,1,3,1,0,0,3,147,203,56057,43029,112,219,60101,41765
362,33,2,0,0,3,1,0,115,73,56059,43029,148,0,60104,41765
363,34,3,1,0,3,1,0,272,232,56062,43030,327,51,60107,41765
364,34,1,0,0,3,1,0,124,0,56063,43030,282,0,60110,41765
365,34,2,2,2,1,2,1,68,68,56065,43032,34,34,60111,41766
366,34,2,2,2,1,2,1,176,204,56067,43034,150,34,60112,41767
367,34,1,3,1,0,0,3,46,156,56068,43037,11,162,60112,41770
368,34,0,0,2,1,2,1,0,0,56068,43037,34,64,60113,41771
369,34,2,1,0,3,1,0,177,111,56070,43038,216,30,60116,41771
370,34,2,0,0,3,1,0,85,37,56072,43038,114,30,60119,41771
371,34,1,0,0,3,1,0,34,0,56073,43038,102,0,60122,41771
372,34,1,3,1,0,0,3,148,206,56074,43041,112,222,60122,41774
373,34,2,0,0,3,1,0,117,73,56076,43041,151,0,60125,41774
374,35,3,1,0,3,1,0,275,233,56079,43042,330,51,60128,41774
375,35,1,0,0,3,1,0,125,0,56080,43042,285,0,60131,41774
376,35,2,2,2,1,2,1,70,70,56082,43044,35,35,60132,41775
377,35,2,2,2,1,2,1,178,206,56084,43046,151,35,60133,41776
378,35,1,3,1,0,0,3,47,159,56085,43049,11,165,60133,41779
379,35,0,0,2,1,2,1,0,0,56085,43049,35,65,60134,41780
380,35,2,1,0,3,1,0,179,112,56087,43050,219,30,60137,41780
381,35,2,0,0,3,1,0,87,37,56089,43050,117,30,60140,41780
382,35,1,0,0,3,1,0,35,0,56090,43050,105,0,60143,41780
383,35,1,3,1,0,0,3,149,209,56091,43053,112,225,60143,41783
384,35,2,0,0,3,1,0,119,73,56093,43053,154,0,60146,41783
385,36,3,1,0,3,1,0,278,234,56096,43054,333,51,60149,41783
386,36,1,0,0,3,1,0,126,0,56097,43054,288,0,60152,41783
387,36,2,2,2,1,2,1,72,72,56099,43056,36,36,60153,41784
388,36,2,2,2,1,2,1,180,208,56101,43058,152,36,60154,41785
389,36,1,3,1,0,0,3,48,162,56102,43061,11,168,60154,41788
390,36,0,0,2,1,2,1,0,0,56102,43061,36,66,60155,41789
391,36,2,1,0,3,1,0,181,113,56104,43062,222,30,60158,41789
392,36,2,0,0,3,1,0,89,37,56106,43062,120,30,60161,41789
393,36,1,0,0,3,1,0,36,0,56107,43062,108,0,60164,41789
394,36,1,3,1,0,0,3,150,212,56108,43065,112,228,60164,41792
395,36,2,0,0,3,1,0,121,73,56110,43065,157,0,60167,41792
396,37,3,1,0,3,1,0,281,235,56113,43066,336,51,60170,41792
397,37,1,0,0,3,1,0,127,0,56114,43066,291,0,60173,41792
398,37,2,2,2,1,2,1,74,74,56116,43068,37,37,60174,41793
399,37,2,2,2,1,2,1,182,210,56118,43070,153,37,60175,41794
400,37,1,3,1,0,0,3,49,165,56119,43073,11,171,60175,41797
401,37,0,0,2,1,2,1,0,0,56119,43073,37,67,60176,41798
402,37,2,1,0,3,1,0,183,114,56121,43074,225,30,60179,41798
403,37,2,0,0,3,1,0,91,37,56123,43074,123,30,60182,41798
404,37,1,0,0,3,1,0,37,0,56124,43074,111,0,60185,41798
405,37,1,3,1,0,0,3,151,215,56125,43077,112,231,60185,41801
406,37,2,0,0,3,1,0,123,73,56127,43077,160,0,60188,41801
407,38,3,1,0,3,1,0,284,236,56130,43078,339,51,60191,41801
408,38,1,0,0,3,1,0,128,0,56131,43078,294,0,60194,41801
409,38,2,2,2,1,2,1,76,76,56133,43080,38,38,60195,41802
410,38,2,2,2,1,2,1,184,212,56135,43082,154,38,60196,41803
411,38,1,3,1,0,0,3,50,168,56136,43085,11,174,60196,41806
412,38,0,0,2,1,2,1,0,0,56136,43085,38,68,60197,41807
413,38,2,1,0,3,1,0,185,115,56138,43086,228,30,60200,41807
414,38,2,0,0,3,1,0,93,37,56140,43086,126,30,60203,41807
415,38,1,0,0,3,1,0,38,0,56141,43086,114,0,60206,41807
416,38,1,3,1,0,0,3,152,218,56142,43089,112,234,60206,41810
417,38,2,0,0,3,1,0,125,73,56144,43089,163,0,60209,41810
418,39,3,1,0,3,1,0,287,237,56147,43090,342,51,60212,41810
419,39,1,0,0,3,1,0,129,0,56148,43090,297,0,60215,41810
420,39,2,2,2,1,2,1,78,78,56150,43092,39,39,60216,41811
421,39,2,2,2,1,2,1,186,214,56152,43094,155,39,60217,41812
422,39,1,3,1,0,0,3,51,171,56153,43097,11,177,60217,41815
423,39,0,0,2,1,2,1,0,0,56153,43097,39,69,60218,41816
424,39,2,1,0,3,1,0,187,116,56155,43098,231,30,60221,41816
425,39,2,0,0,3,1,0,95,37,56157,43098,129,30,60224,41816
426,39,1,0,0,3,1,0,39,0,56158,43098,117,0,60227,41816
427,39,1,3,1,0,0,3,153,221,56159,43101,112,237,60227,41819
428,39,2,0,0,3,1,0,127,73,56161,43101,166,0,60230,41819
429,40,3,1,0,3,1,0,290,238,56164,43102,345,51,60233,41819
430,40,1,0,0,3,1,0,130,0,56165,43102,300,0,60236,41819
431,40,2,2,2,1,2,1,80,80,56167,43104,40,40,60237,41820
432,40,2,2,2,1,2,1,188,216,56169,43106,156,40,60238,41821
433,40,1,3,1,0,0,3,52,174,56170,43109,11,180,60238,41824
434,40,0,0,2,1,2,1,0,0,56170,43109,40,70,60239,41825
435,40,2,1,0,3,1,0,189,117,56172,43110,234,30,60242,41825
436,40,2,0,0,3,1,0,97,37,56174,43110,132,30,60245,41825
437,40,1,0,0,3,1,0,40,0,56175,43110,120,0,60248,41825
438,40,1,3,1,0,0,3,154,224,56176,43113,112,240,60248,41828
439,40,2,0,0,3,1,0,129,73,56178,43113,169,0,60251,41828
440,41,3,1,0,3,1,0,293,239,56181,43114,348,51,60254,41828
441,41,1,0,0,3,1,0,131,0,56182,43114,303,0,60257,41828
442,41,2,2,2,1,2,1,82,82,56184,43116,41,41,60258,41829
443,41,2,2,2,1,2,1,190,218,56186,43118,157,41,60259,41830
444,41,1,3,1,0,0,3,53,177,56187,43121,11,183,60259,41833
445,41,0,0,2,1,2,1,0,0,56187,43121,41,71,60260,41834
446,41,2,1,0,3,1,0,191,118,56189,43122,237,30,60263,41834
447,41,2,0,0,3,1,0,99,37,56191,43122,135,30,60266,41834
448,41,1,0,0,3,1,0,41,0,56192,43122,123,0,60269,41834
449,41,1,3,1,0,0,3,155,227,56193,43125,112,243,60269,41837
450,41,2,0,0,3,1,0,131,73,56195,43125,172,0,60272,41837
451,42,3,1,0,3,1,0,296,240,56198,43126,351,51,60275,41837
452,42,1,0,0,3,1,0,132,0,56199,43126,306,0,60278,41837
453,42,2,2,2,1,2,1,84,84,56201,43128,42,42,60279,41838
454,42,2,2,2,1,2,1,192,220,56203,43130,158,42,60280,41839
455,42,1,3,1,0,0,3,54,180,56204,43133,11,186,60280,41842
456,42,0,0,2,1,2,1,0,0,56204,43133,42,72,60281,41843
457,42,2,1,0,3,1,0,193,119,56206,43134,240,30,60284,41843
458,42,2,0,0,3,1,0,101,37,56208,43134,138,30,60287,41843
459,42,1,0,0,3,1,0,42,0,56209,43134,126,0,60290,41843
460,42,1,3,1,0,0,3,156,230,56210,43137,112,246,60290,41846
461,42,2,0,0,3,1,0,133,73,56212,43137,175,0,60293,41846
0,1,2,0,0,3,1,0,235,168,56214,43137,342,0,60296,41846
1,1,0,0,2,1,2,1,60,60,56214,43137,31,1,60297,41847
2,1,3,0,0,3,1,0,159,230,56217,43137,115,9,60300,41847
3,1,1,0,0,3,1,0,1,0,56218,43137,3,72,60303,41847
4,1,1,0,0,3,1,0,102,37,56219,43137,141,0,60306,41847
5,1,1,2,1,0,0,3,1,2,56220,43139,0,86,60306,41850
6,1,3,0,0,3,1,0,45,0,56223,43139,129,51,60309,41850
7,1,0,2,1,0,0,3,133,75,56223,43141,175,8,60309,41853
8,1,0,1,1,0,0,3,90,91,56223,43142,120,52,60309,41856
9,1,1,0,0,3,1,0,1,0,56224,43142,3,0,60312,41856
10,1,2,3,1,0,0,3,53,65,56226,43145,49,45,60312,41859
11,2,2,0,0,3,1,0,237,168,56228,43145,345,0,60315,41859
12,2,0,0,2,1,2,1,60,60,56228,43145,32,2,60316,41860
13,2,3,0,0,3,1,0,162,230,56231,43145,118,9,60319,41860
14,2,1,0,0,3,1,0,2,0,56232,43145,6,72,60322,41860
15,2,1,0,0,3,1,0,103,37,56233,43145,144,0,60325,41860
16,2,1,2,1,0,0,3,2,4,56234,43147,0,89,60325,41863
17,2,3,0,0,3,1,0,48,0,56237,43147,132,51,60328,41863
18,2,0,2,1,0,0,3,133,77,56237,43149,175,11,60328,41866
19,2,0,1,1,0,0,3,90,92,56237,43150,120,55,60328,41869
20,2,1,0,0,3,1,0,2,0,56238,43150,6,0,60331,41869
21,2,2,3,1,0,0,3,55,68,56240,43153,49,48,60331,41872
22,3,2,0,0,3,1,0,239,168,56242,43153,348,0,60334,41872
23,3,0,0,2,1,2,1,60,60,56242,43153,33,3,60335,41873
24,3,3,0,0,3,1,0,165,230,56245,43153,121,9,60338,41873
25,3,1,0,0,3,1,0,3,0,56246,43153,9,72,60341,41873
26,3,1,0,0,3,1,0,104,37,56247,43153,147,0,60344,41873
27,3,1,2,1,0,0,3,3,6,56248,43155,0,92,60344,41876
28,3,3,0,0,3,1,0,51,0,56251,43155,135,51,60347,41876
29,3,0,2,1,0,0,3,133,79,56251,43157,175,14,60347,41879
30,3,0,1,1,0,0,3,90,93,56251,43158,120,58,60347,41882
31,3,1,0,0,3,1,0,3,0,56252,43158,9,0,60350,41882
32,3,2,3,1,0,0,3,57,71,56254,43161,49,51,60350,41885
33,4,2,0,0,3,1,0,241,168,56256,43161,351,0,60353,41885
34,4,0,0,2,1,2,1,60,60,56256,43161,34,4,60354,41886
35,4,3,0,0,3,1,0,168,230,56259,43161,124,9,60357,41886
36,4,1,0,0,3,1,0,4,0,56260,43161,12,72,60360,41886
37,4,1,0,0,3,1,0,105,37,56261,43161,150,0,60363,41886
38,4,1,2,1,0,0,3,4,8,56262,43163,0,95,60363,41889
39,4,3,0,0,3,1,0,54,0,56265,43163,138,51,60366,41889
40,4,0,2,1,0,0,3,133,81,56265,43165,175,17,60366,41892
41,4,0,1,1,0,0,3,90,94,56265,43166,120,61,60366,41895
42,4,1,0,0,3,1,0,4,0,56266,43166,12,0,60369,41895
43,4,2,3,1,0,0,3,59,74,56268,43169,49,54,60369,41898
44,5,2,0,0,3,1,0,243,168,56270,43169,354,0,60372,41898
45,5,0,0,2,1,2,1,60,60,56270,43169,35,5,60373,41899
46,5,3,0,0,3,1,0,171,230,56273,43169,127,9,60376,41899
47,5,1,0,0,3,1,0,5,0,56274,43169,15,72,60379,41899
48,5,1,0,0,3,1,0,106,37,56275,43169,153,0,60382,41899
49,5,1,2,1,0,0,3,5,10,56276,43171,0,98,60382,41902
50,5,3,0,0,3,1,0,57,0,56279,43171,141,51,60385,41902
51,5,0,2,1,0,0,3,133,83,56279,43173,175,20,60385,41905
52,5,0,1,1,0,0,3,90,95,56279,43174,120,64,60385,41908
53,5,1,0,0,3,1,0,5,0,56280,43174,15,0,60388,41908
54,5,2,3,1,0,0,3,61,77,56282,43177,49,57,60388,41911
55,6,2,0,0,3,1,0,245,168,56284,43177,357,0,60391,41911
56,6,0,0,2,1,2,1,60,60,56284,43177,36,6,60392,41912
57,6,3,0,0,3,1,0,174,230,56287,43177,130,9,60395,41912
58,6,1,0,0,3,1,0,6,0,56288,43177,18,72,60398,41912
59,6,1,0,0,3,1,0,107,37,56289,43177,156,0,60401,41912
60,6,1,2,1,0,0,3,6,12,56290,43179,0,101,60401,41915
61,6,3,0,0,3,1,0,60,0,56293,43179,144,51,60404,41915
62,6,0,2,1,0,0,3,133,85,56293,43181,175,23,60404,41918
63,6,0,1,1,0,0,3,90,96,56293,43182,120,67,60404,41921
64,6,1,0,0,3,1,0,6,0,56294,43182,18,0,60407,41921
65,6,2,3,1,0,0,3,63,80,56296,43185,49,60,60407,41924
66,7,2,0,0,3,1,0,247,168,56298,43185,360,0,60410,41924
67,7,0,0,2,1,2,1,60,60,56298,43185,37,7,60411,41925
68,7,3,0,0,3,1,0,177,230,56301,43185,133,9,60414,41925
69,7,1,0,0,3,1,0,7,0,56302,43185,21,72,60417,41925
70,7,1,0,0,3,1,0,108,37,56303,43185,159,0,60420,41925
71,7,1,2,1,0,0,3,7,14,56304,43187,0,104,60420,41928
72,7,3,0,0,3,1,0,63,0,56307,43187,147,51,60423,41928
73,7,0,2,1,0,0,3,133,87,56307,43189,175,26,60423,41931
74,7,0,1,1,0,0,3,90,97,56307,43190,120,70,60423,41934
75,7,1,0,0,3,1,0,7,0,56308,43190,21,0,60426,41934
76,7,2,3,1,0,0,3,65,83,56310,43193,49,63,60426,41937
77,8,2,0,0,3,1,0,249,168,56312,43193,363,0,60429,41937
78,8,0,0,2,1,2,1,60,60,56312,43193,38,8,60430,41938
79,8,3,0,0,3,1,0,180,230,56315,43193,136,9,60433,41938
80,8,1,0,0,3,1,0,8,0,56316,43193,24,72,60436,41938
81,8,1,0,0,3,1,0,109,37,56317,43193,162,0,60439,41938
82,8,1,2,1,0,0,3,8,16,56318,43195,0,107,60439,41941
83,8,3,0,0,3,1,0,66,0,56321,43195,150,51,60442,41941
84,8,0,2,1,0,0,3,133,89,56321,43197,175,29,60442,41944
85,8,0,1,1,0,0,3,90,98,56321,43198,120,73,60442,41947
86,8,1,0,0,3,1,0,8,0,56322,43198,24,0,60445,41947
87,8,2,3,1,0,0,3,67,86,56324,43201,49,66,60445,41950
88,9,2,0,0,3,1,0,251,168,56326,43201,366,0,60448,41950
89,9,0,0,2,1,2,1,60,60,56326,43201,39,9,60449,41951
90,9,3,0,0,3,1,0,183,230,56329,43201,139,9,60452,41951
91,9,1,0,0,3,1,0,9,0,56330,43201,27,72,60455,41951
92,9,1,0,0,3,1,0,110,37,56331,43201,165,0,60458,41951
93,9,1,2,1,0,0,3,9,18,56332,43203,0,110,60458,41954
94,9,3,0,0,3,1,0,69,0,56335,43203,153,51,60461,41954
95,9,0,2,1,0,0,3,133,91,56335,43205,175,32,60461,41957
96,9,0,1,1,0,0,3,90,99,56335,43206,120,76,60461,41960
97,9,1,0,0,3,1,0,9,0,56336,43206,27,0,60464,41960
98,9,2,3,1,0,0,3,69,89,56338,43209,49,69,60464,41963
99,10,2,0,0,3,1,0,253,168,56340,43209,369,0,60467,41963
100,10,0,0,2,1,2,1,60,60,56340,43209,40,10,60468,41964
101,10,3,0,0,3,1,0,186,230,56343,43209,142,9,60471,41964
102,10,1,0,0,3,1,0,10,0,56344,43209,30,72,60474,41964
103,10,1,0,0,3,1,0,111,37,56345,43209,168,0,60477,41964
104,10,1,2,1,0,0,3,10,20,56346,43211,0,113,60477,41967
105,10,3,0,0,3,1,0,72,0,56349,43211,156,51,60480,41967
106,10,0,2,1,0,0,3,133,93,56349,43213,175,35,60480,41970
107,10,0,1,1,0,0,3,90,100,56349,43214,120,79,60480,41973
108,10,1,0,0,3,1,0,10,0,56350,43214,30,0,60483,41973
109,10,2,3,1,0,0,3,71,92,56352,43217,49,72,60483,41976
110,11,2,0,0,3,1,0,255,168,56354,43217,372,0,60486,41976
111,11,0,0,2,1,2,1,60,60,56354,43217,41,11,60487,41977
112,11,3,0,0,3,1,0,189,230,56357,43217,145,9,60490,41977
113,11,1,0,0,3,1,0,11,0,56358,43217,33,72,60493,41977
114,11,1,0,0,3,1,0,112,37,56359,43217,171,0,60496,41977
115,11,1,2,1,0,0,3,11,22,56360,43219,0,116,60496,41980
116,11,3,0,0,3,1,0,75,0,56363,43219,159,51,60499,41980
117,11,0,2,1,0,0,3,133,95,56363,43221,175,38,60499,41983
118,11,0,1,1,0,0,3,90,101,56363,43222,120,82,60499,41986
119,11,1,0,0,3,1,0,11,0,56364,43222,33,0,60502,41986
120,11,2,3,1,0,0,3,73,95,56366,43225,49,75,60502,41989
121,12,2,0,0,3,1,0,257,168,56368,43225,375,0,60505,41989
122,12,0,0,2,1,2,1,60,60,56368,43225,42,12,60506,41990
123,12,3,0,0,3,1,0,192,230,56371,43225,148,9,60509,41990
124,12,1,0,0,3,1,0,12,0,56372,43225,36,72,60512,41990
125,12,1,0,0,3,1,0,113,37,56373,43225,174,0,60515,41990
126,12,1,2,1,0,0,3,12,24,56374,43227,0,119,60515,41993
127,12,3,0,0,3,1,0,78,0,56377,43227,162,51,60518,41993
128,12,0,2,1,0,0,3,133,97,56377,43229,175,41,60518,41996
129,12,0,1,1,0,0,3,90,102,56377,43230,120,85,60518,41999
130,12,1,0,0,3,1,0,12,0,56378,43230,36,0,60521,41999
131,12,2,3,1,0,0,3,75,98,56380,43233,49,78,60521,42002
132,13,2,0,0,3,1,0,259,168,56382,43233,378,0,60524,42002
133,13,0,0,2,1,2,1,60,60,56382,43233,43,13,60525,42003
134,13,3,0,0,3,1,0,195,230,56385,43233,151,9,60528,42003
135,13,1,0,0,3,1,0,13,0,56386,43233,39,72,60531,42003
136,13,1,0,0,3,1,0,114,37,56387,43233,177,0,60534,42003
137,13,1,2,1,0,0,3,13,26,56388,43235,0,122,60534,42006
138,13,3,0,0,3,1,0,81,0,56391,43235,165,51,60537,42006
139,13,0,2,1,0,0,3,133,99,56391,43237,175,44,60537,42009
140,13,0,1,1,0,0,3,90,103,56391,43238,120,88,60537,42012
141,13,1,0,0,3,1,0,13,0,56392,43238,39,0,60540,42012
142,13,2,3,1,0,0,3,77,101,56394,43241,49,81,60540,42015
143,14,2,0,0,3,1,0,261,168,56396,43241,381,0,60543,42015
144,14,0,0,2,1,2,1,60,60,56396,43241,44,14,60544,42016
145,14,3,0,0,3,1,0,198,230,56399,43241,154,9,60547,42016
146,14,1,0,0,3,1,0,14,0,56400,43241,42,72,60550,42016
147,14,1,0,0,3,1,0,115,37,56401,43241,180,0,60553,42016
148,14,1,2,1,0,0,3,14,28,56402,43243,0,125,60553,42019
149,14,3,0,0,3,1,0,84,0,56405,43243,168,51,60556,42019
150,14,0,2,1,0,0,3,133,101,56405,43245,175,47,60556,42022
151,14,0,1,1,0,0,3,90,104,56405,43246,120,91,60556,42025
152,14,1,0,0,3,1,0,14,0,56406,43246,42,0,60559,42025
153,14,2,3,1,0,0,3,79,104,56408,43249,49,84,60559,42028
154,15,2,0,0,3,1,0,263,168,56410,43249,384,0,60562,42028
155,15,0,0,2,1,2,1,60,60,56410,43249,45,15,60563,42029
156,15,3,0,0,3,1,0,201,230,56413,43249,157,9,60566,42029
157,15,1,0,0,3,1,0,15,0,56414,43249,45,72,60569,42029
158,15,1,0,0,3,1,0,116,37,56415,43249,183,0,60572,42029
159,15,1,2,1,0,0,3,15,30,56416,43251,0,128,60572,42032
160,15,3,0,0,3,1,0,87,0,56419,43251,171,51,60575,42032
161,15,0,2,1,0,0,3,133,103,56419,43253,175,50,60575,42035
162,15,0,1,1,0,0,3,90,105,56419,43254,120,94,60575,42038
163,15,1,0,0,3,1,0,15,0,56420,43254,45,0,60578,42038
164,15,2,3,1,0,0,3,81,107,56422,43257,49,87,60578,42041
165,16,2,0,0,3,1,0,265,168,56424,43257,387,0,60581,42041
166,16,0,0,2,1,2,1,60,60,56424,43257,46,16,60582,42042
167,16,3,0,0,3,1,0,204,230,56427,43257,160,9,60585,42042
168,16,1,0,0,3,1,0,16,0,56428,43257,48,72,60588,42042
169,16,1,0,0,3,1,0,117,37,56429,43257,186,0,60591,42042
170,16,1,2,1,0,0,3,16,32,56430,43259,0,131,60591,42045
171,16,3,0,0,3,1,0,90,0,56433,43259,174,51,60594,42045
172,16,0,2,1,0,0,3,133,105,56433,43261,175,53,60594,42048
173,16,0,1,1,0,0,3,90,106,56433,43262,120,97,60594,42051
174,16,1,0,0,3,1,0,16,0,56434,43262,48,0,60597,42051
175,16,2,3,1,0,0,3,83,110,56436,43265,49,90,60597,42054
176,17,2,0,0,3,1,0,267,168,56438,43265,390,0,60600,42054
177,17,0,0,2,1,2,1,60,60,56438,43265,47,17,60601,42055
178,17,3,0,0,3,1,0,207,230,56441,43265,163,9,60604,42055
179,17,1,0,0,3,1,0,17,0,56442,43265,51,72,60607,42055
180,17,1,0,0,3,1,0,118,37,56443,43265,189,0,60610,42055
181,17,1,2,1,0,0,3,17,34,56444,43267,0,134,60610,42058
182,17,3,0,0,3,1,0,93,0,56447,43267,177,51,60613,42058
183,17,0,2,1,0,0,3,133,107,56447,43269,175,56,60613,42061
184,17,0,1,1,0,0,3,90,107,56447,43270,120,100,60613,42064
185,17,1,0,0,3,1,0,17,0,56448,43270,51,0,60616,42064
186,17,2,3,1,0,0,3,85,113,56450,43273,49,93,60616,42067
187,18,2,0,0,3,1,0,269,168,56452,43273,393,0,60619,42067
188,18,0,0,2,1,2,1,60,60,56452,43273,48,18,60620,42068
189,18,3,0,0,3,1,0,210,230,56455,43273,166,9,60623,42068
190,18,1,0,0,3,1,0,18,0,56456,43273,54,72,60626,42068
191,18,1,0,0,3,1,0,119,37,56457,43273,192,0,60629,42068
192,18,1,2,1,0,0,3,18,36,56458,43275,0,137,60629,42071
193,18,3,0,0,3,1,0,96,0,56461,43275,180,51,60632,42071
194,18,0,2,1,0,0,3,133,109,56461,43277,175,59,60632,42074
195,18,0,1,1,0,0,3,90,108,56461,43278,120,103,60632,42077
196,18,1,0,0,3,1,0,18,0,56462,43278,54,0,60635,42077
197,18,2,3,1,0,0,3,87,116,56464,43281,49,96,60635,42080
198,19,2,0,0,3,1,0,271,168,56466,43281,396,0,60638,42080
199,19,0,0,2,1,2,1,60,60,56466,43281,49,19,60639,42081
200,19,3,0,0,3,1,0,213,230,56469,43281,169,9,60642,42081
201,19,1,0,0,3,1,0,19,0,56470,43281,57,72,60645,42081
202,19,1,0,0,3,1,0,120,37,56471,43281,195,0,60648,42081
203,19,1,2,1,0,0,3,19,38,56472,43283,0,140,60648,42084
204,19,3,0,0,3,1,0,99,0,56475,43283,183,51,60651,42084
205,19,0,2,1,0,0,3,133,111,56475,43285,175,62,60651,42087
206,19,0,1,1,0,0,3,90,109,56475,43286,120,106,60651,42090
207,19,1,0,0,3,1,0,19,0,56476,43286,57,0,60654,42090
208,19,2,3,1,0,0,3,89,119,56478,43289,49,99,60654,42093
209,20,2,0,0,3,1,0,273,168,56480,43289,399,0,60657,42093
210,20,0,0,2,1,2,1,60,60,56480,43289,50,20,60658,42094
211,20,3,0,0,3,1,0,216,230,56483,43289,172,9,60661,42094
212,20,1,0,0,3,1,0,20,0,56484,43289,60,72,60664,42094
213,20,1,0,0,3,1,0,121,37,56485,43289,198,0,60667,42094
214,20,1,2,1,0,0,3,20,40,56486,43291,0,143,60667,42097
215,20,3,0,0,3,1,0,102,0,56489,43291,186,51,60670,42097
216,20,0,2,1,0,0,3,133,113,56489,43293,175,65,60670,42100
217,20,0,1,1,0,0,3,90,110,56489,43294,120,109,60670,42103
218,20,1,0,0,3,1,0,20,0,56490,43294,60,0,60673,42103
219,20,2,3,1,0,0,3,91,122,56492,43297,49,102,60673,42106
220,21,2,0,0,3,1,0,275,168,56494,43297,402,0,60676,42106
221,21,0,0,2,1,2,1,60,60,56494,43297,51,21,60677,42107
222,21,3,0,0,3,1,0,219,230,56497,43297,175,9,60680,42107
223,21,1,0,0,3,1,0,21,0,56498,43297,63,72,60683,42107
224,21,1,0,0,3,1,0,122,37,56499,43297,201,0,60686,42107
225,21,1,2,1,0,0,3,21,42,56500,43299,0,146,60686,42110
226,21,3,0,0,3,1,0,105,0,56503,43299,189,51,60689,42110
227,21,0,2,1,0,0,3,133,115,56503,43301,175,68,60689,42113
228,21,0,1,1,0,0,3,90,111,56503,43302,120,112,60689,42116
229,21,1,0,0,3,1,0,21,0,56504,43302,63,0,60692,42116
230,21,2,3,1,0,0,3,93,125,56506,43305,49,105,60692,42119
231,22,2,0,0,3,1,0,277,168,56508,43305,405,0,60695,42119
232,22,0,0,2,1,2,1,60,60,56508,43305,52,22,60696,42120
233,22,3,0,0,3,1,0,222,230,56511,43305,178,9,60699,42120
234,22,1,0,0,3,1,0,22,0,56512,43305,66,72,60702,42120
235,22,1,0,0,3,1,0,123,37,56513,43305,204,0,60705,42120
236,22,1,2,1,0,0,3,22,44,56514,43307,0,149,60705,42123
237,22,3,0,0,3,1,0,108,0,56517,43307,192,51,60708,42123
238,22,0,2,1,0,0,3,133,117,56517,43309,175,71,60708,42126
239,22,0,1,1,0,0,3,90,112,56517,43310,120,115,60708,42129
240,22,1,0,0,3,1,0,22,0,56518,43310,66,0,60711,42129
241,22,2,3,1,0,0,3,95,128,56520,43313,49,108,60711,42132
242,23,2,0,0,3,1,0,279,168,56522,43313,408,0,60714,42132
243,23,0,0,2,1,2,1,60,60,56522,43313,53,23,60715,42133
244,23,3,0,0,3,1,0,225,230,56525,43313,181,9,60718,42133
245,23,1,0,0,3,1,0,23,0,56526,43313,69,72,60721,42133
246,23,1,0,0,3,1,0,124,37,56527,43313,207,0,60724,42133
247,23,1,2,1,0,0,3,23,46,56528,43315,0,152,60724,42136
248,23,3,0,0,3,1,0,111,0,56531,43315,195,51,60727,42136
249,23,0,2,1,0,0,3,133,119,56531,43317,175,74,60727,42139
250,23,0,1,1,0,0,3,90,113,56531,43318,120,118,60727,42142
251,23,1,0,0,3,1,0,23,0,56532,43318,69,0,60730,42142
252,23,2,3,1,0,0,3,97,131,56534,43321,49,111,60730,42145
253,24,2,0,0,3,1,0,281,168,56536,43321,411,0,60733,42145
254,24,0,0,2,1,2,1,60,60,56536,43321,54,24,60734,42146
255,24,3,0,0,3,1,0,228,230,56539,43321,184,9,60737,42146
256,24,1,0,0,3,1,0,24,0,56540,43321,72,72,60740,42146
257,24,1,0,0,3,1,0,125,37,56541,43321,210,0,60743,42146
258,24,1,2,1,0,0,3,24,48,56542,43323,0,155,60743,42149
259,24,3,0,0,3,1,0,114,0,56545,43323,198,51,60746,42149
260,24,0,2,1,0,0,3,133,121,56545,43325,175,77,60746,42152
261,24,0,1,1,0,0,3,90,114,56545,43326,120,121,60746,42155
262,24,1,0,0,3,1,0,24,0,56546,43326,72,0,60749,42155
263,24,2,3,1,0,0,3,99,134,56548,43329,49,114,60749,42158
264,25,2,0,0,3,1,0,283,168,56550,43329,414,0,60752,42158
265,25,0,0,2,1,2,1,60,60,56550,43329,55,25,60753,42159
266,25,3,0,0,3,1,0,231,230,56553,43329,187,9,60756,42159
267,25,1,0,0,3,1,0,25,0,56554,43329,75,72,60759,42159
268,25,1,0,0,3,1,0,126,37,56555,43329,213,0,60762,42159
269,25,1,2,1,0,0,3,25,50,56556,43331,0,158,60762,42162
270,25,3,0,0,3,1,0,117,0,56559,43331,201,51,60765,42162
271,25,0,2,1,0,0,3,133,123,56559,43333,175,80,60765,42165
272,25,0,1,1,0,0,3,90,115,56559,43334,120,124,60765,42168
273,25,1,0,0,3,1,0,25,0,56560,43334,75,0,60768,42168
274,25,2,3,1,0,0,3,101,137,56562,43337,49,117,60768,42171
275,26,2,0,0,3,1,0,285,168,56564,43337,417,0,60771,42171
276,26,0,0,2,1,2,1,60,60,56564,43337,56,26,60772,42172
277,26,3,0,0,3,1,0,234,230,56567,43337,190,9,60775,42172
278,26,1,0,0,3,1,0,26,0,56568,43337,78,72,60778,42172
279,26,1,0,0,3,1,0,127,37,56569,43337,216,0,60781,42172
280,26,1,2,1,0,0,3,26,52,56570,43339,0,161,60781,42175
281,26,3,0,0,3,1,0,120,0,56573,43339,204,51,60784,42175
282,26,0,2,1,0,0,3,133,125,56573,43341,175,83,60784,42178
283,26,0,1,1,0,0,3,90,116,56573,43342,120,127,60784,42181
284,26,1,0,0,3,1,0,26,0,56574,43342,78,0,60787,42181
285,26,2,3,1,0,0,3,103,140,56576,43345,49,120,60787,42184
286,27,2,0,0,3,1,0,287,168,56578,43345,420,0,60790,42184
287,27,0,0,2,1,2,1,60,60,56578,43345,57,27,60791,42185
288,27,3,0,0,3,1,0,237,230,56581,43345,193,9,60794,42185
289,27,1,0,0,3,1,0,27,0,56582,43345,81,72,60797,42185
290,27,1,0,0,3,1,0,128,37,56583,43345,219,0,60800,42185
291,27,1,2,1,0,0,3,27,54,56584,43347,0,164,60800,42188
292,27,3,0,0,3,1,0,123,0,56587,43347,207,51,60803,42188
293,27,0,2,1,0,0,3,133,127,56587,43349,175,86,60803,42191
294,27,0,1,1,0,0,3,90,117,56587,43350,120,130,60803,42194
295,27,1,0,0,3,1,0,27,0,56588,43350,81,0,60806,42194
296,27,2,3,1,0,0,3,105,143,56590,43353,49,123,60806,42197
297,28,2,0,0,3,1,0,289,168,56592,43353,423,0,60809,42197
298,28,0,0,2,1,2,1,60,60,56592,43353,58,28,60810,42198
299,28,3,0,0,3,1,0,240,230,56595,43353,196,9,60813,42198
300,28,1,0,0,3,1,0,28,0,56596,43353,84,72,60816,42198
301,28,1,0,0,3,1,0,129,37,56597,43353,222,0,60819,42198
302,28,1,2,1,0,0,3,28,56,56598,43355,0,167,60819,42201
303,28,3,0,0,3,1,0,126,0,56601,43355,210,51,60822,42201
304,28,0,2,1,0,0,3,133,129,56601,43357,175,89,60822,42204
305,28,0,1,1,0,0,3,90,118,56601,43358,120,133,60822,42207
306,28,1,0,0,3,1,0,28,0,56602,43358,84,0,60825,42207
307,28,2,3,1,0,0,3,107,146,56604,43361,49,126,60825,42210
308,29,2,0,0,3,1,0,291,168,56606,43361,426,0,60828,42210
309,29,0,0,2,1,2,1,60,60,56606,43361,59,29,60829,42211
310,29,3,0,0,3,1,0,243,230,56609,43361,199,9,60832,42211
311,29,1,0,0,3,1,0,29,0,56610,43361,87,72,60835,42211
312,29,1,0,0,3,1,0,130,37,56611,43361,225,0,60838,42211
313,29,1,2,1,0,0,3,29,58,56612,43363,0,170,60838,42214
314,29,3,0,0,3,1,0,129,0,56615,43363,213,51,60841,42214
315,29,0,2,1,0,0,3,133,131,56615,43365,175,92,60841,42217
316,29,0,1,1,0,0,3,90,119,56615,43366,120,136,60841,42220
317,29,1,0,0,3,1,0,29,0,56616,43366,87,0,60844,42220
318,29,2,3,1,0,0,3,109,149,56618,43369,49,129,60844,42223
319,30,2,0,0,3,1,0,293,168,56620,43369,429,0,60847,42223
320,30,0,0,2,1,2,1,60,60,56620,43369,60,30,60848,42224
321,30,3,0,0,3,1,0,246,230,56623,43369,202,9,60851,42224
322,30,1,0,0,3,1,0,30,0,56624,43369,90,72,60854,42224
323,30,1,0,0,3,1,0,131,37,56625,43369,228,0,60857,42224
324,30,1,2,1,0,0,3,30,60,56626,43371,0,173,60857,42227
325,30,3,0,0,3,1,0,132,0,56629,43371,216,51,60860,42227
326,30,0,2,1,0,0,3,133,133,56629,43373,175,95,60860,42230
327,30,0,1,1,0,0,3,90,120,56629,43374,120,139,60860,42233
328,30,1,0,0,3,1,0,30,0,56630,43374,90,0,60863,42233
329,30,2,3,1,0,0,3,111,152,56632,43377,49,132,60863,42236
330,31,2,0,0,3,1,0,295,168,56634,43377,432,0,60866,42236
331,31,0,0,2,1,2,1,60,60,56634,43377,61,31,60867,42237
332,31,3,0,0,3,1,0,249,230,56637,43377,205,9,60870,42237
333,31,1,0,0,3,1,0,31,0,56638,43377,93,72,60873,42237
334,31,1,0,0,3,1,0,132,37,56639,43377,231,0,60876,42237
335,31,1,2,1,0,0,3,31,62,56640,43379,0,176,60876,42240
336,31,3,0,0,3,1,0,135,0,56643,43379,219,51,60879,42240
337,31,0,2,1,0,0,3,133,135,56643,43381,175,98,60879,42243
338,31,0,1,1,0,0,3,90,121,56643,43382,120,142,60879,42246
339,31,1,0,0,3,1,0,31,0,56644,43382,93,0,60882,42246
340,31,2,3,1,0,0,3,113,155,56646,43385,49,135,60882,42249
341,32,2,0,0,3,1,0,297,168,56648,43385,435,0,60885,42249
342,32,0,0,2,1,2,1,60,60,56648,43385,62,32,60886,42250
343,32,3,0,0,3,1,0,252,230,56651,43385,208,9,60889,42250
344,32,1,0,0,3,1,0,32,0,56652,43385,96,72,60892,42250
345,32,1,0,0,3,1,0,133,37,56653,43385,234,0,60895,42250
346,32,1,2,1,0,0,3,32,64,56654,43387,0,179,60895,42253
347,32,3,0,0,3,1,0,138,0,56657,43387,222,51,60898,42253
348,32,0,2,1,0,0,3,133,137,56657,43389,175,101,60898,42256
349,32,0,1,1,0,0,3,90,122,56657,43390,120,145,60898,42259
350,32,1,0,0,3,1,0,32,0,56658,43390,96,0,60901,42259
351,32,2,3,1,0,0,3,115,158,56660,43393,49,138,60901,42262
352,33,2,0,0,3,1,0,299,168,56662,43393,438,0,60904,42262
353,33,0,0,2,1,2,1,60,60,56662,43393,63,33,60905,42263
354,33,3,0,0,3,1,0,255,230,56665,43393,211,9,60908,42263
355,33,1,0,0,3,1,0,33,0,56666,43393,99,72,60911,42263
356,33,1,0,0,3,1,0,134,37,56667,43393,237,0,60914,42263
357,33,1,2,1,0,0,3,33,66,56668,43395,0,182,60914,42266
358,33,3,0,0,3,1,0,141,0,56671,43395,225,51,60917,42266
359,33,0,2,1,0,0,3,133,139,56671,43397,175,104,60917,42269
360,33,0,1,1,0,0,3,90,123,56671,43398,120,148,60917,42272
361,33,1,0,0,3,1,0,33,0,56672,43398,99,0,60920,42272
362,33,2,3,1,0,0,3,117,161,56674,43401,49,141,60920,42275
363,34,2,0,0,3,1,0,301,168,56676,43401,441,0,60923,42275
364,34,0,0,2,1,2,1,60,60,56676,43401,64,34,60924,42276
365,34,3,0,0,3,1,0,258,230,56679,43401,214,9,60927,42276
366,34,1,0,0,3,1,0,34,0,56680,43401,102,72,60930,42276
367,34,1,0,0,3,1,0,135,37,56681,43401,240,0,60933,42276
368,34,1,2,1,0,0,3,34,68,56682,43403,0,185,60933,42279
369,34,3,0,0,3,1,0,144,0,56685,43403,228,51,60936,42279
370,34,0,2,1,0,0,3,133,141,56685,43405,175,107,60936,42282
371,34,0,1,1,0,0,3,90,124,56685,43406,120,151,60936,42285
372,34,1,0,0,3,1,0,34,0,56686,43406,102,0,60939,42285
373,34,2,3,1,0,0,3,119,164,56688,43409,49,144,60939,42288
374,35,2,0,0,3,1,0,303,168,56690,43409,444,0,60942,42288
375,35,0,0,2,1,2,1,60,60,56690,43409,65,35,60943,42289
376,35,3,0,0,3,1,0,261,230,56693,43409,217,9,60946,42289
377,35,1,0,0,3,1,0,35,0,56694,43409,105,72,60949,42289
378,35,1,0,0,3,1,0,136,37,56695,43409,243,0,60952,42289
379,35,1,2,1,0,0,3,35,70,56696,43411,0,188,60952,42292
380,35,3,0,0,3,1,0,147,0,56699,43411,231,51,60955,42292
381,35,0,2,1,0,0,3,133,143,56699,43413,175,110,60955,42295
382,35,0,1,1,0,0,3,90,125,56699,43414,120,154,60955,42298
383,35,1,0,0,3,1,0,35,0,56700,43414,105,0,60958,42298
384,35,2,3,1,0,0,3,121,167,56702,43417,49,147,60958,42301
385,36,2,0,0,3,1,0,305,168,56704,43417,447,0,60961,42301
386,36,0,0,2,1,2,1,60,60,56704,43417,66,36,60962,42302
387,36,3,0,0,3,1,0,264,230,56707,43417,220,9,60965,42302
388,36,1,0,0,3,1,0,36,0,56708,43417,108,72,60968,42302
389,36,1,0,0,3,1,0,137,37,56709,43417,246,0,60971,42302
390,36,1,2,1,0,0,3,36,72,56710,43419,0,191,60971,42305
391,36,3,0,0,3,1,0,150,0,56713,43419,234,51,60974,42305
392,36,0,2,1,0,0,3,133,145,56713,43421,175,113,60974,42308
393,36,0,1,1,0,0,3,90,126,56713,43422,120,157,60974,42311
394,36,1,0,0,3,1,0,36,0,56714,43422,108,0,60977,42311
395,36,2,3,1,0,0,3,123,170,56716,43425,49,150,60977,42314
396,37,2,0,0,3,1,0,307,168,56718,43425,450,0,60980,42314
397,37,0,0,2,1,2,1,60,60,56718,43425,67,37,60981,42315
398,37,3,0,0,3,1,0,267,230,56721,43425,223,9,60984,42315
399,37,1,0,0,3,1,0,37,0,56722,43425,111,72,60987,42315
400,37,1,0,0,3,1,0,138,37,56723,43425,249,0,60990,42315
401,37,1,2,1,0,0,3,37,74,56724,43427,0,194,60990,42318
402,37,3,0,0,3,1,0,153,0,56727,43427,237,51,60993,42318
403,37,0,2,1,0,0,3,133,147,56727,43429,175,116,60993,42321
404,37,0,1,1,0,0,3,90,127,56727,43430,120,160,60993,42324
405,37,1,0,0,3,1,0,37,0,56728,43430,111,0,60996,42324
406,37,2,3,1,0,0,3,125,173,56730,43433,49,153,60996,42327
407,38,2,0,0,3,1,0,309,168,56732,43433,453,0,60999,42327
408,38,0,0,2,1,2,1,60,60,56732,43433,68,38,61000,42328
409,38,3,0,0,3,1,0,270,230,56735,43433,226,9,61003,42328
410,38,1,0,0,3,1,0,38,0,56736,43433,114,72,61006,42328
411,38,1,0,0,3,1,0,139,37,56737,43433,252,0,61009,42328
412,38,1,2,1,0,0,3,38,76,56738,43435,0,197,61009,42331
413,38,3,0,0,3,1,0,156,0,56741,43435,240,51,61012,42331
414,38,0,2,1,0,0,3,133,149,56741,43437,175,119,61012,42334
415,38,0,1,1,0,0,3,90,128,56741,43438,120,163,61012,42337
416,38,1,0,0,3,1,0,38,0,56742,43438,114,0,61015,42337
417,38,2,3,1,0,0,3,127,176,56744,43441,49,156,61015,42340
418,39,2,0,0,3,1,0,311,168,56746,43441,456,0,61018,42340
419,39,0,0,2,1,2,1,60,60,56746,43441,69,39,61019,42341
420,39,3,0,0,3,1,0,273,230,56749,43441,229,9,61022,42341
421,39,1,0,0,3,1,0,39,0,56750,43441,117,72,61025,42341
422,39,1,0,0,3,1,0,140,37,56751,43441,255,0,61028,42341
423,39,1,2,1,0,0,3,39,78,56752,43443,0,200,61028,42344
424,39,3,0,0,3,1,0,159,0,56755,43443,243,51,61031,42344
425,39,0,2,1,0,0,3,133,151,56755,43445,175,122,61031,42347
426,39,0,1,1,0,0,3,90,129,56755,43446,120,166,61031,42350
427,39,1,0,0,3,1,0,39,0,56756,43446,117,0,61034,42350
428,39,2,3,1,0,0,3,129,179,56758,43449,49,159,61034,42353
429,40,2,0,0,3,1,0,313,168,56760,43449,459,0,61037,42353
430,40,0,0,2,1,2,1,60,60,56760,43449,70,40,61038,42354
431,40,3,0,0,3,1,0,276,230,56763,43449,232,9,61041,42354
432,40,1,0,0,3,1,0,40,0,56764,43449,120,72,61044,42354
433,40,1,0,0,3,1,0,141,37,56765,43449,258,0,61047,42354
434,40,1,2,1,0,0,3,40,80,56766,43451,0,203,61047,42357
435,40,3,0,0,3,1,0,162,0,56769,43451,246,51,61050,42357
436,40,0,2,1,0,0,3,133,153,56769,43453,175,125,61050,42360
437,40,0,1,1,0,0,3,90,130,56769,43454,120,169,61050,42363
438,40,1,0,0,3,1,0,40,0,56770,43454,120,0,61053,42363
439,40,2,3,1,0,0,3,131,182,56772,43457,49,162,61053,42366
440,41,2,0,0,3,1,0,315,168,56774,43457,462,0,61056,42366
441,41,0,0,2,1,2,1,60,60,56774,43457,71,41,61057,42367
442,41,3,0,0,3,1,0,279,230,56777,43457,235,9,61060,42367
443,41,1,0,0,3,1,0,41,0,56778,43457,123,72,61063,42367
444,41,1,0,0,3,1,0,142,37,56779,43457,261,0,61066,42367
445,41,1,2,1,0,0,3,41,82,56780,43459,0,206,61066,42370
446,41,3,0,0,3,1,0,165,0,56783,43459,249,51,61069,42370
447,41,0,2,1,0,0,3,133,155,56783,43461,175,128,61069,42373
448,41,0,1,1,0,0,3,90,131,56783,43462,120,172,61069,42376
449,41,1,0,0,3,1,0,41,0,56784,43462,123,0,61072,42376
450,41,2,3,1,0,0,3,133,185,56786,43465,49,165,61072,42379
451,42,2,0,0,3,1,0,317,168,56788,43465,465,0,61075,42379
452,42,0,0,2,1,2,1,60,60,56788,43465,72,42,61076,42380
453,42,3,0,0,3,1,0,282,230,56791,43465,238,9,61079,42380
454,42,1,0,0,3,1,0,42,0,56792,43465,126,72,61082,42380
455,42,1,0,0,3,1,0,143,37,56793,43465,264,0,61085,42380
456,42,1,2,1,0,0,3,42,84,56794,43467,0,209,61085,42383
457,42,3,0,0,3,1,0,168,0,56797,43467,252,51,61088,42383
458,42,0,2,1,0,0,3,133,157,56797,43469,175,131,61088,42386
459,42,0,1,1,0,0,3,90,132,56797,43470,120,175,61088,42389
460,42,1,0,0,3,1,0,42,0,56798,43470,126,0,61091,42389
461,42,2,3,1,0,0,3,135,188,56800,43473,49,168,61091,42392
0,1,2,0,0,3,1,0,60,74,56802,43473,70,90,61094,42392
1,1,2,1,0,3,1,0,135,158,56804,43474,178,0,61097,42392
2,1,1,1,2,1,2,1,67,65,56805,43475,69,1,61098,42393
3,1,1,0,0,3,1,0,193,220,56806,43475,161,42,61101,42393
4,1,1,0,0,3,1,0,1,0,56807,43475,3,30,61104,42393
5,1,3,0,0,3,1,0,3,0,56810,43475,45,51,61107,42393
6,1,1,1,2,1,2,1,91,133,56811,43476,121,1,61108,42394
7,1,1,1,2,1,2,1,283,231,56812,43477,239,73,61109,42395
8,1,3,2,0,3,1,0,87,86,56815,43479,45,0,61112,42395
9,1,1,3,1,0,0,3,1,3,56816,43482,0,3,61112,42398
10,1,1,0,0,3,1,0,16,16,56817,43482,16,0,61115,42398
11,1,1,2,1,0,0,3,136,190,56818,43484,49,134,61115,42401
12,2,2,0,0,3,1,0,62,74,56820,43484,73,90,61118,42401
13,2,2,1,0,3,1,0,137,159,56822,43485,181,0,61121,42401
14,2,1,1,2,1,2,1,68,66,56823,43486,70,2,61122,42402
15,2,1,0,0,3,1,0,194,220,56824,43486,164,42,61125,42402
16,2,1,0,0,3,1,0,2,0,56825,43486,6,30,61128,42402
17,2,3,0,0,3,1,0,6,0,56828,43486,48,51,61131,42402
18,2,1,1,2,1,2,1,92,134,56829,43487,122,2,61132,42403
19,2,1,1,2,1,2,1,284,232,56830,43488,240,74,61133,42404
20,2,3,2,0,3,1,0,90,88,56833,43490,48,0,61136,42404
21,2,1,3,1,0,0,3,2,6,56834,43493,0,6,61136,42407
22,2,1,0,0,3,1,0,17,16,56835,43493,19,0,61139,42407
23,2,1,2,1,0,0,3,137,192,56836,43495,49,137,61139,42410
24,3,2,0,0,3,1,0,64,74,56838,43495,76,90,61142,42410
25,3,2,1,0,3,1,0,139,160,56840,43496,184,0,61145,42410
26,3,1,1,2,1,2,1,69,67,56841,43497,71,3,61146,42411
27,3,1,0,0,3,1,0,195,220,56842,43497,167,42,61149,42411
28,3,1,0,0,3,1,0,3,0,56843,43497,9,30,61152,42411
29,3,3,0,0,3,1,0,9,0,56846,43497,51,51,61155,42411
30,3,1,1,2,1,2,1,93,135,56847,43498,123,3,61156,42412
31,3,1,1,2,1,2,1,285,233,56848,43499,241,75,61157,42413
32,3,3,2,0,3,1,0,93,90,56851,43501,51,0,61160,42413
33,3,1,3,1,0,0,3,3,9,56852,43504,0,9,61160,42416
34,3,1,0,0,3,1,0,18,16,56853,43504,22,0,61163,42416
35,3,1,2,1,0,0,3,138,194,56854,43506,49,140,61163,42419
36,4,2,0,0,3,1,0,66,74,56856,43506,79,90,61166,42419
37,4,2,1,0,3,1,0,141,161,56858,43507,187,0,61169,42419
38,4,1,1,2,1,2,1,70,68,56859,43508,72,4,61170,42420
39,4,1,0,0,3,1,0,196,220,56860,43508,170,42,61173,42420
40,4,1,0,0,3,1,0,4,0,56861,43508,12,30,61176,42420
41,4,3,0,0,3,1,0,12,0,56864,43508,54,51,61179,42420
42,4,1,1,2,1,2,1,94,136,56865,43509,124,4,61180,42421
43,4,1,1,2,1,2,1,286,234,56866,43510,242,76,61181,42422
44,4,3,2,0,3,1,0,96,92,56869,43512,54,0,61184,42422
45,4,1,3,1,0,0,3,4,12,56870,43515,0,12,61184,42425
46,4,1,0,0,3,1,0,19,16,56871,43515,25,0,61187,42425
47,4,1,2,1,0,0,3,139,196,56872,43517,49,143,61187,42428
48,5,2,0,0,3,1,0,68,74,56874,43517,82,90,61190,42428
49,5,2,1,0,3,1,0,143,162,56876,43518,190,0,61193,42428
50,5,1,1,2,1,2,1,71,69,56877,43519,73,5,61194,42429
51,5,1,0,0,3,1,0,197,220,56878,43519,173,42,61197,42429
52,5,1,0,0,3,1,0,5,0,56879,43519,15,30,61200,42429
53,5,3,0,0,3,1,0,15,0,56882,43519,57,51,61203,42429
54,5,1,1,2,1,2,1,95,137,56883,43520,125,5,61204,42430
55,5,1,1,2,1,2,1,287,235,56884,43521,243,77,61205,42431
56,5,3,2,0,3,1,0,99,94,56887,43523,57,0,61208,42431
57,5,1,3,1,0,0,3,5,15,56888,43526,0,15,61208,42434
58,5,1,0,0,3,1,0,20,16,56889,43526,28,0,61211,42434
59,5,1,2,1,0,0,3,140,198,56890,43528,49,146,61211,42437
60,6,2,0,0,3,1,0,70,74,56892,43528,85,90,61214,42437
61,6,2,1,0,3,1,0,145,163,56894,43529,193,0,61217,42437
62,6,1,1,2,1,2,1,72,70,56895,43530,74,6,61218,42438
63,6,1,0,0,3,1,0,198,220,56896,43530,176,42,61221,42438
64,6,1,0,0,3,1,0,6,0,56897,43530,18,30,61224,42438
65,6,3,0,0,3,1,0,18,0,56900,43530,60,51,61227,42438
66,6,1,1,2,1,2,1,96,138,56901,43531,126,6,61228,42439
67,6,1,1,2,1,2,1,288,236,56902,43532,244,78,61229,42440
68,6,3,2,0,3,1,0,102,96,56905,43534,60,0,61232,42440
69,6,1,3,1,0,0,3,6,18,56906,43537,0,18,61232,42443
70,6,1,0,0,3,1,0,21,16,56907,43537,31,0,61235,42443
71,6,1,2,1,0,0,3,141,200,56908,43539,49,149,61235,42446
72,7,2,0,0,3,1,0,72,74,56910,43539,88,90,61238,42446
73,7,2,1,0,3,1,0,147,164,56912,43540,196,0,61241,42446
74,7,1,1,2,1,2,1,73,71,56913,43541,75,7,61242,42447
75,7,1,0,0,3,1,0,199,220,56914,43541,179,42,61245,42447
76,7,1,0,0,3,1,0,7,0,56915,43541,21,30,61248,42447
77,7,3,0,0,3,1,0,21,0,56918,43541,63,51,61251,42447
78,7,1,1,2,1,2,1,97,139,56919,43542,127,7,61252,42448
79,7,1,1,2,1,2,1,289,237,56920,43543,245,79,61253,42449
80,7,3,2,0,3,1,0,105,98,56923,43545,63,0,61256,42449
81,7,1,3,1,0,0,3,7,21,56924,43548,0,21,61256,42452
82,7,1,0,0,3,1,0,22,16,56925,43548,34,0,61259,42452
83,7,1,2,1,0,0,3,142,202,56926,43550,49,152,61259,42455
84,8,2,0,0,3,1,0,74,74,56928,43550,91,90,61262,42455
85,8,2,1,0,3,1,0,149,165,56930,43551,199,0,61265,42455
86,8,1,1,2,1,2,1,74,72,56931,43552,76,8,61266,42456
87,8,1,0,0,3,1,0,200,220,56932,43552,182,42,61269,42456
88,8,1,0,0,3,1,0,8,0,56933,43552,24,30,61272,42456
89,8,3,0,0,3,1,0,24,0,56936,43552,66,51,61275,42456
90,8,1,1,2,1,2,1,98,140,56937,43553,128,8,61276,42457
91,8,1,1,2,1,2,1,290,238,56938,43554,246,80,61277,42458
92,8,3,2,0,3,1,0,108,100,56941,43556,66,0,61280,42458
93,8,1,3,1,0,0,3,8,24,56942,43559,0,24,61280,42461
94,8,1,0,0,3,1,0,23,16,56943,43559,37,0,61283,42461
95,8,1,2,1,0,0,3,143,204,56944,43561,49,155,61283,42464
96,9,2,0,0,3,1,0,76,74,56946,43561,94,90,61286,42464
97,9,2,1,0,3,1,0,151,166,56948,43562,202,0,61289,42464
98,9,1,1,2,1,2,1,75,73,56949,43563,77,9,61290,42465
99,9,1,0,0,3,1,0,201,220,56950,43563,185,42,61293,42465
100,9,1,0,0,3,1,0,9,0,56951,43563,27,30,61296,42465
101,9,3,0,0,3,1,0,27,0,56954,43563,69,51,61299,42465
102,9,1,1,2,1,2,1,99,141,56955,43564,129,9,61300,42466
103,9,1,1,2,1,2,1,291,239,56956,43565,247,81,61301,42467
104,9,3,2,0,3,1,0,111,102,56959,43567,69,0,61304,42467
105,9,1,3,1,0,0,3,9,27,56960,43570,0,27,61304,42470
106,9,1,0,0,3,1,0,24,16,56961,43570,40,0,61307,42470
107,9,1,2,1,0,0,3,144,206,56962,43572,49,158,61307,42473
108,10,2,0,0,3,1,0,78,74,56964,43572,97,90,61310,42473
109,10,2,1,0,3,1,0,153,167,56966,43573,205,0,61313,42473
110,10,1,1,2,1,2,1,76,74,56967,43574,78,10,61314,42474
111,10,1,0,0,3,1,0,202,220,56968,43574,188,42,61317,42474
112,10,1,0,0,3,1,0,10,0,56969,43574,30,30,61320,42474
113,10,3,0,0,3,1,0,30,0,56972,43574,72,51,61323,42474
114,10,1,1,2,1,2,1,100,142,56973,43575,130,10,61324,42475
115,10,1,1,2,1,2,1,292,240,56974,43576,248,82,61325,42476
116,10,3,2,0,3,1,0,114,104,56977,43578,72,0,61328,42476
117,10,1,3,1,0,0,3,10,30,56978,43581,0,30,61328,42479
118,10,1,0,0,3,1,0,25,16,56979,43581,43,0,61331,42479
119,10,1,2,1,0,0,3,145,208,56980,43583,49,161,61331,42482
120,11,2,0,0,3,1,0,80,74,56982,43583,100,90,61334,42482
121,11,2,1,0,3,1,0,155,168,56984,43584,208,0,61337,42482
122,11,1,1,2,1,2,1,77,75,56985,43585,79,11,61338,42483
123,11,1,0,0,3,1,0,203,220,56986,43585,191,42,61341,42483
124,11,1,0,0,3,1,0,11,0,56987,43585,33,30,61344,42483
125,11,3,0,0,3,1,0,33,0,56990,43585,75,51,61347,42483
126,11,1,1,2,1,2,1,101,143,56991,43586,131,11,61348,42484
127,11,1,1,2,1,2,1,293,241,56992,43587,249,83,61349,42485
128,11,3,2,0,3,1,0,117,106,56995,43589,75,0,61352,42485
129,11,1,3,1,0,0,3,11,33,56996,43592,0,33,61352,42488
130,11,1,0,0,3,1,0,26,16,56997,43592,46,0,61355,42488
131,11,1,2,1,0,0,3,146,210,56998,43594,49,164,61355,42491
132,12,2,0,0,3,1,0,82,74,57000,43594,103,90,61358,42491
133,12,2,1,0,3,1,0,157,169,57002,43595,211,0,61361,42491
134,12,1,1,2,1,2,1,78,76,57003,43596,80,12,61362,42492
135,12,1,0,0,3,1,0,204,220,57004,43596,194,42,61365,42492
136,12,1,0,0,3,1,0,12,0,57005,43596,36,30,61368,42492
137,12,3,0,0,3,1,0,36,0,57008,43596,78,51,61371,42492
138,12,1,1,2,1,2,1,102,144,57009,43597,132,12,61372,42493
139,12,1,1,2,1,2,1,294,242,57010,43598,250,84,61373,42494
140,12,3,2,0,3,1,0,120,108,57013,43600,78,0,61376,42494
141,12,1,3,1,0,0,3,12,36,57014,43603,0,36,61376,42497
142,12,1,0,0,3,1,0,27,16,57015,43603,49,0,61379,42497
143,12,1,2,1,0,0,3,147,212,57016,43605,49,167,61379,42500
144,13,2,0,0,3,1,0,84,74,57018,43605,106,90,61382,42500
145,13,2,1,0,3,1,0,159,170,57020,43606,214,0,61385,42500
146,13,1,1,2,1,2,1,79,77,57021,43607,81,13,61386,42501
147,13,1,0,0,3,1,0,205,220,57022,43607,197,42,61389,42501
148,13,1,0,0,3,1,0,13,0,57023,43607,39,30,61392,42501
149,13,3,0,0,3,1,0,39,0,57026,43607,81,51,61395,42501
150,13,1,1,2,1,2,1,103,145,57027,43608,133,13,61396,42502
151,13,1,1,2,1,2,1,295,243,57028,43609,251,85,61397,42503
152,13,3,2,0,3,1,0,123,110,57031,43611,81,0,61400,42503
153,13,1,3,1,0,0,3,13,39,57032,43614,0,39,61400,42506
154,13,1,0,0,3,1,0,28,16,57033,43614,52,0,61403,42506
155,13,1,2,1,0,0,3,148,214,57034,43616,49,170,61403,42509
156,14,2,0,0,3,1,0,86,74,57036,43616,109,90,61406,42509
157,14,2,1,0,3,1,0,161,171,57038,43617,217,0,61409,42509
158,14,1,1,2,1,2,1,80,78,57039,43618,82,14,61410,42510
159,14,1,0,0,3,1,0,206,220,57040,43618,200,42,61413,42510
160,14,1,0,0,3,1,0,14,0,57041,43618,42,30,61416,42510
161,14,3,0,0,3,1,0,42,0,57044,43618,84,51,61419,42510
162,14,1,1,2,1,2,1,104,146,57045,43619,134,14,61420,42511
163,14,1,1,2,1,2,1,296,244,57046,43620,252,86,61421,42512
164,14,3,2,0,3,1,0,126,112,57049,43622,84,0,61424,42512
165,14,1,3,1,0,0,3,14,42,57050,43625,0,42,61424,42515
166,14,1,0,0,3,1,0,29,16,57051,43625,55,0,61427,42515
167,14,1,2,1,0,0,3,149,216,57052,43627,49,173,61427,42518
168,15,2,0,0,3,1,0,88,74,57054,43627,112,90,61430,42518
169,15,2,1,0,3,1,0,163,172,57056,43628,220,0,61433,42518
170,15,1,1,2,1,2,1,81,79,57057,43629,83,15,61434,42519
171,15,1,0,0,3,1,0,207,220,57058,43629,203,42,61437,42519
172,15,1,0,0,3,1,0,15,0,57059,43629,45,30,61440,42519
173,15,3,0,0,3,1,0,45,0,57062,43629,87,51,61443,42519
174,15,1,1,2,1,2,1,105,147,57063,43630,135,15,61444,42520
175,15,1,1,2,1,2,1,297,245,57064,43631,253,87,61445,42521
176,15,3,2,0,3,1,0,129,114,57067,43633,87,0,61448,42521
177,15,1,3,1,0,0,3,15,45,57068,43636,0,45,61448,42524
178,15,1,0,0,3,1,0,30,16,57069,43636,58,0,61451,42524
179,15,1,2,1,0,0,3,150,218,57070,43638,49,176,61451,42527
180,16,2,0,0,3,1,0,90,74,57072,43638,115,90,61454,42527
181,16,2,1,0,3,1,0,165,173,57074,43639,223,0,61457,42527
182,16,1,1,2,1,2,1,82,80,57075,43640,84,16,61458,42528
183,16,1,0,0,3,1,0,208,220,57076,43640,206,42,61461,42528
184,16,1,0,0,3,1,0,16,0,57077,43640,48,30,61464,42528
185,16,3,0,0,3,1,0,48,0,57080,43640,90,51,61467,42528
186,16,1,1,2,1,2,1,106,148,57081,43641,136,16,61468,42529
187,16,1,1,2,1,2,1,298,246,57082,43642,254,88,61469,42530
188,16,3,2,0,3,1,0,132,116,57085,43644,90,0,61472,42530
189,16,1,3,1,0,0,3,16,48,57086,43647,0,48,61472,42533
190,16,1,0,0,3,1,0,31,16,57087,43647,61,0,61475,42533
191,16,1,2,1,0,0,3,151,220,57088,43649,49,179,61475,42536
192,17,2,0,0,3,1,0,92,74,57090,43649,118,90,61478,42536
193,17,2,1,0,3,1,0,167,174,57092,43650,226,0,61481,42536
194,17,1,1,2,1,2,1,83,81,57093,43651,85,17,61482,42537
195,17,1,0,0,3,1,0,209,220,57094,43651,209,42,61485,42537
196,17,1,0,0,3,1,0,17,0,57095,43651,51,30,61488,42537
197,17,3,0,0,3,1,0,51,0,57098,43651,93,51,61491,42537
198,17,1,1,2,1,2,1,107,149,57099,43652,137,17,61492,42538
199,17,1,1,2,1,2,1,299,247,57100,43653,255,89,61493,42539
200,17,3,2,0,3,1,0,135,118,57103,43655,93,0,61496,42539
201,17,1,3,1,0,0,3,17,51,57104,43658,0,51,61496,42542
202,17,1,0,0,3,1,0,32,16,57105,43658,64,0,61499,42542
203,17,1,2,1,0,0,3,152,222,57106,43660,49,182,61499,42545
204,18,2,0,0,3,1,0,94,74,57108,43660,121,90,61502,42545
205,18,2,1,0,3,1,0,169,175,57110,43661,229,0,61505,42545
206,18,1,1,2,1,2,1,84,82,57111,43662,86,18,61506,42546
207,18,1,0,0,3,1,0,210,220,57112,43662,212,42,61509,42546
208,18,1,0,0,3,1,0,18,0,57113,43662,54,30,61512,42546
209,18,3,0,0,3,1,0,54,0,57116,43662,96,51,61515,42546
210,18,1,1,2,1,2,1,108,150,57117,43663,138,18,61516,42547
211,18,1,1,2,1,2,1,300,248,57118,43664,256,90,61517,42548
212,18,3,2,0,3,1,0,138,120,57121,43666,96,0,61520,42548
213,18,1,3,1,0,0,3,18,54,57122,43669,0,54,61520,42551
214,18,1,0,0,3,1,0,33,16,57123,43669,67,0,61523,42551
215,18,1,2,1,0,0,3,153,224,57124,43671,49,185,61523,42554
216,19,2,0,0,3,1,0,96,74,57126,43671,124,90,61526,42554
217,19,2,1,0,3,1,0,171,176,57128,43672,232,0,61529,42554
218,19,1,1,2,1,2,1,85,83,57129,43673,87,19,61530,42555
219,19,1,0,0,3,1,0,211,220,57130,43673,215,42,61533,42555
220,19,1,0,0,3,1,0,19,0,57131,43673,57,30,61536,42555
221,19,3,0,0,3,1,0,57,0,57134,43673,99,51,61539,42555
222,19,1,1,2,1,2,1,109,151,57135,43674,139,19,61540,42556
223,19,1,1,2,1,2,1,301,249,57136,43675,257,91,61541,42557
224,19,3,2,0,3,1,0,141,122,57139,43677,99,0,61544,42557
225,19,1,3,1,0,0,3,19,57,57140,43680,0,57,61544,42560
226,19,1,0,0,3,1,0,34,16,57141,43680,70,0,61547,42560
227,19,1,2,1,0,0,3,154,226,57142,43682,49,188,61547,42563
228,20,2,0,0,3,1,0,98,74,57144,43682,127,90,61550,42563
229,20,2,1,0,3,1,0,173,177,57146,43683,235,0,61553,42563
230,20,1,1,2,1,2,1,86,84,57147,43684,88,20,61554,42564
231,20,1,0,0,3,1,0,212,220,57148,43684,218,42,61557,42564
232,20,1,0,0,3,1,0,20,0,57149,43684,60,30,61560,42564
233,20,3,0,0,3,1,0,60,0,57152,43684,102,51,61563,42564
234,20,1,1,2,1,2,1,110,152,57153,43685,140,20,61564,42565
235,20,1,1,2,1,2,1,302,250,57154,43686,258,92,61565,42566
236,20,3,2,0,3,1,0,144,124,57157,43688,102,0,61568,42566
237,20,1,3,1,0,0,3,20,60,57158,43691,0,60,61568,42569
238,20,1,0,0,3,1,0,35,16,57159,43691,73,0,61571,42569
239,20,1,2,1,0,0,3,155,228,57160,43693,49,191,61571,42572
240,21,2,0,0,3,1,0,100,74,57162,43693,130,90,61574,42572
241,21,2,1,0,3,1,0,175,178,57164,43694,238,0,61577,42572
242,21,1,1,2,1,2,1,87,85,57165,43695,89,21,61578,42573
243,21,1,0,0,3,1,0,213,220,57166,43695,221,42,61581,42573
244,21,1,0,0,3,1,0,21,0,57167,43695,63,30,61584,42573
245,21,3,0,0,3,1,0,63,0,57170,43695,105,51,61587,42573
246,21,1,1,2,1,2,1,111,153,57171,43696,141,21,61588,42574
247,21,1,1,2,1,2,1,303,251,57172,43697,259,93,61589,42575
248,21,3,2,0,3,1,0,147,126,57175,43699,105,0,61592,42575
249,21,1,3,1,0,0,3,21,63,57176,43702,0,63,61592,42578
250,21,1,0,0,3,1,0,36,16,57177,43702,76,0,61595,42578
251,21,1,2,1,0,0,3,156,230,57178,43704,49,194,61595,42581
252,22,2,0,0,3,1,0,102,74,57180,43704,133,90,61598,42581
253,22,2,1,0,3,1,0,177,179,57182,43705,241,0,61601,42581
254,22,1,1,2,1,2,1,88,86,57183,43706,90,22,61602,42582
255,22,1,0,0,3,1,0,214,220,57184,43706,224,42,61605,42582
256,22,1,0,0,3,1,0,22,0,57185,43706,66,30,61608,42582
257,22,3,0,0,3,1,0,66,0,57188,43706,108,51,61611,42582
258,22,1,1,2,1,2,1,112,154,57189,43707,142,22,61612,42583
259,22,1,1,2,1,2,1,304,252,57190,43708,260,94,61613,42584
260,22,3,2,0,3,1,0,150,128,57193,43710,108,0,61616,42584
261,22,1,3,1,0,0,3,22,66,57194,43713,0,66,61616,42587
262,22,1,0,0,3,1,0,37,16,57195,43713,79,0,61619,42587
263,22,1,2,1,0,0,3,157,232,57196,43715,49,197,61619,42590
264,23,2,0,0,3,1,0,104,74,57198,43715,136,90,61622,42590
265,23,2,1,0,3,1,0,179,180,57200,43716,244,0,61625,42590
266,23,1,1,2,1,2,1,89,87,57201,43717,91,23,61626,42591
267,23,1,0,0,3,1,0,215,220,57202,43717,227,42,61629,42591
268,23,1,0,0,3,1,0,23,0,57203,43717,69,30,61632,42591
269,23,3,0,0,3,1,0,69,0,57206,43717,111,51,61635,42591
270,23,1,1,2,1,2,1,113,155,57207,43718,143,23,61636,42592
271,23,1,1,2,1,2,1,305,253,57208,43719,261,95,61637,42593
272,23,3,2,0,3,1,0,153,130,57211,43721,111,0,61640,42593
273,23,1,3,1,0,0,3,23,69,57212,43724,0,69,61640,42596
274,23,1,0,0,3,1,0,38,16,57213,43724,82,0,61643,42596
275,23,1,2,1,0,0,3,158,234,57214,43726,49,200,61643,42599
276,24,2,0,0,3,1,0,106,74,57216,43726,139,90,61646,42599
277,24,2,1,0,3,1,0,181,181,57218,43727,247,0,61649,42599
278,24,1,1,2,1,2,1,90,88,57219,43728,92,24,61650,42600
279,24,1,0,0,3,1,0,216,220,57220,43728,230,42,61653,42600
280,24,1,0,0,3,1,0,24,0,57221,43728,72,30,61656,42600
281,24,3,0,0,3,1,0,72,0,57224,43728,114,51,61659,42600
282,24,1,1,2,1,2,1,114,156,57225,43729,144,24,61660,42601
283,24,1,1,2,1,2,1,306,254,57226,43730,262,96,61661,42602
284,24,3,2,0,3,1,0,156,132,57229,43732,114,0,61664,42602
285,24,1,3,1,0,0,3,24,72,57230,43735,0,72,61664,42605
286,24,1,0,0,3,1,0,39,16,57231,43735,85,0,61667,42605
287,24,1,2,1,0,0,3,159,236,57232,43737,49,203,61667,42608
288,25,2,0,0,3,1,0,108,74,57234,43737,142,90,61670,42608
289,25,2,1,0,3,1,0,183,182,57236,43738,250,0,61673,42608
290,25,1,1,2,1,2,1,91,89,57237,43739,93,25,61674,42609
291,25,1,0,0,3,1,0,217,220,57238,43739,233,42,61677,42609
292,25,1,0,0,3,1,0,25,0,57239,43739,75,30,61680,42609
293,25,3,0,0,3,1,0,75,0,57242,43739,117,51,61683,42609
294,25,1,1,2,1,2,1,115,157,57243,43740,145,25,61684,42610
295,25,1,1,2,1,2,1,307,255,57244,43741,263,97,61685,42611
296,25,3,2,0,3,1,0,159,134,57247,43743,117,0,61688,42611
297,25,1,3,1,0,0,3,25,75,57248,43746,0,75,61688,42614
298,25,1,0,0,3,1,0,40,16,57249,43746,88,0,61691,42614
299,25,1,2,1,0,0,3,160,238,57250,43748,49,206,61691,42617
300,26,2,0,0,3,1,0,110,74,57252,43748,145,90,61694,42617
301,26,2,1,0,3,1,0,185,183,57254,43749,253,0,61697,42617
302,26,1,1,2,1,2,1,92,90,57255,43750,94,26,61698,42618
303,26,1,0,0,3,1,0,218,220,57256,43750,236,42,61701,42618
304,26,1,0,0,3,1,0,26,0,57257,43750,78,30,61704,42618
305,26,3,0,0,3,1,0,78,0,57260,43750,120,51,61707,42618
306,26,1,1,2,1,2,1,116,158,57261,43751,146,26,61708,42619
307,26,1,1,2,1,2,1,308,256,57262,43752,264,98,61709,42620
308,26,3,2,0,3,1,0,162,136,57265,43754,120,0,61712,42620
309,26,1,3,1,0,0,3,26,78,57266,43757,0,78,61712,42623
310,26,1,0,0,3,1,0,41,16,57267,43757,91,0,61715,42623
311,26,1,2,1,0,0,3,161,240,57268,43759,49,209,61715,42626
312,27,2,0,0,3,1,0,112,74,57270,43759,148,90,61718,42626
313,27,2,1,0,3,1,0,187,184,57272,43760,256,0,61721,42626
314,27,1,1,2,1,2,1,93,91,57273,43761,95,27,61722,42627
315,27,1,0,0,3,1,0,219,220,57274,43761,239,42,61725,42627
316,27,1,0,0,3,1,0,27,0,57275,43761,81,30,61728,42627
317,27,3,0,0,3,1,0,81,0,57278,43761,123,51,61731,42627
318,27,1,1,2,1,2,1,117,159,57279,43762,147,27,61732,42628
319,27,1,1,2,1,2,1,309,257,57280,43763,265,99,61733,42629
320,27,3,2,0,3,1,0,165,138,57283,43765,123,0,61736,42629
321,27,1,3,1,0,0,3,27,81,57284,43768,0,81,61736,42632
322,27,1,0,0,3,1,0,42,16,57285,43768,94,0,61739,42632
323,27,1,2,1,0,0,3,162,242,57286,43770,49,212,61739,42635
324,28,2,0,0,3,1,0,114,74,57288,43770,151,90,61742,42635
325,28,2,1,0,3,1,0,189,185,57290,43771,259,0,61745,42635
326,28,1,1,2,1,2,1,94,92,57291,43772,96,28,61746,42636
327,28,1,0,0,3,1,0,220,220,57292,43772,242,42,61749,42636
328,28,1,0,0,3,1,0,28,0,57293,43772,84,30,61752,42636
329,28,3,0,0,3,1,0,84,0,57296,43772,126,51,61755,42636
330,28,1,1,2,1,2,1,118,160,57297,43773,148,28,61756,42637
331,28,1,1,2,1,2,1,310,258,57298,43774,266,100,61757,42638
332,28,3,2,0,3,1,0,168,140,57301,43776,126,0,61760,42638
333,28,1,3,1,0,0,3,28,84,57302,43779,0,84,61760,42641
334,28,1,0,0,3,1,0,43,16,57303,43779,97,0,61763,42641
335,28,1,2,1,0,0,3,163,244,57304,43781,49,215,61763,42644
336,29,2,0,0,3,1,0,116,74,57306,43781,154,90,61766,42644
337,29,2,1,0,3,1,0,191,186,57308,43782,262,0,61769,42644
338,29,1,1,2,1,2,1,95,93,57309,43783,97,29,61770,42645
339,29,1,0,0,3,1,0,221,220,57310,43783,245,42,61773,42645
340,29,1,0,0,3,1,0,29,0,57311,43783,87,30,61776,42645
341,29,3,0,0,3,1,0,87,0,57314,43783,129,51,61779,42645
342,29,1,1,2,1,2,1,119,161,57315,43784,149,29,61780,42646
343,29,1,1,2,1,2,1,311,259,57316,43785,267,101,61781,42647
344,29,3,2,0,3,1,0,171,142,57319,43787,129,0,61784,42647
345,29,1,3,1,0,0,3,29,87,57320,43790,0,87,61784,42650
346,29,1,0,0,3,1,0,44,16,57321,43790,100,0,61787,42650
347,29,1,2,1,0,0,3,164,246,57322,43792,49,218,61787,42653
348,30,2,0,0,3,1,0,118,74,57324,43792,157,90,61790,42653
349,30,2,1,0,3,1,0,193,187,57326,43793,265,0,61793,42653
350,30,1,1,2,1,2,1,96,94,57327,43794,98,30,61794,42654
351,30,1,0,0,3,1,0,222,220,57328,43794,248,42,61797,42654
352,30,1,0,0,3,1,0,30,0,57329,43794,90,30,61800,42654
353,30,3,0,0,3,1,0,90,0,57332,43794,132,51,61803,42654
354,30,1,1,2,1,2,1,120,162,57333,43795,150,30,61804,42655
355,30,1,1,2,1,2,1,312,260,57334,43796,268,102,61805,42656
356,30,3,2,0,3,1,0,174,144,57337,43798,132,0,61808,42656
357,30,1,3,1,0,0,3,30,90,57338,43801,0,90,61808,42659
358,30,1,0,0,3,1,0,45,16,57339,43801,103,0,61811,42659
359,30,1,2,1,0,0,3,165,248,57340,43803,49,221,61811,42662
360,31,2,0,0,3,1,0,120,74,57342,43803,160,90,61814,42662
361,31,2,1,0,3,1,0,195,188,57344,43804,268,0,61817,42662
362,31,1,1,2,1,2,1,97,95,57345,43805,99,31,61818,42663
363,31,1,0,0,3,1,0,223,220,57346,43805,251,42,61821,42663
364,31,1,0,0,3,1,0,31,0,57347,43805,93,30,61824,42663
365,31,3,0,0,3,1,0,93,0,57350,43805,135,51,61827,42663
366,31,1,1,2,1,2,1,121,163,57351,43806,151,31,61828,42664
367,31,1,1,2,1,2,1,313,261,57352,43807,269,103,61829,42665
368,31,3,2,0,3,1,0,177,146,57355,43809,135,0,61832,42665
369,31,1,3,1,0,0,3,31,93,57356,43812,0,93,61832,42668
370,31,1,0,0,3,1,0,46,16,57357,43812,106,0,61835,42668
371,31,1,2,1,0,0,3,166,250,57358,43814,49,224,61835,42671
372,32,2,0,0,3,1,0,122,74,57360,43814,163,90,61838,42671
373,32,2,1,0,3,1,0,197,189,57362,43815,271,0,61841,42671
374,32,1,1,2,1,2,1,98,96,57363,43816,100,32,61842,42672
375,32,1,0,0,3,1,0,224,220,57364,43816,254,42,61845,42672
376,32,1,0,0,3,1,0,32,0,57365,43816,96,30,61848,42672
377,32,3,0,0,3,1,0,96,0,57368,43816,138,51,61851,42672
378,32,1,1,2,1,2,1,122,164,57369,43817,152,32,61852,42673
379,32,1,1,2,1,2,1,314,262,57370,43818,270,104,61853,42674
380,32,3,2,0,3,1,0,180,148,57373,43820,138,0,61856,42674
381,32,1,3,1,0,0,3,32,96,57374,43823,0,96,61856,42677
382,32,1,0,0,3,1,0,47,16,57375,43823,109,0,61859,42677
383,32,1,2,1,0,0,3,167,252,57376,43825,49,227,61859,42680
384,33,2,0,0,3,1,0,124,74,57378,43825,166,90,61862,42680
385,33,2,1,0,3,1,0,199,190,57380,43826,274,0,61865,42680
386,33,1,1,2,1,2,1,99,97,57381,43827,101,33,61866,42681
387,33,1,0,0,3,1,0,225,220,57382,43827,257,42,61869,42681
388,33,1,0,0,3,1,0,33,0,57383,43827,99,30,61872,42681
389,33,3,0,0,3,1,0,99,0,57386,43827,141,51,61875,42681
390,33,1,1,2,1,2,1,123,165,57387,43828,153,33,61876,42682
391,33,1,1,2,1,2,1,315,263,57388,43829,271,105,61877,42683
392,33,3,2,0,3,1,0,183,150,57391,43831,141,0,61880,42683
393,33,1,3,1,0,0,3,33,99,57392,43834,0,99,61880,42686
394,33,1,0,0,3,1,0,48,16,57393,43834,112,0,61883,42686
395,33,1,2,1,0,0,3,168,254,57394,43836,49,230,61883,42689
396,34,2,0,0,3,1,0,126,74,57396,43836,169,90,61886,42689
397,34,2,1,0,3,1,0,201,191,57398,43837,277,0,61889,42689
398,34,1,1,2,1,2,1,100,98,57399,43838,102,34,61890,42690
399,34,1,0,0,3,1,0,226,220,57400,43838,260,42,61893,42690
400,34,1,0,0,3,1,0,34,0,57401,43838,102,30,61896,42690
401,34,3,0,0,3,1,0,102,0,57404,43838,144,51,61899,42690
402,34,1,1,2,1,2,1,124,166,57405,43839,154,34,61900,42691
403,34,1,1,2,1,2,1,316,264,57406,43840,272,106,61901,42692
404,34,3,2,0,3,1,0,186,152,57409,43842,144,0,61904,42692
405,34,1,3,1,0,0,3,34,102,57410,43845,0,102,61904,42695
406,34,1,0,0,3,1,0,49,16,57411,43845,115,0,61907,42695
407,34,1,2,1,0,0,3,169,256,57412,43847,49,233,61907,42698
408,35,2,0,0,3,1,0,128,74,57414,43847,172,90,61910,42698
409,35,2,1,0,3,1,0,203,192,57416,43848,280,0,61913,42698
410,35,1,1,2,1,2,1,101,99,57417,43849,103,35,61914,42699
411,35,1,0,0,3,1,0,227,220,57418,43849,263,42,61917,42699
412,35,1,0,0,3,1,0,35,0,57419,43849,105,30,61920,42699
413,35,3,0,0,3,1,0,105,0,57422,43849,147,51,61923,42699
414,35,1,1,2,1,2,1,125,167,57423,43850,155,35,61924,42700
415,35,1,1,2,1,2,1,317,265,57424,43851,273,107,61925,42701
416,35,3,2,0,3,1,0,189,154,57427,43853,147,0,61928,42701
417,35,1,3,1,0,0,3,35,105,57428,43856,0,105,61928,42704
418,35,1,0,0,3,1,0,50,16,57429,43856,118,0,61931,42704
419,35,1,2,1,0,0,3,170,258,57430,43858,49,236,61931,42707
420,36,2,0,0,3,1,0,130,74,57432,43858,175,90,61934,42707
421,36,2,1,0,3,1,0,205,193,57434,43859,283,0,61937,42707
422,36,1,1,2,1,2,1,102,100,57435,43860,104,36,61938,42708
423,36,1,0,0,3,1,0,228,220,57436,43860,266,42,61941,42708
424,36,1,0,0,3,1,0,36,0,57437,43860,108,30,61944,42708
425,36,3,0,0,3,1,0,108,0,57440,43860,150,51,61947,42708
426,36,1,1,2,1,2,1,126,168,57441,43861,156,36,61948,42709
427,36,1,1,2,1,2,1,318,266,57442,43862,274,108,61949,42710
428,36,3,2,0,3,1,0,192,156,57445,43864,150,0,61952,42710
429,36,1,3,1,0,0,3,36,108,57446,43867,0,108,61952,42713
430,36,1,0,0,3,1,0,51,16,57447,43867,121,0,61955,42713
431,36,1,2,1,0,0,3,171,260,57448,43869,49,239,61955,42716
432,37,2,0,0,3,1,0,132,74,57450,43869,178,90,61958,42716
433,37,2,1,0,3,1,0,207,194,57452,43870,286,0,61961,42716
434,37,1,1,2,1,2,1,103,101,57453,43871,105,37,61962,42717
435,37,1,0,0,3,1,0,229,220,57454,43871,269,42,61965,42717
436,37,1,0,0,3,1,0,37,0,57455,43871,111,30,61968,42717
437,37,3,0,0,3,1,0,111,0,57458,43871,153,51,61971,42717
438,37,1,1,2,1,2,1,127,169,57459,43872,157,37,61972,42718
439,37,1,1,2,1,2,1,319,267,57460,43873,275,109,61973,42719
440,37,3,2,0,3,1,0,195,158,57463,43875,153,0,61976,42719
441,37,1,3,1,0,0,3,37,111,57464,43878,0,111,61976,42722
442,37,1,0,0,3,1,0,52,16,57465,43878,124,0,61979,42722
443,37,1,2,1,0,0,3,172,262,57466,43880,49,242,61979,42725
444,38,2,0,0,3,1,0,134,74,57468,43880,181,90,61982,42725
445,38,2,1,0,3,1,0,209,195,57470,43881,289,0,61985,42725
446,38,1,1,2,1,2,1,104,102,57471,43882,106,38,61986,42726
447,38,1,0,0,3,1,0,230,220,57472,43882,272,42,61989,42726
448,38,1,0,0,3,1,0,38,0,57473,43882,114,30,61992,42726
449,38,3,0,0,3,1,0,114,0,57476,43882,156,51,61995,42726
450,38,1,1,2,1,2,1,128,170,57477,43883,158,38,61996,42727
451,38,1,1,2,1,2,1,320,268,57478,43884,276,110,61997,42728
452,38,3,2,0,3,1,0,198,160,57481,43886,156,0,62000,42728
453,38,1,3,1,0,0,3,38,114,57482,43889,0,114,62000,42731
454,38,1,0,0,3,1,0,53,16,57483,43889,127,0,62003,42731
455,38,1,2,1,0,0,3,173,264,57484,43891,49,245,62003,42734
456,39,2,0,0,3,1,0,136,74,57486,43891,184,90,62006,42734
457,39,2,1,0,3,1,0,211,196,57488,43892,292,0,62009,42734
458,39,1,1,2,1,2,1,105,103,57489,43893,107,39,62010,42735
459,39,1,0,0,3,1,0,231,220,57490,43893,275,42,62013,42735
460,39,1,0,0,3,1,0,39,0,57491,43893,117,30,62016,42735
461,39,3,0,0,3,1,0,117,0,57494,43893,159,51,62019,42735
462,39,1,1,2,1,2,1,129,171,57495,43894,159,39,62020,42736
463,39,1,1,2,1,2,1,321,269,57496,43895,277,111,62021,42737
464,39,3,2,0,3,1,0,201,162,57499,43897,159,0,62024,42737
465,39,1,3,1,0,0,3,39,117,57500,43900,0,117,62024,42740
466,39,1,0,0,3,1,0,54,16,57501,43900,130,0,62027,42740
467,39,1,2,1,0,0,3,174,266,57502,43902,49,248,62027,42743
468,40,2,0,0,3,1,0,138,74,57504,43902,187,90,62030,42743
469,40,2,1,0,3,1,0,213,197,57506,43903,295,0,62033,42743
470,40,1,1,2,1,2,1,106,104,57507,43904,108,40,62034,42744
471,40,1,0,0,3,1,0,232,220,57508,43904,278,42,62037,42744
472,40,1,0,0,3,1,0,40,0,57509,43904,120,30,62040,42744
473,40,3,0,0,3,1,0,120,0,57512,43904,162,51,62043,42744
474,40,1,1,2,1,2,1,130,172,57513,43905,160,40,62044,42745
475,40,1,1,2,1,2,1,322,270,57514,43906,278,112,62045,42746
476,40,3,2,0,3,1,0,204,164,57517,43908,162,0,62048,42746
477,40,1,3,1,0,0,3,40,120,57518,43911,0,120,62048,42749
478,40,1,0,0,3,1,0,55,16,57519,43911,133,0,62051,42749
479,40,1,2,1,0,0,3,175,268,57520,43913,49,251,62051,42752
480,41,2,0,0,3,1,0,140,74,57522,43913,190,90,62054,42752
481,41,2,1,0,3,1,0,215,198,57524,43914,298,0,62057,42752
482,41,1,1,2,1,2,1,107,105,57525,43915,109,41,62058,42753
483,41,1,0,0,3,1,0,233,220,57526,43915,281,42,62061,42753
484,41,1,0,0,3,1,0,41,0,57527,43915,123,30,62064,42753
485,41,3,0,0,3,1,0,123,0,57530,43915,165,51,62067,42753
486,41,1,1,2,1,2,1,131,173,57531,43916,161,41,62068,42754
487,41,1,1,2,1,2,1,323,271,57532,43917,279,113,62069,42755
488,41,3,2,0,3,1,0,207,166,57535,43919,165,0,62072,42755
489,41,1,3,1,0,0,3,41,123,57536,43922,0,123,62072,42758
490,41,1,0,0,3,1,0,56,16,57537,43922,136,0,62075,42758
491,41,1,2,1,0,0,3,176,270,57538,43924,49,254,62075,42761
492,42,2,0,0,3,1,0,142,74,57540,43924,193,90,62078,42761
493,42,2,1,0,3,1,0,217,199,57542,43925,301,0,62081,42761
494,42,1,1,2,1,2,1,108,106,57543,43926,110,42,62082,42762
495,42,1,0,0,3,1,0,234,220,57544,43926,284,42,62085,42762
496,42,1,0,0,3,1,0,42,0,57545,43926,126,30,62088,42762
497,42,3,0,0,3,1,0,126,0,57548,43926,168,51,62091,42762
498,42,1,1,2,1,2,1,132,174,57549,43927,162,42,62092,42763
499,42,1,1,2,1,2,1,324,272,57550,43928,280,114,62093,42764
500,42,3,2,0,3,1,0,210,168,57553,43930,168,0,62096,42764
501,42,1,3,1,0,0,3,42,126,57554,43933,0,126,62096,42767
502,42,1,0,0,3,1,0,57,16,57555,43933,139,0,62099,42767
503,42,1,2,1,0,0,3,177,272,57556,43935,49,257,62099,42770
504,43,2,0,0,3,1,0,144,74,57558,43935,196,90,62102,42770
505,43,2,1,0,3,1,0,219,200,57560,43936,304,0,62105,42770
506,43,1,1,2,1,2,1,109,107,57561,43937,111,43,62106,42771
507,43,1,0,0,3,1,0,235,220,57562,43937,287,42,62109,42771
508,43,1,0,0,3,1,0,43,0,57563,43937,129,30,62112,42771
509,43,3,0,0,3,1,0,129,0,57566,43937,171,51,62115,42771
510,43,1,1,2,1,2,1,133,175,57567,43938,163,43,62116,42772
511,43,1,1,2,1,2,1,325,273,57568,43939,281,115,62117,42773
512,43,3,2,0,3,1,0,213,170,57571,43941,171,0,62120,42773
513,43,1,3,1,0,0,3,43,129,57572,43944,0,129,62120,42776
514,43,1,0,0,3,1,0,58,16,57573,43944,142,0,62123,42776
515,43,1,2,1,0,0,3,178,274,57574,43946,49,260,62123,42779
516,44,2,0,0,3,1,0,146,74,57576,43946,199,90,62126,42779
517,44,2,1,0,3,1,0,221,201,57578,43947,307,0,62129,42779
518,44,1,1,2,1,2,1,110,108,57579,43948,112,44,62130,42780
519,44,1,0,0,3,1,0,236,220,57580,43948,290,42,62133,42780
520,44,1,0,0,3,1,0,44,0,57581,43948,132,30,62136,42780
521,44,3,0,0,3,1,0,132,0,57584,43948,174,51,62139,42780
522,44,1,1,2,1,2,1,134,176,57585,43949,164,44,62140,42781
523,44,1,1,2,1,2,1,326,274,57586,43950,282,116,62141,42782
524,44,3,2,0,3,1,0,216,172,57589,43952,174,0,62144,42782
525,44,1,3,1,0,0,3,44,132,57590,43955,0,132,62144,42785
526,44,1,0,0,3,1,0,59,16,57591,43955,145,0,62147,42785
527,44,1,2,1,0,0,3,179,276,57592,43957,49,263,62147,42788
528,45,2,0,0,3,1,0,148,74,57594,43957,202,90,62150,42788
529,45,2,1,0,3,1,0,223,202,57596,43958,310,0,62153,42788
530,45,1,1,2,1,2,1,111,109,57597,43959,113,45,62154,42789
531,45,1,0,0,3,1,0,237,220,57598,43959,293,42,62157,42789
532,45,1,0,0,3,1,0,45,0,57599,43959,135,30,62160,42789
533,45,3,0,0,3,1,0,135,0,57602,43959,177,51,62163,42789
534,45,1,1,2,1,2,1,135,177,57603,43960,165,45,62164,42790
535,45,1,1,2,1,2,1,327,275,57604,43961,283,117,62165,42791
536,45,3,2,0,3,1,0,219,174,57607,43963,177,0,62168,42791
537,45,1,3,1,0,0,3,45,135,57608,43966,0,135,62168,42794
538,45,1,0,0,3,1,0,60,16,57609,43966,148,0,62171,42794
539,45,1,2,1,0,0,3,180,278,57610,43968,49,266,62171,42797
540,46,2,0,0,3,1,0,150,74,57612,43968,205,90,62174,42797
541,46,2,1,0,3,1,0,225,203,57614,43969,313,0,62177,42797
542,46,1,1,2,1,2,1,112,110,57615,43970,114,46,62178,42798
543,46,1,0,0,3,1,0,238,220,57616,43970,296,42,62181,42798
544,46,1,0,0,3,1,0,46,0,57617,43970,138,30,62184,42798
545,46,3,0,0,3,1,0,138,0,57620,43970,180,51,62187,42798
546,46,1,1,2,1,2,1,136,178,57621,43971,166,46,62188,42799
547,46,1,1,2,1,2,1,328,276,57622,43972,284,118,62189,42800
548,46,3,2,0,3,1,0,222,176,57625,43974,180,0,62192,42800
549,46,1,3,1,0,0,3,46,138,57626,43977,0,138,62192,42803
550,46,1,0,0,3,1,0,61,16,57627,43977,151,0,62195,42803
551,46,1,2,1,0,0,3,181,280,57628,43979,49,269,62195,42806
0,1,1,1,2,1,2,1,151,75,57629,43980,206,43,62196,42807
1,1,1,1,2,1,2,1,159,150,57630,43981,206,1,62197,42808
2,1,0,1,1,0,0,3,225,204,57630,43982,313,121,62197,42811
3,1,0,1,1,0,0,3,138,1,57630,43983,180,189,62197,42814
4,1,0,3,1,0,0,3,132,3,57630,43986,306,49,62197,42817
5,1,2,2,2,1,2,1,114,112,57632,43988,115,43,62198,42818
6,1,1,0,0,3,1,0,1,0,57633,43988,3,9,62201,42818
7,1,0,0,2,1,2,1,0,0,57633,43988,1,52,62202,42819
8,1,0,0,2,1,2,1,143,37,57633,43988,265,91,62203,42820
9,1,1,0,0,3,1,0,43,0,57634,43988,129,30,62206,42820
10,1,1,2,1,0,0,3,91,122,57635,43990,0,45,62206,42823
11,1,1,2,1,0,0,3,47,140,57636,43992,0,55,62206,42826
12,2,1,1,2,1,2,1,152,76,57637,43993,207,44,62207,42827
13,2,1,1,2,1,2,1,160,151,57638,43994,207,2,62208,42828
14,2,0,1,1,0,0,3,225,205,57638,43995,313,124,62208,42831
15,2,0,1,1,0,0,3,138,2,57638,43996,180,192,62208,42834
16,2,0,3,1,0,0,3,132,6,57638,43999,306,52,62208,42837
17,2,2,2,2,1,2,1,116,114,57640,44001,116,44,62209,42838
18,2,1,0,0,3,1,0,2,0,57641,44001,6,9,62212,42838
19,2,0,0,2,1,2,1,0,0,57641,44001,2,53,62213,42839
20,2,0,0,2,1,2,1,143,37,57641,44001,266,92,62214,42840
21,2,1,0,0,3,1,0,44,0,57642,44001,132,30,62217,42840
22,2,1,2,1,0,0,3,92,124,57643,44003,0,48,62217,42843
23,2,1,2,1,0,0,3,48,142,57644,44005,0,58,62217,42846
24,3,1,1,2,1,2,1,153,77,57645,44006,208,45,62218,42847
25,3,1,1,2,1,2,1,161,152,57646,44007,208,3,62219,42848
26,3,0,1,1,0,0,3,225,206,57646,44008,313,127,62219,42851
27,3,0,1,1,0,0,3,138,3,57646,44009,180,195,62219,42854
28,3,0,3,1,0,0,3,132,9,57646,44012,306,55,62219,42857
29,3,2,2,2,1,2,1,118,116,57648,44014,117,45,62220,42858
30,3,1,0,0,3,1,0,3,0,57649,44014,9,9,62223,42858
31,3,0,0,2,1,2,1,0,0,57649,44014,3,54,62224,42859
32,3,0,0,2,1,2,1,143,37,57649,44014,267,93,62225,42860
33,3,1,0,0,3,1,0,45,0,57650,44014,135,30,62228,42860
34,3,1,2,1,0,0,3,93,126,57651,44016,0,51,62228,42863
35,3,1,2,1,0,0,3,49,144,57652,44018,0,61,62228,42866
36,4,1,1,2,1,2,1,154,78,57653,44019,209,46,62229,42867
37,4,1,1,2,1,2,1,162,153,57654,44020,209,4,62230,42868
38,4,0,1,1,0,0,3,225,207,57654,44021,313,130,62230,42871
39,4,0,1,1,0,0,3,138,4,57654,44022,180,198,62230,42874
40,4,0,3,1,0,0,3,132,12,57654,44025,306,58,62230,42877
41,4,2,2,2,1,2,1,120,118,57656,44027,118,46,62231,42878
42,4,1,0,0,3,1,0,4,0,57657,44027,12,9,62234,42878
43,4,0,0,2,1,2,1,0,0,57657,44027,4,55,62235,42879
44,4,0,0,2,1,2,1,143,37,57657,44027,268,94,62236,42880
45,4,1,0,0,3,1,0,46,0,57658,44027,138,30,62239,42880
46,4,1,2,1,0,0,3,94,128,57659,44029,0,54,62239,42883
47,4,1,2,1,0,0,3,50,146,57660,44031,0,64,62239,42886
48,5,1,1,2,1,2,1,155,79,57661,44032,210,47,62240,42887
49,5,1,1,2,1,2,1,163,154,57662,44033,210,5,62241,42888
50,5,0,1,1,0,0,3,225,208,57662,44034,313,133,62241,42891
51,5,0,1,1,0,0,3,138,5,57662,44035,180,201,62241,42894
52,5,0,3,1,0,0,3,132,15,57662,44038,306,61,62241,42897
53,5,2,2,2,1,2,1,122,120,57664,44040,119,47,62242,42898
54,5,1,0,0,3,1,0,5,0,57665,44040,15,9,62245,42898
55,5,0,0,2,1,2,1,0,0,57665,44040,5,56,62246,42899
56,5,0,0,2,1,2,1,143,37,57665,44040,269,95,62247,42900
57,5,1,0,0,3,1,0,47,0,57666,44040,141,30,62250,42900
58,5,1,2,1,0,0,3,95,130,57667,44042,0,57,62250,42903
59,5,1,2,1,0,0,3,51,148,57668,44044,0,67,62250,42906
60,6,1,1,2,1,2,1,156,80,57669,44045,211,48,62251,42907
61,6,1,1,2,1,2,1,164,155,57670,44046,211,6,62252,42908
62,6,0,1,1,0,0,3,225,209,57670,44047,313,136,62252,42911
63,6,0,1,1,0,0,3,138,6,57670,44048,180,204,62252,42914
64,6,0,3,1,0,0,3,132,18,57670,44051,306,64,62252,42917
65,6,2,2,2,1,2,1,124,122,57672,44053,120,48,62253,42918
66,6,1,0,0,3,1,0,6,0,57673,44053,18,9,62256,42918
67,6,0,0,2,1,2,1,0,0,57673,44053,6,57,62257,42919
68,6,0,0,2,1,2,1,143,37,57673,44053,270,96,62258,42920
69,6,1,0,0,3,1,0,48,0,57674,44053,144,30,62261,42920
70,6,1,2,1,0,0,3,96,132,57675,44055,0,60,62261,42923
71,6,1,2,1,0,0,3,52,150,57676,44057,0,70,62261,42926
72,7,1,1,2,1,2,1,157,81,57677,44058,212,49,62262,42927
73,7,1,1,2,1,2,1,165,156,57678,44059,212,7,62263,42928
74,7,0,1,1,0,0,3,225,210,57678,44060,313,139,62263,42931
75,7,0,1,1,0,0,3,138,7,57678,44061,180,207,62263,42934
76,7,0,3,1,0,0,3,132,21,57678,44064,306,67,62263,42937
77,7,2,2,2,1,2,1,126,124,57680,44066,121,49,62264,42938
78,7,1,0,0,3,1,0,7,0,57681,44066,21,9,62267,42938
79,7,0,0,2,1,2,1,0,0,57681,44066,7,58,62268,42939
80,7,0,0,2,1,2,1,143,37,57681,44066,271,97,62269,42940
81,7,1,0,0,3,1,0,49,0,57682,44066,147,30,62272,42940
82,7,1,2,1,0,0,3,97,134,57683,44068,0,63,62272,42943
83,7,1,2,1,0,0,3,53,152,57684,44070,0,73,62272,42946
84,8,1,1,2,1,2,1,158,82,57685,44071,213,50,62273,42947
85,8,1,1,2,1,2,1,166,157,57686,44072,213,8,62274,42948
86,8,0,1,1,0,0,3,225,211,57686,44073,313,142,62274,42951
87,8,0,1,1,0,0,3,138,8,57686,44074,180,210,62274,42954
88,8,0,3,1,0,0,3,132,24,57686,44077,306,70,62274,42957
89,8,2,2,2,1,2,1,128,126,57688,44079,122,50,62275,42958
90,8,1,0,0,3,1,0,8,0,57689,44079,24,9,62278,42958
91,8,0,0,2,1,2,1,0,0,57689,44079,8,59,62279,42959
92,8,0,0,2,1,2,1,143,37,57689,44079,272,98,62280,42960
93,8,1,0,0,3,1,0,50,0,57690,44079,150,30,62283,42960
94,8,1,2,1,0,0,3,98,136,57691,44081,0,66,62283,42963
95,8,1,2,1,0,0,3,54,154,57692,44083,0,76,62283,42966
96,9,1,1,2,1,2,1,159,83,57693,44084,214,51,62284,42967
97,9,1,1,2,1,2,1,167,158,57694,44085,214,9,62285,42968
98,9,0,1,1,0,0,3,225,212,57694,44086,313,145,62285,42971
99,9,0,1,1,0,0,3,138,9,57694,44087,180,213,62285,42974
100,9,0,3,1,0,0,3,132,27,57694,44090,306,73,62285,42977
101,9,2,2,2,1,2,1,130,128,57696,44092,123,51,62286,42978
102,9,1,0,0,3,1,0,9,0,57697,44092,27,9,62289,42978
103,9,0,0,2,1,2,1,0,0,57697,44092,9,60,62290,42979
104,9,0,0,2,1,2,1,143,37,57697,44092,273,99,62291,42980
105,9,1,0,0,3,1,0,51,0,57698,44092,153,30,62294,42980
106,9,1,2,1,0,0,3,99,138,57699,44094,0,69,62294,42983
107,9,1,2,1,0,0,3,55,156,57700,44096,0,79,62294,42986
108,10,1,1,2,1,2,1,160,84,57701,44097,215,52,62295,42987
109,10,1,1,2,1,2,1,168,159,57702,44098,215,10,62296,42988
110,10,0,1,1,0,0,3,225,213,57702,44099,313,148,62296,42991
111,10,0,1,1,0,0,3,138,10,57702,44100,180,216,62296,42994
112,10,0,3,1,0,0,3,132,30,57702,44103,306,76,62296,42997
113,10,2,2,2,1,2,1,132,130,57704,44105,124,52,62297,42998
114,10,1,0,0,3,1,0,10,0,57705,44105,30,9,62300,42998
115,10,0,0,2,1,2,1,0,0,57705,44105,10,61,62301,42999
116,10,0,0,2,1,2,1,143,37,57705,44105,274,100,62302,43000
117,10,1,0,0,3,1,0,52,0,57706,44105,156,30,62305,43000
118,10,1,2,1,0,0,3,100,140,57707,44107,0,72,62305,43003
119,10,1,2,1,0,0,3,56,158,57708,44109,0,82,62305,43006
120,11,1,1,2,1,2,1,161,85,57709,44110,216,53,62306,43007
121,11,1,1,2,1,2,1,169,160,57710,44111,216,11,62307,43008
122,11,0,1,1,0,0,3,225,214,57710,44112,313,151,62307,43011
123,11,0,1,1,0,0,3,138,11,57710,44113,180,219,62307,43014
124,11,0,3,1,0,0,3,132,33,57710,44116,306,79,62307,43017
125,11,2,2,2,1,2,1,134,132,57712,44118,125,53,62308,43018
126,11,1,0,0,3,1,0,11,0,57713,44118,33,9,62311,43018
127,11,0,0,2,1,2,1,0,0,57713,44118,11,62,62312,43019
128,11,0,0,2,1,2,1,143,37,57713,44118,275,101,62313,43020
129,11,1,0,0,3,1,0,53,0,57714,44118,159,30,62316,43020
130,11,1,2,1,0,0,3,101,142,57715,44120,0,75,62316,43023
131,11,1,2,1,0,0,3,57,160,57716,44122,0,85,62316,43026
132,12,1,1,2,1,2,1,162,86,57717,44123,217,54,62317,43027
133,12,1,1,2,1,2,1,170,161,57718,44124,217,12,62318,43028
134,12,0,1,1,0,0,3,225,215,57718,44125,313,154,62318,43031
135,12,0,1,1,0,0,3,138,12,57718,44126,180,222,62318,43034
136,12,0,3,1,0,0,3,132,36,57718,44129,306,82,62318,43037
137,12,2,2,2,1,2,1,136,134,57720,44131,126,54,62319,43038
138,12,1,0,0,3,1,0,12,0,57721,44131,36,9,62322,43038
139,12,0,0,2,1,2,1,0,0,57721,44131,12,63,62323,43039
140,12,0,0,2,1,2,1,143,37,57721,44131,276,102,62324,43040
141,12,1,0,0,3,1,0,54,0,57722,44131,162,30,62327,43040
142,12,1,2,1,0,0,3,102,144,57723,44133,0,78,62327,43043
143,12,1,2,1,0,0,3,58,162,57724,44135,0,88,62327,43046
144,13,1,1,2,1,2,1,163,87,57725,44136,218,55,62328,43047
145,13,1,1,2,1,2,1,171,162,57726,44137,218,13,62329,43048
146,13,0,1,1,0,0,3,225,216,57726,44138,313,157,62329,43051
147,13,0,1,1,0,0,3,138,13,57726,44139,180,225,62329,43054
148,13,0,3,1,0,0,3,132,39,57726,44142,306,85,62329,43057
149,13,2,2,2,1,2,1,138,136,57728,44144,127,55,62330,43058
150,13,1,0,0,3,1,0,13,0,57729,44144,39,9,62333,43058
151,13,0,0,2,1,2,1,0,0,57729,44144,13,64,62334,43059
152,13,0,0,2,1,2,1,143,37,57729,44144,277,103,62335,43060
153,13,1,0,0,3,1,0,55,0,57730,44144,165,30,62338,43060
154,13,1,2,1,0,0,3,103,146,57731,44146,0,81,62338,43063
155,13,1,2,1,0,0,3,59,164,57732,44148,0,91,62338,43066
156,14,1,1,2,1,2,1,164,88,57733,44149,219,56,62339,43067
157,14,1,1,2,1,2,1,172,163,57734,44150,219,14,62340,43068
158,14,0,1,1,0,0,3,225,217,57734,44151,313,160,62340,43071
159,14,0,1,1,0,0,3,138,14,57734,44152,180,228,62340,43074
160,14,0,3,1,0,0,3,132,42,57734,44155,306,88,62340,43077
161,14,2,2,2,1,2,1,140,138,57736,44157,128,56,62341,43078
162,14,1,0,0,3,1,0,14,0,57737,44157,42,9,62344,43078
163,14,0,0,2,1,2,1,0,0,57737,44157,14,65,62345,43079
164,14,0,0,2,1,2,1,143,37,57737,44157,278,104,62346,43080
165,14,1,0,0,3,1,0,56,0,57738,44157,168,30,62349,43080
166,14,1,2,1,0,0,3,104,148,57739,44159,0,84,62349,43083
167,14,1,2,1,0,0,3,60,166,57740,44161,0,94,62349,43086
168,15,1,1,2,1,2,1,165,89,57741,44162,220,57,62350,43087
169,15,1,1,2,1,2,1,173,164,57742,44163,220,15,62351,43088
170,15,0,1,1,0,0,3,225,218,57742,44164,313,163,62351,43091
171,15,0,1,1,0,0,3,138,15,57742,44165,180,231,62351,43094
172,15,0,3,1,0,0,3,132,45,57742,44168,306,91,62351,43097
173,15,2,2,2,1,2,1,142,140,57744,44170,129,57,62352,43098
174,15,1,0,0,3,1,0,15,0,57745,44170,45,9,62355,43098
175,15,0,0,2,1,2,1,0,0,57745,44170,15,66,62356,43099
176,15,0,0,2,1,2,1,143,37,57745,44170,279,105,62357,43100
177,15,1,0,0,3,1,0,57,0,57746,44170,171,30,62360,43100
178,15,1,2,1,0,0,3,105,150,57747,44172,0,87,62360,43103
179,15,1,2,1,0,0,3,61,168,57748,44174,0,97,62360,43106
180,16,1,1,2,1,2,1,166,90,57749,44175,221,58,62361,43107
181,16,1,1,2,1,2,1,174,165,57750,44176,221,16,62362,43108
182,16,0,1,1,0,0,3,225,219,57750,44177,313,166,62362,43111
183,16,0,1,1,0,0,3,138,16,57750,44178,180,234,62362,43114
184,16,0,3,1,0,0,3,132,48,57750,44181,306,94,62362,43117
185,16,2,2,2,1,2,1,144,142,57752,44183,130,58,62363,43118
186,16,1,0,0,3,1,0,16,0,57753,44183,48,9,62366,43118
187,16,0,0,2,1,2,1,0,0,57753,44183,16,67,62367,43119
188,16,0,0,2,1,2,1,143,37,57753,44183,280,106,62368,43120
189,16,1,0,0,3,1,0,58,0,57754,44183,174,30,62371,43120
190,16,1,2,1,0,0,3,106,152,57755,44185,0,90,62371,43123
191,16,1,2,1,0,0,3,62,170,57756,44187,0,100,62371,43126
192,17,1,1,2,1,2,1,167,91,57757,44188,222,59,62372,43127
193,17,1,1,2,1,2,1,175,166,57758,44189,222,17,62373,43128
194,17,0,1,1,0,0,3,225,220,57758,44190,313,169,62373,43131
195,17,0,1,1,0,0,3,138,17,57758,44191,180,237,62373,43134
196,17,0,3,1,0,0,3,132,51,57758,44194,306,97,62373,43137
197,17,2,2,2,1,2,1,146,144,57760,44196,131,59,62374,43138
198,17,1,0,0,3,1,0,17,0,57761,44196,51,9,62377,43138
199,17,0,0,2,1,2,1,0,0,57761,44196,17,68,62378,43139
200,17,0,0,2,1,2,1,143,37,57761,44196,281,107,62379,43140
201,17,1,0,0,3,1,0,59,0,57762,44196,177,30,62382,43140
202,17,1,2,1,0,0,3,107,154,57763,44198,0,93,62382,43143
203,17,1,2,1,0,0,3,63,172,57764,44200,0,103,62382,43146
204,18,1,1,2,1,2,1,168,92,57765,44201,223,60,62383,43147
205,18,1,1,2,1,2,1,176,167,57766,44202,223,18,62384,43148
206,18,0,1,1,0,0,3,225,221,57766,44203,313,172,62384,43151
207,18,0,1,1,0,0,3,138,18,57766,44204,180,240,62384,43154
208,18,0,3,1,0,0,3,132,54,57766,44207,306,100,62384,43157
209,18,2,2,2,1,2,1,148,146,57768,44209,132,60,62385,43158
210,18,1,0,0,3,1,0,18,0,57769,44209,54,9,62388,43158
211,18,0,0,2,1,2,1,0,0,57769,44209,18,69,62389,43159
212,18,0,0,2,1,2,1,143,37,57769,44209,282,108,62390,43160
213,18,1,0,0,3,1,0,60,0,57770,44209,180,30,62393,43160
214,18,1,2,1,0,0,3,108,156,57771,44211,0,96,62393,43163
215,18,1,2,1,0,0,3,64,174,57772,44213,0,106,62393,43166
216,19,1,1,2,1,2,1,169,93,57773,44214,224,61,62394,43167
217,19,1,1,2,1,2,1,177,168,57774,44215,224,19,62395,43168
218,19,0,1,1,0,0,3,225,222,57774,44216,313,175,62395,43171
219,19,0,1,1,0,0,3,138,19,57774,44217,180,243,62395,43174
220,19,0,3,1,0,0,3,132,57,57774,44220,306,103,62395,43177
221,19,2,2,2,1,2,1,150,148,57776,44222,133,61,62396,43178
222,19,1,0,0,3,1,0,19,0,57777,44222,57,9,62399,43178
223,19,0,0,2,1,2,1,0,0,57777,44222,19,70,62400,43179
224,19,0,0,2,1,2,1,143,37,57777,44222,283,109,62401,43180
225,19,1,0,0,3,1,0,61,0,57778,44222,183,30,62404,43180
226,19,1,2,1,0,0,3,109,158,57779,44224,0,99,62404,43183
227,19,1,2,1,0,0,3,65,176,57780,44226,0,109,62404,43186
228,20,1,1,2,1,2,1,170,94,57781,44227,225,62,62405,43187
229,20,1,1,2,1,2,1,178,169,57782,44228,225,20,62406,43188
230,20,0,1,1,0,0,3,225,223,57782,44229,313,178,62406,43191
231,20,0,1,1,0,0,3,138,20,57782,44230,180,246,62406,43194
232,20,0,3,1,0,0,3,132,60,57782,44233,306,106,62406,43197
233,20,2,2,2,1,2,1,152,150,57784,44235,134,62,62407,43198
234,20,1,0,0,3,1,0,20,0,57785,44235,60,9,62410,43198
235,20,0,0,2,1,2,1,0,0,57785,44235,20,71,62411,43199
236,20,0,0,2,1,2,1,143,37,57785,44235,284,110,62412,43200
237,20,1,0,0,3,1,0,62,0,57786,44235,186,30,62415,43200
238,20,1,2,1,0,0,3,110,160,57787,44237,0,102,62415,43203
239,20,1,2,1,0,0,3,66,178,57788,44239,0,112,62415,43206
240,21,1,1,2,1,2,1,171,95,57789,44240,226,63,62416,43207
241,21,1,1,2,1,2,1,179,170,57790,44241,226,21,62417,43208
242,21,0,1,1,0,0,3,225,224,57790,44242,313,181,62417,43211
243,21,0,1,1,0,0,3,138,21,57790,44243,180,249,62417,43214
244,21,0,3,1,0,0,3,132,63,57790,44246,306,109,62417,43217
245,21,2,2,2,1,2,1,154,152,57792,44248,135,63,62418,43218
246,21,1,0,0,3,1,0,21,0,57793,44248,63,9,62421,43218
247,21,0,0,2,1,2,1,0,0,57793,44248,21,72,62422,43219
248,21,0,0,2,1,2,1,143,37,57793,44248,285,111,62423,43220
249,21,1,0,0,3,1,0,63,0,57794,44248,189,30,62426,43220
250,21,1,2,1,0,0,3,111,162,57795,44250,0,105,62426,43223
251,21,1,2,1,0,0,3,67,180,57796,44252,0,115,62426,43226
252,22,1,1,2,1,2,1,172,96,57797,44253,227,64,62427,43227
253,22,1,1,2,1,2,1,180,171,57798,44254,227,22,62428,43228
254,22,0,1,1,0,0,3,225,225,57798,44255,313,184,62428,43231
255,22,0,1,1,0,0,3,138,22,57798,44256,180,252,62428,43234
256,22,0,3,1,0,0,3,132,66,57798,44259,306,112,62428,43237
257,22,2,2,2,1,2,1,156,154,57800,44261,136,64,62429,43238
258,22,1,0,0,3,1,0,22,0,57801,44261,66,9,62432,43238
259,22,0,0,2,1,2,1,0,0,57801,44261,22,73,62433,43239
260,22,0,0,2,1,2,1,143,37,57801,44261,286,112,62434,43240
261,22,1,0,0,3,1,0,64,0,57802,44261,192,30,62437,43240
262,22,1,2,1,0,0,3,112,164,57803,44263,0,108,62437,43243
263,22,1,2,1,0,0,3,68,182,57804,44265,0,118,62437,43246
264,23,1,1,2,1,2,1,173,97,57805,44266,228,65,62438,43247
265,23,1,1,2,1,2,1,181,172,57806,44267,228,23,62439,43248
266,23,0,1,1,0,0,3,225,226,57806,44268,313,187,62439,43251
267,23,0,1,1,0,0,3,138,23,57806,44269,180,255,62439,43254
268,23,0,3,1,0,0,3,132,69,57806,44272,306,115,62439,43257
269,23,2,2,2,1,2,1,158,156,57808,44274,137,65,62440,43258
270,23,1,0,0,3,1,0,23,0,57809,44274,69,9,62443,43258
271,23,0,0,2,1,2,1,0,0,57809,44274,23,74,62444,43259
272,23,0,0,2,1,2,1,143,37,57809,44274,287,113,62445,43260
273,23,1,0,0,3,1,0,65,0,57810,44274,195,30,62448,43260
274,23,1,2,1,0,0,3,113,166,57811,44276,0,111,62448,43263
275,23,1,2,1,0,0,3,69,184,57812,44278,0,121,62448,43266
276,24,1,1,2,1,2,1,174,98,57813,44279,229,66,62449,43267
277,24,1,1,2,1,2,1,182,173,57814,44280,229,24,62450,43268
278,24,0,1,1,0,0,3,225,227,57814,44281,313,190,62450,43271
279,24,0,1,1,0,0,3,138,24,57814,44282,180,258,62450,43274
280,24,0,3,1,0,0,3,132,72,57814,44285,306,118,62450,43277
281,24,2,2,2,1,2,1,160,158,57816,44287,138,66,62451,43278
282,24,1,0,0,3,1,0,24,0,57817,44287,72,9,62454,43278
283,24,0,0,2,1,2,1,0,0,57817,44287,24,75,62455,43279
284,24,0,0,2,1,2,1,143,37,57817,44287,288,114,62456,43280
285,24,1,0,0,3,1,0,66,0,57818,44287,198,30,62459,43280
286,24,1,2,1,0,0,3,114,168,57819,44289,0,114,62459,43283
287,24,1,2,1,0,0,3,70,186,57820,44291,0,124,62459,43286
288,25,1,1,2,1,2,1,175,99,57821,44292,230,67,62460,43287
289,25,1,1,2,1,2,1,183,174,57822,44293,230,25,62461,43288
290,25,0,1,1,0,0,3,225,228,57822,44294,313,193,62461,43291
291,25,0,1,1,0,0,3,138,25,57822,44295,180,261,62461,43294
292,25,0,3,1,0,0,3,132,75,57822,44298,306,121,62461,43297
293,25,2,2,2,1,2,1,162,160,57824,44300,139,67,62462,43298
294,25,1,0,0,3,1,0,25,0,57825,44300,75,9,62465,43298
295,25,0,0,2,1,2,1,0,0,57825,44300,25,76,62466,43299
296,25,0,0,2,1,2,1,143,37,57825,44300,289,115,62467,43300
297,25,1,0,0,3,1,0,67,0,57826,44300,201,30,62470,43300
298,25,1,2,1,0,0,3,115,170,57827,44302,0,117,62470,43303
299,25,1,2,1,0,0,3,71,188,57828,44304,0,127,62470,43306
300,26,1,1,2,1,2,1,176,100,57829,44305,231,68,62471,43307
301,26,1,1,2,1,2,1,184,175,57830,44306,231,26,62472,43308
302,26,0,1,1,0,0,3,225,229,57830,44307,313,196,62472,43311
303,26,0,1,1,0,0,3,138,26,57830,44308,180,264,62472,43314
304,26,0,3,1,0,0,3,132,78,57830,44311,306,124,62472,43317
305,26,2,2,2,1,2,1,164,162,57832,44313,140,68,62473,43318
306,26,1,0,0,3,1,0,26,0,57833,44313,78,9,62476,43318
307,26,0,0,2,1,2,1,0,0,57833,44313,26,77,62477,43319
308,26,0,0,2,1,2,1,143,37,57833,44313,290,116,62478,43320
309,26,1,0,0,3,1,0,68,0,57834,44313,204,30,62481,43320
310,26,1,2,1,0,0,3,116,172,57835,44315,0,120,62481,43323
311,26,1,2,1,0,0,3,72,190,57836,44317,0,130,62481,43326
312,27,1,1,2,1,2,1,177,101,57837,44318,232,69,62482,43327
313,27,1,1,2,1,2,1,185,176,57838,44319,232,27,62483,43328
314,27,0,1,1,0,0,3,225,230,57838,44320,313,199,62483,43331
315,27,0,1,1,0,0,3,138,27,57838,44321,180,267,62483,43334
316,27,0,3,1,0,0,3,132,81,57838,44324,306,127,62483,43337
317,27,2,2,2,1,2,1,166,164,57840,44326,141,69,62484,43338
318,27,1,0,0,3,1,0,27,0,57841,44326,81,9,62487,43338
319,27,0,0,2,1,2,1,0,0,57841,44326,27,78,62488,43339
320,27,0,0,2,1,2,1,143,37,57841,44326,291,117,62489,43340
321,27,1,0,0,3,1,0,69,0,57842,44326,207,30,62492,43340
322,27,1,2,1,0,0,3,117,174,57843,44328,0,123,62492,43343
323,27,1,2,1,0,0,3,73,192,57844,44330,0,133,62492,43346
324,28,1,1,2,1,2,1,178,102,57845,44331,233,70,62493,43347
325,28,1,1,2,1,2,1,186,177,57846,44332,233,28,62494,43348
326,28,0,1,1,0,0,3,225,231,57846,44333,313,202,62494,43351
327,28,0,1,1,0,0,3,138,28,57846,44334,180,270,62494,43354
328,28,0,3,1,0,0,3,132,84,57846,44337,306,130,62494,43357
329,28,2,2,2,1,2,1,168,166,57848,44339,142,70,62495,43358
330,28,1,0,0,3,1,0,28,0,57849,44339,84,9,62498,43358
331,28,0,0,2,1,2,1,0,0,57849,44339,28,79,62499,43359
332,28,0,0,2,1,2,1,143,37,57849,44339,292,118,62500,43360
333,28,1,0,0,3,1,0,70,0,57850,44339,210,30,62503,43360
334,28,1,2,1,0,0,3,118,176,57851,44341,0,126,62503,43363
335,28,1,2,1,0,0,3,74,194,57852,44343,0,136,62503,43366
336,29,1,1,2,1,2,1,179,103,57853,44344,234,71,62504,43367
337,29,1,1,2,1,2,1,187,178,57854,44345,234,29,62505,43368
338,29,0,1,1,0,0,3,225,232,57854,44346,313,205,62505,43371
339,29,0,1,1,0,0,3,138,29,57854,44347,180,273,62505,43374
340,29,0,3,1,0,0,3,132,87,57854,44350,306,133,62505,43377
341,29,2,2,2,1,2,1,170,168,57856,44352,143,71,62506,43378
342,29,1,0,0,3,1,0,29,0,57857,44352,87,9,62509,43378
343,29,0,0,2,1,2,1,0,0,57857,44352,29,80,62510,43379
344,29,0,0,2,1,2,1,143,37,57857,44352,293,119,62511,43380
345,29,1,0,0,3,1,0,71,0,57858,44352,213,30,62514,43380
346,29,1,2,1,0,0,3,119,178,57859,44354,0,129,62514,43383
347,29,1,2,1,0,0,3,75,196,57860,44356,0,139,62514,43386
348,30,1,1,2,1,2,1,180,104,57861,44357,235,72,62515,43387
349,30,1,1,2,1,2,1,188,179,57862,44358,235,30,62516,43388
350,30,0,1,1,0,0,3,225,233,57862,44359,313,208,62516,43391
351,30,0,1,1,0,0,3,138,30,57862,44360,180,276,62516,43394
352,30,0,3,1,0,0,3,132,90,57862,44363,306,136,62516,43397
353,30,2,2,2,1,2,1,172,170,57864,44365,144,72,62517,43398
354,30,1,0,0,3,1,0,30,0,57865,44365,90,9,62520,43398
355,30,0,0,2,1,2,1,0,0,57865,44365,30,81,62521,43399
356,30,0,0,2,1,2,1,143,37,57865,44365,294,120,62522,43400
357,30,1,0,0,3,1,0,72,0,57866,44365,216,30,62525,43400
358,30,1,2,1,0,0,3,120,180,57867,44367,0,132,62525,43403
359,30,1,2,1,0,0,3,76,198,57868,44369,0,142,62525,43406
360,31,1,1,2,1,2,1,181,105,57869,44370,236,73,62526,43407
361,31,1,1,2,1,2,1,189,180,57870,44371,236,31,62527,43408
362,31,0,1,1,0,0,3,225,234,57870,44372,313,211,62527,43411
363,31,0,1,1,0,0,3,138,31,57870,44373,180,279,62527,43414
364,31,0,3,1,0,0,3,132,93,57870,44376,306,139,62527,43417
365,31,2,2,2,1,2,1,174,172,57872,44378,145,73,62528,43418
366,31,1,0,0,3,1,0,31,0,57873,44378,93,9,62531,43418
367,31,0,0,2,1,2,1,0,0,57873,44378,31,82,62532,43419
368,31,0,0,2,1,2,1,143,37,57873,44378,295,121,62533,43420
369,31,1,0,0,3,1,0,73,0,57874,44378,219,30,62536,43420
370,31,1,2,1,0,0,3,121,182,57875,44380,0,135,62536,43423
371,31,1,2,1,0,0,3,77,200,57876,44382,0,145,62536,43426
372,32,1,1,2,1,2,1,182,106,57877,44383,237,74,62537,43427
373,32,1,1,2,1,2,1,190,181,57878,44384,237,32,62538,43428
374,32,0,1,1,0,0,3,225,235,57878,44385,313,214,62538,43431
375,32,0,1,1,0,0,3,138,32,57878,44386,180,282,62538,43434
376,32,0,3,1,0,0,3,132,96,57878,44389,306,142,62538,43437
377,32,2,2,2,1,2,1,176,174,57880,44391,146,74,62539,43438
378,32,1,0,0,3,1,0,32,0,57881,44391,96,9,62542,43438
379,32,0,0,2,1,2,1,0,0,57881,44391,32,83,62543,43439
380,32,0,0,2,1,2,1,143,37,57881,44391,296,122,62544,43440
381,32,1,0,0,3,1,0,74,0,57882,44391,222,30,62547,43440
382,32,1,2,1,0,0,3,122,184,57883,44393,0,138,62547,43443
383,32,1,2,1,0,0,3,78,202,57884,44395,0,148,62547,43446
384,33,1,1,2,1,2,1,183,107,57885,44396,238,75,62548,43447
385,33,1,1,2,1,2,1,191,182,57886,44397,238,33,62549,43448
386,33,0,1,1,0,0,3,225,236,57886,44398,313,217,62549,43451
387,33,0,1,1,0,0,3,138,33,57886,44399,180,285,62549,43454
388,33,0,3,1,0,0,3,132,99,57886,44402,306,145,62549,43457
389,33,2,2,2,1,2,1,178,176,57888,44404,147,75,62550,43458
390,33,1,0,0,3,1,0,33,0,57889,44404,99,9,62553,43458
391,33,0,0,2,1,2,1,0,0,57889,44404,33,84,62554,43459
392,33,0,0,2,1,2,1,143,37,57889,44404,297,123,62555,43460
393,33,1,0,0,3,1,0,75,0,57890,44404,225,30,62558,43460
394,33,1,2,1,0,0,3,123,186,57891,44406,0,141,62558,43463
395,33,1,2,1,0,0,3,79,204,57892,44408,0,151,62558,43466
396,34,1,1,2,1,2,1,184,108,57893,44409,239,76,62559,43467
397,34,1,1,2,1,2,1,192,183,57894,44410,239,34,62560,43468
398,34,0,1,1,0,0,3,225,237,57894,44411,313,220,62560,43471
399,34,0,1,1,0,0,3,138,34,57894,44412,180,288,62560,43474
400,34,0,3,1,0,0,3,132,102,57894,44415,306,148,62560,43477
401,34,2,2,2,1,2,1,180,178,57896,44417,148,76,62561,43478
402,34,1,0,0,3,1,0,34,0,57897,44417,102,9,62564,43478
403,34,0,0,2,1,2,1,0,0,57897,44417,34,85,62565,43479
404,34,0,0,2,1,2,1,143,37,57897,44417,298,124,62566,43480
405,34,1,0,0,3,1,0,76,0,57898,44417,228,30,62569,43480
406,34,1,2,1,0,0,3,124,188,57899,44419,0,144,62569,43483
407,34,1,2,1,0,0,3,80,206,57900,44421,0,154,62569,43486
408,35,1,1,2,1,2,1,185,109,57901,44422,240,77,62570,43487
409,35,1,1,2,1,2,1,193,184,57902,44423,240,35,62571,43488
410,35,0,1,1,0,0,3,225,238,57902,44424,313,223,62571,43491
411,35,0,1,1,0,0,3,138,35,57902,44425,180,291,62571,43494
412,35,0,3,1,0,0,3,132,105,57902,44428,306,151,62571,43497
413,35,2,2,2,1,2,1,182,180,57904,44430,149,77,62572,43498
414,35,1,0,0,3,1,0,35,0,57905,44430,105,9,62575,43498
415,35,0,0,2,1,2,1,0,0,57905,44430,35,86,62576,43499
416,35,0,0,2,1,2,1,143,37,57905,44430,299,125,62577,43500
417,35,1,0,0,3,1,0,77,0,57906,44430,231,30,62580,43500
418,35,1,2,1,0,0,3,125,190,57907,44432,0,147,62580,43503
419,35,1,2,1,0,0,3,81,208,57908,44434,0,157,62580,43506
420,36,1,1,2,1,2,1,186,110,57909,44435,241,78,62581,43507
421,36,1,1,2,1,2,1,194,185,57910,44436,241,36,62582,43508
422,36,0,1,1,0,0,3,225,239,57910,44437,313,226,62582,43511
423,36,0,1,1,0,0,3,138,36,57910,44438,180,294,62582,43514
424,36,0,3,1,0,0,3,132,108,57910,44441,306,154,62582,43517
425,36,2,2,2,1,2,1,184,182,57912,44443,150,78,62583,43518
426,36,1,0,0,3,1,0,36,0,57913,44443,108,9,62586,43518
427,36,0,0,2,1,2,1,0,0,57913,44443,36,87,62587,43519
428,36,0,0,2,1,2,1,143,37,57913,44443,300,126,62588,43520
429,36,1,0,0,3,1,0,78,0,57914,44443,234,30,62591,43520
430,36,1,2,1,0,0,3,126,192,57915,44445,0,150,62591,43523
431,36,1,2,1,0,0,3,82,210,57916,44447,0,160,62591,43526
432,37,1,1,2,1,2,1,187,111,57917,44448,242,79,62592,43527
433,37,1,1,2,1,2,1,195,186,57918,44449,242,37,62593,43528
434,37,0,1,1,0,0,3,225,240,57918,44450,313,229,62593,43531
435,37,0,1,1,0,0,3,138,37,57918,44451,180,297,62593,43534
436,37,0,3,1,0,0,3,132,111,57918,44454,306,157,62593,43537
437,37,2,2,2,1,2,1,186,184,57920,44456,151,79,62594,43538
438,37,1,0,0,3,1,0,37,0,57921,44456,111,9,62597,43538
439,37,0,0,2,1,2,1,0,0,57921,44456,37,88,62598,43539
440,37,0,0,2,1,2,1,143,37,57921,44456,301,127,62599,43540
441,37,1,0,0,3,1,0,79,0,57922,44456,237,30,62602,43540
442,37,1,2,1,0,0,3,127,194,57923,44458,0,153,62602,43543
443,37,1,2,1,0,0,3,83,212,57924,44460,0,163,62602,43546
444,38,1,1,2,1,2,1,188,112,57925,44461,243,80,62603,43547
445,38,1,1,2,1,2,1,196,187,57926,44462,243,38,62604,43548
446,38,0,1,1,0,0,3,225,241,57926,44463,313,232,62604,43551
447,38,0,1,1,0,0,3,138,38,57926,44464,180,300,62604,43554
448,38,0,3,1,0,0,3,132,114,57926,44467,306,160,62604,43557
449,38,2,2,2,1,2,1,188,186,57928,44469,152,80,62605,43558
450,38,1,0,0,3,1,0,38,0,57929,44469,114,9,62608,43558
451,38,0,0,2,1,2,1,0,0,57929,44469,38,89,62609,43559
452,38,0,0,2,1,2,1,143,37,57929,44469,302,128,62610,43560
453,38,1,0,0,3,1,0,80,0,57930,44469,240,30,62613,43560
454,38,1,2,1,0,0,3,128,196,57931,44471,0,156,62613,43563
455,38,1,2,1,0,0,3,84,214,57932,44473,0,166,62613,43566
456,39,1,1,2,1,2,1,189,113,57933,44474,244,81,62614,43567
457,39,1,1,2,1,2,1,197,188,57934,44475,244,39,62615,43568
458,39,0,1,1,0,0,3,225,242,57934,44476,313,235,62615,43571
459,39,0,1,1,0,0,3,138,39,57934,44477,180,303,62615,43574
460,39,0,3,1,0,0,3,132,117,57934,44480,306,163,62615,43577
461,39,2,2,2,1,2,1,190,188,57936,44482,153,81,62616,43578
462,39,1,0,0,3,1,0,39,0,57937,44482,117,9,62619,43578
463,39,0,0,2,1,2,1,0,0,57937,44482,39,90,62620,43579
464,39,0,0,2,1,2,1,143,37,57937,44482,303,129,62621,43580
465,39,1,0,0,3,1,0,81,0,57938,44482,243,30,62624,43580
466,39,1,2,1,0,0,3,129,198,57939,44484,0,159,62624,43583
467,39,1,2,1,0,0,3,85,216,57940,44486,0,169,62624,43586
468,40,1,1,2,1,2,1,190,114,57941,44487,245,82,62625,43587
469,40,1,1,2,1,2,1,198,189,57942,44488,245,40,62626,43588
470,40,0,1,1,0,0,3,225,243,57942,44489,313,238,62626,43591
471,40,0,1,1,0,0,3,138,40,57942,44490,180,306,62626,43594
472,40,0,3,1,0,0,3,132,120,57942,44493,306,166,62626,43597
473,40,2,2,2,1,2,1,192,190,57944,44495,154,82,62627,43598
474,40,1,0,0,3,1,0,40,0,57945,44495,120,9,62630,43598
475,40,0,0,2,1,2,1,0,0,57945,44495,40,91,62631,43599
476,40,0,0,2,1,2,1,143,37,57945,44495,304,130,62632,43600
477,40,1,0,0,3,1,0,82,0,57946,44495,246,30,62635,43600
478,40,1,2,1,0,0,3,130,200,57947,44497,0,162,62635,43603
479,40,1,2,1,0,0,3,86,218,57948,44499,0,172,62635,43606
480,41,1,1,2,1,2,1,191,115,57949,44500,246,83,62636,43607
481,41,1,1,2,1,2,1,199,190,57950,44501,246,41,62637,43608
482,41,0,1,1,0,0,3,225,244,57950,44502,313,241,62637,43611
483,41,0,1,1,0,0,3,138,41,57950,44503,180,309,62637,43614
484,41,0,3,1,0,0,3,132,123,57950,44506,306,169,62637,43617
485,41,2,2,2,1,2,1,194,192,57952,44508,155,83,62638,43618
486,41,1,0,0,3,1,0,41,0,57953,44508,123,9,62641,43618
487,41,0,0,2,1,2,1,0,0,57953,44508,41,92,62642,43619
488,41,0,0,2,1,2,1,143,37,57953,44508,305,131,62643,43620
489,41,1,0,0,3,1,0,83,0,57954,44508,249,30,62646,43620
490,41,1,2,1,0,0,3,131,202,57955,44510,0,165,62646,43623
491,41,1,2,1,0,0,3,87,220,57956,44512,0,175,62646,43626
492,42,1,1,2,1,2,1,192,116,57957,44513,247,84,62647,43627
493,42,1,1,2,1,2,1,200,191,57958,44514,247,42,62648,43628
494,42,0,1,1,0,0,3,225,245,57958,44515,313,244,62648,43631
495,42,0,1,1,0,0,3,138,42,57958,44516,180,312,62648,43634
496,42,0,3,1,0,0,3,132,126,57958,44519,306,172,62648,43637
497,42,2,2,2,1,2,1,196,194,57960,44521,156,84,62649,43638
498,42,1,0,0,3,1,0,42,0,57961,44521,126,9,62652,43638
499,42,0,0,2,1,2,1,0,0,57961,44521,42,93,62653,43639
500,42,0,0,2,1,2,1,143,37,57961,44521,306,132,62654,43640
501,42,1,0,0,3,1,0,84,0,57962,44521,252,30,62657,43640
502,42,1,2,1,0,0,3,132,204,57963,44523,0,168,62657,43643
503,42,1,2,1,0,0,3,88,222,57964,44525,0,178,62657,43646
504,43,1,1,2,1,2,1,193,117,57965,44526,248,85,62658,43647
505,43,1,1,2,1,2,1,201,192,57966,44527,248,43,62659,43648
506,43,0,1,1,0,0,3,225,246,57966,44528,313,247,62659,43651
507,43,0,1,1,0,0,3,138,43,57966,44529,180,315,62659,43654
508,43,0,3,1,0,0,3,132,129,57966,44532,306,175,62659,43657
509,43,2,2,2,1,2,1,198,196,57968,44534,157,85,62660,43658
510,43,1,0,0,3,1,0,43,0,57969,44534,129,9,62663,43658
511,43,0,0,2,1,2,1,0,0,57969,44534,43,94,62664,43659
512,43,0,0,2,1,2,1,143,37,57969,44534,307,133,62665,43660
513,43,1,0,0,3,1,0,85,0,57970,44534,255,30,62668,43660
514,43,1,2,1,0,0,3,133,206,57971,44536,0,171,62668,43663
515,43,1,2,1,0,0,3,89,224,57972,44538,0,181,62668,43666
516,44,1,1,2,1,2,1,194,118,57973,44539,249,86,62669,43667
517,44,1,1,2,1,2,1,202,193,57974,44540,249,44,62670,43668
518,44,0,1,1,0,0,3,225,247,57974,44541,313,250,62670,43671
519,44,0,1,1,0,0,3,138,44,57974,44542,180,318,62670,43674
520,44,0,3,1,0,0,3,132,132,57974,44545,306,178,62670,43677
521,44,2,2,2,1,2,1,200,198,57976,44547,158,86,62671,43678
522,44,1,0,0,3,1,0,44,0,57977,44547,132,9,62674,43678
523,44,0,0,2,1,2,1,0,0,57977,44547,44,95,62675,43679
524,44,0,0,2,1,2,1,143,37,57977,44547,308,134,62676,43680
525,44,1,0,0,3,1,0,86,0,57978,44547,258,30,62679,43680
526,44,1,2,1,0,0,3,134,208,57979,44549,0,174,62679,43683
527,44,1,2,1,0,0,3,90,226,57980,44551,0,184,62679,43686
528,45,1,1,2,1,2,1,195,119,57981,44552,250,87,62680,43687
529,45,1,1,2,1,2,1,203,194,57982,44553,250,45,62681,43688
530,45,0,1,1,0,0,3,225,248,57982,44554,313,253,62681,43691
531,45,0,1,1,0,0,3,138,45,57982,44555,180,321,62681,43694
532,45,0,3,1,0,0,3,132,135,57982,44558,306,181,62681,43697
533,45,2,2,2,1,2,1,202,200,57984,44560,159,87,62682,43698
534,45,1,0,0,3,1,0,45,0,57985,44560,135,9,62685,43698
535,45,0,0,2,1,2,1,0,0,57985,44560,45,96,62686,43699
536,45,0,0,2,1,2,1,143,37,57985,44560,309,135,62687,43700
537,45,1,0,0,3,1,0,87,0,57986,44560,261,30,62690,43700
538,45,1,2,1,0,0,3,135,210,57987,44562,0,177,62690,43703
539,45,1,2,1,0,0,3,91,228,57988,44564,0,187,62690,43706
540,46,1,1,2,1,2,1,196,120,57989,44565,251,88,62691,43707
541,46,1,1,2,1,2,1,204,195,57990,44566,251,46,62692,43708
542,46,0,1,1,0,0,3,225,249,57990,44567,313,256,62692,43711
543,46,0,1,1,0,0,3,138,46,57990,44568,180,324,62692,43714
544,46,0,3,1,0,0,3,132,138,57990,44571,306,184,62692,43717
545,46,2,2,2,1,2,1,204,202,57992,44573,160,88,62693,43718
546,46,1,0,0,3,1,0,46,0,57993,44573,138,9,62696,43718
547,46,0,0,2,1,2,1,0,0,57993,44573,46,97,62697,43719
548,46,0,0,2,1,2,1,143,37,57993,44573,310,136,62698,43720
549,46,1,0,0,3,1,0,88,0,57994,44573,264,30,62701,43720
550,46,1,2,1,0,0,3,136,212,57995,44575,0,180,62701,43723
551,46,1,2,1,0,0,3,92,230,57996,44577,0,190,62701,43726
0,1,1,2,1,0,0,3,197,122,57997,44579,251,74,62701,43729
1,1,0,1,1,0,0,3,46,1,57997,44580,138,3,62701,43732
2,1,1,2,1,0,0,3,1,2,57998,44582,46,193,62701,43735
3,1,2,1,0,3,1,0,138,179,58000,44583,169,0,62704,43735
4,1,1,1,2,1,2,1,43,85,58001,44584,1,1,62705,43736
5,1,0,1,1,0,0,3,46,1,58001,44585,138,272,62705,43739
6,1,1,0,0,3,1,0,144,37,58002,44585,313,256,62708,43739
7,1,0,0,2,1,2,1,168,0,58002,44585,253,181,62709,43740
8,1,1,1,2,1,2,1,223,177,58003,44586,181,1,62710,43741
9,1,1,0,0,3,1,0,205,195,58004,44586,254,0,62713,43741
10,1,2,1,0,3,1,0,227,250,58006,44587,316,168,62716,43741
11,2,1,2,1,0,0,3,198,124,58007,44589,251,77,62716,43744
12,2,0,1,1,0,0,3,46,2,58007,44590,138,6,62716,43747
13,2,1,2,1,0,0,3,2,4,58008,44592,46,196,62716,43750
14,2,2,1,0,3,1,0,140,180,58010,44593,172,0,62719,43750
15,2,1,1,2,1,2,1,44,86,58011,44594,2,2,62720,43751
16,2,0,1,1,0,0,3,46,2,58011,44595,138,275,62720,43754
17,2,1,0,0,3,1,0,145,37,58012,44595,316,256,62723,43754
18,2,0,0,2,1,2,1,168,0,58012,44595,254,182,62724,43755
19,2,1,1,2,1,2,1,224,178,58013,44596,182,2,62725,43756
20,2,1,0,0,3,1,0,206,195,58014,44596,257,0,62728,43756
21,2,2,1,0,3,1,0,229,251,58016,44597,319,168,62731,43756
22,3,1,2,1,0,0,3,199,126,58017,44599,251,80,62731,43759
23,3,0,1,1,0,0,3,46,3,58017,44600,138,9,62731,43762
24,3,1,2,1,0,0,3,3,6,58018,44602,46,199,62731,43765
25,3,2,1,0,3,1,0,142,181,58020,44603,175,0,62734,43765
26,3,1,1,2,1,2,1,45,87,58021,44604,3,3,62735,43766
27,3,0,1,1,0,0,3,46,3,58021,44605,138,278,62735,43769
28,3,1,0,0,3,1,0,146,37,58022,44605,319,256,62738,43769
29,3,0,0,2,1,2,1,168,0,58022,44605,255,183,62739,43770
30,3,1,1,2,1,2,1,225,179,58023,44606,183,3,62740,43771
31,3,1,0,0,3,1,0,207,195,58024,44606,260,0,62743,43771
32,3,2,1,0,3,1,0,231,252,58026,44607,322,168,62746,43771
33,4,1,2,1,0,0,3,200,128,58027,44609,251,83,62746,43774
34,4,0,1,1,0,0,3,46,4,58027,44610,138,12,62746,43777
35,4,1,2,1,0,0,3,4,8,58028,44612,46,202,62746,43780
36,4,2,1,0,3,1,0,144,182,58030,44613,178,0,62749,43780
37,4,1,1,2,1,2,1,46,88,58031,44614,4,4,62750,43781
38,4,0,1,1,0,0,3,46,4,58031,44615,138,281,62750,43784
39,4,1,0,0,3,1,0,147,37,58032,44615,322,256,62753,43784
40,4,0,0,2,1,2,1,168,0,58032,44615,256,184,62754,43785
41,4,1,1,2,1,2,1,226,180,58033,44616,184,4,62755,43786
42,4,1,0,0,3,1,0,208,195,58034,44616,263,0,62758,43786
43,4,2,1,0,3,1,0,233,253,58036,44617,325,168,62761,43786
44,5,1,2,1,0,0,3,201,130,58037,44619,251,86,62761,43789
45,5,0,1,1,0,0,3,46,5,58037,44620,138,15,62761,43792
46,5,1,2,1,0,0,3,5,10,58038,44622,46,205,62761,43795
47,5,2,1,0,3,1,0,146,183,58040,44623,181,0,62764,43795
48,5,1,1,2,1,2,1,47,89,58041,44624,5,5,62765,43796
49,5,0,1,1,0,0,3,46,5,58041,44625,138,284,62765,43799
50,5,1,0,0,3,1,0,148,37,58042,44625,325,256,62768,43799
51,5,0,0,2,1,2,1,168,0,58042,44625,257,185,62769,43800
52,5,1,1,2,1,2,1,227,181,58043,44626,185,5,62770,43801
53,5,1,0,0,3,1,0,209,195,58044,44626,266,0,62773,43801
54,5,2,1,0,3,1,0,235,254,58046,44627,328,168,62776,43801
55,6,1,2,1,0,0,3,202,132,58047,44629,251,89,62776,43804
56,6,0,1,1,0,0,3,46,6,58047,44630,138,18,62776,43807
57,6,1,2,1,0,0,3,6,12,58048,44632,46,208,62776,43810
58,6,2,1,0,3,1,0,148,184,58050,44633,184,0,62779,43810
59,6,1,1,2,1,2,1,48,90,58051,44634,6,6,62780,43811
60,6,0,1,1,0,0,3,46,6,58051,44635,138,287,62780,43814
61,6,1,0,0,3,1,0,149,37,58052,44635,328,256,62783,43814
62,6,0,0,2,1,2,1,168,0,58052,44635,258,186,62784,43815
63,6,1,1,2,1,2,1,228,182,58053,44636,186,6,62785,43816
64,6,1,0,0,3,1,0,210,195,58054,44636,269,0,62788,43816
65,6,2,1,0,3,1,0,237,255,58056,44637,331,168,62791,43816
66,7,1,2,1,0,0,3,203,134,58057,44639,251,92,62791,43819
67,7,0,1,1,0,0,3,46,7,58057,44640,138,21,62791,43822
68,7,1,2,1,0,0,3,7,14,58058,44642,46,211,62791,43825
69,7,2,1,0,3,1,0,150,185,58060,44643,187,0,62794,43825
70,7,1,1,2,1,2,1,49,91,58061,44644,7,7,62795,43826
71,7,0,1,1,0,0,3,46,7,58061,44645,138,290,62795,43829
72,7,1,0,0,3,1,0,150,37,58062,44645,331,256,62798,43829
73,7,0,0,2,1,2,1,168,0,58062,44645,259,187,62799,43830
74,7,1,1,2,1,2,1,229,183,58063,44646,187,7,62800,43831
75,7,1,0,0,3,1,0,211,195,58064,44646,272,0,62803,43831
76,7,2,1,0,3,1,0,239,256,58066,44647,334,168,62806,43831
77,8,1,2,1,0,0,3,204,136,58067,44649,251,95,62806,43834
78,8,0,1,1,0,0,3,46,8,58067,44650,138,24,62806,43837
79,8,1,2,1,0,0,3,8,16,58068,44652,46,214,62806,43840
80,8,2,1,0,3,1,0,152,186,58070,44653,190,0,62809,43840
81,8,1,1,2,1,2,1,50,92,58071,44654,8,8,62810,43841
82,8,0,1,1,0,0,3,46,8,58071,44655,138,293,62810,43844
83,8,1,0,0,3,1,0,151,37,58072,44655,334,256,62813,43844
84,8,0,0,2,1,2,1,168,0,58072,44655,260,188,62814,43845
85,8,1,1,2,1,2,1,230,184,58073,44656,188,8,62815,43846
86,8,1,0,0,3,1,0,212,195,58074,44656,275,0,62818,43846
87,8,2,1,0,3,1,0,241,257,58076,44657,337,168,62821,43846
88,9,1,2,1,0,0,3,205,138,58077,44659,251,98,62821,43849
89,9,0,1,1,0,0,3,46,9,58077,44660,138,27,62821,43852
90,9,1,2,1,0,0,3,9,18,58078,44662,46,217,62821,43855
91,9,2,1,0,3,1,0,154,187,58080,44663,193,0,62824,43855
92,9,1,1,2,1,2,1,51,93,58081,44664,9,9,62825,43856
93,9,0,1,1,0,0,3,46,9,58081,44665,138,296,62825,43859
94,9,1,0,0,3,1,0,152,37,58082,44665,337,256,62828,43859
95,9,0,0,2,1,2,1,168,0,58082,44665,261,189,62829,43860
96,9,1,1,2,1,2,1,231,185,58083,44666,189,9,62830,43861
97,9,1,0,0,3,1,0,213,195,58084,44666,278,0,62833,43861
98,9,2,1,0,3,1,0,243,258,58086,44667,340,168,62836,43861
99,10,1,2,1,0,0,3,206,140,58087,44669,251,101,62836,43864
100,10,0,1,1,0,0,3,46,10,58087,44670,138,30,62836,43867
101,10,1,2,1,0,0,3,10,20,58088,44672,46,220,62836,43870
102,10,2,1,0,3,1,0,156,188,58090,44673,196,0,62839,43870
103,10,1,1,2,1,2,1,52,94,58091,44674,10,10,62840,43871
104,10,0,1,1,0,0,3,46,10,58091,44675,138,299,62840,43874
105,10,1,0,0,3,1,0,153,37,58092,44675,340,256,62843,43874
106,10,0,0,2,1,2,1,168,0,58092,44675,262,190,62844,43875
107,10,1,1,2,1,2,1,232,186,58093,44676,190,10,62845,43876
108,10,1,0,0,3,1,0,214,195,58094,44676,281,0,62848,43876
109,10,2,1,0,3,1,0,245,259,58096,44677,343,168,62851,43876
110,11,1,2,1,0,0,3,207,142,58097,44679,251,104,62851,43879
111,11,0,1,1,0,0,3,46,11,58097,44680,138,33,62851,43882
112,11,1,2,1,0,0,3,11,22,58098,44682,46,223,62851,43885
113,11,2,1,0,3,1,0,158,189,58100,44683,199,0,62854,43885
114,11,1,1,2,1,2,1,53,95,58101,44684,11,11,62855,43886
115,11,0,1,1,0,0,3,46,11,58101,44685,138,302,62855,43889
116,11,1,0,0,3,1,0,154,37,58102,44685,343,256,62858,43889
117,11,0,0,2,1,2,1,168,0,58102,44685,263,191,62859,43890
118,11,1,1,2,1,2,1,233,187,58103,44686,191,11,62860,43891
119,11,1,0,0,3,1,0,215,195,58104,44686,284,0,62863,43891
120,11,2,1,0,3,1,0,247,260,58106,44687,346,168,62866,43891
121,12,1,2,1,0,0,3,208,144,58107,44689,251,107,62866,43894
122,12,0,1,1,0,0,3,46,12,58107,44690,138,36,62866,43897
123,12,1,2,1,0,0,3,12,24,58108,44692,46,226,62866,43900
124,12,2,1,0,3,1,0,160,190,58110,44693,202,0,62869,43900
125,12,1,1,2,1,2,1,54,96,58111,44694,12,12,62870,43901
126,12,0,1,1,0,0,3,46,12,58111,44695,138,305,62870,43904
127,12,1,0,0,3,1,0,155,37,58112,44695,346,256,62873,43904
128,12,0,0,2,1,2,1,168,0,58112,44695,264,192,62874,43905
129,12,1,1,2,1,2,1,234,188,58113,44696,192,12,62875,43906
130,12,1,0,0,3,1,0,216,195,58114,44696,287,0,62878,43906
131,12,2,1,0,3,1,0,249,261,58116,44697,349,168,62881,43906
132,13,1,2,1,0,0,3,209,146,58117,44699,251,110,62881,43909
133,13,0,1,1,0,0,3,46,13,58117,44700,138,39,62881,43912
134,13,1,2,1,0,0,3,13,26,58118,44702,46,229,62881,43915
135,13,2,1,0,3,1,0,162,191,58120,44703,205,0,62884,43915
136,13,1,1,2,1,2,1,55,97,58121,44704,13,13,62885,43916
137,13,0,1,1,0,0,3,46,13,58121,44705,138,308,62885,43919
138,13,1,0,0,3,1,0,156,37,58122,44705,349,256,62888,43919
139,13,0,0,2,1,2,1,168,0,58122,44705,265,193,62889,43920
140,13,1,1,2,1,2,1,235,189,58123,44706,193,13,62890,43921
141,13,1,0,0,3,1,0,217,195,58124,44706,290,0,62893,43921
142,13,2,1,0,3,1,0,251,262,58126,44707,352,168,62896,43921
143,14,1,2,1,0,0,3,210,148,58127,44709,251,113,62896,43924
144,14,0,1,1,0,0,3,46,14,58127,44710,138,42,62896,43927
145,14,1,2,1,0,0,3,14,28,58128,44712,46,232,62896,43930
146,14,2,1,0,3,1,0,164,192,58130,44713,208,0,62899,43930
147,14,1,1,2,1,2,1,56,98,58131,44714,14,14,62900,43931
148,14,0,1,1,0,0,3,46,14,58131,44715,138,311,62900,43934
149,14,1,0,0,3,1,0,157,37,58132,44715,352,256,62903,43934
150,14,0,0,2,1,2,1,168,0,58132,44715,266,194,62904,43935
151,14,1,1,2,1,2,1,236,190,58133,44716,194,14,62905,43936
152,14,1,0,0,3,1,0,218,195,58134,44716,293,0,62908,43936
153,14,2,1,0,3,1,0,253,263,58136,44717,355,168,62911,43936
154,15,1,2,1,0,0,3,211,150,58137,44719,251,116,62911,43939
155,15,0,1,1,0,0,3,46,15,58137,44720,138,45,62911,43942
156,15,1,2,1,0,0,3,15,30,58138,44722,46,235,62911,43945
157,15,2,1,0,3,1,0,166,193,58140,44723,211,0,62914,43945
158,15,1,1,2,1,2,1,57,99,58141,44724,15,15,62915,43946
159,15,0,1,1,0,0,3,46,15,58141,44725,138,314,62915,43949
160,15,1,0,0,3,1,0,158,37,58142,44725,355,256,62918,43949
161,15,0,0,2,1,2,1,168,0,58142,44725,267,195,62919,43950
162,15,1,1,2,1,2,1,237,191,58143,44726,195,15,62920,43951
163,15,1,0,0,3,1,0,219,195,58144,44726,296,0,62923,43951
164,15,2,1,0,3,1,0,255,264,58146,44727,358,168,62926,43951
165,16,1,2,1,0,0,3,212,152,58147,44729,251,119,62926,43954
166,16,0,1,1,0,0,3,46,16,58147,44730,138,48,62926,43957
167,16,1,2,1,0,0,3,16,32,58148,44732,46,238,62926,43960
168,16,2,1,0,3,1,0,168,194,58150,44733,214,0,62929,43960
169,16,1,1,2,1,2,1,58,100,58151,44734,16,16,62930,43961
170,16,0,1,1,0,0,3,46,16,58151,44735,138,317,62930,43964
171,16,1,0,0,3,1,0,159,37,58152,44735,358,256,62933,43964
172,16,0,0,2,1,2,1,168,0,58152,44735,268,196,62934,43965
173,16,1,1,2,1,2,1,238,192,58153,44736,196,16,62935,43966
174,16,1,0,0,3,1,0,220,195,58154,44736,299,0,62938,43966
175,16,2,1,0,3,1,0,257,265,58156,44737,361,168,62941,43966
176,17,1,2,1,0,0,3,213,154,58157,44739,251,122,62941,43969
177,17,0,1,1,0,0,3,46,17,58157,44740,138,51,62941,43972
178,17,1,2,1,0,0,3,17,34,58158,44742,46,241,62941,43975
179,17,2,1,0,3,1,0,170,195,58160,44743,217,0,62944,43975
180,17,1,1,2,1,2,1,59,101,58161,44744,17,17,62945,43976
181,17,0,1,1,0,0,3,46,17,58161,44745,138,320,62945,43979
182,17,1,0,0,3,1,0,160,37,58162,44745,361,256,62948,43979
183,17,0,0,2,1,2,1,168,0,58162,44745,269,197,62949,43980
184,17,1,1,2,1,2,1,239,193,58163,44746,197,17,62950,43981
185,17,1,0,0,3,1,0,221,195,58164,44746,302,0,62953,43981
186,17,2,1,0,3,1,0,259,266,58166,44747,364,168,62956,43981
187,18,1,2,1,0,0,3,214,156,58167,44749,251,125,62956,43984
188,18,0,1,1,0,0,3,46,18,58167,44750,138,54,62956,43987
189,18,1,2,1,0,0,3,18,36,58168,44752,46,244,62956,43990
190,18,2,1,0,3,1,0,172,196,58170,44753,220,0,62959,43990
191,18,1,1,2,1,2,1,60,102,58171,44754,18,18,62960,43991
192,18,0,1,1,0,0,3,46,18,58171,44755,138,323,62960,43994
193,18,1,0,0,3,1,0,161,37,58172,44755,364,256,62963,43994
194,18,0,0,2,1,2,1,168,0,58172,44755,270,198,62964,43995
195,18,1,1,2,1,2,1,240,194,58173,44756,198,18,62965,43996
196,18,1,0,0,3,1,0,222,195,58174,44756,305,0,62968,43996
197,18,2,1,0,3,1,0,261,267,58176,44757,367,168,62971,43996
198,19,1,2,1,0,0,3,215,158,58177,44759,251,128,62971,43999
199,19,0,1,1,0,0,3,46,19,58177,44760,138,57,62971,44002
200,19,1,2,1,0,0,3,19,38,58178,44762,46,247,62971,44005
201,19,2,1,0,3,1,0,174,197,58180,44763,223,0,62974,44005
202,19,1,1,2,1,2,1,61,103,58181,44764,19,19,62975,44006
203,19,0,1,1,0,0,3,46,19,58181,44765,138,326,62975,44009
204,19,1,0,0,3,1,0,162,37,58182,44765,367,256,62978,44009
205,19,0,0,2,1,2,1,168,0,58182,44765,271,199,62979,44010
206,19,1,1,2,1,2,1,241,195,58183,44766,199,19,62980,44011
207,19,1,0,0,3,1,0,223,195,58184,44766,308,0,62983,44011
208,19,2,1,0,3,1,0,263,268,58186,44767,370,168,62986,44011
209,20,1,2,1,0,0,3,216,160,58187,44769,251,131,62986,44014
210,20,0,1,1,0,0,3,46,20,58187,44770,138,60,62986,44017
211,20,1,2,1,0,0,3,20,40,58188,44772,46,250,62986,44020
212,20,2,1,0,3,1,0,176,198,58190,44773,226,0,62989,44020
213,20,1,1,2,1,2,1,62,104,58191,44774,20,20,62990,44021
214,20,0,1,1,0,0,3,46,20,58191,44775,138,329,62990,44024
215,20,1,0,0,3,1,0,163,37,58192,44775,370,256,62993,44024
216,20,0,0,2,1,2,1,168,0,58192,44775,272,200,62994,44025
217,20,1,1,2,1,2,1,242,196,58193,44776,200,20,62995,44026
218,20,1,0,0,3,1,0,224,195,58194,44776,311,0,62998,44026
219,20,2,1,0,3,1,0,265,269,58196,44777,373,168,63001,44026
220,21,1,2,1,0,0,3,217,162,58197,44779,251,134,63001,44029
221,21,0,1,1,0,0,3,46,21,58197,44780,138,63,63001,44032
222,21,1,2,1,0,0,3,21,42,58198,44782,46,253,63001,44035
223,21,2,1,0,3,1,0,178,199,58200,44783,229,0,63004,44035
224,21,1,1,2,1,2,1,63,105,58201,44784,21,21,63005,44036
225,21,0,1,1,0,0,3,46,21,58201,44785,138,332,63005,44039
226,21,1,0,0,3,1,0,164,37,58202,44785,373,256,63008,44039
227,21,0,0,2,1,2,1,168,0,58202,44785,273,201,63009,44040
228,21,1,1,2,1,2,1,243,197,58203,44786,201,21,63010,44041
229,21,1,0,0,3,1,0,225,195,58204,44786,314,0,63013,44041
230,21,2,1,0,3,1,0,267,270,58206,44787,376,168,63016,44041
231,22,1,2,1,0,0,3,218,164,58207,44789,251,137,63016,44044
232,22,0,1,1,0,0,3,46,22,58207,44790,138,66,63016,44047
233,22,1,2,1,0,0,3,22,44,58208,44792,46,256,63016,44050
234,22,2,1,0,3,1,0,180,200,58210,44793,232,0,63019,44050
235,22,1,1,2,1,2,1,64,106,58211,44794,22,22,63020,44051
236,22,0,1,1,0,0,3,46,22,58211,44795,138,335,63020,44054
237,22,1,0,0,3,1,0,165,37,58212,44795,376,256,63023,44054
238,22,0,0,2,1,2,1,168,0,58212,44795,274,202,63024,44055
239,22,1,1,2,1,2,1,244,198,58213,44796,202,22,63025,44056
240,22,1,0,0,3,1,0,226,195,58214,44796,317,0,63028,44056
241,22,2,1,0,3,1,0,269,271,58216,44797,379,168,63031,44056
242,23,1,2,1,0,0,3,219,166,58217,44799,251,140,63031,44059
243,23,0,1,1,0,0,3,46,23,58217,44800,138,69,63031,44062
244,23,1,2,1,0,0,3,23,46,58218,44802,46,259,63031,44065
245,23,2,1,0,3,1,0,182,201,58220,44803,235,0,63034,44065
246,23,1,1,2,1,2,1,65,107,58221,44804,23,23,63035,44066
247,23,0,1,1,0,0,3,46,23,58221,44805,138,338,63035,44069
248,23,1,0,0,3,1,0,166,37,58222,44805,379,256,63038,44069
249,23,0,0,2,1,2,1,168,0,58222,44805,275,203,63039,44070
250,23,1,1,2,1,2,1,245,199,58223,44806,203,23,63040,44071
251,23,1,0,0,3,1,0,227,195,58224,44806,320,0,63043,44071
252,23,2,1,0,3,1,0,271,272,58226,44807,382,168,63046,44071
253,24,1,2,1,0,0,3,220,168,58227,44809,251,143,63046,44074
254,24,0,1,1,0,0,3,46,24,58227,44810,138,72,63046,44077
255,24,1,2,1,0,0,3,24,48,58228,44812,46,262,63046,44080
256,24,2,1,0,3,1,0,184,202,58230,44813,238,0,63049,44080
257,24,1,1,2,1,2,1,66,108,58231,44814,24,24,63050,44081
258,24,0,1,1,0,0,3,46,24,58231,44815,138,341,63050,44084
259,24,1,0,0,3,1,0,167,37,58232,44815,382,256,63053,44084
260,24,0,0,2,1,2,1,168,0,58232,44815,276,204,63054,44085
261,24,1,1,2,1,2,1,246,200,58233,44816,204,24,63055,44086
262,24,1,0,0,3,1,0,228,195,58234,44816,323,0,63058,44086
263,24,2,1,0,3,1,0,273,273,58236,44817,385,168,63061,44086
264,25,1,2,1,0,0,3,221,170,58237,44819,251,146,63061,44089
265,25,0,1,1,0,0,3,46,25,58237,44820,138,75,63061,44092
266,25,1,2,1,0,0,3,25,50,58238,44822,46,265,63061,44095
267,25,2,1,0,3,1,0,186,203,58240,44823,241,0,63064,44095
268,25,1,1,2,1,2,1,67,109,58241,44824,25,25,63065,44096
269,25,0,1,1,0,0,3,46,25,58241,44825,138,344,63065,44099
270,25,1,0,0,3,1,0,168,37,58242,44825,385,256,63068,44099
271,25,0,0,2,1,2,1,168,0,58242,44825,277,205,63069,44100
272,25,1,1,2,1,2,1,247,201,58243,44826,205,25,63070,44101
273,25,1,0,0,3,1,0,229,195,58244,44826,326,0,63073,44101
274,25,2,1,0,3,1,0,275,274,58246,44827,388,168,63076,44101
275,26,1,2,1,0,0,3,222,172,58247,44829,251,149,63076,44104
276,26,0,1,1,0,0,3,46,26,58247,44830,138,78,63076,44107
277,26,1,2,1,0,0,3,26,52,58248,44832,46,268,63076,44110
278,26,2,1,0,3,1,0,188,204,58250,44833,244,0,63079,44110
279,26,1,1,2,1,2,1,68,110,58251,44834,26,26,63080,44111
280,26,0,1,1,0,0,3,46,26,58251,44835,138,347,63080,44114
281,26,1,0,0,3,1,0,169,37,58252,44835,388,256,63083,44114
282,26,0,0,2,1,2,1,168,0,58252,44835,278,206,63084,44115
283,26,1,1,2,1,2,1,248,202,58253,44836,206,26,63085,44116
284,26,1,0,0,3,1,0,230,195,58254,44836,329,0,63088,44116
285,26,2,1,0,3,1,0,277,275,58256,44837,391,168,63091,44116
286,27,1,2,1,0,0,3,223,174,58257,44839,251,152,63091,44119
287,27,0,1,1,0,0,3,46,27,58257,44840,138,81,63091,44122
288,27,1,2,1,0,0,3,27,54,58258,44842,46,271,63091,44125
289,27,2,1,0,3,1,0,190,205,58260,44843,247,0,63094,44125
290,27,1,1,2,1,2,1,69,111,58261,44844,27,27,63095,44126
291,27,0,1,1,0,0,3,46,27,58261,44845,138,350,63095,44129
292,27,1,0,0,3,1,0,170,37,58262,44845,391,256,63098,44129
293,27,0,0,2,1,2,1,168,0,58262,44845,279,207,63099,44130
294,27,1,1,2,1,2,1,249,203,58263,44846,207,27,63100,44131
295,27,1,0,0,3,1,0,231,195,58264,44846,332,0,63103,44131
296,27,2,1,0,3,1,0,279,276,58266,44847,394,168,63106,44131
297,28,1,2,1,0,0,3,224,176,58267,44849,251,155,63106,44134
298,28,0,1,1,0,0,3,46,28,58267,44850,138,84,63106,44137
299,28,1,2,1,0,0,3,28,56,58268,44852,46,274,63106,44140
300,28,2,1,0,3,1,0,192,206,58270,44853,250,0,63109,44140
301,28,1,1,2,1,2,1,70,112,58271,44854,28,28,63110,44141
302,28,0,1,1,0,0,3,46,28,58271,44855,138,353,63110,44144
303,28,1,0,0,3,1,0,171,37,58272,44855,394,256,63113,44144
304,28,0,0,2,1,2,1,168,0,58272,44855,280,208,63114,44145
305,28,1,1,2,1,2,1,250,204,58273,44856,208,28,63115,44146
306,28,1,0,0,3,1,0,232,195,58274,44856,335,0,63118,44146
307,28,2,1,0,3,1,0,281,277,58276,44857,397,168,63121,44146
308,29,1,2,1,0,0,3,225,178,58277,44859,251,158,63121,44149
309,29,0,1,1,0,0,3,46,29,58277,44860,138,87,63121,44152
310,29,1,2,1,0,0,3,29,58,58278,44862,46,277,63121,44155
311,29,2,1,0,3,1,0,194,207,58280,44863,253,0,63124,44155
312,29,1,1,2,1,2,1,71,113,58281,44864,29,29,63125,44156
313,29,0,1,1,0,0,3,46,29,58281,44865,138,356,63125,44159
314,29,1,0,0,3,1,0,172,37,58282,44865,397,256,63128,44159
315,29,0,0,2,1,2,1,168,0,58282,44865,281,209,63129,44160
316,29,1,1,2,1,2,1,251,205,58283,44866,209,29,63130,44161
317,29,1,0,0,3,1,0,233,195,58284,44866,338,0,63133,44161
318,29,2,1,0,3,1,0,283,278,58286,44867,400,168,63136,44161
319,30,1,2,1,0,0,3,226,180,58287,44869,251,161,63136,44164
320,30,0,1,1,0,0,3,46,30,58287,44870,138,90,63136,44167
321,30,1,2,1,0,0,3,30,60,58288,44872,46,280,63136,44170
322,30,2,1,0,3,1,0,196,208,58290,44873,256,0,63139,44170
323,30,1,1,2,1,2,1,72,114,58291,44874,30,30,63140,44171
324,30,0,1,1,0,0,3,46,30,58291,44875,138,359,63140,44174
325,30,1,0,0,3,1,0,173,37,58292,44875,400,256,63143,44174
326,30,0,0,2,1,2,1,168,0,58292,44875,282,210,63144,44175
327,30,1,1,2,1,2,1,252,206,58293,44876,210,30,63145,44176
328,30,1,0,0,3,1,0,234,195,58294,44876,341,0,63148,44176
329,30,2,1,0,3,1,0,285,279,58296,44877,403,168,63151,44176
330,31,1,2,1,0,0,3,227,182,58297,44879,251,164,63151,44179
331,31,0,1,1,0,0,3,46,31,58297,44880,138,93,63151,44182
332,31,1,2,1,0,0,3,31,62,58298,44882,46,283,63151,44185
333,31,2,1,0,3,1,0,198,209,58300,44883,259,0,63154,44185
334,31,1,1,2,1,2,1,73,115,58301,44884,31,31,63155,44186
335,31,0,1,1,0,0,3,46,31,58301,44885,138,362,63155,44189
336,31,1,0,0,3,1,0,174,37,58302,44885,403,256,63158,44189
337,31,0,0,2,1,2,1,168,0,58302,44885,283,211,63159,44190
338,31,1,1,2,1,2,1,253,207,58303,44886,211,31,63160,44191
339,31,1,0,0,3,1,0,235,195,58304,44886,344,0,63163,44191
340,31,2,1,0,3,1,0,287,280,58306,44887,406,168,63166,44191
341,32,1,2,1,0,0,3,228,184,58307,44889,251,167,63166,44194
342,32,0,1,1,0,0,3,46,32,58307,44890,138,96,63166,44197
343,32,1,2,1,0,0,3,32,64,58308,44892,46,286,63166,44200
344,32,2,1,0,3,1,0,200,210,58310,44893,262,0,63169,44200
345,32,1,1,2,1,2,1,74,116,58311,44894,32,32,63170,44201
346,32,0,1,1,0,0,3,46,32,58311,44895,138,365,63170,44204
347,32,1,0,0,3,1,0,175,37,58312,44895,406,256,63173,44204
348,32,0,0,2,1,2,1,168,0,58312,44895,284,212,63174,44205
349,32,1,1,2,1,2,1,254,208,58313,44896,212,32,63175,44206
350,32,1,0,0,3,1,0,236,195,58314,44896,347,0,63178,44206
351,32,2,1,0,3,1,0,289,281,58316,44897,409,168,63181,44206
352,33,1,2,1,0,0,3,229,186,58317,44899,251,170,63181,44209
353,33,0,1,1,0,0,3,46,33,58317,44900,138,99,63181,44212
354,33,1,2,1,0,0,3,33,66,58318,44902,46,289,63181,44215
355,33,2,1,0,3,1,0,202,211,58320,44903,265,0,63184,44215
356,33,1,1,2,1,2,1,75,117,58321,44904,33,33,63185,44216
357,33,0,1,1,0,0,3,46,33,58321,44905,138,368,63185,44219
358,33,1,0,0,3,1,0,176,37,58322,44905,409,256,63188,44219
359,33,0,0,2,1,2,1,168,0,58322,44905,285,213,63189,44220
360,33,1,1,2,1,2,1,255,209,58323,44906,213,33,63190,44221
361,33,1,0,0,3,1,0,237,195,58324,44906,350,0,63193,44221
362,33,2,1,0,3,1,0,291,282,58326,44907,412,168,63196,44221
363,34,1,2,1,0,0,3,230,188,58327,44909,251,173,63196,44224
364,34,0,1,1,0,0,3,46,34,58327,44910,138,102,63196,44227
365,34,1,2,1,0,0,3,34,68,58328,44912,46,292,63196,44230
366,34,2,1,0,3,1,0,204,212,58330,44913,268,0,63199,44230
367,34,1,1,2,1,2,1,76,118,58331,44914,34,34,63200,44231
368,34,0,1,1,0,0,3,46,34,58331,44915,138,371,63200,44234
369,34,1,0,0,3,1,0,177,37,58332,44915,412,256,63203,44234
370,34,0,0,2,1,2,1,168,0,58332,44915,286,214,63204,44235
371,34,1,1,2,1,2,1,256,210,58333,44916,214,34,63205,44236
372,34,1,0,0,3,1,0,238,195,58334,44916,353,0,63208,44236
373,34,2,1,0,3,1,0,293,283,58336,44917,415,168,63211,44236
374,35,1,2,1,0,0,3,231,190,58337,44919,251,176,63211,44239
375,35,0,1,1,0,0,3,46,35,58337,44920,138,105,63211,44242
376,35,1,2,1,0,0,3,35,70,58338,44922,46,295,63211,44245
377,35,2,1,0,3,1,0,206,213,58340,44923,271,0,63214,44245
378,35,1,1,2,1,2,1,77,119,58341,44924,35,35,63215,44246
379,35,0,1,1,0,0,3,46,35,58341,44925,138,374,63215,44249
380,35,1,0,0,3,1,0,178,37,58342,44925,415,256,63218,44249
381,35,0,0,2,1,2,1,168,0,58342,44925,287,215,63219,44250
382,35,1,1,2,1,2,1,257,211,58343,44926,215,35,63220,44251
383,35,1,0,0,3,1,0,239,195,58344,44926,356,0,63223,44251
384,35,2,1,0,3,1,0,295,284,58346,44927,418,168,63226,44251
385,36,1,2,1,0,0,3,232,192,58347,44929,251,179,63226,44254
386,36,0,1,1,0,0,3,46,36,58347,44930,138,108,63226,44257
387,36,1,2,1,0,0,3,36,72,58348,44932,46,298,63226,44260
388,36,2,1,0,3,1,0,208,214,58350,44933,274,0,63229,44260
389,36,1,1,2,1,2,1,78,120,58351,44934,36,36,63230,44261
390,36,0,1,1,0,0,3,46,36,58351,44935,138,377,63230,44264
391,36,1,0,0,3,1,0,179,37,58352,44935,418,256,63233,44264
392,36,0,0,2,1,2,1,168,0,58352,44935,288,216,63234,44265
393,36,1,1,2,1,2,1,258,212,58353,44936,216,36,63235,44266
394,36,1,0,0,3,1,0,240,195,58354,44936,359,0,63238,44266
395,36,2,1,0,3,1,0,297,285,58356,44937,421,168,63241,44266
396,37,1,2,1,0,0,3,233,194,58357,44939,251,182,63241,44269
397,37,0,1,1,0,0,3,46,37,58357,44940,138,111,63241,44272
398,37,1,2,1,0,0,3,37,74,58358,44942,46,301,63241,44275
399,37,2,1,0,3,1,0,210,215,58360,44943,277,0,63244,44275
400,37,1,1,2,1,2,1,79,121,58361,44944,37,37,63245,44276
401,37,0,1,1,0,0,3,46,37,58361,44945,138,380,63245,44279
402,37,1,0,0,3,1,0,180,37,58362,44945,421,256,63248,44279
403,37,0,0,2,1,2,1,168,0,58362,44945,289,217,63249,44280
404,37,1,1,2,1,2,1,259,213,58363,44946,217,37,63250,44281
405,37,1,0,0,3,1,0,241,195,58364,44946,362,0,63253,44281
406,37,2,1,0,3,1,0,299,286,58366,44947,424,168,63256,44281
407,38,1,2,1,0,0,3,234,196,58367,44949,251,185,63256,44284
408,38,0,1,1,0,0,3,46,38,58367,44950,138,114,63256,44287
409,38,1,2,1,0,0,3,38,76,58368,44952,46,304,63256,44290
410,38,2,1,0,3,1,0,212,216,58370,44953,280,0,63259,44290
411,38,1,1,2,1,2,1,80,122,58371,44954,38,38,63260,44291
412,38,0,1,1,0,0,3,46,38,58371,44955,138,383,63260,44294
413,38,1,0,0,3,1,0,181,37,58372,44955,424,256,63263,44294
414,38,0,0,2,1,2,1,168,0,58372,44955,290,218,63264,44295
415,38,1,1,2,1,2,1,260,214,58373,44956,218,38,63265,44296
416,38,1,0,0,3,1,0,242,195,58374,44956,365,0,63268,44296
417,38,2,1,0,3,1,0,301,287,58376,44957,427,168,63271,44296
418,39,1,2,1,0,0,3,235,198,58377,44959,251,188,63271,44299
419,39,0,1,1,0,0,3,46,39,58377,44960,138,117,63271,44302
420,39,1,2,1,0,0,3,39,78,58378,44962,46,307,63271,44305
421,39,2,1,0,3,1,0,214,217,58380,44963,283,0,63274,44305
422,39,1,1,2,1,2,1,81,123,58381,44964,39,39,63275,44306
423,39,0,1,1,0,0,3,46,39,58381,44965,138,386,63275,44309
424,39,1,0,0,3,1,0,182,37,58382,44965,427,256,63278,44309
425,39,0,0,2,1,2,1,168,0,58382,44965,291,219,63279,44310
426,39,1,1,2,1,2,1,261,215,58383,44966,219,39,63280,44311
427,39,1,0,0,3,1,0,243,195,58384,44966,368,0,63283,44311
428,39,2,1,0,3,1,0,303,288,58386,44967,430,168,63286,44311
429,40,1,2,1,0,0,3,236,200,58387,44969,251,191,63286,44314
430,40,0,1,1,0,0,3,46,40,58387,44970,138,120,63286,44317
431,40,1,2,1,0,0,3,40,80,58388,44972,46,310,63286,44320
432,40,2,1,0,3,1,0,216,218,58390,44973,286,0,63289,44320
433,40,1,1,2,1,2,1,82,124,58391,44974,40,40,63290,44321
434,40,0,1,1,0,0,3,46,40,58391,44975,138,389,63290,44324
435,40,1,0,0,3,1,0,183,37,58392,44975,430,256,63293,44324
436,40,0,0,2,1,2,1,168,0,58392,44975,292,220,63294,44325
437,40,1,1,2,1,2,1,262,216,58393,44976,220,40,63295,44326
438,40,1,0,0,3,1,0,244,195,58394,44976,371,0,63298,44326
439,40,2,1,0,3,1,0,305,289,58396,44977,433,168,63301,44326
440,41,1,2,1,0,0,3,237,202,58397,44979,251,194,63301,44329
441,41,0,1,1,0,0,3,46,41,58397,44980,138,123,63301,44332
442,41,1,2,1,0,0,3,41,82,58398,44982,46,313,63301,44335
443,41,2,1,0,3,1,0,218,219,58400,44983,289,0,63304,44335
444,41,1,1,2,1,2,1,83,125,58401,44984,41,41,63305,44336
445,41,0,1,1,0,0,3,46,41,58401,44985,138,392,63305,44339
446,41,1,0,0,3,1,0,184,37,58402,44985,433,256,63308,44339
447,41,0,0,2,1,2,1,168,0,58402,44985,293,221,63309,44340
448,41,1,1,2,1,2,1,263,217,58403,44986,221,41,63310,44341
449,41,1,0,0,3,1,0,245,195,58404,44986,374,0,63313,44341
450,41,2,1,0,3,1,0,307,290,58406,44987,436,168,63316,44341
451,42,1,2,1,0,0,3,238,204,58407,44989,251,197,63316,44344
452,42,0,1,1,0,0,3,46,42,58407,44990,138,126,63316,44347
453,42,1,2,1,0,0,3,42,84,58408,44992,46,316,63316,44350
454,42,2,1,0,3,1,0,220,220,58410,44993,292,0,63319,44350
455,42,1,1,2,1,2,1,84,126,58411,44994,42,42,63320,44351
456,42,0,1,1,0,0,3,46,42,58411,44995,138,395,63320,44354
457,42,1,0,0,3,1,0,185,37,58412,44995,436,256,63323,44354
458,42,0,0,2,1,2,1,168,0,58412,44995,294,222,63324,44355
459,42,1,1,2,1,2,1,264,218,58413,44996,222,42,63325,44356
460,42,1,0,0,3,1,0,246,195,58414,44996,377,0,63328,44356
461,42,2,1,0,3,1,0,309,291,58416,44997,439,168,63331,44356
0,1,1,2,1,0,0,3,61,32,58417,44999,90,3,63331,44359
1,1,1,1,2,1,2,1,85,127,58418,45000,43,396,63332,44360
2,1,1,1,2,1,2,1,183,180,58419,45001,204,131,63333,44361
3,1,1,2,1,0,0,3,1,2,58420,45003,0,327,63333,44364
4,1,2,1,0,3,1,0,48,43,58422,45004,141,197,63336,44364
5,1,2,0,0,3,1,0,43,47,58424,45004,42,246,63339,44364
6,1,1,2,1,0,0,3,93,232,58425,45006,0,72,63339,44367
7,1,4,1,0,3,1,0,4,1,58429,45007,3,136,63342,44367
8,1,3,0,0,3,1,0,139,212,58432,45007,3,0,63345,44367
9,1,2,1,0,3,1,0,134,139,58434,45008,309,88,63348,44367
10,2,1,2,1,0,0,3,62,34,58435,45010,90,6,63348,44370
11,2,1,1,2,1,2,1,86,128,58436,45011,44,397,63349,44371
12,2,1,1,2,1,2,1,184,181,58437,45012,205,132,63350,44372
13,2,1,2,1,0,0,3,2,4,58438,45014,0,330,63350,44375
14,2,2,1,0,3,1,0,50,44,58440,45015,144,197,63353,44375
15,2,2,0,0,3,1,0,45,47,58442,45015,45,246,63356,44375
16,2,1,2,1,0,0,3,94,234,58443,45017,0,75,63356,44378
17,2,4,1,0,3,1,0,8,2,58447,45018,6,136,63359,44378
18,2,3,0,0,3,1,0,142,212,58450,45018,6,0,63362,44378
19,2,2,1,0,3,1,0,136,140,58452,45019,312,88,63365,44378
20,3,1,2,1,0,0,3,63,36,58453,45021,90,9,63365,44381
21,3,1,1,2,1,2,1,87,129,58454,45022,45,398,63366,44382
22,3,1,1,2,1,2,1,185,182,58455,45023,206,133,63367,44383
23,3,1,2,1,0,0,3,3,6,58456,45025,0,333,63367,44386
24,3,2,1,0,3,1,0,52,45,58458,45026,147,197,63370,44386
25,3,2,0,0,3,1,0,47,47,58460,45026,48,246,63373,44386
26,3,1,2,1,0,0,3,95,236,58461,45028,0,78,63373,44389
27,3,4,1,0,3,1,0,12,3,58465,45029,9,136,63376,44389
28,3,3,0,0,3,1,0,145,212,58468,45029,9,0,63379,44389
29,3,2,1,0,3,1,0,138,141,58470,45030,315,88,63382,44389
30,4,1,2,1,0,0,3,64,38,58471,45032,90,12,63382,44392
31,4,1,1,2,1,2,1,88,130,58472,45033,46,399,63383,44393
32,4,1,1,2,1,2,1,186,183,58473,45034,207,134,63384,44394
33,4,1,2,1,0,0,3,4,8,58474,45036,0,336,63384,44397
34,4,2,1,0,3,1,0,54,46,58476,45037,150,197,63387,44397
35,4,2,0,0,3,1,0,49,47,58478,45037,51,246,63390,44397
36,4,1,2,1,0,0,3,96,238,58479,45039,0,81,63390,44400
37,4,4,1,0,3,1,0,16,4,58483,45040,12,136,63393,44400
38,4,3,0,0,3,1,0,148,212,58486,45040,12,0,63396,44400
39,4,2,1,0,3,1,0,140,142,58488,45041,318,88,63399,44400
40,5,1,2,1,0,0,3,65,40,58489,45043,90,15,63399,44403
41,5,1,1,2,1,2,1,89,131,58490,45044,47,400,63400,44404
42,5,1,1,2,1,2,1,187,184,58491,45045,208,135,63401,44405
43,5,1,2,1,0,0,3,5,10,58492,45047,0,339,63401,44408
44,5,2,1,0,3,1,0,56,47,58494,45048,153,197,63404,44408
45,5,2,0,0,3,1,0,51,47,58496,45048,54,246,63407,44408
46,5,1,2,1,0,0,3,97,240,58497,45050,0,84,63407,44411
47,5,4,1,0,3,1,0,20,5,58501,45051,15,136,63410,44411
48,5,3,0,0,3,1,0,151,212,58504,45051,15,0,63413,44411
49,5,2,1,0,3,1,0,142,143,58506,45052,321,88,63416,44411
50,6,1,2,1,0,0,3,66,42,58507,45054,90,18,63416,44414
51,6,1,1,2,1,2,1,90,132,58508,45055,48,401,63417,44415
52,6,1,1,2,1,2,1,188,185,58509,45056,209,136,63418,44416
53,6,1,2,1,0,0,3,6,12,58510,45058,0,342,63418,44419
54,6,2,1,0,3,1,0,58,48,58512,45059,156,197,63421,44419
55,6,2,0,0,3,1,0,53,47,58514,45059,57,246,63424,44419
56,6,1,2,1,0,0,3,98,242,58515,45061,0,87,63424,44422
57,6,4,1,0,3,1,0,24,6,58519,45062,18,136,63427,44422
58,6,3,0,0,3,1,0,154,212,58522,45062,18,0,63430,44422
59,6,2,1,0,3,1,0,144,144,58524,45063,324,88,63433,44422
60,7,1,2,1,0,0,3,67,44,58525,45065,90,21,63433,44425
61,7,1,1,2,1,2,1,91,133,58526,45066,49,402,63434,44426
62,7,1,1,2,1,2,1,189,186,58527,45067,210,137,63435,44427
63,7,1,2,1,0,0,3,7,14,58528,45069,0,345,63435,44430
64,7,2,1,0,3,1,0,60,49,58530,45070,159,197,63438,44430
65,7,2,0,0,3,1,0,55,47,58532,45070,60,246,63441,44430
66,7,1,2,1,0,0,3,99,244,58533,45072,0,90,63441,44433
67,7,4,1,0,3,1,0,28,7,58537,45073,21,136,63444,44433
68,7,3,0,0,3,1,0,157,212,58540,45073,21,0,63447,44433
69,7,2,1,0,3,1,0,146,145,58542,45074,327,88,63450,44433
70,8,1,2,1,0,0,3,68,46,58543,45076,90,24,63450,44436
71,8,1,1,2,1,2,1,92,134,58544,45077,50,403,63451,44437
72,8,1,1,2,1,2,1,190,187,58545,45078,211,138,63452,44438
73,8,1,2,1,0,0,3,8,16,58546,45080,0,348,63452,44441
74,8,2,1,0,3,1,0,62,50,58548,45081,162,197,63455,44441
75,8,2,0,0,3,1,0,57,47,58550,45081,63,246,63458,44441
76,8,1,2,1,0,0,3,100,246,58551,45083,0,93,63458,44444
77,8,4,1,0,3,1,0,32,8,58555,45084,24,136,63461,44444
78,8,3,0,0,3,1,0,160,212,58558,45084,24,0,63464,44444
79,8,2,1,0,3,1,0,148,146,58560,45085,330,88,63467,44444
80,9,1,2,1,0,0,3,69,48,58561,45087,90,27,63467,44447
81,9,1,1,2,1,2,1,93,135,58562,45088,51,404,63468,44448
82,9,1,1,2,1,2,1,191,188,58563,45089,212,139,63469,44449
83,9,1,2,1,0,0,3,9,18,58564,45091,0,351,63469,44452
84,9,2,1,0,3,1,0,64,51,58566,45092,165,197,63472,44452
85,9,2,0,0,3,1,0,59,47,58568,45092,66,246,63475,44452
86,9,1,2,1,0,0,3,101,248,58569,45094,0,96,63475,44455
87,9,4,1,0,3,1,0,36,9,58573,45095,27,136,63478,44455
88,9,3,0,0,3,1,0,163,212,58576,45095,27,0,63481,44455
89,9,2,1,0,3,1,0,150,147,58578,45096,333,88,63484,44455
90,10,1,2,1,0,0,3,70,50,58579,45098,90,30,63484,44458
91,10,1,1,2,1,2,1,94,136,58580,45099,52,405,63485,44459
92,10,1,1,2,1,2,1,192,189,58581,45100,213,140,63486,44460
93,10,1,2,1,0,0,3,10,20,58582,45102,0,354,63486,44463
94,10,2,1,0,3,1,0,66,52,58584,45103,168,197,63489,44463
95,10,2,0,0,3,1,0,61,47,58586,45103,69,246,63492,44463
96,10,1,2,1,0,0,3,102,250,58587,45105,0,99,63492,44466
97,10,4,1,0,3,1,0,40,10,58591,45106,30,136,63495,44466
98,10,3,0,0,3,1,0,166,212,58594,45106,30,0,63498,44466
99,10,2,1,0,3,1,0,152,148,58596,45107,336,88,63501,44466
100,11,1,2,1,0,0,3,71,52,58597,45109,90,33,63501,44469
101,11,1,1,2,1,2,1,95,137,58598,45110,53,406,63502,44470
102,11,1,1,2,1,2,1,193,190,58599,45111,214,141,63503,44471
103,11,1,2,1,0,0,3,11,22,58600,45113,0,357,63503,44474
104,11,2,1,0,3,1,0,68,53,58602,45114,171,197,63506,44474
105,11,2,0,0,3,1,0,63,47,58604,45114,72,246,63509,44474
106,11,1,2,1,0,0,3,103,252,58605,45116,0,102,63509,44477
107,11,4,1,0,3,1,0,44,11,58609,45117,33,136,63512,44477
108,11,3,0,0,3,1,0,169,212,58612,45117,33,0,63515,44477
109,11,2,1,0,3,1,0,154,149,58614,45118,339,88,63518,44477
110,12,1,2,1,0,0,3,72,54,58615,45120,90,36,63518,44480
111,12,1,1,2,1,2,1,96,138,58616,45121,54,407,63519,44481
112,12,1,1,2,1,2,1,194,191,58617,45122,215,142,63520,44482
113,12,1,2,1,0,0,3,12,24,58618,45124,0,360,63520,44485
114,12,2,1,0,3,1,0,70,54,58620,45125,174,197,63523,44485
115,12,2,0,0,3,1,0,65,47,58622,45125,75,246,63526,44485
116,12,1,2,1,0,0,3,104,254,58623,45127,0,105,63526,44488
117,12,4,1,0,3,1,0,48,12,58627,45128,36,136,63529,44488
118,12,3,0,0,3,1,0,172,212,58630,45128,36,0,63532,44488
119,12,2,1,0,3,1,0,156,150,58632,45129,342,88,63535,44488
120,13,1,2,1,0,0,3,73,56,58633,45131,90,39,63535,44491
121,13,1,1,2,1,2,1,97,139,58634,45132,55,408,63536,44492
122,13,1,1,2,1,2,1,195,192,58635,45133,216,143,63537,44493
123,13,1,2,1,0,0,3,13,26,58636,45135,0,363,63537,44496
124,13,2,1,0,3,1,0,72,55,58638,45136,177,197,63540,44496
125,13,2,0,0,3,1,0,67,47,58640,45136,78,246,63543,44496
126,13,1,2,1,0,0,3,105,256,58641,45138,0,108,63543,44499
127,13,4,1,0,3,1,0,52,13,58645,45139,39,136,63546,44499
128,13,3,0,0,3,1,0,175,212,58648,45139,39,0,63549,44499
129,13,2,1,0,3,1,0,158,151,58650,45140,345,88,63552,44499
130,14,1,2,1,0,0,3,74,58,58651,45142,90,42,63552,44502
131,14,1,1,2,1,2,1,98,140,58652,45143,56,409,63553,44503
132,14,1,1,2,1,2,1,196,193,58653,45144,217,144,63554,44504
133,14,1,2,1,0,0,3,14,28,58654,45146,0,366,63554,44507
134,14,2,1,0,3,1,0,74,56,58656,45147,180,197,63557,44507
135,14,2,0,0,3,1,0,69,47,58658,45147,81,246,63560,44507
136,14,1,2,1,0,0,3,106,258,58659,45149,0,111,63560,44510
137,14,4,1,0,3,1,0,56,14,58663,45150,42,136,63563,44510
138,14,3,0,0,3,1,0,178,212,58666,45150,42,0,63566,44510
139,14,2,1,0,3,1,0,160,152,58668,45151,348,88,63569,44510
140,15,1,2,1,0,0,3,75,60,58669,45153,90,45,63569,44513
141,15,1,1,2,1,2,1,99,141,58670,45154,57,410,63570,44514
142,15,1,1,2,1,2,1,197,194,58671,45155,218,145,63571,44515
143,15,1,2,1,0,0,3,15,30,58672,45157,0,369,63571,44518
144,15,2,1,0,3,1,0,76,57,58674,45158,183,197,63574,44518
145,15,2,0,0,3,1,0,71,47,58676,45158,84,246,63577,44518
146,15,1,2,1,0,0,3,107,260,58677,45160,0,114,63577,44521
147,15,4,1,0,3,1,0,60,15,58681,45161,45,136,63580,44521
148,15,3,0,0,3,1,0,181,212,58684,45161,45,0,63583,44521
149,15,2,1,0,3,1,0,162,153,58686,45162,351,88,63586,44521
150,16,1,2,1,0,0,3,76,62,58687,45164,90,48,63586,44524
151,16,1,1,2,1,2,1,100,142,58688,45165,58,411,63587,44525
152,16,1,1,2,1,2,1,198,195,58689,45166,219,146,63588,44526
153,16,1,2,1,0,0,3,16,32,58690,45168,0,372,63588,44529
154,16,2,1,0,3,1,0,78,58,58692,45169,186,197,63591,44529
155,16,2,0,0,3,1,0,73,47,58694,45169,87,246,63594,44529
156,16,1,2,1,0,0,3,108,262,58695,45171,0,117,63594,44532
157,16,4,1,0,3,1,0,64,16,58699,45172,48,136,63597,44532
158,16,3,0,0,3,1,0,184,212,58702,45172,48,0,63600,44532
159,16,2,1,0,3,1,0,164,154,58704,45173,354,88,63603,44532
160,17,1,2,1,0,0,3,77,64,58705,45175,90,51,63603,44535
161,17,1,1,2,1,2,1,101,143,58706,45176,59,412,63604,44536
162,17,1,1,2,1,2,1,199,196,58707,45177,220,147,63605,44537
163,17,1,2,1,0,0,3,17,34,58708,45179,0,375,63605,44540
164,17,2,1,0,3,1,0,80,59,58710,45180,189,197,63608,44540
165,17,2,0,0,3,1,0,75,47,58712,45180,90,246,63611,44540
166,17,1,2,1,0,0,3,109,264,58713,45182,0,120,63611,44543
167,17,4,1,0,3,1,0,68,17,58717,45183,51,136,63614,44543
168,17,3,0,0,3,1,0,187,212,58720,45183,51,0,63617,44543
169,17,2,1,0,3,1,0,166,155,58722,45184,357,88,63620,44543
170,18,1,2,1,0,0,3,78,66,58723,45186,90,54,63620,44546
171,18,1,1,2,1,2,1,102,144,58724,45187,60,413,63621,44547
172,18,1,1,2,1,2,1,200,197,58725,45188,221,148,63622,44548
173,18,1,2,1,0,0,3,18,36,58726,45190,0,378,63622,44551
174,18,2,1,0,3,1,0,82,60,58728,45191,192,197,63625,44551
175,18,2,0,0,3,1,0,77,47,58730,45191,93,246,63628,44551
176,18,1,2,1,0,0,3,110,266,58731,45193,0,123,63628,44554
177,18,4,1,0,3,1,0,72,18,58735,45194,54,136,63631,44554
178,18,3,0,0,3,1,0,190,212,58738,45194,54,0,63634,44554
179,18,2,1,0,3,1,0,168,156,58740,45195,360,88,63637,44554
180,19,1,2,1,0,0,3,79,68,58741,45197,90,57,63637,44557
181,19,1,1,2,1,2,1,103,145,58742,45198,61,414,63638,44558
182,19,1,1,2,1,2,1,201,198,58743,45199,222,149,63639,44559
183,19,1,2,1,0,0,3,19,38,58744,45201,0,381,63639,44562
184,19,2,1,0,3,1,0,84,61,58746,45202,195,197,63642,44562
185,19,2,0,0,3,1,0,79,47,58748,45202,96,246,63645,44562
186,19,1,2,1,0,0,3,111,268,58749,45204,0,126,63645,44565
187,19,4,1,0,3,1,0,76,19,58753,45205,57,136,63648,44565
188,19,3,0,0,3,1,0,193,212,58756,45205,57,0,63651,44565
189,19,2,1,0,3,1,0,170,157,58758,45206,363,88,63654,44565
190,20,1,2,1,0,0,3,80,70,58759,45208,90,60,63654,44568
191,20,1,1,2,1,2,1,104,146,58760,45209,62,415,63655,44569
192,20,1,1,2,1,2,1,202,199,58761,45210,223,150,63656,44570
193,20,1,2,1,0,0,3,20,40,58762,45212,0,384,63656,44573
194,20,2,1,0,3,1,0,86,62,58764,45213,198,197,63659,44573
195,20,2,0,0,3,1,0,81,47,58766,45213,99,246,63662,44573
196,20,1,2,1,0,0,3,112,270,58767,45215,0,129,63662,44576
197,20,4,1,0,3,1,0,80,20,58771,45216,60,136,63665,44576
198,20,3,0,0,3,1,0,196,212,58774,45216,60,0,63668,44576
199,20,2,1,0,3,1,0,172,158,58776,45217,366,88,63671,44576
200,21,1,2,1,0,0,3,81,72,58777,45219,90,63,63671,44579
201,21,1,1,2,1,2,1,105,147,58778,45220,63,416,63672,44580
202,21,1,1,2,1,2,1,203,200,58779,45221,224,151,63673,44581
203,21,1,2,1,0,0,3,21,42,58780,45223,0,387,63673,44584
204,21,2,1,0,3,1,0,88,63,58782,45224,201,197,63676,44584
205,21,2,0,0,3,1,0,83,47,58784,45224,102,246,63679,44584
206,21,1,2,1,0,0,3,113,272,58785,45226,0,132,63679,44587
207,21,4,1,0,3,1,0,84,21,58789,45227,63,136,63682,44587
208,21,3,0,0,3,1,0,199,212,58792,45227,63,0,63685,44587
209,21,2,1,0,3,1,0,174,159,58794,45228,369,88,63688,44587
210,22,1,2,1,0,0,3,82,74,58795,45230,90,66,63688,44590
211,22,1,1,2,1,2,1,106,148,58796,45231,64,417,63689,44591
212,22,1,1,2,1,2,1,204,201,58797,45232,225,152,63690,44592
213,22,1,2,1,0,0,3,22,44,58798,45234,0,390,63690,44595
214,22,2,1,0,3,1,0,90,64,58800,45235,204,197,63693,44595
215,22,2,0,0,3,1,0,85,47,58802,45235,105,246,63696,44595
216,22,1,2,1,0,0,3,114,274,58803,45237,0,135,63696,44598
217,22,4,1,0,3,1,0,88,22,58807,45238,66,136,63699,44598
218,22,3,0,0,3,1,0,202,212,58810,45238,66,0,63702,44598
219,22,2,1,0,3,1,0,176,160,58812,45239,372,88,63705,44598
220,23,1,2,1,0,0,3,83,76,58813,45241,90,69,63705,44601
221,23,1,1,2,1,2,1,107,149,58814,45242,65,418,63706,44602
222,23,1,1,2,1,2,1,205,202,58815,45243,226,153,63707,44603
223,23,1,2,1,0,0,3,23,46,58816,45245,0,393,63707,44606
224,23,2,1,0,3,1,0,92,65,58818,45246,207,197,63710,44606
225,23,2,0,0,3,1,0,87,47,58820,45246,108,246,63713,44606
226,23,1,2,1,0,0,3,115,276,58821,45248,0,138,63713,44609
227,23,4,1,0,3,1,0,92,23,58825,45249,69,136,63716,44609
228,23,3,0,0,3,1,0,205,212,58828,45249,69,0,63719,44609
229,23,2,1,0,3,1,0,178,161,58830,45250,375,88,63722,44609
230,24,1,2,1,0,0,3,84,78,58831,45252,90,72,63722,44612
231,24,1,1,2,1,2,1,108,150,58832,45253,66,419,63723,44613
232,24,1,1,2,1,2,1,206,203,58833,45254,227,154,63724,44614
233,24,1,2,1,0,0,3,24,48,58834,45256,0,396,63724,44617
234,24,2,1,0,3,1,0,94,66,58836,45257,210,197,63727,44617
235,24,2,0,0,3,1,0,89,47,58838,45257,111,246,63730,44617
236,24,1,2,1,0,0,3,116,278,58839,45259,0,141,63730,44620
237,24,4,1,0,3,1,0,96,24,58843,45260,72,136,63733,44620
238,24,3,0,0,3,1,0,208,212,58846,45260,72,0,63736,44620
239,24,2,1,0,3,1,0,180,162,58848,45261,378,88,63739,44620
240,25,1,2,1,0,0,3,85,80,58849,45263,90,75,63739,44623
241,25,1,1,2,1,2,1,109,151,58850,45264,67,420,63740,44624
242,25,1,1,2,1,2,1,207,204,58851,45265,228,155,63741,44625
243,25,1,2,1,0,0,3,25,50,58852,45267,0,399,63741,44628
244,25,2,1,0,3,1,0,96,67,58854,45268,213,197,63744,44628
245,25,2,0,0,3,1,0,91,47,58856,45268,114,246,63747,44628
246,25,1,2,1,0,0,3,117,280,58857,45270,0,144,63747,44631
247,25,4,1,0,3,1,0,100,25,58861,45271,75,136,63750,44631
248,25,3,0,0,3,1,0,211,212,58864,45271,75,0,63753,44631
249,25,2,1,0,3,1,0,182,163,58866,45272,381,88,63756,44631
250,26,1,2,1,0,0,3,86,82,58867,45274,90,78,63756,44634
251,26,1,1,2,1,2,1,110,152,58868,45275,68,421,63757,44635
252,26,1,1,2,1,2,1,208,205,58869,45276,229,156,63758,44636
253,26,1,2,1,0,0,3,26,52,58870,45278,0,402,63758,44639
254,26,2,1,0,3,1,0,98,68,58872,45279,216,197,63761,44639
255,26,2,0,0,3,1,0,93,47,58874,45279,117,246,63764,44639
256,26,1,2,1,0,0,3,118,282,58875,45281,0,147,63764,44642
257,26,4,1,0,3,1,0,104,26,58879,45282,78,136,63767,44642
258,26,3,0,0,3,1,0,214,212,58882,45282,78,0,63770,44642
259,26,2,1,0,3,1,0,184,164,58884,45283,384,88,63773,44642
260,27,1,2,1,0,0,3,87,84,58885,45285,90,81,63773,44645
261,27,1,1,2,1,2,1,111,153,58886,45286,69,422,63774,44646
262,27,1,1,2,1,2,1,209,206,58887,45287,230,157,63775,44647
263,27,1,2,1,0,0,3,27,54,58888,45289,0,405,63775,44650
264,27,2,1,0,3,1,0,100,69,58890,45290,219,197,63778,44650
265,27,2,0,0,3,1,0,95,47,58892,45290,120,246,63781,44650
266,27,1,2,1,0,0,3,119,284,58893,45292,0,150,63781,44653
267,27,4,1,0,3,1,0,108,27,58897,45293,81,136,63784,44653
268,27,3,0,0,3,1,0,217,212,58900,45293,81,0,63787,44653
269,27,2,1,0,3,1,0,186,165,58902,45294,387,88,63790,44653
270,28,1,2,1,0,0,3,88,86,58903,45296,90,84,63790,44656
271,28,1,1,2,1,2,1,112,154,58904,45297,70,423,63791,44657
272,28,1,1,2,1,2,1,210,207,58905,45298,231,158,63792,44658
273,28,1,2,1,0,0,3,28,56,58906,45300,0,408,63792,44661
274,28,2,1,0,3,1,0,102,70,58908,45301,222,197,63795,44661
275,28,2,0,0,3,1,0,97,47,58910,45301,123,246,63798,44661
276,28,1,2,1,0,0,3,120,286,58911,45303,0,153,63798,44664
277,28,4,1,0,3,1,0,112,28,58915,45304,84,136,63801,44664
278,28,3,0,0,3,1,0,220,212,58918,45304,84,0,63804,44664
279,28,2,1,0,3,1,0,188,166,58920,45305,390,88,63807,44664
280,29,1,2,1,0,0,3,89,88,58921,45307,90,87,63807,44667
281,29,1,1,2,1,2,1,113,155,58922,45308,71,424,63808,44668
282,29,1,1,2,1,2,1,211,208,58923,45309,232,159,63809,44669
283,29,1,2,1,0,0,3,29,58,58924,45311,0,411,63809,44672
284,29,2,1,0,3,1,0,104,71,58926,45312,225,197,63812,44672
285,29,2,0,0,3,1,0,99,47,58928,45312,126,246,63815,44672
286,29,1,2,1,0,0,3,121,288,58929,45314,0,156,63815,44675
287,29,4,1,0,3,1,0,116,29,58933,45315,87,136,63818,44675
288,29,3,0,0,3,1,0,223,212,58936,45315,87,0,63821,44675
289,29,2,1,0,3,1,0,190,167,58938,45316,393,88,63824,44675
290,30,1,2,1,0,0,3,90,90,58939,45318,90,90,63824,44678
291,30,1,1,2,1,2,1,114,156,58940,45319,72,425,63825,44679
292,30,1,1,2,1,2,1,212,209,58941,45320,233,160,63826,44680
293,30,1,2,1,0,0,3,30,60,58942,45322,0,414,63826,44683
294,30,2,1,0,3,1,0,106,72,58944,45323,228,197,63829,44683
295,30,2,0,0,3,1,0,101,47,58946,45323,129,246,63832,44683
296,30,1,2,1,0,0,3,122,290,58947,45325,0,159,63832,44686
297,30,4,1,0,3,1,0,120,30,58951,45326,90,136,63835,44686
298,30,3,0,0,3,1,0,226,212,58954,45326,90,0,63838,44686
299,30,2,1,0,3,1,0,192,168,58956,45327,396,88,63841,44686
300,31,1,2,1,0,0,3,91,92,58957,45329,90,93,63841,44689
301,31,1,1,2,1,2,1,115,157,58958,45330,73,426,63842,44690
302,31,1,1,2,1,2,1,213,210,58959,45331,234,161,63843,44691
303,31,1,2,1,0,0,3,31,62,58960,45333,0,417,63843,44694
304,31,2,1,0,3,1,0,108,73,58962,45334,231,197,63846,44694
305,31,2,0,0,3,1,0,103,47,58964,45334,132,246,63849,44694
306,31,1,2,1,0,0,3,123,292,58965,45336,0,162,63849,44697
307,31,4,1,0,3,1,0,124,31,58969,45337,93,136,63852,44697
308,31,3,0,0,3,1,0,229,212,58972,45337,93,0,63855,44697
309,31,2,1,0,3,1,0,194,169,58974,45338,399,88,63858,44697
310,32,1,2,1,0,0,3,92,94,58975,45340,90,96,63858,44700
311,32,1,1,2,1,2,1,116,158,58976,45341,74,427,63859,44701
312,32,1,1,2,1,2,1,214,211,58977,45342,235,162,63860,44702
313,32,1,2,1,0,0,3,32,64,58978,45344,0,420,63860,44705
314,32,2,1,0,3,1,0,110,74,58980,45345,234,197,63863,44705
315,32,2,0,0,3,1,0,105,47,58982,45345,135,246,63866,44705
316,32,1,2,1,0,0,3,124,294,58983,45347,0,165,63866,44708
317,32,4,1,0,3,1,0,128,32,58987,45348,96,136,63869,44708
318,32,3,0,0,3,1,0,232,212,58990,45348,96,0,63872,44708
319,32,2,1,0,3,1,0,196,170,58992,45349,402,88,63875,44708
320,33,1,2,1,0,0,3,93,96,58993,45351,90,99,63875,44711
321,33,1,1,2,1,2,1,117,159,58994,45352,75,428,63876,44712
322,33,1,1,2,1,2,1,215,212,58995,45353,236,163,63877,44713
323,33,1,2,1,0,0,3,33,66,58996,45355,0,423,63877,44716
324,33,2,1,0,3,1,0,112,75,58998,45356,237,197,63880,44716
325,33,2,0,0,3,1,0,107,47,59000,45356,138,246,63883,44716
326,33,1,2,1,0,0,3,125,296,59001,45358,0,168,63883,44719
327,33,4,1,0,3,1,0,132,33,59005,45359,99,136,63886,44719
328,33,3,0,0,3,1,0,235,212,59008,45359,99,0,63889,44719
329,33,2,1,0,3,1,0,198,171,59010,45360,405,88,63892,44719
330,34,1,2,1,0,0,3,94,98,59011,45362,90,102,63892,44722
331,34,1,1,2,1,2,1,118,160,59012,45363,76,429,63893,44723
332,34,1,1,2,1,2,1,216,213,59013,45364,237,164,63894,44724
333,34,1,2,1,0,0,3,34,68,59014,45366,0,426,63894,44727
334,34,2,1,0,3,1,0,114,76,59016,45367,240,197,63897,44727
335,34,2,0,0,3,1,0,109,47,59018,45367,141,246,63900,44727
336,34,1,2,1,0,0,3,126,298,59019,45369,0,171,63900,44730
337,34,4,1,0,3,1,0,136,34,59023,45370,102,136,63903,44730
338,34,3,0,0,3,1,0,238,212,59026,45370,102,0,63906,44730
339,34,2,1,0,3,1,0,200,172,59028,45371,408,88,63909,44730
340,35,1,2,1,0,0,3,95,100,59029,45373,90,105,63909,44733
341,35,1,1,2,1,2,1,119,161,59030,45374,77,430,63910,44734
342,35,1,1,2,1,2,1,217,214,59031,45375,238,165,63911,44735
343,35,1,2,1,0,0,3,35,70,59032,45377,0,429,63911,44738
344,35,2,1,0,3,1,0,116,77,59034,45378,243,197,63914,44738
345,35,2,0,0,3,1,0,111,47,59036,45378,144,246,63917,44738
346,35,1,2,1,0,0,3,127,300,59037,45380,0,174,63917,44741
347,35,4,1,0,3,1,0,140,35,59041,45381,105,136,63920,44741
348,35,3,0,0,3,1,0,241,212,59044,45381,105,0,63923,44741
349,35,2,1,0,3,1,0,202,173,59046,45382,411,88,63926,44741
350,36,1,2,1,0,0,3,96,102,59047,45384,90,108,63926,44744
351,36,1,1,2,1,2,1,120,162,59048,45385,78,431,63927,44745
352,36,1,1,2,1,2,1,218,215,59049,45386,239,166,63928,44746
353,36,1,2,1,0,0,3,36,72,59050,45388,0,432,63928,44749
354,36,2,1,0,3,1,0,118,78,59052,45389,246,197,63931,44749
355,36,2,0,0,3,1,0,113,47,59054,45389,147,246,63934,44749
356,36,1,2,1,0,0,3,128,302,59055,45391,0,177,63934,44752
357,36,4,1,0,3,1,0,144,36,59059,45392,108,136,63937,44752
358,36,3,0,0,3,1,0,244,212,59062,45392,108,0,63940,44752
359,36,2,1,0,3,1,0,204,174,59064,45393,414,88,63943,44752
360,37,1,2,1,0,0,3,97,104,59065,45395,90,111,63943,44755
361,37,1,1,2,1,2,1,121,163,59066,45396,79,432,63944,44756
362,37,1,1,2,1,2,1,219,216,59067,45397,240,167,63945,44757
363,37,1,2,1,0,0,3,37,74,59068,45399,0,435,63945,44760
364,37,2,1,0,3,1,0,120,79,59070,45400,249,197,63948,44760
365,37,2,0,0,3,1,0,115,47,59072,45400,150,246,63951,44760
366,37,1,2,1,0,0,3,129,304,59073,45402,0,180,63951,44763
367,37,4,1,0,3,1,0,148,37,59077,45403,111,136,63954,44763
368,37,3,0,0,3,1,0,247,212,59080,45403,111,0,63957,44763
369,37,2,1,0,3,1,0,206,175,59082,45404,417,88,63960,44763
370,38,1,2,1,0,0,3,98,106,59083,45406,90,114,63960,44766
371,38,1,1,2,1,2,1,122,164,59084,45407,80,433,63961,44767
372,38,1,1,2,1,2,1,220,217,59085,45408,241,168,63962,44768
373,38,1,2,1,0,0,3,38,76,59086,45410,0,438,63962,44771
374,38,2,1,0,3,1,0,122,80,59088,45411,252,197,63965,44771
375,38,2,0,0,3,1,0,117,47,59090,45411,153,246,63968,44771
376,38,1,2,1,0,0,3,130,306,59091,45413,0,183,63968,44774
377,38,4,1,0,3,1,0,152,38,59095,45414,114,136,63971,44774
378,38,3,0,0,3,1,0,250,212,59098,45414,114,0,63974,44774
379,38,2,1,0,3,1,0,208,176,59100,45415,420,88,63977,44774
0,1,4,0,0,3,1,0,135,122,59104,45415,178,168,63980,44774
1,1,1,0,0,3,1,0,62,16,59105,45415,154,222,63983,44774
2,1,2,1,0,3,1,0,266,219,59107,45416,225,136,63986,44774
3,1,1,1,2,1,2,1,209,177,59108,45417,421,198,63987,44775
4,1,2,0,0,3,1,0,198,201,59110,45417,240,88,63990,44775
5,1,0,1,1,0,0,3,250,213,59110,45418,114,49,63990,44778
6,1,1,2,1,0,0,3,186,39,59111,45420,436,249,63990,44781
7,1,0,0,2,1,2,1,98,106,59111,45420,91,47,63991,44782
8,1,0,1,1,0,0,3,138,47,59111,45421,180,45,63991,44785
9,2,4,0,0,3,1,0,139,122,59115,45421,181,168,63994,44785
10,2,1,0,0,3,1,0,63,16,59116,45421,157,222,63997,44785
11,2,2,1,0,3,1,0,268,220,59118,45422,228,136,64000,44785
12,2,1,1,2,1,2,1,210,178,59119,45423,422,199,64001,44786
13,2,2,0,0,3,1,0,200,201,59121,45423,243,88,64004,44786
14,2,0,1,1,0,0,3,250,214,59121,45424,114,52,64004,44789
15,2,1,2,1,0,0,3,187,41,59122,45426,436,252,64004,44792
16,2,0,0,2,1,2,1,98,106,59122,45426,92,48,64005,44793
17,2,0,1,1,0,0,3,138,48,59122,45427,180,48,64005,44796
18,3,4,0,0,3,1,0,143,122,59126,45427,184,168,64008,44796
19,3,1,0,0,3,1,0,64,16,59127,45427,160,222,64011,44796
20,3,2,1,0,3,1,0,270,221,59129,45428,231,136,64014,44796
21,3,1,1,2,1,2,1,211,179,59130,45429,423,200,64015,44797
22,3,2,0,0,3,1,0,202,201,59132,45429,246,88,64018,44797
23,3,0,1,1,0,0,3,250,215,59132,45430,114,55,64018,44800
24,3,1,2,1,0,0,3,188,43,59133,45432,436,255,64018,44803
25,3,0,0,2,1,2,1,98,106,59133,45432,93,49,64019,44804
26,3,0,1,1,0,0,3,138,49,59133,45433,180,51,64019,44807
27,4,4,0,0,3,1,0,147,122,59137,45433,187,168,64022,44807
28,4,1,0,0,3,1,0,65,16,59138,45433,163,222,64025,44807
29,4,2,1,0,3,1,0,272,222,59140,45434,234,136,64028,44807
30,4,1,1,2,1,2,1,212,180,59141,45435,424,201,64029,44808
31,4,2,0,0,3,1,0,204,201,59143,45435,249,88,64032,44808
32,4,0,1,1,0,0,3,250,216,59143,45436,114,58,64032,44811
33,4,1,2,1,0,0,3,189,45,59144,45438,436,258,64032,44814
34,4,0,0,2,1,2,1,98,106,59144,45438,94,50,64033,44815
35,4,0,1,1,0,0,3,138,50,59144,45439,180,54,64033,44818
36,5,4,0,0,3,1,0,151,122,59148,45439,190,168,64036,44818
37,5,1,0,0,3,1,0,66,16,59149,45439,166,222,64039,44818
38,5,2,1,0,3,1,0,274,223,59151,45440,237,136,64042,44818
39,5,1,1,2,1,2,1,213,181,59152,45441,425,202,64043,44819
40,5,2,0,0,3,1,0,206,201,59154,45441,252,88,64046,44819
41,5,0,1,1,0,0,3,250,217,59154,45442,114,61,64046,44822
42,5,1,2,1,0,0,3,190,47,59155,45444,436,261,64046,44825
43,5,0,0,2,1,2,1,98,106,59155,45444,95,51,64047,44826
44,5,0,1,1,0,0,3,138,51,59155,45445,180,57,64047,44829
45,6,4,0,0,3,1,0,155,122,59159,45445,193,168,64050,44829
46,6,1,0,0,3,1,0,67,16,59160,45445,169,222,64053,44829
47,6,2,1,0,3,1,0,276,224,59162,45446,240,136,64056,44829
48,6,1,1,2,1,2,1,214,182,59163,45447,426,203,64057,44830
49,6,2,0,0,3,1,0,208,201,59165,45447,255,88,64060,44830
50,6,0,1,1,0,0,3,250,218,59165,45448,114,64,64060,44833
51,6,1,2,1,0,0,3,191,49,59166,45450,436,264,64060,44836
52,6,0,0,2,1,2,1,98,106,59166,45450,96,52,64061,44837
53,6,0,1,1,0,0,3,138,52,59166,45451,180,60,64061,44840
54,7,4,0,0,3,1,0,159,122,59170,45451,196,168,64064,44840
55,7,1,0,0,3,1,0,68,16,59171,45451,172,222,64067,44840
56,7,2,1,0,3,1,0,278,225,59173,45452,243,136,64070,44840
57,7,1,1,2,1,2,1,215,183,59174,45453,427,204,64071,44841
58,7,2,0,0,3,1,0,210,201,59176,45453,258,88,64074,44841
59,7,0,1,1,0,0,3,250,219,59176,45454,114,67,64074,44844
60,7,1,2,1,0,0,3,192,51,59177,45456,436,267,64074,44847
61,7,0,0,2,1,2,1,98,106,59177,45456,97,53,64075,44848
62,7,0,1,1,0,0,3,138,53,59177,45457,180,63,64075,44851
63,8,4,0,0,3,1,0,163,122,59181,45457,199,168,64078,44851
64,8,1,0,0,3,1,0,69,16,59182,45457,175,222,64081,44851
65,8,2,1,0,3,1,0,280,226,59184,45458,246,136,64084,44851
66,8,1,1,2,1,2,1,216,184,59185,45459,428,205,64085,44852
67,8,2,0,0,3,1,0,212,201,59187,45459,261,88,64088,44852
68,8,0,1,1,0,0,3,250,220,59187,45460,114,70,64088,44855
69,8,1,2,1,0,0,3,193,53,59188,45462,436,270,64088,44858
70,8,0,0,2,1,2,1,98,106,59188,45462,98,54,64089,44859
71,8,0,1,1,0,0,3,138,54,59188,45463,180,66,64089,44862
72,9,4,0,0,3,1,0,167,122,59192,45463,202,168,64092,44862
73,9,1,0,0,3,1,0,70,16,59193,45463,178,222,64095,44862
74,9,2,1,0,3,1,0,282,227,59195,45464,249,136,64098,44862
75,9,1,1,2,1,2,1,217,185,59196,45465,429,206,64099,44863
76,9,2,0,0,3,1,0,214,201,59198,45465,264,88,64102,44863
77,9,0,1,1,0,0,3,250,221,59198,45466,114,73,64102,44866
78,9,1,2,1,0,0,3,194,55,59199,45468,436,273,64102,44869
79,9,0,0,2,1,2,1,98,106,59199,45468,99,55,64103,44870
80,9,0,1,1,0,0,3,138,55,59199,45469,180,69,64103,44873
81,10,4,0,0,3,1,0,171,122,59203,45469,205,168,64106,44873
82,10,1,0,0,3,1,0,71,16,59204,45469,181,222,64109,44873
83,10,2,1,0,3,1,0,284,228,59206,45470,252,136,64112,44873
84,10,1,1,2,1,2,1,218,186,59207,45471,430,207,64113,44874
85,10,2,0,0,3,1,0,216,201,59209,45471,267,88,64116,44874
86,10,0,1,1,0,0,3,250,222,59209,45472,114,76,64116,44877
87,10,1,2,1,0,0,3,195,57,59210,45474,436,276,64116,44880
88,10,0,0,2,1,2,1,98,106,59210,45474,100,56,64117,44881
89,10,0,1,1,0,0,3,138,56,59210,45475,180,72,64117,44884
90,11,4,0,0,3,1,0,175,122,59214,45475,208,168,64120,44884
91,11,1,0,0,3,1,0,72,16,59215,45475,184,222,64123,44884
92,11,2,1,0,3,1,0,286,229,59217,45476,255,136,64126,44884
93,11,1,1,2,1,2,1,219,187,59218,45477,431,208,64127,44885
94,11,2,0,0,3,1,0,218,201,59220,45477,270,88,64130,44885
95,11,0,1,1,0,0,3,250,223,59220,45478,114,79,64130,44888
96,11,1,2,1,0,0,3,196,59,59221,45480,436,279,64130,44891
97,11,0,0,2,1,2,1,98,106,59221,45480,101,57,64131,44892
98,11,0,1,1,0,0,3,138,57,59221,45481,180,75,64131,44895
99,12,4,0,0,3,1,0,179,122,59225,45481,211,168,64134,44895
100,12,1,0,0,3,1,0,73,16,59226,45481,187,222,64137,44895
101,12,2,1,0,3,1,0,288,230,59228,45482,258,136,64140,44895
102,12,1,1,2,1,2,1,220,188,59229,45483,432,209,64141,44896
103,12,2,0,0,3,1,0,220,201,59231,45483,273,88,64144,44896
104,12,0,1,1,0,0,3,250,224,59231,45484,114,82,64144,44899
105,12,1,2,1,0,0,3,197,61,59232,45486,436,282,64144,44902
106,12,0,0,2,1,2,1,98,106,59232,45486,102,58,64145,44903
107,12,0,1,1,0,0,3,138,58,59232,45487,180,78,64145,44906
108,13,4,0,0,3,1,0,183,122,59236,45487,214,168,64148,44906
109,13,1,0,0,3,1,0,74,16,59237,45487,190,222,64151,44906
110,13,2,1,0,3,1,0,290,231,59239,45488,261,136,64154,44906
111,13,1,1,2,1,2,1,221,189,59240,45489,433,210,64155,44907
112,13,2,0,0,3,1,0,222,201,59242,45489,276,88,64158,44907
113,13,0,1,1,0,0,3,250,225,59242,45490,114,85,64158,44910
114,13,1,2,1,0,0,3,198,63,59243,45492,436,285,64158,44913
115,13,0,0,2,1,2,1,98,106,59243,45492,103,59,64159,44914
116,13,0,1,1,0,0,3,138,59,59243,45493,180,81,64159,44917
117,14,4,0,0,3,1,0,187,122,59247,45493,217,168,64162,44917
118,14,1,0,0,3,1,0,75,16,59248,45493,193,222,64165,44917
119,14,2,1,0,3,1,0,292,232,59250,45494,264,136,64168,44917
120,14,1,1,2,1,2,1,222,190,59251,45495,434,211,64169,44918
121,14,2,0,0,3,1,0,224,201,59253,45495,279,88,64172,44918
122,14,0,1,1,0,0,3,250,226,59253,45496,114,88,64172,44921
123,14,1,2,1,0,0,3,199,65,59254,45498,436,288,64172,44924
124,14,0,0,2,1,2,1,98,106,59254,45498,104,60,64173,44925
125,14,0,1,1,0,0,3,138,60,59254,45499,180,84,64173,44928
126,15,4,0,0,3,1,0,191,122,59258,45499,220,168,64176,44928
127,15,1,0,0,3,1,0,76,16,59259,45499,196,222,64179,44928
128,15,2,1,0,3,1,0,294,233,59261,45500,267,136,64182,44928
129,15,1,1,2,1,2,1,223,191,59262,45501,435,212,64183,44929
130,15,2,0,0,3,1,0,226,201,59264,45501,282,88,64186,44929
131,15,0,1,1,0,0,3,250,227,59264,45502,114,91,64186,44932
132,15,1,2,1,0,0,3,200,67,59265,45504,436,291,64186,44935
133,15,0,0,2,1,2,1,98,106,59265,45504,105,61,64187,44936
134,15,0,1,1,0,0,3,138,61,59265,45505,180,87,64187,44939
135,16,4,0,0,3,1,0,195,122,59269,45505,223,168,64190,44939
136,16,1,0,0,3,1,0,77,16,59270,45505,199,222,64193,44939
137,16,2,1,0,3,1,0,296,234,59272,45506,270,136,64196,44939
138,16,1,1,2,1,2,1,224,192,59273,45507,436,213,64197,44940
139,16,2,0,0,3,1,0,228,201,59275,45507,285,88,64200,44940
140,16,0,1,1,0,0,3,250,228,59275,45508,114,94,64200,44943
141,16,1,2,1,0,0,3,201,69,59276,45510,436,294,64200,44946
142,16,0,0,2,1,2,1,98,106,59276,45510,106,62,64201,44947
143,16,0,1,1,0,0,3,138,62,59276,45511,180,90,64201,44950
144,17,4,0,0,3,1,0,199,122,59280,45511,226,168,64204,44950
145,17,1,0,0,3,1,0,78,16,59281,45511,202,222,64207,44950
146,17,2,1,0,3,1,0,298,235,59283,45512,273,136,64210,44950
147,17,1,1,2,1,2,1,225,193,59284,45513,437,214,64211,44951
148,17,2,0,0,3,1,0,230,201,59286,45513,288,88,64214,44951
149,17,0,1,1,0,0,3,250,229,59286,45514,114,97,64214,44954
150,17,1,2,1,0,0,3,202,71,59287,45516,436,297,64214,44957
151,17,0,0,2,1,2,1,98,106,59287,45516,107,63,64215,44958
152,17,0,1,1,0,0,3,138,63,59287,45517,180,93,64215,44961
153,18,4,0,0,3,1,0,203,122,59291,45517,229,168,64218,44961
154,18,1,0,0,3,1,0,79,16,59292,45517,205,222,64221,44961
155,18,2,1,0,3,1,0,300,236,59294,45518,276,136,64224,44961
156,18,1,1,2,1,2,1,226,194,59295,45519,438,215,64225,44962
157,18,2,0,0,3,1,0,232,201,59297,45519,291,88,64228,44962
158,18,0,1,1,0,0,3,250,230,59297,45520,114,100,64228,44965
159,18,1,2,1,0,0,3,203,73,59298,45522,436,300,64228,44968
160,18,0,0,2,1,2,1,98,106,59298,45522,108,64,64229,44969
161,18,0,1,1,0,0,3,138,64,59298,45523,180,96,64229,44972
162,19,4,0,0,3,1,0,207,122,59302,45523,232,168,64232,44972
163,19,1,0,0,3,1,0,80,16,59303,45523,208,222,64235,44972
164,19,2,1,0,3,1,0,302,237,59305,45524,279,136,64238,44972
165,19,1,1,2,1,2,1,227,195,59306,45525,439,216,64239,44973
166,19,2,0,0,3,1,0,234,201,59308,45525,294,88,64242,44973
167,19,0,1,1,0,0,3,250,231,59308,45526,114,103,64242,44976
168,19,1,2,1,0,0,3,204,75,59309,45528,436,303,64242,44979
169,19,0,0,2,1,2,1,98,106,59309,45528,109,65,64243,44980
170,19,0,1,1,0,0,3,138,65,59309,45529,180,99,64243,44983
171,20,4,0,0,3,1,0,211,122,59313,45529,235,168,64246,44983
172,20,1,0,0,3,1,0,81,16,59314,45529,211,222,64249,44983
173,20,2,1,0,3,1,0,304,238,59316,45530,282,136,64252,44983
174,20,1,1,2,1,2,1,228,196,59317,45531,440,217,64253,44984
175,20,2,0,0,3,1,0,236,201,59319,45531,297,88,64256,44984
176,20,0,1,1,0,0,3,250,232,59319,45532,114,106,64256,44987
177,20,1,2,1,0,0,3,205,77,59320,45534,436,306,64256,44990
178,20,0,0,2,1,2,1,98,106,59320,45534,110,66,64257,44991
179,20,0,1,1,0,0,3,138,66,59320,45535,180,102,64257,44994
180,21,4,0,0,3,1,0,215,122,59324,45535,238,168,64260,44994
181,21,1,0,0,3,1,0,82,16,59325,45535,214,222,64263,44994
182,21,2,1,0,3,1,0,306,239,59327,45536,285,136,64266,44994
183,21,1,1,2,1,2,1,229,197,59328,45537,441,218,64267,44995
184,21,2,0,0,3,1,0,238,201,59330,45537,300,88,64270,44995
185,21,0,1,1,0,0,3,250,233,59330,45538,114,109,64270,44998
186,21,1,2,1,0,0,3,206,79,59331,45540,436,309,64270,45001
187,21,0,0,2,1,2,1,98,106,59331,45540,111,67,64271,45002
188,21,0,1,1,0,0,3,138,67,59331,45541,180,105,64271,45005
189,22,4,0,0,3,1,0,219,122,59335,45541,241,168,64274,45005
190,22,1,0,0,3,1,0,83,16,59336,45541,217,222,64277,45005
191,22,2,1,0,3,1,0,308,240,59338,45542,288,136,64280,45005
192,22,1,1,2,1,2,1,230,198,59339,45543,442,219,64281,45006
193,22,2,0,0,3,1,0,240,201,59341,45543,303,88,64284,45006
194,22,0,1,1,0,0,3,250,234,59341,45544,114,112,64284,45009
195,22,1,2,1,0,0,3,207,81,59342,45546,436,312,64284,45012
196,22,0,0,2,1,2,1,98,106,59342,45546,112,68,64285,45013
197,22,0,1,1,0,0,3,138,68,59342,45547,180,108,64285,45016
198,23,4,0,0,3,1,0,223,122,59346,45547,244,168,64288,45016
199,23,1,0,0,3,1,0,84,16,59347,45547,220,222,64291,45016
200,23,2,1,0,3,1,0,310,241,59349,45548,291,136,64294,45016
201,23,1,1,2,1,2,1,231,199,59350,45549,443,220,64295,45017
202,23,2,0,0,3,1,0,242,201,59352,45549,306,88,64298,45017
203,23,0,1,1,0,0,3,250,235,59352,45550,114,115,64298,45020
204,23,1,2,1,0,0,3,208,83,59353,45552,436,315,64298,45023
205,23,0,0,2,1,2,1,98,106,59353,45552,113,69,64299,45024
206,23,0,1,1,0,0,3,138,69,59353,45553,180,111,64299,45027
207,24,4,0,0,3,1,0,227,122,59357,45553,247,168,64302,45027
208,24,1,0,0,3,1,0,85,16,59358,45553,223,222,64305,45027
209,24,2,1,0,3,1,0,312,242,59360,45554,294,136,64308,45027
210,24,1,1,2,1,2,1,232,200,59361,45555,444,221,64309,45028
211,24,2,0,0,3,1,0,244,201,59363,45555,309,88,64312,45028
212,24,0,1,1,0,0,3,250,236,59363,45556,114,118,64312,45031
213,24,1,2,1,0,0,3,209,85,59364,45558,436,318,64312,45034
214,24,0,0,2,1,2,1,98,106,59364,45558,114,70,64313,45035
215,24,0,1,1,0,0,3,138,70,59364,45559,180,114,64313,45038
216,25,4,0,0,3,1,0,231,122,59368,45559,250,168,64316,45038
217,25,1,0,0,3,1,0,86,16,59369,45559,226,222,64319,45038
218,25,2,1,0,3,1,0,314,243,59371,45560,297,136,64322,45038
219,25,1,1,2,1,2,1,233,201,59372,45561,445,222,64323,45039
220,25,2,0,0,3,1,0,246,201,59374,45561,312,88,64326,45039
221,25,0,1,1,0,0,3,250,237,59374,45562,114,121,64326,45042
222,25,1,2,1,0,0,3,210,87,59375,45564,436,321,64326,45045
223,25,0,0,2,1,2,1,98,106,59375,45564,115,71,64327,45046
224,25,0,1,1,0,0,3,138,71,59375,45565,180,117,64327,45049
225,26,4,0,0,3,1,0,235,122,59379,45565,253,168,64330,45049
226,26,1,0,0,3,1,0,87,16,59380,45565,229,222,64333,45049
227,26,2,1,0,3,1,0,316,244,59382,45566,300,136,64336,45049
228,26,1,1,2,1,2,1,234,202,59383,45567,446,223,64337,45050
229,26,2,0,0,3,1,0,248,201,59385,45567,315,88,64340,45050
230,26,0,1,1,0,0,3,250,238,59385,45568,114,124,64340,45053
231,26,1,2,1,0,0,3,211,89,59386,45570,436,324,64340,45056
232,26,0,0,2,1,2,1,98,106,59386,45570,116,72,64341,45057
233,26,0,1,1,0,0,3,138,72,59386,45571,180,120,64341,45060
234,27,4,0,0,3,1,0,239,122,59390,45571,256,168,64344,45060
235,27,1,0,0,3,1,0,88,16,59391,45571,232,222,64347,45060
236,27,2,1,0,3,1,0,318,245,59393,45572,303,136,64350,45060
237,27,1,1,2,1,2,1,235,203,59394,45573,447,224,64351,45061
238,27,2,0,0,3,1,0,250,201,59396,45573,318,88,64354,45061
239,27,0,1,1,0,0,3,250,239,59396,45574,114,127,64354,45064
240,27,1,2,1,0,0,3,212,91,59397,45576,436,327,64354,45067
241,27,0,0,2,1,2,1,98,106,59397,45576,117,73,64355,45068
242,27,0,1,1,0,0,3,138,73,59397,45577,180,123,64355,45071
243,28,4,0,0,3,1,0,243,122,59401,45577,259,168,64358,45071
244,28,1,0,0,3,1,0,89,16,59402,45577,235,222,64361,45071
245,28,2,1,0,3,1,0,320,246,59404,45578,306,136,64364,45071
246,28,1,1,2,1,2,1,236,204,59405,45579,448,225,64365,45072
247,28,2,0,0,3,1,0,252,201,59407,45579,321,88,64368,45072
248,28,0,1,1,0,0,3,250,240,59407,45580,114,130,64368,45075
249,28,1,2,1,0,0,3,213,93,59408,45582,436,330,64368,45078
250,28,0,0,2,1,2,1,98,106,59408,45582,118,74,64369,45079
251,28,0,1,1,0,0,3,138,74,59408,45583,180,126,64369,45082
252,29,4,0,0,3,1,0,247,122,59412,45583,262,168,64372,45082
253,29,1,0,0,3,1,0,90,16,59413,45583,238,222,64375,45082
254,29,2,1,0,3,1,0,322,247,59415,45584,309,136,64378,45082
255,29,1,1,2,1,2,1,237,205,59416,45585,449,226,64379,45083
256,29,2,0,0,3,1,0,254,201,59418,45585,324,88,64382,45083
257,29,0,1,1,0,0,3,250,241,59418,45586,114,133,64382,45086
258,29,1,2,1,0,0,3,214,95,59419,45588,436,333,64382,45089
259,29,0,0,2,1,2,1,98,106,59419,45588,119,75,64383,45090
260,29,0,1,1,0,0,3,138,75,59419,45589,180,129,64383,45093
261,30,4,0,0,3,1,0,251,122,59423,45589,265,168,64386,45093
262,30,1,0,0,3,1,0,91,16,59424,45589,241,222,64389,45093
263,30,2,1,0,3,1,0,324,248,59426,45590,312,136,64392,45093
264,30,1,1,2,1,2,1,238,206,59427,45591,450,227,64393,45094
265,30,2,0,0,3,1,0,256,201,59429,45591,327,88,64396,45094
266,30,0,1,1,0,0,3,250,242,59429,45592,114,136,64396,45097
267,30,1,2,1,0,0,3,215,97,59430,45594,436,336,64396,45100
268,30,0,0,2,1,2,1,98,106,59430,45594,120,76,64397,45101
269,30,0,1,1,0,0,3,138,76,59430,45595,180,132,64397,45104
270,31,4,0,0,3,1,0,255,122,59434,45595,268,168,64400,45104
271,31,1,0,0,3,1,0,92,16,59435,45595,244,222,64403,45104
272,31,2,1,0,3,1,0,326,249,59437,45596,315,136,64406,45104
273,31,1,1,2,1,2,1,239,207,59438,45597,451,228,64407,45105
274,31,2,0,0,3,1,0,258,201,59440,45597,330,88,64410,45105
275,31,0,1,1,0,0,3,250,243,59440,45598,114,139,64410,45108
276,31,1,2,1,0,0,3,216,99,59441,45600,436,339,64410,45111
277,31,0,0,2,1,2,1,98,106,59441,45600,121,77,64411,45112
278,31,0,1,1,0,0,3,138,77,59441,45601,180,135,64411,45115
279,32,4,0,0,3,1,0,259,122,59445,45601,271,168,64414,45115
280,32,1,0,0,3,1,0,93,16,59446,45601,247,222,64417,45115
281,32,2,1,0,3,1,0,328,250,59448,45602,318,136,64420,45115
282,32,1,1,2,1,2,1,240,208,59449,45603,452,229,64421,45116
283,32,2,0,0,3,1,0,260,201,59451,45603,333,88,64424,45116
284,32,0,1,1,0,0,3,250,244,59451,45604,114,142,64424,45119
285,32,1,2,1,0,0,3,217,101,59452,45606,436,342,64424,45122
286,32,0,0,2,1,2,1,98,106,59452,45606,122,78,64425,45123
287,32,0,1,1,0,0,3,138,78,59452,45607,180,138,64425,45126
288,33,4,0,0,3,1,0,263,122,59456,45607,274,168,64428,45126
289,33,1,0,0,3,1,0,94,16,59457,45607,250,222,64431,45126
290,33,2,1,0,3,1,0,330,251,59459,45608,321,136,64434,45126
291,33,1,1,2,1,2,1,241,209,59460,45609,453,230,64435,45127
292,33,2,0,0,3,1,0,262,201,59462,45609,336,88,64438,45127
293,33,0,1,1,0,0,3,250,245,59462,45610,114,145,64438,45130
294,33,1,2,1,0,0,3,218,103,59463,45612,436,345,64438,45133
295,33,0,0,2,1,2,1,98,106,59463,45612,123,79,64439,45134
296,33,0,1,1,0,0,3,138,79,59463,45613,180,141,64439,45137
297,34,4,0,0,3,1,0,267,122,59467,45613,277,168,64442,45137
298,34,1,0,0,3,1,0,95,16,59468,45613,253,222,64445,45137
299,34,2,1,0,3,1,0,332,252,59470,45614,324,136,64448,45137
300,34,1,1,2,1,2,1,242,210,59471,45615,454,231,64449,45138
301,34,2,0,0,3,1,0,264,201,59473,45615,339,88,64452,45138
302,34,0,1,1,0,0,3,250,246,59473,45616,114,148,64452,45141
303,34,1,2,1,0,0,3,219,105,59474,45618,436,348,64452,45144
304,34,0,0,2,1,2,1,98,106,59474,45618,124,80,64453,45145
305,34,0,1,1,0,0,3,138,80,59474,45619,180,144,64453,45148
0,1,3,0,0,3,1,0,223,217,59477,45619,244,175,64456,45148
1,1,0,0,2,1,2,1,250,246,59477,45619,115,139,64457,45149
2,1,3,1,0,3,1,0,98,17,59480,45620,256,0,64460,45149
3,1,3,2,0,3,1,0,3,2,59483,45622,3,144,64463,45149
4,1,3,2,0,3,1,0,101,125,59486,45624,110,136,64466,45149
5,1,2,0,0,3,1,0,68,96,59488,45624,105,0,64469,45149
6,1,2,0,0,3,1,0,100,106,59490,45624,127,168,64472,45149
7,1,0,2,1,0,0,3,219,107,59490,45626,436,83,64472,45152
8,1,2,1,0,3,1,0,334,253,59492,45627,327,109,64475,45152
9,2,3,0,0,3,1,0,226,217,59495,45627,247,175,64478,45152
10,2,0,0,2,1,2,1,250,246,59495,45627,116,140,64479,45153
11,2,3,1,0,3,1,0,101,18,59498,45628,259,0,64482,45153
12,2,3,2,0,3,1,0,6,4,59501,45630,6,144,64485,45153
13,2,3,2,0,3,1,0,104,127,59504,45632,113,136,64488,45153
14,2,2,0,0,3,1,0,70,96,59506,45632,108,0,64491,45153
15,2,2,0,0,3,1,0,102,106,59508,45632,130,168,64494,45153
16,2,0,2,1,0,0,3,219,109,59508,45634,436,86,64494,45156
17,2,2,1,0,3,1,0,336,254,59510,45635,330,109,64497,45156
18,3,3,0,0,3,1,0,229,217,59513,45635,250,175,64500,45156
19,3,0,0,2,1,2,1,250,246,59513,45635,117,141,64501,45157
20,3,3,1,0,3,1,0,104,19,59516,45636,262,0,64504,45157
21,3,3,2,0,3,1,0,9,6,59519,45638,9,144,64507,45157
22,3,3,2,0,3,1,0,107,129,59522,45640,116,136,64510,45157
23,3,2,0,0,3,1,0,72,96,59524,45640,111,0,64513,45157
24,3,2,0,0,3,1,0,104,106,59526,45640,133,168,64516,45157
25,3,0,2,1,0,0,3,219,111,59526,45642,436,89,64516,45160
26,3,2,1,0,3,1,0,338,255,59528,45643,333,109,64519,45160
27,4,3,0,0,3,1,0,232,217,59531,45643,253,175,64522,45160
28,4,0,0,2,1,2,1,250,246,59531,45643,118,142,64523,45161
29,4,3,1,0,3,1,0,107,20,59534,45644,265,0,64526,45161
30,4,3,2,0,3,1,0,12,8,59537,45646,12,144,64529,45161
31,4,3,2,0,3,1,0,110,131,59540,45648,119,136,64532,45161
32,4,2,0,0,3,1,0,74,96,59542,45648,114,0,64535,45161
33,4,2,0,0,3,1,0,106,106,59544,45648,136,168,64538,45161
34,4,0,2,1,0,0,3,219,113,59544,45650,436,92,64538,45164
35,4,2,1,0,3,1,0,340,256,59546,45651,336,109,64541,45164
36,5,3,0,0,3,1,0,235,217,59549,45651,256,175,64544,45164
37,5,0,0,2,1,2,1,250,246,59549,45651,119,143,64545,45165
38,5,3,1,0,3,1,0,110,21,59552,45652,268,0,64548,45165
39,5,3,2,0,3,1,0,15,10,59555,45654,15,144,64551,45165
40,5,3,2,0,3,1,0,113,133,59558,45656,122,136,64554,45165
41,5,2,0,0,3,1,0,76,96,59560,45656,117,0,64557,45165
42,5,2,0,0,3,1,0,108,106,59562,45656,139,168,64560,45165
43,5,0,2,1,0,0,3,219,115,59562,45658,436,95,64560,45168
44,5,2,1,0,3,1,0,342,257,59564,45659,339,109,64563,45168
45,6,3,0,0,3,1,0,238,217,59567,45659,259,175,64566,45168
46,6,0,0,2,1,2,1,250,246,59567,45659,120,144,64567,45169
47,6,3,1,0,3,1,0,113,22,59570,45660,271,0,64570,45169
48,6,3,2,0,3,1,0,18,12,59573,45662,18,144,64573,45169
49,6,3,2,0,3,1,0,116,135,59576,45664,125,136,64576,45169
50,6,2,0,0,3,1,0,78,96,59578,45664,120,0,64579,45169
51,6,2,0,0,3,1,0,110,106,59580,45664,142,168,64582,45169
52,6,0,2,1,0,0,3,219,117,59580,45666,436,98,64582,45172
53,6,2,1,0,3,1,0,344,258,59582,45667,342,109,64585,45172
54,7,3,0,0,3,1,0,241,217,59585,45667,262,175,64588,45172
55,7,0,0,2,1,2,1,250,246,59585,45667,121,145,64589,45173
56,7,3,1,0,3,1,0,116,23,59588,45668,274,0,64592,45173
57,7,3,2,0,3,1,0,21,14,59591,45670,21,144,64595,45173
58,7,3,2,0,3,1,0,119,137,59594,45672,128,136,64598,45173
59,7,2,0,0,3,1,0,80,96,59596,45672,123,0,64601,45173
60,7,2,0,0,3,1,0,112,106,59598,45672,145,168,64604,45173
61,7,0,2,1,0,0,3,219,119,59598,45674,436,101,64604,45176
62,7,2,1,0,3,1,0,346,259,59600,45675,345,109,64607,45176
63,8,3,0,0,3,1,0,244,217,59603,45675,265,175,64610,45176
64,8,0,0,2,1,2,1,250,246,59603,45675,122,146,64611,45177
65,8,3,1,0,3,1,0,119,24,59606,45676,277,0,64614,45177
66,8,3,2,0,3,1,0,24,16,59609,45678,24,144,64617,45177
67,8,3,2,0,3,1,0,122,139,59612,45680,131,136,64620,45177
68,8,2,0,0,3,1,0,82,96,59614,45680,126,0,64623,45177
69,8,2,0,0,3,1,0,114,106,59616,45680,148,168,64626,45177
70,8,0,2,1,0,0,3,219,121,59616,45682,436,104,64626,45180
71,8,2,1,0,3,1,0,348,260,59618,45683,348,109,64629,45180
72,9,3,0,0,3,1,0,247,217,59621,45683,268,175,64632,45180
73,9,0,0,2,1,2,1,250,246,59621,45683,123,147,64633,45181
74,9,3,1,0,3,1,0,122,25,59624,45684,280,0,64636,45181
75,9,3,2,0,3,1,0,27,18,59627,45686,27,144,64639,45181
76,9,3,2,0,3,1,0,125,141,59630,45688,134,136,64642,45181
77,9,2,0,0,3,1,0,84,96,59632,45688,129,0,64645,45181
78,9,2,0,0,3,1,0,116,106,59634,45688,151,168,64648,45181
79,9,0,2,1,0,0,3,219,123,59634,45690,436,107,64648,45184
80,9,2,1,0,3,1,0,350,261,59636,45691,351,109,64651,45184
81,10,3,0,0,3,1,0,250,217,59639,45691,271,175,64654,45184
82,10,0,0,2,1,2,1,250,246,59639,45691,124,148,64655,45185
83,10,3,1,0,3,1,0,125,26,59642,45692,283,0,64658,45185
84,10,3,2,0,3,1,0,30,20,59645,45694,30,144,64661,45185
85,10,3,2,0,3,1,0,128,143,59648,45696,137,136,64664,45185
86,10,2,0,0,3,1,0,86,96,59650,45696,132,0,64667,45185
87,10,2,0,0,3,1,0,118,106,59652,45696,154,168,64670,45185
88,10,0,2,1,0,0,3,219,125,59652,45698,436,110,64670,45188
89,10,2,1,0,3,1,0,352,262,59654,45699,354,109,64673,45188
90,11,3,0,0,3,1,0,253,217,59657,45699,274,175,64676,45188
91,11,0,0,2,1,2,1,250,246,59657,45699,125,149,64677,45189
92,11,3,1,0,3,1,0,128,27,59660,45700,286,0,64680,45189
93,11,3,2,0,3,1,0,33,22,59663,45702,33,144,64683,45189
94,11,3,2,0,3,1,0,131,145,59666,45704,140,136,64686,45189
95,11,2,0,0,3,1,0,88,96,59668,45704,135,0,64689,45189
96,11,2,0,0,3,1,0,120,106,59670,45704,157,168,64692,45189
97,11,0,2,1,0,0,3,219,127,59670,45706,436,113,64692,45192
98,11,2,1,0,3,1,0,354,263,59672,45707,357,109,64695,45192
99,12,3,0,0,3,1,0,256,217,59675,45707,277,175,64698,45192
100,12,0,0,2,1,2,1,250,246,59675,45707,126,150,64699,45193
101,12,3,1,0,3,1,0,131,28,59678,45708,289,0,64702,45193
102,12,3,2,0,3,1,0,36,24,59681,45710,36,144,64705,45193
103,12,3,2,0,3,1,0,134,147,59684,45712,143,136,64708,45193
104,12,2,0,0,3,1,0,90,96,59686,45712,138,0,64711,45193
105,12,2,0,0,3,1,0,122,106,59688,45712,160,168,64714,45193
106,12,0,2,1,0,0,3,219,129,59688,45714,436,116,64714,45196
107,12,2,1,0,3,1,0,356,264,59690,45715,360,109,64717,45196
108,13,3,0,0,3,1,0,259,217,59693,45715,280,175,64720,45196
109,13,0,0,2,1,2,1,250,246,59693,45715,127,151,64721,45197
110,13,3,1,0,3,1,0,134,29,59696,45716,292,0,64724,45197
111,13,3,2,0,3,1,0,39,26,59699,45718,39,144,64727,45197
112,13,3,2,0,3,1,0,137,149,59702,45720,146,136,64730,45197
113,13,2,0,0,3,1,0,92,96,59704,45720,141,0,64733,45197
114,13,2,0,0,3,1,0,124,106,59706,45720,163,168,64736,45197
115,13,0,2,1,0,0,3,219,131,59706,45722,436,119,64736,45200
116,13,2,1,0,3,1,0,358,265,59708,45723,363,109,64739,45200
117,14,3,0,0,3,1,0,262,217,59711,45723,283,175,64742,45200
118,14,0,0,2,1,2,1,250,246,59711,45723,128,152,64743,45201
119,14,3,1,0,3,1,0,137,30,59714,45724,295,0,64746,45201
120,14,3,2,0,3,1,0,42,28,59717,45726,42,144,64749,45201
121,14,3,2,0,3,1,0,140,151,59720,45728,149,136,64752,45201
122,14,2,0,0,3,1,0,94,96,59722,45728,144,0,64755,45201
123,14,2,0,0,3,1,0,126,106,59724,45728,166,168,64758,45201
124,14,0,2,1,0,0,3,219,133,59724,45730,436,122,64758,45204
125,14,2,1,0,3,1,0,360,266,59726,45731,366,109,64761,45204
126,15,3,0,0,3,1,0,265,217,59729,45731,286,175,64764,45204
127,15,0,0,2,1,2,1,250,246,59729,45731,129,153,64765,45205
128,15,3,1,0,3,1,0,140,31,59732,45732,298,0,64768,45205
129,15,3,2,0,3,1,0,45,30,59735,45734,45,144,64771,45205
130,15,3,2,0,3,1,0,143,153,59738,45736,152,136,64774,45205
131,15,2,0,0,3,1,0,96,96,59740,45736,147,0,64777,45205
132,15,2,0,0,3,1,0,128,106,59742,45736,169,168,64780,45205
133,15,0,2,1,0,0,3,219,135,59742,45738,436,125,64780,45208
134,15,2,1,0,3,1,0,362,267,59744,45739,369,109,64783,45208
135,16,3,0,0,3,1,0,268,217,59747,45739,289,175,64786,45208
136,16,0,0,2,1,2,1,250,246,59747,45739,130,154,64787,45209
137,16,3,1,0,3,1,0,143,32,59750,45740,301,0,64790,45209
138,16,3,2,0,3,1,0,48,32,59753,45742,48,144,64793,45209
139,16,3,2,0,3,1,0,146,155,59756,45744,155,136,64796,45209
140,16,2,0,0,3,1,0,98,96,59758,45744,150,0,64799,45209
141,16,2,0,0,3,1,0,130,106,59760,45744,172,168,64802,45209
142,16,0,2,1,0,0,3,219,137,59760,45746,436,128,64802,45212
143,16,2,1,0,3,1,0,364,268,59762,45747,372,109,64805,45212
144,17,3,0,0,3,1,0,271,217,59765,45747,292,175,64808,45212
145,17,0,0,2,1,2,1,250,246,59765,45747,131,155,64809,45213
146,17,3,1,0,3,1,0,146,33,59768,45748,304,0,64812,45213
147,17,3,2,0,3,1,0,51,34,59771,45750,51,144,64815,45213
148,17,3,2,0,3,1,0,149,157,59774,45752,158,136,64818,45213
149,17,2,0,0,3,1,0,100,96,59776,45752,153,0,64821,45213
150,17,2,0,0,3,1,0,132,106,59778,45752,175,168,64824,45213
151,17,0,2,1,0,0,3,219,139,59778,45754,436,131,64824,45216
152,17,2,1,0,3,1,0,366,269,59780,45755,375,109,64827,45216
153,18,3,0,0,3,1,0,274,217,59783,45755,295,175,64830,45216
154,18,0,0,2,1,2,1,250,246,59783,45755,132,156,64831,45217
155,18,3,1,0,3,1,0,149,34,59786,45756,307,0,64834,45217
156,18,3,2,0,3,1,0,54,36,59789,45758,54,144,64837,45217
157,18,3,2,0,3,1,0,152,159,59792,45760,161,136,64840,45217
158,18,2,0,0,3,1,0,102,96,59794,45760,156,0,64843,45217
159,18,2,0,0,3,1,0,134,106,59796,45760,178,168,64846,45217
160,18,0,2,1,0,0,3,219,141,59796,45762,436,134,64846,45220
161,18,2,1,0,3,1,0,368,270,59798,45763,378,109,64849,45220
162,19,3,0,0,3,1,0,277,217,59801,45763,298,175,64852,45220
163,19,0,0,2,1,2,1,250,246,59801,45763,133,157,64853,45221
164,19,3,1,0,3,1,0,152,35,59804,45764,310,0,64856,45221
165,19,3,2,0,3,1,0,57,38,59807,45766,57,144,64859,45221
166,19,3,2,0,3,1,0,155,161,59810,45768,164,136,64862,45221
167,19,2,0,0,3,1,0,104,96,59812,45768,159,0,64865,45221
168,19,2,0,0,3,1,0,136,106,59814,45768,181,168,64868,45221
169,19,0,2,1,0,0,3,219,143,59814,45770,436,137,64868,45224
170,19,2,1,0,3,1,0,370,271,59816,45771,381,109,64871,45224
171,20,3,0,0,3,1,0,280,217,59819,45771,301,175,64874,45224
172,20,0,0,2,1,2,1,250,246,59819,45771,134,158,64875,45225
173,20,3,1,0,3,1,0,155,36,59822,45772,313,0,64878,45225
174,20,3,2,0,3,1,0,60,40,59825,45774,60,144,64881,45225
175,20,3,2,0,3,1,0,158,163,59828,45776,167,136,64884,45225
176,20,2,0,0,3,1,0,106,96,59830,45776,162,0,64887,45225
177,20,2,0,0,3,1,0,138,106,59832,45776,184,168,64890,45225
178,20,0,2,1,0,0,3,219,145,59832,45778,436,140,64890,45228
179,20,2,1,0,3,1,0,372,272,59834,45779,384,109,64893,45228
180,21,3,0,0,3,1,0,283,217,59837,45779,304,175,64896,45228
181,21,0,0,2,1,2,1,250,246,59837,45779,135,159,64897,45229
182,21,3,1,0,3,1,0,158,37,59840,45780,316,0,64900,45229
183,21,3,2,0,3,1,0,63,42,59843,45782,63,144,64903,45229
184,21,3,2,0,3,1,0,161,165,59846,45784,170,136,64906,45229
185,21,2,0,0,3,1,0,108,96,59848,45784,165,0,64909,45229
186,21,2,0,0,3,1,0,140,106,59850,45784,187,168,64912,45229
187,21,0,2,1,0,0,3,219,147,59850,45786,436,143,64912,45232
188,21,2,1,0,3,1,0,374,273,59852,45787,387,109,64915,45232
189,22,3,0,0,3,1,0,286,217,59855,45787,307,175,64918,45232
190,22,0,0,2,1,2,1,250,246,59855,45787,136,160,64919,45233
191,22,3,1,0,3,1,0,161,38,59858,45788,319,0,64922,45233
192,22,3,2,0,3,1,0,66,44,59861,45790,66,144,64925,45233
193,22,3,2,0,3,1,0,164,167,59864,45792,173,136,64928,45233
194,22,2,0,0,3,1,0,110,96,59866,45792,168,0,64931,45233
195,22,2,0,0,3,1,0,142,106,59868,45792,190,168,64934,45233
196,22,0,2,1,0,0,3,219,149,59868,45794,436,146,64934,45236
197,22,2,1,0,3,1,0,376,274,59870,45795,390,109,64937,45236
198,23,3,0,0,3,1,0,289,217,59873,45795,310,175,64940,45236
199,23,0,0,2,1,2,1,250,246,59873,45795,137,161,64941,45237
200,23,3,1,0,3,1,0,164,39,59876,45796,322,0,64944,45237
201,23,3,2,0,3,1,0,69,46,59879,45798,69,144,64947,45237
202,23,3,2,0,3,1,0,167,169,59882,45800,176,136,64950,45237
203,23,2,0,0,3,1,0,112,96,59884,45800,171,0,64953,45237
204,23,2,0,0,3,1,0,144,106,59886,45800,193,168,64956,45237
205,23,0,2,1,0,0,3,219,151,59886,45802,436,149,64956,45240
206,23,2,1,0,3,1,0,378,275,59888,45803,393,109,64959,45240
207,24,3,0,0,3,1,0,292,217,59891,45803,313,175,64962,45240
208,24,0,0,2,1,2,1,250,246,59891,45803,138,162,64963,45241
209,24,3,1,0,3,1,0,167,40,59894,45804,325,0,64966,45241
210,24,3,2,0,3,1,0,72,48,59897,45806,72,144,64969,45241
211,24,3,2,0,3,1,0,170,171,59900,45808,179,136,64972,45241
212,24,2,0,0,3,1,0,114,96,59902,45808,174,0,64975,45241
213,24,2,0,0,3,1,0,146,106,59904,45808,196,168,64978,45241
214,24,0,2,1,0,0,3,219,153,59904,45810,436,152,64978,45244
215,24,2,1,0,3,1,0,380,276,59906,45811,396,109,64981,45244
0,1,1,0,0,3,1,0,268,122,59907,45811,280,348,64984,45244
1,1,2,1,0,3,1,0,2,1,59909,45812,3,162,64987,45244
2,1,0,4,1,0,0,3,38,80,59909,45816,0,151,64987,45247
3,1,2,2,2,1,2,1,170,2,59911,45818,295,1,64988,45248
4,1,3,2,0,3,1,0,383,278,59914,45820,399,0,64991,45248
5,1,1,0,0,3,1,0,251,246,59915,45820,141,168,64994,45248
6,1,1,0,0,3,1,0,220,153,59916,45820,439,256,64997,45248
7,1,0,0,2,1,2,1,122,80,59916,45820,253,232,64998,45249
8,1,0,4,1,0,0,3,114,100,59916,45824,174,178,64998,45252
9,2,1,0,0,3,1,0,269,122,59917,45824,283,348,65001,45252
10,2,2,1,0,3,1,0,4,2,59919,45825,6,162,65004,45252
11,2,0,4,1,0,0,3,38,84,59919,45829,0,154,65004,45255
12,2,2,2,2,1,2,1,172,4,59921,45831,296,2,65005,45256
13,2,3,2,0,3,1,0,386,280,59924,45833,402,0,65008,45256
14,2,1,0,0,3,1,0,252,246,59925,45833,144,168,65011,45256
15,2,1,0,0,3,1,0,221,153,59926,45833,442,256,65014,45256
16,2,0,0,2,1,2,1,122,80,59926,45833,254,233,65015,45257
17,2,0,4,1,0,0,3,114,104,59926,45837,174,181,65015,45260
18,3,1,0,0,3,1,0,270,122,59927,45837,286,348,65018,45260
19,3,2,1,0,3,1,0,6,3,59929,45838,9,162,65021,45260
20,3,0,4,1,0,0,3,38,88,59929,45842,0,157,65021,45263
21,3,2,2,2,1,2,1,174,6,59931,45844,297,3,65022,45264
22,3,3,2,0,3,1,0,389,282,59934,45846,405,0,65025,45264
23,3,1,0,0,3,1,0,253,246,59935,45846,147,168,65028,45264
24,3,1,0,0,3,1,0,222,153,59936,45846,445,256,65031,45264
25,3,0,0,2,1,2,1,122,80,59936,45846,255,234,65032,45265
26,3,0,4,1,0,0,3,114,108,59936,45850,174,184,65032,45268
27,4,1,0,0,3,1,0,271,122,59937,45850,289,348,65035,45268
28,4,2,1,0,3,1,0,8,4,59939,45851,12,162,65038,45268
29,4,0,4,1,0,0,3,38,92,59939,45855,0,160,65038,45271
30,4,2,2,2,1,2,1,176,8,59941,45857,298,4,65039,45272
31,4,3,2,0,3,1,0,392,284,59944,45859,408,0,65042,45272
32,4,1,0,0,3,1,0,254,246,59945,45859,150,168,65045,45272
33,4,1,0,0,3,1,0,223,153,59946,45859,448,256,65048,45272
34,4,0,0,2,1,2,1,122,80,59946,45859,256,235,65049,45273
35,4,0,4,1,0,0,3,114,112,59946,45863,174,187,65049,45276
36,5,1,0,0,3,1,0,272,122,59947,45863,292,348,65052,45276
37,5,2,1,0,3,1,0,10,5,59949,45864,15,162,65055,45276
38,5,0,4,1,0,0,3,38,96,59949,45868,0,163,65055,45279
39,5,2,2,2,1,2,1,178,10,59951,45870,299,5,65056,45280
40,5,3,2,0,3,1,0,395,286,59954,45872,411,0,65059,45280
41,5,1,0,0,3,1,0,255,246,59955,45872,153,168,65062,45280
42,5,1,0,0,3,1,0,224,153,59956,45872,451,256,65065,45280
43,5,0,0,2,1,2,1,122,80,59956,45872,257,236,65066,45281
44,5,0,4,1,0,0,3,114,116,59956,45876,174,190,65066,45284
45,6,1,0,0,3,1,0,273,122,59957,45876,295,348,65069,45284
46,6,2,1,0,3,1,0,12,6,59959,45877,18,162,65072,45284
47,6,0,4,1,0,0,3,38,100,59959,45881,0,166,65072,45287
48,6,2,2,2,1,2,1,180,12,59961,45883,300,6,65073,45288
49,6,3,2,0,3,1,0,398,288,59964,45885,414,0,65076,45288
50,6,1,0,0,3,1,0,256,246,59965,45885,156,168,65079,45288
51,6,1,0,0,3,1,0,225,153,59966,45885,454,256,65082,45288
52,6,0,0,2,1,2,1,122,80,59966,45885,258,237,65083,45289
53,6,0,4,1,0,0,3,114,120,59966,45889,174,193,65083,45292
54,7,1,0,0,3,1,0,274,122,59967,45889,298,348,65086,45292
55,7,2,1,0,3,1,0,14,7,59969,45890,21,162,65089,45292
56,7,0,4,1,0,0,3,38,104,59969,45894,0,169,65089,45295
57,7,2,2,2,1,2,1,182,14,59971,45896,301,7,65090,45296
58,7,3,2,0,3,1,0,401,290,59974,45898,417,0,65093,45296
59,7,1,0,0,3,1,0,257,246,59975,45898,159,168,65096,45296
60,7,1,0,0,3,1,0,226,153,59976,45898,457,256,65099,45296
61,7,0,0,2,1,2,1,122,80,59976,45898,259,238,65100,45297
62,7,0,4,1,0,0,3,114,124,59976,45902,174,196,65100,45300
63,8,1,0,0,3,1,0,275,122,59977,45902,301,348,65103,45300
64,8,2,1,0,3,1,0,16,8,59979,45903,24,162,65106,45300
65,8,0,4,1,0,0,3,38,108,59979,45907,0,172,65106,45303
66,8,2,2,2,1,2,1,184,16,59981,45909,302,8,65107,45304
67,8,3,2,0,3,1,0,404,292,59984,45911,420,0,65110,45304
68,8,1,0,0,3,1,0,258,246,59985,45911,162,168,65113,45304
69,8,1,0,0,3,1,0,227,153,59986,45911,460,256,65116,45304
70,8,0,0,2,1,2,1,122,80,59986,45911,260,239,65117,45305
71,8,0,4,1,0,0,3,114,128,59986,45915,174,199,65117,45308
72,9,1,0,0,3,1,0,276,122,59987,45915,304,348,65120,45308
73,9,2,1,0,3,1,0,18,9,59989,45916,27,162,65123,45308
74,9,0,4,1,0,0,3,38,112,59989,45920,0,175,65123,45311
75,9,2,2,2,1,2,1,186,18,59991,45922,303,9,65124,45312
76,9,3,2,0,3,1,0,407,294,59994,45924,423,0,65127,45312
77,9,1,0,0,3,1,0,259,246,59995,45924,165,168,65130,45312
78,9,1,0,0,3,1,0,228,153,59996,45924,463,256,65133,45312
79,9,0,0,2,1,2,1,122,80,59996,45924,261,240,65134,45313
80,9,0,4,1,0,0,3,114,132,59996,45928,174,202,65134,45316
81,10,1,0,0,3,1,0,277,122,59997,45928,307,348,65137,45316
82,10,2,1,0,3,1,0,20,10,59999,45929,30,162,65140,45316
83,10,0,4,1,0,0,3,38,116,59999,45933,0,178,65140,45319
84,10,2,2,2,1,2,1,188,20,60001,45935,304,10,65141,45320
85,10,3,2,0,3,1,0,410,296,60004,45937,426,0,65144,45320
86,10,1,0,0,3,1,0,260,246,60005,45937,168,168,65147,45320
87,10,1,0,0,3,1,0,229,153,60006,45937,466,256,65150,45320
88,10,0,0,2,1,2,1,122,80,60006,45937,262,241,65151,45321
89,10,0,4,1,0,0,3,114,136,60006,45941,174,205,65151,45324
90,11,1,0,0,3,1,0,278,122,60007,45941,310,348,65154,45324
91,11,2,1,0,3,1,0,22,11,60009,45942,33,162,65157,45324
92,11,0,4,1,0,0,3,38,120,60009,45946,0,181,65157,45327
93,11,2,2,2,1,2,1,190,22,60011,45948,305,11,65158,45328
94,11,3,2,0,3,1,0,413,298,60014,45950,429,0,65161,45328
95,11,1,0,0,3,1,0,261,246,60015,45950,171,168,65164,45328
96,11,1,0,0,3,1,0,230,153,60016,45950,469,256,65167,45328
97,11,0,0,2,1,2,1,122,80,60016,45950,263,242,65168,45329
98,11,0,4,1,0,0,3,114,140,60016,45954,174,208,65168,45332
99,12,1,0,0,3,1,0,279,122,60017,45954,313,348,65171,45332
100,12,2,1,0,3,1,0,24,12,60019,45955,36,162,65174,45332
101,12,0,4,1,0,0,3,38,124,60019,45959,0,184,65174,45335
102,12,2,2,2,1,2,1,192,24,60021,45961,306,12,65175,45336
103,12,3,2,0,3,1,0,416,300,60024,45963,432,0,65178,45336
104,12,1,0,0,3,1,0,262,246,60025,45963,174,168,65181,45336
105,12,1,0,0,3,1,0,231,153,60026,45963,472,256,65184,45336
106,12,0,0,2,1,2,1,122,80,60026,45963,264,243,65185,45337
107,12,0,4,1,0,0,3,114,144,60026,45967,174,211,65185,45340
108,13,1,0,0,3,1,0,280,122,60027,45967,316,348,65188,45340
109,13,2,1,0,3,1,0,26,13,60029,45968,39,162,65191,45340
110,13,0,4,1,0,0,3,38,128,60029,45972,0,187,65191,45343
111,13,2,2,2,1,2,1,194,26,60031,45974,307,13,65192,45344
112,13,3,2,0,3,1,0,419,302,60034,45976,435,0,65195,45344
113,13,1,0,0,3,1,0,263,246,60035,45976,177,168,65198,45344
114,13,1,0,0,3,1,0,232,153,60036,45976,475,256,65201,45344
115,13,0,0,2,1,2,1,122,80,60036,45976,265,244,65202,45345
116,13,0,4,1,0,0,3,114,148,60036,45980,174,214,65202,45348
117,14,1,0,0,3,1,0,281,122,60037,45980,319,348,65205,45348
118,14,2,1,0,3,1,0,28,14,60039,45981,42,162,65208,45348
119,14,0,4,1,0,0,3,38,132,60039,45985,0,190,65208,45351
120,14,2,2,2,1,2,1,196,28,60041,45987,308,14,65209,45352
121,14,3,2,0,3,1,0,422,304,60044,45989,438,0,65212,45352
122,14,1,0,0,3,1,0,264,246,60045,45989,180,168,65215,45352
123,14,1,0,0,3,1,0,233,153,60046,45989,478,256,65218,45352
124,14,0,0,2,1,2,1,122,80,60046,45989,266,245,65219,45353
125,14,0,4,1,0,0,3,114,152,60046,45993,174,217,65219,45356
126,15,1,0,0,3,1,0,282,122,60047,45993,322,348,65222,45356
127,15,2,1,0,3,1,0,30,15,60049,45994,45,162,65225,45356
128,15,0,4,1,0,0,3,38,136,60049,45998,0,193,65225,45359
129,15,2,2,2,1,2,1,198,30,60051,46000,309,15,65226,45360
130,15,3,2,0,3,1,0,425,306,60054,46002,441,0,65229,45360
131,15,1,0,0,3,1,0,265,246,60055,46002,183,168,65232,45360
132,15,1,0,0,3,1,0,234,153,60056,46002,481,256,65235,45360
133,15,0,0,2,1,2,1,122,80,60056,46002,267,246,65236,45361
134,15,0,4,1,0,0,3,114,156,60056,46006,174,220,65236,45364
135,16,1,0,0,3,1,0,283,122,60057,46006,325,348,65239,45364
136,16,2,1,0,3,1,0,32,16,60059,46007,48,162,65242,45364
137,16,0,4,1,0,0,3,38,140,60059,46011,0,196,65242,45367
138,16,2,2,2,1,2,1,200,32,60061,46013,310,16,65243,45368
139,16,3,2,0,3,1,0,428,308,60064,46015,444,0,65246,45368
140,16,1,0,0,3,1,0,266,246,60065,46015,186,168,65249,45368
141,16,1,0,0,3,1,0,235,153,60066,46015,484,256,65252,45368
142,16,0,0,2,1,2,1,122,80,60066,46015,268,247,65253,45369
143,16,0,4,1,0,0,3,114,160,60066,46019,174,223,65253,45372
144,17,1,0,0,3,1,0,284,122,60067,46019,328,348,65256,45372
145,17,2,1,0,3,1,0,34,17,60069,46020,51,162,65259,45372
146,17,0,4,1,0,0,3,38,144,60069,46024,0,199,65259,45375
147,17,2,2,2,1,2,1,202,34,60071,46026,311,17,65260,45376
148,17,3,2,0,3,1,0,431,310,60074,46028,447,0,65263,45376
149,17,1,0,0,3,1,0,267,246,60075,46028,189,168,65266,45376
150,17,1,0,0,3,1,0,236,153,60076,46028,487,256,65269,45376
151,17,0,0,2,1,2,1,122,80,60076,46028,269,248,65270,45377
152,17,0,4,1,0,0,3,114,164,60076,46032,174,226,65270,45380
153,18,1,0,0,3,1,0,285,122,60077,46032,331,348,65273,45380
154,18,2,1,0,3,1,0,36,18,60079,46033,54,162,65276,45380
155,18,0,4,1,0,0,3,38,148,60079,46037,0,202,65276,45383
156,18,2,2,2,1,2,1,204,36,60081,46039,312,18,65277,45384
157,18,3,2,0,3,1,0,434,312,60084,46041,450,0,65280,45384
158,18,1,0,0,3,1,0,268,246,60085,46041,192,168,65283,45384
159,18,1,0,0,3,1,0,237,153,60086,46041,490,256,65286,45384
160,18,0,0,2,1,2,1,122,80,60086,46041,270,249,65287,45385
161,18,0,4,1,0,0,3,114,168,60086,46045,174,229,65287,45388
162,19,1,0,0,3,1,0,286,122,60087,46045,334,348,65290,45388
163,19,2,1,0,3,1,0,38,19,60089,46046,57,162,65293,45388
164,19,0,4,1,0,0,3,38,152,60089,46050,0,205,65293,45391
165,19,2,2,2,1,2,1,206,38,60091,46052,313,19,65294,45392
166,19,3,2,0,3,1,0,437,314,60094,46054,453,0,65297,45392
167,19,1,0,0,3,1,0,269,246,60095,46054,195,168,65300,45392
168,19,1,0,0,3,1,0,238,153,60096,46054,493,256,65303,45392
169,19,0,0,2,1,2,1,122,80,60096,46054,271,250,65304,45393
170,19,0,4,1,0,0,3,114,172,60096,46058,174,232,65304,45396
171,20,1,0,0,3,1,0,287,122,60097,46058,337,348,65307,45396
172,20,2,1,0,3,1,0,40,20,60099,46059,60,162,65310,45396
173,20,0,4,1,0,0,3,38,156,60099,46063,0,208,65310,45399
174,20,2,2,2,1,2,1,208,40,60101,46065,314,20,65311,45400
175,20,3,2,0,3,1,0,440,316,60104,46067,456,0,65314,45400
176,20,1,0,0,3,1,0,270,246,60105,46067,198,168,65317,45400
177,20,1,0,0,3,1,0,239,153,60106,46067,496,256,65320,45400
178,20,0,0,2,1,2,1,122,80,60106,46067,272,251,65321,45401
179,20,0,4,1,0,0,3,114,176,60106,46071,174,235,65321,45404
180,21,1,0,0,3,1,0,288,122,60107,46071,340,348,65324,45404
181,21,2,1,0,3,1,0,42,21,60109,46072,63,162,65327,45404
182,21,0,4,1,0,0,3,38,160,60109,46076,0,211,65327,45407
183,21,2,2,2,1,2,1,210,42,60111,46078,315,21,65328,45408
184,21,3,2,0,3,1,0,443,318,60114,46080,459,0,65331,45408
185,21,1,0,0,3,1,0,271,246,60115,46080,201,168,65334,45408
186,21,1,0,0,3,1,0,240,153,60116,46080,499,256,65337,45408
187,21,0,0,2,1,2,1,122,80,60116,46080,273,252,65338,45409
188,21,0,4,1,0,0,3,114,180,60116,46084,174,238,65338,45412
189,22,1,0,0,3,1,0,289,122,60117,46084,343,348,65341,45412
190,22,2,1,0,3,1,0,44,22,60119,46085,66,162,65344,45412
191,22,0,4,1,0,0,3,38,164,60119,46089,0,214,65344,45415
192,22,2,2,2,1,2,1,212,44,60121,46091,316,22,65345,45416
193,22,3,2,0,3,1,0,446,320,60124,46093,462,0,65348,45416
194,22,1,0,0,3,1,0,272,246,60125,46093,204,168,65351,45416
195,22,1,0,0,3,1,0,241,153,60126,46093,502,256,65354,45416
196,22,0,0,2,1,2,1,122,80,60126,46093,274,253,65355,45417
197,22,0,4,1,0,0,3,114,184,60126,46097,174,241,65355,45420
198,23,1,0,0,3,1,0,290,122,60127,46097,346,348,65358,45420
199,23,2,1,0,3,1,0,46,23,60129,46098,69,162,65361,45420
200,23,0,4,1,0,0,3,38,168,60129,46102,0,217,65361,45423
201,23,2,2,2,1,2,1,214,46,60131,46104,317,23,65362,45424
202,23,3,2,0,3,1,0,449,322,60134,46106,465,0,65365,45424
203,23,1,0,0,3,1,0,273,246,60135,46106,207,168,65368,45424
204,23,1,0,0,3,1,0,242,153,60136,46106,505,256,65371,45424
205,23,0,0,2,1,2,1,122,80,60136,46106,275,254,65372,45425
206,23,0,4,1,0,0,3,114,188,60136,46110,174,244,65372,45428
207,24,1,0,0,3,1,0,291,122,60137,46110,349,348,65375,45428
208,24,2,1,0,3,1,0,48,24,60139,46111,72,162,65378,45428
209,24,0,4,1,0,0,3,38,172,60139,46115,0,220,65378,45431
210,24,2,2,2,1,2,1,216,48,60141,46117,318,24,65379,45432
211,24,3,2,0,3,1,0,452,324,60144,46119,468,0,65382,45432
212,24,1,0,0,3,1,0,274,246,60145,46119,210,168,65385,45432
213,24,1,0,0,3,1,0,243,153,60146,46119,508,256,65388,45432
214,24,0,0,2,1,2,1,122,80,60146,46119,276,255,65389,45433
215,24,0,4,1,0,0,3,114,192,60146,46123,174,247,65389,45436
216,25,1,0,0,3,1,0,292,122,60147,46123,352,348,65392,45436
217,25,2,1,0,3,1,0,50,25,60149,46124,75,162,65395,45436
218,25,0,4,1,0,0,3,38,176,60149,46128,0,223,65395,45439
219,25,2,2,2,1,2,1,218,50,60151,46130,319,25,65396,45440
220,25,3,2,0,3,1,0,455,326,60154,46132,471,0,65399,45440
221,25,1,0,0,3,1,0,275,246,60155,46132,213,168,65402,45440
222,25,1,0,0,3,1,0,244,153,60156,46132,511,256,65405,45440
223,25,0,0,2,1,2,1,122,80,60156,46132,277,256,65406,45441
224,25,0,4,1,0,0,3,114,196,60156,46136,174,250,65406,45444
225,26,1,0,0,3,1,0,293,122,60157,46136,355,348,65409,45444
226,26,2,1,0,3,1,0,52,26,60159,46137,78,162,65412,45444
227,26,0,4,1,0,0,3,38,180,60159,46141,0,226,65412,45447
228,26,2,2,2,1,2,1,220,52,60161,46143,320,26,65413,45448
229,26,3,2,0,3,1,0,458,328,60164,46145,474,0,65416,45448
230,26,1,0,0,3,1,0,276,246,60165,46145,216,168,65419,45448
231,26,1,0,0,3,1,0,245,153,60166,46145,514,256,65422,45448
232,26,0,0,2,1,2,1,122,80,60166,46145,278,257,65423,45449
233,26,0,4,1,0,0,3,114,200,60166,46149,174,253,65423,45452
234,27,1,0,0,3,1,0,294,122,60167,46149,358,348,65426,45452
235,27,2,1,0,3,1,0,54,27,60169,46150,81,162,65429,45452
236,27,0,4,1,0,0,3,38,184,60169,46154,0,229,65429,45455
237,27,2,2,2,1,2,1,222,54,60171,46156,321,27,65430,45456
238,27,3,2,0,3,1,0,461,330,60174,46158,477,0,65433,45456
239,27,1,0,0,3,1,0,277,246,60175,46158,219,168,65436,45456
240,27,1,0,0,3,1,0,246,153,60176,46158,517,256,65439,45456
241,27,0,0,2,1,2,1,122,80,60176,46158,279,258,65440,45457
242,27,0,4,1,0,0,3,114,204,60176,46162,174,256,65440,45460
243,28,1,0,0,3,1,0,295,122,60177,46162,361,348,65443,45460
244,28,2,1,0,3,1,0,56,28,60179,46163,84,162,65446,45460
245,28,0,4,1,0,0,3,38,188,60179,46167,0,232,65446,45463
246,28,2,2,2,1,2,1,224,56,60181,46169,322,28,65447,45464
247,28,3,2,0,3,1,0,464,332,60184,46171,480,0,65450,45464
248,28,1,0,0,3,1,0,278,246,60185,46171,222,168,65453,45464
249,28,1,0,0,3,1,0,247,153,60186,46171,520,256,65456,45464
250,28,0,0,2,1,2,1,122,80,60186,46171,280,259,65457,45465
251,28,0,4,1,0,0,3,114,208,60186,46175,174,259,65457,45468
0,1,0,1,1,0,0,3,0,1,60186,46176,0,3,65457,45471
1,1,0,0,2,1,2,1,0,0,60186,46176,1,1,65458,45472
2,1,1,0,0,3,1,0,1,0,60187,46176,3,0,65461,45472
3,1,2,1,0,3,1,0,2,1,60189,46177,3,0,65464,45472
4,1,4,0,0,3,1,0,4,0,60193,46177,3,0,65467,45472
5,1,2,0,0,3,1,0,2,0,60195,46177,3,0,65470,45472
6,1,2,0,0,3,1,0,2,0,60197,46177,3,0,65473,45472
7,1,0,0,2,1,2,1,0,0,60197,46177,1,1,65474,45473
8,1,1,1,2,1,2,1,1,1,60198,46178,1,1,65475,45474
9,1,0,0,2,1,2,1,0,0,60198,46178,1,1,65476,45475
10,2,2,1,0,3,1,0,2,1,60200,46179,3,0,65479,45475
11,2,5,1,0,3,1,0,5,1,60205,46180,3,0,65482,45475
12,2,2,0,0,3,1,0,2,0,60207,46180,3,0,65485,45475
13,2,3,2,0,3,1,0,3,2,60210,46182,3,0,65488,45475
14,2,2,1,0,3,1,0,2,1,60212,46183,3,0,65491,45475
15,2,1,3,1,0,0,3,1,3,60213,46186,0,3,65491,45478
16,2,3,3,2,1,2,1,3,3,60216,46189,1,1,65492,45479
17,2,3,1,0,3,1,0,3,1,60219,46190,3,0,65495,45479
18,2,1,0,0,3,1,0,1,0,60220,46190,3,0,65498,45479
19,2,2,2,2,1,2,1,2,2,60222,46192,1,1,65499,45480
20,3,1,2,1,0,0,3,2,3,60223,46194,1,3,65499,45483
21,3,1,1,2,1,2,1,5,1,60224,46195,4,1,65500,45484
22,3,0,0,2,1,2,1,1,0,60224,46195,4,2,65501,45485
23,3,0,1,1,0,0,3,2,2,60224,46196,3,3,65501,45488
24,3,1,0,0,3,1,0,3,0,60225,46196,6,0,65504,45488
25,3,1,1,2,1,2,1,3,1,60226,46197,4,4,65505,45489
26,3,2,2,2,1,2,1,2,2,60228,46199,2,1,65506,45490
27,3,0,4,1,0,0,3,0,5,60228,46203,0,3,65506,45493
28,3,1,2,1,0,0,3,1,2,60229,46205,1,4,65506,45496
29,3,1,2,1,0,0,3,3,2,60230,46207,3,4,65506,45499
30,4,2,1,0,3,1,0,5,3,60232,46208,6,0,65509,45499
31,4,0,0,2,1,2,1,5,1,60232,46208,4,2,65510,45500
32,4,2,0,0,3,1,0,4,1,60234,46208,6,1,65513,45500
33,4,1,1,2,1,2,1,2,4,60235,46209,1,1,65514,45501
34,4,4,0,0,3,1,0,6,1,60239,46209,6,1,65517,45501
35,4,1,1,2,1,2,1,4,2,60240,46210,4,1,65518,45502
36,4,1,1,2,1,2,1,2,1,60241,46211,4,1,65519,45503
37,4,2,1,0,3,1,0,2,1,60243,46212,4,0,65522,45503
38,4,1,3,1,0,0,3,3,5,60244,46215,1,6,65522,45506
39,4,1,3,1,0,0,3,4,6,60245,46218,1,3,65522,45509
40,5,1,0,0,3,1,0,6,1,60246,46218,7,4,65525,45509
41,5,1,0,0,3,1,0,3,2,60247,46218,5,4,65528,45509
42,5,1,4,1,0,0,3,4,4,60248,46222,6,7,65528,45512
43,5,2,1,0,3,1,0,3,1,60250,46223,7,3,65531,45512
44,5,0,1,1,0,0,3,2,3,60250,46224,3,6,65531,45515
45,5,1,1,2,1,2,1,5,2,60251,46225,7,2,65532,45516
46,5,0,0,2,1,2,1,3,2,60251,46225,4,1,65533,45517
47,5,2,2,2,1,2,1,3,4,60253,46227,2,1,65534,45518
48,5,2,0,0,3,1,0,4,3,60255,46227,4,1,65537,45518
49,5,4,2,0,3,1,0,8,8,60259,46229,4,2,65540,45518
50,6,1,0,0,3,1,0,1,5,60260,46229,3,1,65543,45518
51,6,0,1,1,0,0,3,3,2,60260,46230,4,4,65543,45521
52,6,1,0,0,3,1,0,3,1,60261,46230,7,1,65546,45521
53,6,0,0,2,1,2,1,2,3,60261,46230,4,3,65547,45522
54,6,2,1,0,3,1,0,4,5,60263,46231,4,1,65550,45522
55,6,1,0,0,3,1,0,5,2,60264,46231,7,3,65553,45522
56,6,1,1,2,1,2,1,3,2,60265,46232,5,3,65554,45523
57,6,1,2,1,0,0,3,5,5,60266,46234,4,6,65554,45526
58,6,2,0,0,3,1,0,5,5,60268,46234,4,0,65557,45526
59,6,0,0,2,1,2,1,6,1,60268,46234,7,4,65558,45527
60,7,3,1,0,3,1,0,9,2,60271,46235,10,6,65561,45527
61,7,2,1,0,3,1,0,5,3,60273,46236,8,4,65564,45527
62,7,0,1,1,0,0,3,5,2,60273,46237,4,7,65564,45530
63,7,0,1,1,0,0,3,5,4,60273,46238,6,4,65564,45533
64,7,1,1,2,1,2,1,6,3,60274,46239,8,8,65565,45534
65,7,1,1,2,1,2,1,5,5,60275,46240,7,2,65566,45535
66,7,4,0,0,3,1,0,12,8,60279,46240,7,1,65569,45535
67,7,4,1,0,3,1,0,7,5,60283,46241,5,2,65572,45535
68,7,2,1,0,3,1,0,5,3,60285,46242,7,1,65575,45535
69,7,0,2,1,0,0,3,3,3,60285,46244,7,9,65575,45538
70,8,2,1,0,3,1,0,7,6,60287,46245,7,1,65578,45538
71,8,0,0,2,1,2,1,3,2,60287,46245,5,1,65579,45539
72,8,0,0,2,1,2,1,3,2,60287,46245,6,5,65580,45540
73,8,2,1,0,3,1,0,4,4,60289,46246,7,1,65583,45540
74,8,1,0,0,3,1,0,5,5,60290,46246,7,1,65586,45540
75,8,2,1,0,3,1,0,7,3,60292,46247,10,3,65589,45540
76,8,2,1,0,3,1,0,5,2,60294,46248,10,3,65592,45540
77,8,2,1,0,3,1,0,3,6,60296,46249,6,6,65595,45540
78,8,1,1,2,1,2,1,7,2,60297,46250,8,4,65596,45541
79,8,1,2,1,0,0,3,6,7,60298,46252,4,7,65596,45544
80,9,0,1,1,0,0,3,5,6,60298,46253,7,10,65596,45547
81,9,2,0,0,3,1,0,7,3,60300,46253,11,1,65599,45547
82,9,1,2,1,0,0,3,10,4,60301,46255,10,8,65599,45550
83,9,0,1,1,0,0,3,7,6,60301,46256,5,12,65599,45553
84,9,0,2,1,0,0,3,3,5,60301,46258,7,7,65599,45556
85,9,0,1,1,0,0,3,5,5,60301,46259,6,11,65599,45559
86,9,2,0,0,3,1,0,7,2,60303,46259,7,2,65602,45559
87,9,0,1,1,0,0,3,5,6,60303,46260,7,7,65602,45562
88,9,0,0,2,1,2,1,3,2,60303,46260,6,7,65603,45563
89,9,0,0,2,1,2,1,6,3,60303,46260,9,2,65604,45564
90,10,2,0,0,3,1,0,5,2,60305,46260,9,1,65607,45564
91,10,1,1,2,1,2,1,8,3,60306,46261,9,4,65608,45565
92,10,1,0,0,3,1,0,8,6,60307,46261,10,7,65611,45565
93,10,2,3,1,0,0,3,5,8,60309,46264,7,10,65611,45568
94,10,3,1,0,3,1,0,15,9,60312,46265,10,1,65614,45568
95,10,0,2,1,0,0,3,7,5,60312,46267,10,4,65614,45571
96,10,0,0,2,1,2,1,5,3,60312,46267,8,2,65615,45572
97,10,1,1,2,1,2,1,4,7,60313,46268,7,4,65616,45573
98,10,2,0,0,3,1,0,8,7,60315,46268,7,2,65619,45573
99,10,1,0,0,3,1,0,8,6,60316,46268,8,4,65622,45573
100,11,1,1,2,1,2,1,6,6,60317,46269,7,9,65623,45574
101,11,0,1,1,0,0,3,7,3,60317,46270,7,14,65623,45577
102,11,1,0,0,3,1,0,7,3,60318,46270,12,7,65626,45577
103,11,1,0,0,3,1,0,6,6,60319,46270,10,12,65629,45577
104,11,0,0,2,1,2,1,4,4,60319,46270,8,2,65630,45578
105,11,1,0,0,3,1,0,6,6,60320,46270,10,2,65633,45578
106,11,1,1,2,1,2,1,6,3,60321,46271,11,11,65634,45579
107,11,3,1,0,3,1,0,13,5,60324,46272,13,6,65637,45579
108,11,3,2,0,3,1,0,10,5,60327,46274,14,2,65640,45579
109,11,1,0,0,3,1,0,4,2,60328,46274,9,7,65643,45579
110,12,1,0,0,3,1,0,9,6,60329,46274,13,1,65646,45579
111,12,1,1,2,1,2,1,16,10,60330,46275,11,5,65647,45580
112,12,2,0,0,3,1,0,9,5,60332,46275,13,14,65650,45580
113,12,0,1,1,0,0,3,5,9,60332,46276,7,5,65650,45583
114,12,1,0,0,3,1,0,6,2,60333,46276,12,4,65653,45583
115,12,0,1,1,0,0,3,7,4,60333,46277,7,7,65653,45586
116,12,3,1,0,3,1,0,11,7,60336,46278,11,2,65656,45586
117,12,0,0,2,1,2,1,5,3,60336,46278,9,8,65657,45587
118,12,4,0,0,3,1,0,8,7,60340,46278,10,1,65660,45587
119,12,0,1,1,0,0,3,8,4,60340,46279,9,13,65660,45590
120,13,2,0,0,3,1,0,12,5,60342,46279,17,7,65663,45590
121,13,1,0,0,3,1,0,14,5,60343,46279,16,2,65666,45590
122,13,0,2,1,0,0,3,6,8,60343,46281,10,12,65666,45593
123,13,1,2,1,0,0,3,7,8,60344,46283,7,7,65666,45596
124,13,1,0,0,3,1,0,8,3,60345,46283,15,2,65669,45596
125,13,1,2,1,0,0,3,7,8,60346,46285,10,9,65669,45599
126,13,2,1,0,3,1,0,6,5,60348,46286,11,11,65672,45599
127,13,2,3,1,0,0,3,8,6,60350,46289,11,10,65672,45602
128,13,1,1,2,1,2,1,5,3,60351,46290,10,13,65673,45603
129,13,4,1,0,3,1,0,12,8,60355,46291,10,2,65676,45603
130,14,1,1,2,1,2,1,6,4,60356,46292,10,14,65677,45604
131,14,1,1,2,1,2,1,17,11,60357,46293,12,3,65678,45605
132,14,5,2,0,3,1,0,13,6,60362,46295,12,5,65681,45605
133,14,1,1,2,1,2,1,6,10,60363,46296,8,2,65682,45606
134,14,0,0,2,1,2,1,7,8,60363,46296,8,8,65683,45607
135,14,3,2,0,3,1,0,10,6,60366,46298,10,1,65686,45607
136,14,1,1,2,1,2,1,10,6,60367,46299,14,3,65687,45608
137,14,3,1,0,3,1,0,11,8,60370,46300,13,14,65690,45608
138,14,3,1,0,3,1,0,14,8,60373,46301,14,5,65693,45608
139,14,2,1,0,3,1,0,8,3,60375,46302,15,8,65696,45608
140,15,3,1,0,3,1,0,13,7,60378,46303,17,11,65699,45608
141,15,2,2,2,1,2,1,8,7,60380,46305,12,6,65700,45609
142,15,3,0,0,3,1,0,17,5,60383,46305,19,4,65703,45609
143,15,0,2,1,0,0,3,7,10,60383,46307,10,5,65703,45612
144,15,1,0,0,3,1,0,10,6,60384,46307,16,7,65706,45612
145,15,1,3,1,0,0,3,9,9,60385,46310,11,11,65706,45615
146,15,2,1,0,3,1,0,7,4,60387,46311,13,7,65709,45615
147,15,3,0,0,3,1,0,9,4,60390,46311,13,2,65712,45615
148,15,1,3,1,0,0,3,9,6,60391,46314,15,15,65712,45618
149,15,1,0,0,3,1,0,13,8,60392,46314,13,9,65715,45618
150,16,3,1,0,3,1,0,17,9,60395,46315,17,5,65718,45618
151,16,2,1,0,3,1,0,13,9,60397,46316,16,3,65721,45618
152,16,0,1,1,0,0,3,6,9,60397,46317,10,17,65721,45621
153,16,0,3,1,0,0,3,8,6,60397,46320,15,17,65721,45624
154,16,1,0,0,3,1,0,8,8,60398,46320,11,10,65724,45624
155,16,3,0,0,3,1,0,13,6,60401,46320,13,3,65727,45624
156,16,3,2,0,3,1,0,12,11,60404,46322,14,8,65730,45624
157,16,1,0,0,3,1,0,13,5,60405,46322,20,2,65733,45624
158,16,2,1,0,3,1,0,19,12,60407,46323,15,13,65736,45624
159,16,3,2,0,3,1,0,16,8,60410,46325,15,2,65739,45624
160,17,1,0,0,3,1,0,8,10,60411,46325,13,7,65742,45624
161,17,0,1,1,0,0,3,17,6,60411,46326,19,9,65742,45627
162,17,3,2,0,3,1,0,16,9,60414,46328,20,7,65745,45627
163,17,1,1,2,1,2,1,7,11,60415,46329,9,10,65746,45628
164,17,1,1,2,1,2,1,9,8,60416,46330,13,16,65747,45629
165,17,1,0,0,3,1,0,10,6,60417,46330,18,4,65750,45629
166,17,0,0,2,1,2,1,7,4,60417,46330,14,6,65751,45630
167,17,1,0,0,3,1,0,14,8,60418,46330,16,1,65754,45630
168,17,0,1,1,0,0,3,9,5,60418,46331,13,14,65754,45633
169,17,1,2,1,0,0,3,11,8,60419,46333,16,14,65754,45636
170,18,1,4,1,0,0,3,20,16,60420,46337,15,8,65754,45639
171,18,1,2,1,0,0,3,9,10,60421,46339,11,5,65754,45642
172,18,0,1,1,0,0,3,13,7,60421,46340,13,20,65754,45645
173,18,0,0,2,1,2,1,6,9,60421,46340,11,14,65755,45646
174,18,0,1,1,0,0,3,12,12,60421,46341,14,5,65755,45649
175,18,4,2,0,3,1,0,17,7,60425,46343,23,3,65758,45649
176,18,2,0,0,3,1,0,15,9,60427,46343,19,8,65761,45649
177,18,1,1,2,1,2,1,9,7,60428,46344,16,4,65762,45650
178,18,3,0,0,3,1,0,20,9,60431,46344,20,10,65765,45650
179,18,3,1,0,3,1,0,19,9,60434,46345,18,17,65768,45650
180,19,2,1,0,3,1,0,11,6,60436,46346,16,9,65771,45650
181,19,0,2,1,0,0,3,7,13,60436,46348,9,9,65771,45653
182,19,0,0,2,1,2,1,9,8,60436,46348,14,11,65772,45654
183,19,1,2,1,0,0,3,11,8,60437,46350,18,17,65772,45657
184,19,0,0,2,1,2,1,8,10,60437,46350,14,15,65773,45658
185,19,3,2,0,3,1,0,14,10,60440,46352,19,4,65776,45658
186,19,1,2,1,0,0,3,17,11,60441,46354,20,4,65776,45661
187,19,4,4,2,1,2,1,21,10,60445,46358,20,8,65777,45662
188,19,1,2,1,0,0,3,8,6,60446,46360,14,10,65777,45665
189,19,3,0,0,3,1,0,17,8,60449,46360,19,16,65780,45665
190,20,0,0,2,1,2,1,17,8,60449,46360,20,5,65781,45666
191,20,4,1,0,3,1,0,23,10,60453,46361,21,9,65784,45666
192,20,3,1,0,3,1,0,16,8,60456,46362,16,11,65787,45666
193,20,2,1,0,3,1,0,22,17,60458,46363,18,5,65790,45666
194,20,1,1,2,1,2,1,12,9,60459,46364,19,9,65791,45667
195,20,2,0,0,3,1,0,11,10,60461,46364,14,8,65794,45667
196,20,0,1,1,0,0,3,8,11,60461,46365,14,12,65794,45670
197,20,1,0,0,3,1,0,18,11,60462,46365,23,10,65797,45670
198,20,2,4,1,0,0,3,8,13,60464,46369,11,11,65797,45673
199,20,1,1,2,1,2,1,13,13,60465,46370,15,21,65798,45674
200,21,1,0,0,3,1,0,21,9,60466,46370,23,4,65801,45674
201,21,2,0,0,3,1,0,10,6,60468,46370,17,3,65804,45674
202,21,3,0,0,3,1,0,20,7,60471,46370,26,10,65807,45674
203,21,3,1,0,3,1,0,18,10,60474,46371,22,17,65810,45674
204,21,0,0,2,1,2,1,9,8,60474,46371,15,16,65811,45675
205,21,0,0,2,1,2,1,11,6,60474,46371,17,17,65812,45676
206,21,3,1,0,3,1,0,12,8,60477,46372,19,14,65815,45676
207,21,1,1,2,1,2,1,15,11,60478,46373,20,5,65816,45677
208,21,0,2,1,0,0,3,7,15,60478,46375,9,20,65816,45680
209,21,2,0,0,3,1,0,23,10,60480,46375,23,5,65819,45680
210,22,2,0,0,3,1,0,20,11,60482,46375,26,5,65822,45680
211,22,0,2,1,0,0,3,12,11,60482,46377,19,24,65822,45683
212,22,0,3,1,0,0,3,11,13,60482,46380,14,12,65822,45686
213,22,2,1,0,3,1,0,18,9,60484,46381,19,5,65825,45686
214,22,1,1,2,1,2,1,14,14,60485,46382,16,6,65826,45687
215,22,3,1,0,3,1,0,11,14,60488,46383,14,8,65829,45687
216,22,4,0,0,3,1,0,21,8,60492,46383,23,10,65832,45687
217,22,3,2,0,3,1,0,26,12,60495,46385,24,11,65835,45687
218,22,1,2,1,0,0,3,23,19,60496,46387,18,14,65835,45690
219,22,0,1,1,0,0,3,12,9,60496,46388,19,15,65835,45693
220,23,0,0,2,1,2,1,23,10,60496,46388,24,15,65836,45694
221,23,1,1,2,1,2,1,21,8,60497,46389,27,5,65837,45695
222,23,0,1,1,0,0,3,11,7,60497,46390,17,13,65837,45698
223,23,1,1,2,1,2,1,9,12,60498,46391,15,4,65838,45699
224,23,1,0,0,3,1,0,16,11,60499,46391,23,16,65841,45699
225,23,2,1,0,3,1,0,23,10,60501,46392,26,17,65844,45699
226,23,0,1,1,0,0,3,10,7,60501,46393,17,8,65844,45702
227,23,1,1,2,1,2,1,19,11,60502,46394,23,10,65845,45703
228,23,2,0,0,3,1,0,11,8,60504,46394,18,20,65848,45703
229,23,0,3,1,0,0,3,7,18,60504,46397,9,20,65848,45706
230,24,2,0,0,3,1,0,21,11,60506,46397,26,10,65851,45706
231,24,1,3,1,0,0,3,19,12,60507,46400,19,20,65851,45709
232,24,1,0,0,3,1,0,13,9,60508,46400,22,4,65854,45709
233,24,2,0,0,3,1,0,13,13,60510,46400,17,5,65857,45709
234,24,1,1,2,1,2,1,21,12,60511,46401,27,13,65858,45710
235,24,2,0,0,3,1,0,23,8,60513,46401,26,6,65861,45710
236,24,1,1,2,1,2,1,12,15,60514,46402,15,25,65862,45711
237,24,2,4,1,0,0,3,16,18,60516,46406,16,14,65862,45714
238,24,1,1,2,1,2,1,11,8,60517,46407,18,6,65863,45715
239,24,5,3,0,3,1,0,31,15,60522,46410,27,15,65866,45715
240,25,4,0,0,3,1,0,27,10,60526,46410,27,8,65869,45715
241,25,0,2,1,0,0,3,21,10,60526,46412,27,23,65869,45718
242,25,2,4,1,0,0,3,25,14,60528,46416,26,9,65869,45721
243,25,4,1,0,3,1,0,23,13,60532,46417,22,13,65872,45721
244,25,0,0,2,1,2,1,7,18,60532,46417,10,17,65873,45722
245,25,0,2,1,0,0,3,13,15,60532,46419,17,18,65873,45725
246,25,3,2,0,3,1,0,15,13,60535,46421,22,8,65876,45725
247,25,0,3,1,0,0,3,9,15,60535,46424,15,17,65876,45728
248,25,3,1,0,3,1,0,14,8,60538,46425,20,10,65879,45728
249,25,1,0,0,3,1,0,24,19,60539,46425,21,20,65882,45728
250,26,1,0,0,3,1,0,14,9,60540,46425,25,14,65885,45728
251,26,1,0,0,3,1,0,32,15,60541,46425,30,13,65888,45728
252,26,2,0,0,3,1,0,18,18,60543,46425,19,20,65891,45728
253,26,1,0,0,3,1,0,22,12,60544,46425,30,5,65894,45728
254,26,0,0,2,1,2,1,21,11,60544,46425,27,6,65895,45729
255,26,2,2,2,1,2,1,13,10,60546,46427,19,7,65896,45730
256,26,1,2,1,0,0,3,12,10,60547,46429,18,28,65896,45733
257,26,4,3,0,3,1,0,16,18,60551,46432,18,15,65899,45733
258,26,0,0,2,1,2,1,16,11,60551,46432,24,11,65900,45734
259,26,1,0,0,3,1,0,24,8,60552,46432,29,4,65903,45734
260,27,0,2,1,0,0,3,24,21,60552,46434,21,13,65903,45737
261,27,2,1,0,3,1,0,17,14,60554,46435,25,17,65906,45737
262,27,1,0,0,3,1,0,10,15,60555,46435,18,13,65909,45737
263,27,1,1,2,1,2,1,8,19,60556,46436,11,10,65910,45738
264,27,1,0,0,3,1,0,24,13,60557,46436,25,18,65913,45738
265,27,2,2,2,1,2,1,15,17,60559,46438,18,9,65914,45739
266,27,2,2,2,1,2,1,23,12,60561,46440,28,9,65915,45740
267,27,0,7,1,0,0,3,25,21,60561,46447,26,20,65915,45743
268,27,0,2,1,0,0,3,14,10,60561,46449,20,23,65915,45746
269,27,3,0,0,3,1,0,30,10,60564,46449,30,23,65918,45746
270,28,1,2,1,0,0,3,19,20,60565,46451,19,18,65918,45749
271,28,0,1,1,0,0,3,24,22,60565,46452,21,31,65918,45752
272,28,2,3,1,0,0,3,16,13,60567,46455,20,10,65918,45755
273,28,1,0,0,3,1,0,22,11,60568,46455,30,5,65921,45755
274,28,0,0,2,1,2,1,24,8,60568,46455,30,7,65922,45756
275,28,2,2,2,1,2,1,16,11,60570,46457,26,14,65923,45757
276,28,3,0,0,3,1,0,19,11,60573,46457,27,4,65926,45757
277,28,5,2,0,3,1,0,37,17,60578,46459,33,17,65929,45757
278,28,0,0,2,1,2,1,12,10,60578,46459,19,10,65930,45758
279,28,2,0,0,3,1,0,24,12,60580,46459,33,14,65933,45758
280,29,1,1,2,1,2,1,16,18,60581,46460,19,24,65934,45759
281,29,2,2,2,1,2,1,12,17,60583,46462,19,21,65935,45760
282,29,1,1,2,1,2,1,31,11,60584,46463,31,6,65936,45761
283,29,2,0,0,3,1,0,25,12,60586,46463,31,18,65939,45761
284,29,1,0,0,3,1,0,18,14,60587,46463,28,11,65942,45761
285,29,0,4,1,0,0,3,24,17,60587,46467,25,23,65942,45764
286,29,1,0,0,3,1,0,17,18,60588,46467,21,14,65945,45764
287,29,0,1,1,0,0,3,19,21,60588,46468,19,16,65945,45767
288,29,0,1,1,0,0,3,12,11,60588,46469,19,13,65945,45770
289,29,1,3,1,0,0,3,14,13,60589,46472,19,26,65945,45773
290,30,1,0,0,3,1,0,25,12,60590,46472,36,10,65948,45773
291,30,1,0,0,3,1,0,26,21,60591,46472,29,31,65951,45773
292,30,2,2,2,1,2,1,21,13,60593,46474,28,19,65952,45774
293,30,2,1,0,3,1,0,26,23,60595,46475,24,7,65955,45774
294,30,2,0,0,3,1,0,24,11,60597,46475,33,4,65958,45774
295,30,1,2,1,0,0,3,9,21,60598,46477,11,16,65958,45777
296,30,1,1,2,1,2,1,17,12,60599,46478,27,18,65959,45778
297,30,1,0,0,3,1,0,38,17,60600,46478,36,9,65962,45778
298,30,0,1,1,0,0,3,16,14,60600,46479,20,13,65962,45781
299,30,2,1,0,3,1,0,26,9,60602,46480,33,14,65965,45781
300,31,3,1,0,3,1,0,19,19,60605,46481,22,16,65968,45781
301,31,3,0,0,3,1,0,34,11,60608,46481,34,24,65971,45781
302,31,4,3,0,3,1,0,30,12,60612,46484,36,18,65974,45781
303,31,1,2,1,0,0,3,15,15,60613,46486,19,9,65974,45784
304,31,0,1,1,0,0,3,17,19,60613,46487,21,17,65974,45787
305,31,2,2,2,1,2,1,14,19,60615,46489,20,14,65975,45788
306,31,4,0,0,3,1,0,22,14,60619,46489,31,14,65978,45788
307,31,0,0,2,1,2,1,12,11,60619,46489,20,12,65979,45789
308,31,2,0,0,3,1,0,21,21,60621,46489,22,23,65982,45789
309,31,0,2,1,0,0,3,25,14,60621,46491,31,24,65982,45792
310,32,2,0,0,3,1,0,40,17,60623,46491,39,16,65985,45792
311,32,1,2,1,0,0,3,25,13,60624,46493,33,22,65985,45795
312,32,3,2,0,3,1,0,29,25,60627,46495,27,18,65988,45795
313,32,1,1,2,1,2,1,25,18,60628,46496,26,8,65989,45796
314,32,1,1,2,1,2,1,10,22,60629,46497,12,5,65990,45797
315,32,2,2,2,1,2,1,28,23,60631,46499,30,11,65991,45798
316,32,1,2,1,0,0,3,17,16,60632,46501,20,12,65991,45801
317,32,0,2,1,0,0,3,17,14,60632,46503,27,29,65991,45804
318,32,2,0,0,3,1,0,27,12,60634,46503,39,13,65994,45804
319,32,1,2,1,0,0,3,22,15,60635,46505,28,34,65994,45807
320,33,2,3,1,0,0,3,27,17,60637,46508,31,17,65994,45810
321,33,2,0,0,3,1,0,17,15,60639,46508,22,24,65997,45810
322,33,3,0,0,3,1,0,37,11,60642,46508,37,12,66000,45810
323,33,1,0,0,3,1,0,15,19,60643,46508,23,9,66003,45810
324,33,2,0,0,3,1,0,14,11,60645,46508,23,16,66006,45810
325,33,3,0,0,3,1,0,20,19,60648,46508,24,8,66009,45810
326,33,3,3,2,1,2,1,24,24,60651,46511,23,18,66010,45811
327,33,0,0,2,1,2,1,22,15,60651,46511,29,25,66011,45812
328,33,1,4,1,0,0,3,23,18,60652,46515,31,21,66011,45815
329,33,1,2,1,0,0,3,31,14,60653,46517,36,26,66011,45818
330,34,1,0,0,3,1,0,28,17,60654,46517,34,16,66014,45818
331,34,0,2,1,0,0,3,17,16,60654,46519,27,14,66014,45821
332,34,1,2,1,0,0,3,26,20,60655,46521,26,17,66014,45824
333,34,2,1,0,3,1,0,42,18,60657,46522,42,21,66017,45824
334,34,4,2,0,3,1,0,24,21,60661,46524,27,12,66020,45824
335,34,2,1,0,3,1,0,30,24,60663,46525,33,29,66023,45824
336,34,0,2,1,0,0,3,25,15,60663,46527,33,16,66023,45827
337,34,0,1,1,0,0,3,10,23,60663,46528,12,15,66023,45830
338,34,0,1,1,0,0,3,19,20,60663,46529,22,37,66023,45833
339,34,2,2,2,1,2,1,31,27,60665,46531,28,6,66024,45834
340,35,1,2,1,0,0,3,16,21,60666,46533,23,27,66024,45837
341,35,1,0,0,3,1,0,32,14,60667,46533,39,18,66027,45837
342,35,1,0,0,3,1,0,38,11,60668,46533,40,16,66030,45837
343,35,3,3,2,1,2,1,20,19,60671,46536,21,9,66031,45838
344,35,2,0,0,3,1,0,25,18,60673,46536,34,18,66034,45838
345,35,1,0,0,3,1,0,15,11,60674,46536,26,12,66037,45838
346,35,3,1,0,3,1,0,20,16,60677,46537,25,17,66040,45838
347,35,5,2,0,3,1,0,27,17,60682,46539,32,26,66043,45838
348,35,2,3,1,0,0,3,12,26,60684,46542,12,25,66043,45841
349,35,0,1,1,0,0,3,27,13,60684,46543,39,28,66043,45844
350,36,2,1,0,3,1,0,32,25,60686,46544,36,9,66046,45844
351,36,0,0,2,1,2,1,28,17,60686,46544,35,38,66047,45845
352,36,1,2,1,0,0,3,20,22,60687,46546,22,9,66047,45848
353,36,0,2,1,0,0,3,26,22,60687,46548,26,17,66047,45851
354,36,2,1,0,3,1,0,27,16,60689,46549,36,21,66050,45851
355,36,0,0,2,1,2,1,17,16,60689,46549,28,17,66051,45852
356,36,3,1,0,3,1,0,45,19,60692,46550,45,17,66054,45852
357,36,2,1,0,3,1,0,26,25,60694,46551,26,29,66057,45852
358,36,2,1,0,3,1,0,26,22,60696,46552,30,15,66060,45852
359,36,2,2,2,1,2,1,33,29,60698,46554,29,17,66061,45853
360,37,4,2,0,3,1,0,31,15,60702,46556,42,18,66064,45853
361,37,4,1,0,3,1,0,42,12,60706,46557,43,18,66067,45853
362,37,1,1,2,1,2,1,28,18,60707,46558,33,17,66068,45854
363,37,1,0,0,3,1,0,17,21,60708,46558,26,9,66071,45854
364,37,1,0,0,3,1,0,21,16,60709,46558,28,28,66074,45854
365,37,0,2,1,0,0,3,12,28,60709,46560,12,15,66074,45857
366,37,2,1,0,3,1,0,27,19,60711,46561,37,25,66077,45857
367,37,0,2,1,0,0,3,15,13,60711,46563,26,29,66077,45860
368,37,1,2,1,0,0,3,21,21,60712,46565,21,20,66077,45863
369,37,1,1,2,1,2,1,33,15,60713,46566,40,28,66078,45864
370,38,0,4,1,0,0,3,17,20,60713,46570,28,12,66078,45867
371,38,1,3,1,0,0,3,33,28,60714,46573,36,20,66078,45870
372,38,3,1,0,3,1,0,48,20,60717,46574,48,9,66081,45870
373,38,3,2,0,3,1,0,29,24,60720,46576,33,17,66084,45870
374,38,2,2,2,1,2,1,22,24,60722,46578,23,18,66085,45871
375,38,1,1,2,1,2,1,27,23,60723,46579,27,18,66086,45872
376,38,2,4,1,0,0,3,28,29,60725,46583,26,24,66086,45875
377,38,0,0,2,1,2,1,27,16,60725,46583,37,39,66087,45876
378,38,3,1,0,3,1,0,31,18,60728,46584,38,15,66090,45876
379,38,2,2,2,1,2,1,35,31,60730,46586,30,30,66091,45877
0,1,0,0,2,1,2,1,0,0,60730,46586,1,19,66092,45878
1,1,0,2,1,0,0,3,27,25,60730,46588,27,42,66092,45881
2,1,0,0,2,1,2,1,27,16,60730,46588,38,29,66093,45882
3,1,4,1,0,3,1,0,4,1,60734,46589,3,17,66096,45882
4,1,0,2,1,0,0,3,17,22,60734,46591,28,28,66096,45885
5,1,4,1,0,3,1,0,52,21,60738,46592,51,15,66099,45885
6,1,0,0,2,1,2,1,31,15,60738,46592,43,21,66100,45886
7,1,6,1,0,3,1,0,39,16,60744,46593,43,18,66103,45886
8,1,2,2,2,1,2,1,2,2,60746,46595,1,21,66104,45887
9,1,3,3,2,1,2,1,24,19,60749,46598,29,10,66105,45888
10,2,2,2,2,1,2,1,44,14,60751,46600,44,25,66106,45889
11,2,1,3,1,0,0,3,18,24,60752,46603,26,33,66106,45892
12,2,4,1,0,3,1,0,39,32,60756,46604,33,18,66109,45892
13,2,0,0,2,1,2,1,27,19,60756,46604,38,1,66110,45893
14,2,2,2,2,1,2,1,17,15,60758,46606,27,1,66111,45894
15,2,2,0,0,3,1,0,30,18,60760,46606,36,17,66114,45894
16,2,2,2,2,1,2,1,31,26,60762,46608,34,1,66115,45895
17,2,0,2,1,0,0,3,28,31,60762,46610,26,32,66115,45898
18,2,1,2,1,0,0,3,32,20,60763,46612,38,21,66115,45901
19,2,4,3,0,3,1,0,37,31,60767,46615,39,28,66118,45901
20,3,2,1,0,3,1,0,29,26,60769,46616,30,1,66121,45901
21,3,0,0,2,1,2,1,52,21,60769,46616,52,29,66122,45902
22,3,1,0,0,3,1,0,5,1,60770,46616,6,21,66125,45902
23,3,0,2,1,0,0,3,17,24,60770,46618,28,18,66125,45905
24,3,1,0,0,3,1,0,28,19,60771,46618,41,17,66128,45905
25,3,1,2,1,0,0,3,32,17,60772,46620,43,21,66128,45908
26,3,2,1,0,3,1,0,26,20,60774,46621,32,21,66131,45908
27,3,0,1,1,0,0,3,0,1,60774,46622,1,32,66131,45911
28,3,2,0,0,3,1,0,29,16,60776,46622,41,19,66134,45911
29,3,3,1,0,3,1,0,42,17,60779,46623,46,42,66137,45911
30,4,3,1,0,3,1,0,5,3,60782,46624,4,28,66140,45911
31,4,1,2,1,0,0,3,19,26,60783,46626,26,28,66140,45914
32,4,1,0,0,3,1,0,18,15,60784,46626,30,33,66143,45914
33,4,3,0,0,3,1,0,33,18,60787,46626,39,18,66146,45914
34,4,3,0,0,3,1,0,34,26,60790,46626,37,10,66149,45914
35,4,1,1,2,1,2,1,40,33,60791,46627,34,18,66150,45915
36,4,1,2,1,0,0,3,29,33,60792,46629,26,4,66150,45918
37,4,1,1,2,1,2,1,45,15,60793,46630,45,33,66151,45919
38,4,3,2,0,3,1,0,40,33,60796,46632,42,21,66154,45919
39,4,1,1,2,1,2,1,33,21,60797,46633,39,2,66155,45920
40,5,1,3,1,0,0,3,18,27,60798,46636,28,31,66155,45923
41,5,1,0,0,3,1,0,46,15,60799,46636,48,17,66158,45923
42,5,0,0,2,1,2,1,42,17,60799,46636,47,20,66159,45924
43,5,2,1,0,3,1,0,20,16,60801,46637,33,21,66162,45924
44,5,2,1,0,3,1,0,7,2,60803,46638,9,1,66165,45924
45,5,0,0,2,1,2,1,29,26,60803,46638,31,34,66166,45925
46,5,1,1,2,1,2,1,29,20,60804,46639,42,33,66167,45926
47,5,0,0,2,1,2,1,32,17,60804,46639,44,22,66168,45927
48,5,3,0,0,3,1,0,3,1,60807,46639,4,18,66171,45927
49,5,0,1,1,0,0,3,26,21,60807,46640,32,32,66171,45930
50,6,3,1,0,3,1,0,36,22,60810,46641,42,4,66174,45930
51,6,0,3,1,0,0,3,52,24,60810,46644,52,36,66174,45933
52,6,3,3,2,1,2,1,8,6,60813,46647,5,11,66175,45934
53,6,0,0,2,1,2,1,19,26,60813,46647,27,22,66176,45935
54,6,1,2,1,0,0,3,34,20,60814,46649,39,31,66176,45938
55,6,0,2,1,0,0,3,29,35,60814,46651,26,24,66176,45941
56,6,2,0,0,3,1,0,42,33,60816,46651,45,2,66179,45941
57,6,3,1,0,3,1,0,29,22,60819,46652,35,21,66182,45941
58,6,2,0,0,3,1,0,31,16,60821,46652,44,18,66185,45941
59,6,2,0,0,3,1,0,42,33,60823,46652,37,42,66188,45941
60,7,2,1,0,3,1,0,31,21,60825,46653,45,31,66191,45941
61,7,3,0,0,3,1,0,49,15,60828,46653,51,22,66194,45941
62,7,1,2,1,0,0,3,43,19,60829,46655,47,21,66194,45944
63,7,0,0,2,1,2,1,19,26,60829,46655,28,21,66195,45945
64,7,0,0,2,1,2,1,7,2,60829,46655,10,35,66196,45946
65,7,0,0,2,1,2,1,29,26,60829,46655,32,3,66197,45947
66,7,0,0,2,1,2,1,20,16,60829,46655,34,34,66198,45948
67,7,0,0,2,1,2,1,34,26,60829,46655,38,19,66199,45949
68,7,0,2,1,0,0,3,8,8,60829,46657,5,21,66199,45952
69,7,2,1,0,3,1,0,34,18,60831,46658,47,32,66202,45952
70,8,2,2,2,1,2,1,36,22,60833,46660,40,12,66203,45953
71,8,2,2,2,1,2,1,44,35,60835,46662,38,22,66204,45954
72,8,3,4,1,0,0,3,32,39,60838,46666,26,45,66204,45957
73,8,0,0,2,1,2,1,29,26,60838,46666,33,37,66205,45958
74,8,1,0,0,3,1,0,53,24,60839,46666,55,22,66208,45958
75,8,1,2,1,0,0,3,30,24,60840,46668,35,7,66208,45961
76,8,1,0,0,3,1,0,37,22,60841,46668,45,22,66211,45961
77,8,2,0,0,3,1,0,5,1,60843,46668,7,17,66214,45961
78,8,3,0,0,3,1,0,34,16,60846,46668,47,1,66217,45961
79,8,0,2,1,0,0,3,18,29,60846,46670,28,34,66217,45964
80,9,2,1,0,3,1,0,46,36,60848,46671,41,21,66220,45964
81,9,1,1,2,1,2,1,8,3,60849,46672,11,32,66221,45965
82,9,1,1,2,1,2,1,20,27,60850,46673,29,25,66222,45966
83,9,0,1,1,0,0,3,20,17,60850,46674,34,24,66222,45969
84,9,2,1,0,3,1,0,36,27,60852,46675,41,32,66225,45969
85,9,1,1,2,1,2,1,35,19,60853,46676,48,13,66226,45970
86,9,4,1,0,3,1,0,53,16,60857,46677,54,21,66229,45970
87,9,2,0,0,3,1,0,45,19,60859,46677,50,35,66232,45970
88,9,1,1,2,1,2,1,9,9,60860,46678,6,4,66233,45971
89,9,2,0,0,3,1,0,44,33,60862,46678,48,19,66236,45971
90,10,2,1,0,3,1,0,33,22,60864,46679,48,37,66239,45971
91,10,2,3,1,0,0,3,39,25,60866,46682,45,48,66239,45974
92,10,1,2,1,0,0,3,54,26,60867,46684,55,37,66239,45977
93,10,4,1,0,3,1,0,9,2,60871,46685,10,22,66242,45977
94,10,3,1,0,3,1,0,21,30,60874,46686,31,7,66245,45977
95,10,1,0,0,3,1,0,37,22,60875,46686,43,22,66248,45977
96,10,1,1,2,1,2,1,33,40,60876,46687,27,2,66249,45978
97,10,2,0,0,3,1,0,32,24,60878,46687,38,17,66252,45978
98,10,1,0,0,3,1,0,35,16,60879,46687,50,22,66255,45978
99,10,0,3,1,0,0,3,29,29,60879,46690,33,37,66255,45981
100,11,3,1,0,3,1,0,47,34,60882,46691,51,24,66258,45981
101,11,0,2,1,0,0,3,9,11,60882,46693,6,35,66258,45984
102,11,1,0,0,3,1,0,9,3,60883,46693,14,25,66261,45984
103,11,0,1,1,0,0,3,20,28,60883,46694,29,22,66261,45987
104,11,1,0,0,3,1,0,21,17,60884,46694,37,21,66264,45987
105,11,1,0,0,3,1,0,36,19,60885,46694,51,21,66267,45987
106,11,4,0,0,3,1,0,57,16,60889,46694,57,13,66270,45987
107,11,2,1,0,3,1,0,37,17,60891,46695,53,4,66273,45987
108,11,3,3,2,1,2,1,48,22,60894,46698,51,38,66274,45988
109,11,0,1,1,0,0,3,36,28,60894,46699,41,35,66274,45991
110,12,2,1,0,3,1,0,56,27,60896,46700,58,25,66277,45991
111,12,0,0,2,1,2,1,37,22,60896,46700,44,49,66278,45992
112,12,0,0,2,1,2,1,48,22,60896,46700,52,38,66279,45993
113,12,0,1,1,0,0,3,21,31,60896,46701,31,20,66279,45996
114,12,1,2,1,0,0,3,34,24,60897,46703,48,25,66279,45999
115,12,1,0,0,3,1,0,37,28,60898,46703,44,2,66282,45999
116,12,3,0,0,3,1,0,49,36,60901,46703,44,22,66285,45999
117,12,2,0,0,3,1,0,34,24,60903,46703,41,35,66288,45999
118,12,2,2,2,1,2,1,11,4,60905,46705,11,8,66289,46000
119,12,2,1,0,3,1,0,41,26,60907,46706,48,22,66292,46000
120,13,2,0,0,3,1,0,39,17,60909,46706,56,35,66295,46000
121,13,2,1,0,3,1,0,11,12,60911,46707,9,21,66298,46000
122,13,0,1,1,0,0,3,33,41,60911,46708,27,16,66298,46003
123,13,1,1,2,1,2,1,10,4,60912,46709,15,38,66299,46004
124,13,0,1,1,0,0,3,36,20,60912,46710,51,41,66299,46007
125,13,1,1,2,1,2,1,30,30,60913,46711,34,25,66300,46008
126,13,2,0,0,3,1,0,22,28,60915,46711,32,22,66303,46008
127,13,2,0,0,3,1,0,49,34,60917,46711,54,21,66306,46008
128,13,0,1,1,0,0,3,11,5,60917,46712,11,38,66306,46011
129,13,4,0,0,3,1,0,61,16,60921,46712,60,25,66309,46011
130,14,0,2,1,0,0,3,37,30,60921,46714,44,52,66309,46014
131,14,0,1,1,0,0,3,56,28,60921,46715,58,38,66309,46017
132,14,4,2,0,3,1,0,52,24,60925,46717,55,22,66312,46017
133,14,0,1,1,0,0,3,34,25,60925,46718,48,28,66312,46020
134,14,1,0,0,3,1,0,22,31,60926,46718,34,4,66315,46020
135,14,0,0,2,1,2,1,21,17,60926,46718,38,9,66316,46021
136,14,3,0,0,3,1,0,40,22,60929,46718,47,35,66319,46021
137,14,2,0,0,3,1,0,51,36,60931,46718,47,20,66322,46021
138,14,0,0,2,1,2,1,34,24,60931,46718,42,23,66323,46022
139,14,3,0,0,3,1,0,39,20,60934,46718,54,2,66326,46022
140,15,0,2,1,0,0,3,11,7,60934,46720,11,25,66326,46025
141,15,2,3,1,0,0,3,35,44,60936,46723,27,41,66326,46028
142,15,2,0,0,3,1,0,58,28,60938,46723,61,21,66329,46028
143,15,0,1,1,0,0,3,49,35,60938,46724,54,23,66329,46031
144,15,1,1,2,1,2,1,11,5,60939,46725,16,17,66330,46032
145,15,2,2,2,1,2,1,24,33,60941,46727,35,53,66331,46033
146,15,0,0,2,1,2,1,30,30,60941,46727,35,22,66332,46034
147,15,2,1,0,3,1,0,41,18,60943,46728,59,25,66335,46034
148,15,1,1,2,1,2,1,12,13,60944,46729,10,39,66336,46035
149,15,1,1,2,1,2,1,42,27,60945,46730,49,42,66337,46036
150,16,2,0,0,3,1,0,23,17,60947,46730,41,28,66340,46036
151,16,2,2,2,1,2,1,42,24,60949,46732,48,10,66341,46037
152,16,2,0,0,3,1,0,63,16,60951,46732,63,4,66344,46037
153,16,2,0,0,3,1,0,36,25,60953,46732,51,23,66347,46037
154,16,0,1,1,0,0,3,22,29,60953,46733,32,41,66347,46040
155,16,2,1,0,3,1,0,39,31,60955,46734,47,25,66350,46040
156,16,2,0,0,3,1,0,53,36,60957,46734,50,2,66353,46040
157,16,3,3,2,1,2,1,37,27,60960,46737,43,23,66354,46041
158,16,2,2,2,1,2,1,41,22,60962,46739,55,39,66355,46042
159,16,1,3,1,0,0,3,53,27,60963,46742,55,38,66355,46045
160,17,4,0,0,3,1,0,15,7,60967,46742,14,41,66358,46045
161,17,5,0,0,3,1,0,63,28,60972,46742,64,22,66361,46045
162,17,4,1,0,3,1,0,45,19,60976,46743,62,23,66364,46045
163,17,0,2,1,0,0,3,11,7,60976,46745,16,56,66364,46048
164,17,2,0,0,3,1,0,26,33,60978,46745,38,17,66367,46048
165,17,3,0,0,3,1,0,33,30,60981,46745,38,25,66370,46048
166,17,0,1,1,0,0,3,35,45,60981,46746,27,45,66370,46051
167,17,0,3,1,0,0,3,12,16,60981,46749,10,24,66370,46054
168,17,2,0,0,3,1,0,44,27,60983,46749,52,25,66373,46054
169,17,1,3,1,0,0,3,50,38,60984,46752,54,42,66373,46057
170,18,2,0,0,3,1,0,43,22,60986,46752,58,10,66376,46057
171,18,3,1,0,3,1,0,25,30,60989,46753,35,2,66379,46057
172,18,1,0,0,3,1,0,24,17,60990,46753,44,23,66382,46057
173,18,0,1,1,0,0,3,42,25,60990,46754,48,26,66382,46060
174,18,3,2,0,3,1,0,42,33,60993,46756,50,39,66385,46060
175,18,1,1,2,1,2,1,54,37,60994,46757,51,29,66386,46061
176,18,3,1,0,3,1,0,40,28,60997,46758,46,4,66389,46061
177,18,0,1,1,0,0,3,63,17,60997,46759,63,44,66389,46064
178,18,1,1,2,1,2,1,54,28,60998,46760,56,26,66390,46065
179,18,1,1,2,1,2,1,37,26,60999,46761,52,39,66391,46066
180,19,5,1,0,3,1,0,49,28,61004,46762,55,23,66394,46066
181,19,0,2,1,0,0,3,11,9,61004,46764,16,48,66394,46069
182,19,0,0,2,1,2,1,26,33,61004,46764,39,23,66395,46070
183,19,2,2,2,1,2,1,37,47,61006,46766,28,26,66396,46071
184,19,0,3,1,0,0,3,12,19,61006,46769,10,59,66396,46074
185,19,5,3,0,3,1,0,55,41,61011,46772,57,25,66399,46074
186,19,1,1,2,1,2,1,16,8,61012,46773,15,43,66400,46075
187,19,2,1,0,3,1,0,47,20,61014,46774,65,17,66403,46075
188,19,0,0,2,1,2,1,33,30,61014,46774,39,25,66404,46076
189,19,2,1,0,3,1,0,65,29,61016,46775,67,41,66407,46076
190,20,1,1,2,1,2,1,38,27,61017,46776,53,24,66408,46077
191,20,2,1,0,3,1,0,56,38,61019,46777,54,39,66411,46077
192,20,2,1,0,3,1,0,44,26,61021,46778,51,4,66414,46077
193,20,0,1,1,0,0,3,25,31,61021,46779,35,13,66414,46080
194,20,1,1,2,1,2,1,50,29,61022,46780,56,27,66415,46081
195,20,1,0,0,3,1,0,38,47,61023,46780,31,44,66418,46081
196,20,0,3,1,0,0,3,24,20,61023,46783,44,44,66418,46084
197,20,3,2,0,3,1,0,45,35,61026,46785,53,43,66421,46084
198,20,2,0,0,3,1,0,57,41,61028,46785,60,2,66424,46084
199,20,3,0,0,3,1,0,66,17,61031,46785,66,29,66427,46084
200,21,2,1,0,3,1,0,49,21,61033,46786,68,26,66430,46084
201,21,0,0,2,1,2,1,54,28,61033,46786,57,24,66431,46085
202,21,2,0,0,3,1,0,45,22,61035,46786,61,59,66434,46085
203,21,4,4,2,1,2,1,69,33,61039,46790,68,24,66435,46086
204,21,4,2,0,3,1,0,37,32,61043,46792,42,39,66438,46086
205,21,1,2,1,0,0,3,13,21,61044,46794,10,29,66438,46089
206,21,1,0,0,3,1,0,12,9,61045,46794,19,25,66441,46089
207,21,0,0,2,1,2,1,40,28,61045,46794,47,49,66442,46090
208,21,2,0,0,3,1,0,28,33,61047,46794,42,25,66445,46090
209,21,0,1,1,0,0,3,16,9,61047,46795,15,20,66445,46093
210,22,3,2,0,3,1,0,48,37,61050,46797,56,44,66448,46093
211,22,2,1,0,3,1,0,59,42,61052,46798,63,13,66451,46093
212,22,0,0,2,1,2,1,38,47,61052,46798,32,28,66452,46094
213,22,0,0,2,1,2,1,13,21,61052,46798,11,30,66453,46095
214,22,4,0,0,3,1,0,54,29,61056,46798,59,44,66456,46095
215,22,0,0,2,1,2,1,66,17,61056,46798,67,44,66457,46096
216,22,1,2,1,0,0,3,25,22,61057,46800,44,27,66457,46099
217,22,0,0,2,1,2,1,56,38,61057,46800,55,5,66458,46100
218,22,3,2,0,3,1,0,47,28,61060,46802,54,39,66461,46100
219,22,0,0,2,1,2,1,25,31,61060,46802,36,21,66462,46101
220,23,3,2,0,3,1,0,48,24,61063,46804,64,24,66465,46101
221,23,1,2,1,0,0,3,50,23,61064,46806,68,62,66465,46104
222,23,2,1,0,3,1,0,39,33,61066,46807,45,24,66468,46104
223,23,4,0,0,3,1,0,42,27,61070,46807,56,25,66471,46104
224,23,0,0,2,1,2,1,12,9,61070,46807,20,27,66472,46105
225,23,0,1,1,0,0,3,69,34,61070,46808,68,5,66472,46108
226,23,2,0,0,3,1,0,56,28,61072,46808,60,29,66475,46108
227,23,1,0,0,3,1,0,17,9,61073,46808,18,39,66478,46108
228,23,2,2,2,1,2,1,42,30,61075,46810,48,26,66479,46109
229,23,1,1,2,1,2,1,29,34,61076,46811,43,50,66480,46110
230,24,0,3,1,0,0,3,69,37,61076,46814,68,31,66480,46113
231,24,0,3,1,0,0,3,47,31,61076,46817,54,47,66480,46116
232,24,3,1,0,3,1,0,59,39,61079,46818,58,21,66483,46116
233,24,4,1,0,3,1,0,42,48,61083,46819,35,5,66486,46116
234,24,0,0,2,1,2,1,13,21,61083,46819,12,14,66487,46117
235,24,0,1,1,0,0,3,48,38,61083,46820,56,32,66487,46120
236,24,1,3,1,0,0,3,26,34,61084,46823,36,65,66487,46123
237,24,1,0,0,3,1,0,55,29,61085,46823,62,27,66490,46123
238,24,0,0,2,1,2,1,50,23,61085,46823,69,31,66491,46124
239,24,5,1,0,3,1,0,64,43,61090,46824,66,44,66494,46124
240,25,2,2,2,1,2,1,50,40,61092,46826,57,28,66495,46125
241,25,1,1,2,1,2,1,67,18,61093,46827,68,51,66496,46126
242,25,1,0,0,3,1,0,26,22,61094,46827,47,24,66499,46126
243,25,1,2,1,0,0,3,40,35,61095,46829,45,30,66499,46129
244,25,3,1,0,3,1,0,45,28,61098,46830,59,5,66502,46129
245,25,4,1,0,3,1,0,21,10,61102,46831,21,24,66505,46129
246,25,4,1,0,3,1,0,16,10,61106,46832,23,39,66508,46129
247,25,1,0,0,3,1,0,49,24,61107,46832,67,26,66511,46129
248,25,1,0,0,3,1,0,57,28,61108,46832,63,44,66514,46129
249,25,1,3,1,0,0,3,30,37,61109,46835,43,42,66514,46132
250,26,0,4,1,0,0,3,64,47,61109,46839,66,68,66514,46135
251,26,1,1,2,1,2,1,60,40,61110,46840,59,33,66515,46136
252,26,1,2,1,0,0,3,43,32,61111,46842,48,50,66515,46139
253,26,0,0,2,1,2,1,50,23,61111,46842,70,15,66516,46140
254,26,3,0,0,3,1,0,24,10,61114,46842,24,31,66519,46140
255,26,2,0,0,3,1,0,49,31,61116,46842,57,24,66522,46140
256,26,2,2,2,1,2,1,44,50,61118,46844,36,26,66523,46141
257,26,1,2,1,0,0,3,56,31,61119,46846,62,47,66523,46144
258,26,1,0,0,3,1,0,31,37,61120,46846,46,5,66526,46144
259,26,2,2,2,1,2,1,71,39,61122,46848,69,22,66527,46145
260,27,6,3,0,3,1,0,63,31,61128,46851,66,31,66530,46145
261,27,0,2,1,0,0,3,26,24,61128,46853,47,47,66530,46148
262,27,0,1,1,0,0,3,64,48,61128,46854,66,42,66530,46151
263,27,1,0,0,3,1,0,46,28,61129,46854,62,26,66533,46151
264,27,0,0,2,1,2,1,50,40,61129,46854,58,52,66534,46152
265,27,2,0,0,3,1,0,69,18,61131,46854,71,30,66537,46152
266,27,1,1,2,1,2,1,17,11,61132,46855,24,29,66538,46153
267,27,0,2,1,0,0,3,26,36,61132,46857,36,8,66538,46156
268,27,1,3,1,0,0,3,50,27,61133,46860,67,34,66538,46159
269,27,1,0,0,3,1,0,14,21,61134,46860,15,42,66541,46159
270,28,0,2,1,0,0,3,43,34,61134,46862,48,71,66541,46162
271,28,0,5,1,0,0,3,49,36,61134,46867,57,55,66541,46165
272,28,3,0,0,3,1,0,43,35,61137,46867,48,24,66544,46165
273,28,0,0,2,1,2,1,71,39,61137,46867,70,16,66545,46166
274,28,2,2,2,1,2,1,33,39,61139,46869,47,34,66546,46167
275,28,1,0,0,3,1,0,47,28,61140,46869,65,47,66549,46167
276,28,0,2,1,0,0,3,24,12,61140,46871,24,8,66549,46170
277,28,1,1,2,1,2,1,45,51,61141,46872,37,25,66550,46171
278,28,2,2,2,1,2,1,52,25,61143,46874,71,51,66551,46172
279,28,1,0,0,3,1,0,57,31,61144,46874,65,26,66554,46172
280,29,2,1,0,3,1,0,71,19,61146,46875,74,42,66557,46172
281,29,1,1,2,1,2,1,65,49,61147,46876,67,43,66558,46173
282,29,2,0,0,3,1,0,19,11,61149,46876,27,34,66561,46173
283,29,1,0,0,3,1,0,51,27,61150,46876,70,31,66564,46173
284,29,2,2,2,1,2,1,65,33,61152,46878,67,23,66565,46174
285,29,2,2,2,1,2,1,52,42,61154,46880,59,27,66566,46175
286,29,0,0,2,1,2,1,14,21,61154,46880,16,31,66567,46176
287,29,2,2,2,1,2,1,28,38,61156,46882,37,30,66568,46177
288,29,1,1,2,1,2,1,27,25,61157,46883,48,9,66569,46178
289,29,2,0,0,3,1,0,62,40,61159,46883,62,47,66572,46178
290,30,1,1,2,1,2,1,48,29,61160,46884,66,72,66573,46179
291,30,3,1,0,3,1,0,46,35,61163,46885,51,47,66576,46179
292,30,5,2,0,3,1,0,62,33,61168,46887,68,8,66579,46179
293,30,2,0,0,3,1,0,45,35,61170,46887,51,16,66582,46179
294,30,0,0,2,1,2,1,45,51,61170,46887,38,25,66583,46180
295,30,1,2,1,0,0,3,50,38,61171,46889,57,37,66583,46183
296,30,5,4,0,3,1,0,76,43,61176,46893,73,26,66586,46183
297,30,1,3,1,0,0,3,34,42,61177,46896,47,28,66586,46186
298,30,1,0,0,3,1,0,25,12,61178,46896,27,43,66589,46186
299,30,3,0,0,3,1,0,65,40,61181,46896,65,51,66592,46186
300,31,0,0,2,1,2,1,28,38,61181,46896,38,35,66593,46187
301,31,3,2,0,3,1,0,30,27,61184,46898,51,23,66596,46187
302,31,1,2,1,0,0,3,72,21,61185,46900,74,30,66596,46190
303,31,1,1,2,1,2,1,15,22,61186,46901,17,27,66597,46191
304,31,2,2,2,1,2,1,47,37,61188,46903,52,48,66598,46192
305,31,3,1,0,3,1,0,55,26,61191,46904,74,30,66601,46192
306,31,4,2,0,3,1,0,49,53,61195,46906,41,42,66604,46192
307,31,1,2,1,0,0,3,20,13,61196,46908,27,12,66604,46195
308,31,0,2,1,0,0,3,65,51,61196,46910,67,58,66604,46198
309,31,3,1,0,3,1,0,54,28,61199,46911,73,51,66607,46198
310,32,0,1,1,0,0,3,30,28,61199,46912,51,75,66607,46201
311,32,1,3,1,0,0,3,66,36,61200,46915,67,19,66607,46204
312,32,1,1,2,1,2,1,53,43,61201,46916,60,26,66608,46205
313,32,2,1,0,3,1,0,67,41,61203,46917,68,47,66611,46205
314,32,1,2,1,0,0,3,49,31,61204,46919,66,34,66611,46208
315,32,2,0,0,3,1,0,48,35,61206,46919,54,8,66614,46208
316,32,0,0,2,1,2,1,50,38,61206,46919,58,29,66615,46209
317,32,2,1,0,3,1,0,78,44,61208,46920,76,12,66618,46209
318,32,3,1,0,3,1,0,65,34,61211,46921,71,43,66621,46209
319,32,1,0,0,3,1,0,35,42,61212,46921,50,31,66624,46209
320,33,3,0,0,3,1,0,50,37,61215,46921,55,23,66627,46209
321,33,1,0,0,3,1,0,21,13,61216,46921,30,37,66630,46209
322,33,2,1,0,3,1,0,17,23,61218,46922,20,47,66633,46209
323,33,2,0,0,3,1,0,27,12,61220,46922,30,35,66636,46209
324,33,1,2,1,0,0,3,66,36,61221,46924,71,33,66636,46212
325,33,1,3,1,0,0,3,56,29,61222,46927,74,51,66636,46215
326,33,0,2,1,0,0,3,49,55,61222,46929,41,54,66636,46218
327,33,1,2,1,0,0,3,66,53,61223,46931,67,33,66636,46221
328,33,1,0,0,3,1,0,73,21,61224,46931,77,27,66639,46221
329,33,0,1,1,0,0,3,28,39,61224,46932,38,61,66639,46224
330,34,3,0,0,3,1,0,51,35,61227,46932,57,31,66642,46224
331,34,0,0,2,1,2,1,30,28,61227,46932,52,44,66643,46225
332,34,2,0,0,3,1,0,51,31,61229,46932,69,19,66646,46225
333,34,2,0,0,3,1,0,68,36,61231,46932,70,8,66649,46225
334,34,0,0,2,1,2,1,50,38,61231,46932,59,52,66650,46226
335,34,1,1,2,1,2,1,74,22,61232,46933,78,36,66651,46227
336,34,1,1,2,1,2,1,55,29,61233,46934,74,35,66652,46228
337,34,2,2,2,1,2,1,30,41,61235,46936,39,30,66653,46229
338,34,1,4,1,0,0,3,54,47,61236,46940,60,15,66653,46232
339,34,4,0,0,3,1,0,71,41,61240,46940,71,42,66656,46232
340,35,1,1,2,1,2,1,67,54,61241,46941,68,24,66657,46233
341,35,0,0,2,1,2,1,50,37,61241,46941,56,38,66658,46234
342,35,2,2,2,1,2,1,68,38,61243,46943,72,55,66659,46235
343,35,3,2,0,3,1,0,38,44,61246,46945,53,27,66662,46235
344,35,2,1,0,3,1,0,80,45,61248,46946,79,26,66665,46235
345,35,2,0,0,3,1,0,23,13,61250,46946,33,33,66668,46235
346,35,0,4,1,0,0,3,17,27,61250,46950,20,64,66668,46238
347,35,1,4,1,0,0,3,28,16,61251,46954,30,78,66668,46241
348,35,1,2,1,0,0,3,50,57,61252,46956,41,36,66668,46244
349,35,2,0,0,3,1,0,58,29,61254,46956,77,47,66671,46244
350,36,0,0,2,1,2,1,30,28,61254,46956,53,43,66672,46245
351,36,2,0,0,3,1,0,70,36,61256,46956,73,30,66675,46245
352,36,2,0,0,3,1,0,76,22,61258,46956,81,19,66678,46245
353,36,0,1,1,0,0,3,51,32,61258,46957,69,39,66678,46248
354,36,2,1,0,3,1,0,56,48,61260,46958,63,31,66681,46248
355,36,3,1,0,3,1,0,54,36,61263,46959,60,52,66684,46248
356,36,1,1,2,1,2,1,72,42,61264,46960,72,36,66685,46249
357,36,2,2,2,1,2,1,52,40,61266,46962,60,9,66686,46250
358,36,1,1,2,1,2,1,56,30,61267,46963,75,16,66687,46251
359,36,0,1,1,0,0,3,30,42,61267,46964,39,47,66687,46254
360,37,0,1,1,0,0,3,50,58,61267,46965,41,36,66687,46257
361,37,2,2,2,1,2,1,70,40,61269,46967,73,25,66688,46258
362,37,0,2,1,0,0,3,28,18,61269,46969,30,39,66688,46261
363,37,3,0,0,3,1,0,20,27,61272,46969,23,26,66691,46261
364,37,4,4,2,1,2,1,71,58,61276,46973,69,39,66692,46262
365,37,2,0,0,3,1,0,60,29,61278,46973,80,27,66695,46262
366,37,0,2,1,0,0,3,23,15,61278,46975,33,50,66695,46265
367,37,2,0,0,3,1,0,40,44,61280,46975,56,55,66698,46265
368,37,0,2,1,0,0,3,50,39,61280,46977,56,67,66698,46268
369,37,4,2,0,3,1,0,84,47,61284,46979,82,78,66701,46268
370,38,3,1,0,3,1,0,75,43,61287,46980,75,19,66704,46268
371,38,0,0,2,1,2,1,52,40,61287,46980,61,32,66705,46269
372,38,2,1,0,3,1,0,78,23,61289,46981,84,9,66708,46269
373,38,1,0,0,3,1,0,55,36,61290,46981,63,39,66711,46269
374,38,2,3,1,0,0,3,32,45,61292,46984,39,46,66711,46272
375,38,3,1,0,3,1,0,59,31,61295,46985,78,52,66714,46272
376,38,1,0,0,3,1,0,31,28,61296,46985,56,36,66717,46272
377,38,2,0,0,3,1,0,58,48,61298,46985,66,30,66720,46272
378,38,2,1,0,3,1,0,72,37,61300,46986,76,16,66723,46272
379,38,0,2,1,0,0,3,51,34,61300,46988,69,50,66723,46275
0,1,2,1,0,3,1,0,54,41,61302,46989,64,50,66726,46275
1,1,2,0,0,3,1,0,77,43,61304,46989,78,39,66729,46275
2,1,0,1,1,0,0,3,78,24,61304,46990,84,18,66729,46278
3,1,0,1,1,0,0,3,23,16,61304,46991,33,53,66729,46281
4,1,2,0,0,3,1,0,33,28,61306,46991,59,39,66732,46281
5,1,2,0,0,3,1,0,60,48,61308,46991,69,32,66735,46281
6,1,0,3,1,0,0,3,71,61,61308,46994,69,58,66735,46284
7,1,0,3,1,0,0,3,0,3,61308,46997,0,55,66735,46287
8,1,2,2,2,1,2,1,72,42,61310,46999,74,26,66736,46288
9,1,0,0,2,1,2,1,28,18,61310,46999,31,1,66737,46289
10,2,3,0,0,3,1,0,3,0,61313,46999,3,0,66740,46289
11,2,1,3,1,0,0,3,41,47,61314,47002,56,81,66740,46292
12,2,1,4,1,0,0,3,61,33,61315,47006,80,70,66740,46295
13,2,1,1,2,1,2,1,51,40,61316,47007,57,20,66741,46296
14,2,3,2,0,3,1,0,54,36,61319,47009,72,27,66744,46296
15,2,1,3,1,0,0,3,85,50,61320,47012,82,49,66744,46299
16,2,3,0,0,3,1,0,62,31,61323,47012,81,30,66747,46299
17,2,2,1,0,3,1,0,74,38,61325,47013,79,36,66750,46299
18,2,2,0,0,3,1,0,57,36,61327,47013,66,39,66753,46299
19,2,2,1,0,3,1,0,23,22,61329,47014,24,16,66756,46299
20,3,1,1,2,1,2,1,72,62,61330,47015,70,33,66757,46300
21,3,0,1,1,0,0,3,78,25,61330,47016,84,23,66757,46303
22,3,1,3,1,0,0,3,34,31,61331,47019,59,56,66757,46306
23,3,2,0,0,3,1,0,56,41,61333,47019,67,26,66760,46306
24,3,1,3,1,0,0,3,61,51,61334,47022,69,73,66760,46309
25,3,3,1,0,3,1,0,77,39,61337,47023,82,39,66763,46309
26,3,2,3,1,0,0,3,2,6,61339,47026,0,21,66763,46312
27,3,2,3,1,0,0,3,74,45,61341,47029,74,42,66763,46315
28,3,2,2,2,1,2,1,30,20,61343,47031,32,51,66764,46316
29,3,0,2,1,0,0,3,3,2,61343,47033,3,58,66764,46319
30,4,1,1,2,1,2,1,58,37,61344,47034,67,37,66765,46320
31,4,2,0,0,3,1,0,79,43,61346,47034,81,39,66768,46320
32,4,0,3,1,0,0,3,51,43,61346,47037,57,52,66768,46323
33,4,1,1,2,1,2,1,24,23,61347,47038,25,2,66769,46324
34,4,1,0,0,3,1,0,24,16,61348,47038,36,30,66772,46324
35,4,1,1,2,1,2,1,42,48,61349,47039,57,1,66773,46325
36,4,0,0,2,1,2,1,54,36,61349,47039,73,59,66774,46326
37,4,0,2,1,0,0,3,85,52,61349,47041,82,19,66774,46329
38,4,2,1,0,3,1,0,63,34,61351,47042,83,81,66777,46329
39,4,0,1,1,0,0,3,62,32,61351,47043,81,30,66777,46332
40,5,0,0,2,1,2,1,56,41,61351,47043,68,74,66778,46333
41,5,1,0,0,3,1,0,3,6,61352,47043,3,30,66781,46333
42,5,2,1,0,3,1,0,56,37,61354,47044,76,23,66784,46333
43,5,0,2,1,0,0,3,34,33,61354,47046,59,61,66784,46336
44,5,1,1,2,1,2,1,62,52,61355,47047,70,40,66785,46337
45,5,2,0,0,3,1,0,80,25,61357,47047,87,33,66788,46337
46,5,3,0,0,3,1,0,80,39,61360,47047,85,56,66791,46337
47,5,1,1,2,1,2,1,75,46,61361,47048,75,22,66792,46338
48,5,0,0,2,1,2,1,3,2,61361,47048,4,52,66793,46339
49,5,1,0,0,3,1,0,31,20,61362,47048,35,42,66796,46339
50,6,1,1,2,1,2,1,59,38,61363,47049,68,82,66797,46340
51,6,4,1,0,3,1,0,83,44,61367,47050,84,52,66800,46340
52,6,0,0,2,1,2,1,63,34,61367,47050,84,31,66801,46341
53,6,1,5,1,0,0,3,25,21,61368,47055,36,5,66801,46344
54,6,4,0,0,3,1,0,46,48,61372,47055,60,26,66804,46344
55,6,1,2,1,0,0,3,52,45,61373,47057,57,4,66804,46347
56,6,2,1,0,3,1,0,64,33,61375,47058,84,19,66807,46347
57,6,4,1,0,3,1,0,76,63,61379,47059,73,39,66810,46347
58,6,0,1,1,0,0,3,24,24,61379,47060,25,62,66810,46350
59,6,2,1,0,3,1,0,87,53,61381,47061,85,37,66813,46350
60,7,2,1,0,3,1,0,36,34,61383,47062,62,22,66816,46350
61,7,1,1,2,1,2,1,63,53,61384,47063,71,31,66817,46351
62,7,2,0,0,3,1,0,77,46,61386,47063,78,23,66820,46351
63,7,2,0,0,3,1,0,58,37,61388,47063,79,40,66823,46351
64,7,1,0,0,3,1,0,57,41,61389,47063,71,42,66826,46351
65,7,0,3,1,0,0,3,3,9,61389,47066,3,59,66826,46354
66,7,1,2,1,0,0,3,32,22,61390,47068,35,77,66826,46357
67,7,0,1,1,0,0,3,3,3,61390,47069,4,36,66826,46360
68,7,0,1,1,0,0,3,80,26,61390,47070,87,64,66826,46363
69,7,2,1,0,3,1,0,82,40,61392,47071,88,52,66829,46363
70,8,2,0,0,3,1,0,85,44,61394,47071,87,62,66832,46363
71,8,3,2,0,3,1,0,67,35,61397,47073,87,82,66835,46363
72,8,1,0,0,3,1,0,53,45,61398,47073,60,42,66838,46363
73,8,2,1,0,3,1,0,27,22,61400,47074,39,19,66841,46363
74,8,1,1,2,1,2,1,37,35,61401,47075,63,38,66842,46364
75,8,2,0,0,3,1,0,89,53,61403,47075,88,26,66845,46364
76,8,0,0,2,1,2,1,76,63,61403,47075,74,6,66846,46365
77,8,2,1,0,3,1,0,61,39,61405,47076,71,22,66849,46365
78,8,1,0,0,3,1,0,64,34,61406,47076,87,4,66852,46365
79,8,2,4,1,0,0,3,65,57,61408,47080,71,55,66852,46368
80,9,0,0,2,1,2,1,32,22,61408,47080,36,32,66853,46369
81,9,1,0,0,3,1,0,81,26,61409,47080,90,31,66856,46369
82,9,0,1,1,0,0,3,58,38,61409,47081,79,80,66856,46372
83,9,1,3,1,0,0,3,47,51,61410,47084,60,67,66856,46375
84,9,2,0,0,3,1,0,59,41,61412,47084,74,59,66859,46375
85,9,0,0,2,1,2,1,3,9,61412,47084,4,24,66860,46376
86,9,0,1,1,0,0,3,24,25,61412,47085,25,39,66860,46379
87,9,1,3,1,0,0,3,4,6,61413,47088,4,43,66860,46382
88,9,1,0,0,3,1,0,83,40,61414,47088,91,39,66863,46382
89,9,2,3,1,0,0,3,79,49,61416,47091,78,55,66863,46385
90,10,2,2,2,1,2,1,78,65,61418,47093,75,83,66864,46386
91,10,1,0,0,3,1,0,28,22,61419,47093,42,62,66867,46386
92,10,4,2,0,3,1,0,57,47,61423,47095,63,19,66870,46386
93,10,2,0,0,3,1,0,39,35,61425,47095,66,4,66873,46386
94,10,3,2,0,3,1,0,92,55,61428,47097,91,22,66876,46386
95,10,2,1,0,3,1,0,87,45,61430,47098,90,42,66879,46386
96,10,1,1,2,1,2,1,68,36,61431,47099,88,7,66880,46387
97,10,3,2,0,3,1,0,64,41,61434,47101,74,55,66883,46387
98,10,2,2,2,1,2,1,66,36,61436,47103,88,27,66884,46388
99,10,0,1,1,0,0,3,65,58,61436,47104,71,41,66884,46391
100,11,5,1,0,3,1,0,86,27,61441,47105,93,39,66887,46391
101,11,1,3,1,0,0,3,88,48,61442,47108,90,70,66887,46394
102,11,2,0,0,3,1,0,5,9,61444,47108,7,43,66890,46394
103,11,1,1,2,1,2,1,48,52,61445,47109,61,56,66891,46395
104,11,4,0,0,3,1,0,62,38,61449,47109,82,59,66894,46395
105,11,4,1,0,3,1,0,63,42,61453,47110,77,39,66897,46395
106,11,1,1,2,1,2,1,84,41,61454,47111,92,8,66898,46396
107,11,1,2,1,0,0,3,25,27,61455,47113,25,27,66898,46399
108,11,1,0,0,3,1,0,33,22,61456,47113,39,31,66901,46399
109,11,4,1,0,3,1,0,83,50,61460,47114,81,32,66904,46399
110,12,0,0,2,1,2,1,57,47,61460,47114,64,28,66905,46400
111,12,1,6,1,0,0,3,6,15,61461,47120,7,83,66905,46403
112,12,2,0,0,3,1,0,80,65,61463,47120,78,22,66908,46403
113,12,2,2,2,1,2,1,41,37,61465,47122,67,57,66909,46404
114,12,2,4,1,0,0,3,67,62,61467,47126,71,65,66909,46407
115,12,3,2,0,3,1,0,71,38,61470,47128,91,55,66912,46407
116,12,1,3,1,0,0,3,87,30,61471,47131,93,44,66912,46410
117,12,0,0,2,1,2,1,64,41,61471,47131,75,20,66913,46411
118,12,1,0,0,3,1,0,5,6,61472,47131,7,42,66916,46411
119,12,3,2,0,3,1,0,31,24,61475,47133,45,70,66919,46411
120,13,0,0,2,1,2,1,88,48,61475,47133,91,60,66920,46412
121,13,2,2,2,1,2,1,86,43,61477,47135,93,84,66921,46413
122,13,3,0,0,3,1,0,51,52,61480,47135,64,32,66924,46413
123,13,2,1,0,3,1,0,64,39,61482,47136,85,39,66927,46413
124,13,4,1,0,3,1,0,67,43,61486,47137,80,27,66930,46413
125,13,2,2,2,1,2,1,94,57,61488,47139,92,40,66931,46414
126,13,1,0,0,3,1,0,34,22,61489,47139,42,4,66934,46414
127,13,2,2,2,1,2,1,68,38,61491,47141,89,44,66935,46415
128,13,3,1,0,3,1,0,28,28,61494,47142,28,31,66938,46415
129,13,2,0,0,3,1,0,85,50,61496,47142,84,8,66941,46415
130,14,3,1,0,3,1,0,83,66,61499,47143,81,28,66944,46415
131,14,0,1,1,0,0,3,31,25,61499,47144,45,34,66944,46418
132,14,0,0,2,1,2,1,41,37,61499,47144,68,21,66945,46419
133,14,0,1,1,0,0,3,6,16,61499,47145,7,58,66945,46422
134,14,1,0,0,3,1,0,29,28,61500,47145,31,42,66948,46422
135,14,2,2,2,1,2,1,7,8,61502,47147,8,45,66949,46423
136,14,1,0,0,3,1,0,88,30,61503,47147,96,83,66952,46423
137,14,0,1,1,0,0,3,57,48,61503,47148,64,68,66952,46426
138,14,1,0,0,3,1,0,65,41,61504,47148,78,70,66955,46426
139,14,3,0,0,3,1,0,74,38,61507,47148,94,57,66958,46426
140,15,1,3,1,0,0,3,65,42,61508,47151,85,87,66958,46429
141,15,3,0,0,3,1,0,91,48,61511,47151,94,8,66961,46429
142,15,5,1,0,3,1,0,91,44,61516,47152,96,4,66964,46429
143,15,2,1,0,3,1,0,53,53,61518,47153,67,27,66967,46429
144,15,2,4,1,0,0,3,69,66,61520,47157,71,42,66967,46432
145,15,1,0,0,3,1,0,95,57,61521,47157,95,32,66970,46432
146,15,2,1,0,3,1,0,76,39,61523,47158,97,44,66973,46432
147,15,1,3,1,0,0,3,35,25,61524,47161,42,61,66973,46435
148,15,4,1,0,3,1,0,72,39,61528,47162,92,40,66976,46435
149,15,2,2,2,1,2,1,69,45,61530,47164,81,23,66977,46436
150,16,2,1,0,3,1,0,33,26,61532,47165,48,44,66980,46436
151,16,4,2,0,3,1,0,89,52,61536,47167,87,45,66983,46436
152,16,0,2,1,0,0,3,57,50,61536,47169,64,45,66983,46439
153,16,0,1,1,0,0,3,83,67,61536,47170,81,86,66983,46442
154,16,2,0,0,3,1,0,8,16,61538,47170,10,34,66986,46442
155,16,1,3,1,0,0,3,36,28,61539,47173,42,31,66986,46445
156,16,2,4,1,0,0,3,9,12,61541,47177,8,90,66986,46448
157,16,2,1,0,3,1,0,97,58,61543,47178,98,68,66989,46448
158,16,0,2,1,0,0,3,29,30,61543,47180,31,60,66989,46451
159,16,0,0,2,1,2,1,53,53,61543,47180,68,61,66990,46452
160,17,1,1,2,1,2,1,73,40,61544,47181,93,33,66991,46453
161,17,1,0,0,3,1,0,77,39,61545,47181,100,70,66994,46453
162,17,4,1,0,3,1,0,73,46,61549,47182,84,21,66997,46453
163,17,3,1,0,3,1,0,68,43,61552,47183,88,23,67000,46453
164,17,1,0,0,3,1,0,42,37,61553,47183,71,61,67003,46453
165,17,1,1,2,1,2,1,70,67,61554,47184,72,9,67004,46454
166,17,3,0,0,3,1,0,94,48,61557,47184,97,27,67007,46454
167,17,4,1,0,3,1,0,92,31,61561,47185,99,4,67010,46454
168,17,4,1,0,3,1,0,69,42,61565,47186,81,40,67013,46454
169,17,2,3,1,0,0,3,93,47,61567,47189,96,45,67013,46457
170,18,2,1,0,3,1,0,10,17,61569,47190,13,31,67016,46457
171,18,1,3,1,0,0,3,58,53,61570,47193,64,89,67016,46460
172,18,1,1,2,1,2,1,98,59,61571,47194,99,35,67017,46461
173,18,1,1,2,1,2,1,34,27,61572,47195,49,61,67018,46462
174,18,1,2,1,0,0,3,54,55,61573,47197,68,47,67018,46465
175,18,0,3,1,0,0,3,83,70,61573,47200,81,48,67018,46468
176,18,0,1,1,0,0,3,29,31,61573,47201,31,64,67018,46471
177,18,0,2,1,0,0,3,36,30,61573,47203,42,71,67018,46474
178,18,2,0,0,3,1,0,11,12,61575,47203,11,45,67021,46474
179,18,4,2,0,3,1,0,93,54,61579,47205,90,90,67024,46474
180,19,0,0,2,1,2,1,68,43,61579,47205,89,10,67025,46475
181,19,2,1,0,3,1,0,79,40,61581,47206,103,40,67028,46475
182,19,3,0,0,3,1,0,76,40,61584,47206,96,70,67031,46475
183,19,1,0,0,3,1,0,43,37,61585,47206,74,27,67034,46475
184,19,0,2,1,0,0,3,73,48,61585,47208,84,7,67034,46478
185,19,2,0,0,3,1,0,72,67,61587,47208,75,45,67037,46478
186,19,1,2,1,0,0,3,95,50,61588,47210,97,26,67037,46481
187,19,2,1,0,3,1,0,94,32,61590,47211,102,21,67040,46481
188,19,2,1,0,3,1,0,71,43,61592,47212,84,33,67043,46481
189,19,4,1,0,3,1,0,97,48,61596,47213,99,61,67046,46481
190,20,4,0,0,3,1,0,58,55,61600,47213,71,45,67049,46481
191,20,2,0,0,3,1,0,100,59,61602,47213,102,7,67052,46481
192,20,3,2,0,3,1,0,14,14,61605,47215,14,21,67055,46481
193,20,2,0,0,3,1,0,81,40,61607,47215,106,27,67058,46481
194,20,3,1,0,3,1,0,79,41,61610,47216,99,48,67061,46481
195,20,2,1,0,3,1,0,60,54,61612,47217,67,35,67064,46481
196,20,1,1,2,1,2,1,72,44,61613,47218,85,90,67065,46482
197,20,3,0,0,3,1,0,100,48,61616,47218,102,33,67068,46482
198,20,1,0,0,3,1,0,69,43,61617,47218,92,61,67071,46482
199,20,0,0,2,1,2,1,29,31,61617,47218,32,91,67072,46483
200,21,2,2,2,1,2,1,85,72,61619,47220,82,65,67073,46484
201,21,4,0,0,3,1,0,99,50,61623,47220,100,61,67076,46484
202,21,1,1,2,1,2,1,74,49,61624,47221,85,72,67077,46485
203,21,2,1,0,3,1,0,96,33,61626,47222,105,45,67080,46485
204,21,0,2,1,0,0,3,72,69,61626,47224,75,34,67080,46488
205,21,1,1,2,1,2,1,44,38,61627,47225,75,48,67081,46489
206,21,1,0,0,3,1,0,37,30,61628,47225,45,26,67084,46489
207,21,0,2,1,0,0,3,10,19,61628,47227,13,13,67084,46492
208,21,1,1,2,1,2,1,35,28,61629,47228,50,41,67085,46493
209,21,1,1,2,1,2,1,94,55,61630,47229,91,71,67086,46494
210,22,0,1,1,0,0,3,81,41,61630,47230,106,48,67086,46497
211,22,1,1,2,1,2,1,100,51,61631,47231,101,36,67087,46498
212,22,3,3,2,1,2,1,61,58,61634,47234,72,62,67088,46499
213,22,2,1,0,3,1,0,71,44,61636,47235,95,48,67091,46499
214,22,0,1,1,0,0,3,35,29,61636,47236,50,94,67091,46502
215,22,1,2,1,0,0,3,73,46,61637,47238,85,75,67091,46505
216,22,1,1,2,1,2,1,61,55,61638,47239,68,34,67092,46506
217,22,6,0,0,3,1,0,35,31,61644,47239,35,7,67095,46506
218,22,1,0,0,3,1,0,80,41,61645,47239,102,21,67098,46506
219,22,2,2,2,1,2,1,102,61,61647,47241,103,14,67099,46507
220,23,2,4,1,0,0,3,96,59,61649,47245,91,44,67099,46510
221,23,0,0,2,1,2,1,14,14,61649,47245,15,27,67100,46511
222,23,2,0,0,3,1,0,102,48,61651,47245,105,34,67103,46511
223,23,1,2,1,0,0,3,45,40,61652,47247,75,93,67103,46514
224,23,1,2,1,0,0,3,86,74,61653,47249,82,30,67103,46517
225,23,2,3,1,0,0,3,12,22,61655,47252,13,48,67103,46520
226,23,3,1,0,3,1,0,40,31,61658,47253,48,71,67106,46520
227,23,3,2,0,3,1,0,75,71,61661,47255,78,65,67109,46520
228,23,2,0,0,3,1,0,76,49,61663,47255,88,48,67112,46520
229,23,2,1,0,3,1,0,98,34,61665,47256,108,61,67115,46520
230,24,2,0,0,3,1,0,102,51,61667,47256,104,48,67118,46520
231,24,1,1,2,1,2,1,82,42,61668,47257,107,76,67119,46521
232,24,0,0,2,1,2,1,73,46,61668,47257,86,37,67120,46522
233,24,0,0,2,1,2,1,35,29,61668,47257,51,35,67121,46523
234,24,1,1,2,1,2,1,62,56,61669,47258,69,95,67122,46524
235,24,1,1,2,1,2,1,87,75,61670,47259,83,8,67123,46525
236,24,3,1,0,3,1,0,38,32,61673,47260,38,62,67126,46525
237,24,1,1,2,1,2,1,62,59,61674,47261,73,22,67127,46526
238,24,1,0,0,3,1,0,81,41,61675,47261,105,14,67130,46526
239,24,3,1,0,3,1,0,105,62,61678,47262,106,48,67133,46526
240,25,2,1,0,3,1,0,100,35,61680,47263,111,48,67136,46526
241,25,1,1,2,1,2,1,46,41,61681,47264,76,35,67137,46527
242,25,1,0,0,3,1,0,97,59,61682,47264,94,93,67140,46527
243,25,2,1,0,3,1,0,16,15,61684,47265,18,30,67143,46527
244,25,1,0,0,3,1,0,72,44,61685,47265,98,48,67146,46527
245,25,0,2,1,0,0,3,12,24,61685,47267,13,47,67146,46530
246,25,0,0,2,1,2,1,102,48,61685,47267,106,28,67147,46531
247,25,1,0,0,3,1,0,76,71,61686,47267,81,61,67150,46531
248,25,4,1,0,3,1,0,80,50,61690,47268,91,71,67153,46531
249,25,3,0,0,3,1,0,43,31,61693,47268,51,65,67156,46531
250,26,0,0,2,1,2,1,87,75,61693,47268,84,38,67157,46532
251,26,2,0,0,3,1,0,40,32,61695,47268,41,48,67160,46532
252,26,1,2,1,0,0,3,74,48,61696,47270,86,38,67160,46535
253,26,2,3,1,0,0,3,37,32,61698,47273,51,65,67160,46538
254,26,3,0,0,3,1,0,105,51,61701,47273,107,22,67163,46538
255,26,4,3,0,3,1,0,66,59,61705,47276,72,14,67166,46538
256,26,1,1,2,1,2,1,106,63,61706,47277,107,96,67167,46539
257,26,0,0,2,1,2,1,81,41,61706,47277,106,77,67168,46540
258,26,2,0,0,3,1,0,84,42,61708,47277,110,8,67171,46540
259,26,2,1,0,3,1,0,64,60,61710,47278,76,48,67174,46540
260,27,1,1,2,1,2,1,103,49,61711,47279,107,94,67175,46541
261,27,3,0,0,3,1,0,103,35,61714,47279,114,65,67178,46541
262,27,0,0,2,1,2,1,16,15,61714,47279,19,36,67179,46542
263,27,0,2,1,0,0,3,43,33,61714,47281,51,33,67179,46545
264,27,3,0,0,3,1,0,67,60,61717,47281,79,47,67182,46545
265,27,2,1,0,3,1,0,82,51,61719,47282,94,48,67185,46545
266,27,2,3,1,0,0,3,74,47,61721,47285,98,74,67185,46548
267,27,1,0,0,3,1,0,41,32,61722,47285,44,48,67188,46548
268,27,0,1,1,0,0,3,12,25,61722,47286,13,64,67188,46551
269,27,3,1,0,3,1,0,100,60,61725,47287,97,38,67191,46551
270,28,0,2,1,0,0,3,76,73,61725,47289,81,99,67191,46554
271,28,1,1,2,1,2,1,82,42,61726,47290,107,66,67192,46555
272,28,2,1,0,3,1,0,39,33,61728,47291,54,8,67195,46555
273,28,1,0,0,3,1,0,106,51,61729,47291,110,38,67198,46555
274,28,2,0,0,3,1,0,48,41,61731,47291,79,77,67201,46555
275,28,3,1,0,3,1,0,69,60,61734,47292,75,28,67204,46555
276,28,1,2,1,0,0,3,88,77,61735,47294,84,25,67204,46558
277,28,4,1,0,3,1,0,78,49,61739,47295,89,14,67207,46558
278,28,0,1,1,0,0,3,106,64,61739,47296,107,51,67207,46561
279,28,0,2,1,0,0,3,84,44,61739,47298,110,51,67207,46564
280,29,3,1,0,3,1,0,77,48,61742,47299,101,64,67210,46564
281,29,0,2,1,0,0,3,67,62,61742,47301,79,97,67210,46567
282,29,0,0,2,1,2,1,43,33,61742,47301,52,48,67211,46568
283,29,3,2,0,3,1,0,106,51,61745,47303,110,33,67214,46568
284,29,0,2,1,0,0,3,12,27,61745,47305,13,51,67214,46571
285,29,3,2,0,3,1,0,85,53,61748,47307,97,38,67217,46571
286,29,2,0,0,3,1,0,105,35,61750,47307,117,36,67220,46571
287,29,1,0,0,3,1,0,17,15,61751,47307,22,65,67223,46571
288,29,2,0,0,3,1,0,102,60,61753,47307,100,48,67226,46571
289,29,0,2,1,0,0,3,41,34,61753,47309,44,77,67226,46574
290,30,0,0,2,1,2,1,82,42,61753,47309,108,52,67227,46575
291,30,2,1,0,3,1,0,86,45,61755,47310,113,38,67230,46575
292,30,2,1,0,3,1,0,71,61,61757,47311,78,51,67233,46575
293,30,1,2,1,0,0,3,107,66,61758,47313,107,100,67233,46578
294,30,3,0,0,3,1,0,81,49,61761,47313,92,8,67236,46578
295,30,2,0,0,3,1,0,90,77,61763,47313,87,66,67239,46578
296,30,0,0,2,1,2,1,39,33,61763,47313,55,29,67240,46579
297,30,2,2,2,1,2,1,78,75,61765,47315,82,26,67241,46580
298,30,0,1,1,0,0,3,48,42,61765,47316,79,102,67241,46583
299,30,3,5,1,0,0,3,20,20,61768,47321,22,80,67241,46586
300,31,2,1,0,3,1,0,108,52,61770,47322,113,8,67244,46586
301,31,2,2,2,1,2,1,69,64,61772,47324,80,15,67245,46587
302,31,2,2,2,1,2,1,87,55,61774,47326,98,103,67246,46588
303,31,0,0,2,1,2,1,77,48,61774,47326,102,49,67247,46589
304,31,3,1,0,3,1,0,85,43,61777,47327,111,51,67250,46589
305,31,1,3,1,0,0,3,42,37,61778,47330,44,39,67250,46592
306,31,0,0,2,1,2,1,43,33,61778,47330,53,49,67251,46593
307,31,3,4,1,0,0,3,110,70,61781,47334,107,36,67251,46596
308,31,2,0,0,3,1,0,108,51,61783,47334,113,38,67254,46596
309,31,1,1,2,1,2,1,103,61,61784,47335,101,66,67255,46597
310,32,2,3,1,0,0,3,14,30,61786,47338,13,29,67255,46600
311,32,0,2,1,0,0,3,39,35,61786,47340,55,54,67255,46603
312,32,1,1,2,1,2,1,91,78,61787,47341,88,53,67256,46604
313,32,0,0,2,1,2,1,48,42,61787,47341,80,39,67257,46605
314,32,2,0,0,3,1,0,73,61,61789,47341,81,77,67260,46605
315,32,1,2,1,0,0,3,21,22,61790,47343,22,69,67260,46608
316,32,1,1,2,1,2,1,79,76,61791,47344,83,30,67261,46609
317,32,0,3,1,0,0,3,81,52,61791,47347,92,67,67261,46612
318,32,1,1,2,1,2,1,106,36,61792,47348,118,81,67262,46613
319,32,0,2,1,0,0,3,86,47,61792,47350,113,103,67262,46616
320,33,1,1,2,1,2,1,80,77,61793,47351,84,37,67263,46617
321,33,1,0,0,3,1,0,86,43,61794,47351,114,66,67266,46617
322,33,1,0,0,3,1,0,111,70,61795,47351,110,49,67269,46617
323,33,3,2,0,3,1,0,111,53,61798,47353,116,49,67272,46617
324,33,0,1,1,0,0,3,43,34,61798,47354,53,54,67272,46620
325,33,1,1,2,1,2,1,78,49,61799,47355,103,40,67273,46621
326,33,1,1,2,1,2,1,104,62,61800,47356,102,9,67274,46622
327,33,1,1,2,1,2,1,70,65,61801,47357,81,31,67275,46623
328,33,4,3,0,3,1,0,91,58,61805,47360,101,15,67278,46623
329,33,1,0,0,3,1,0,109,52,61806,47360,116,103,67281,46623
330,34,1,1,2,1,2,1,40,36,61807,47361,56,54,67282,46624
331,34,0,1,1,0,0,3,73,62,61807,47362,81,70,67282,46627
332,34,0,3,1,0,0,3,14,33,61807,47365,13,84,67282,46630
333,34,0,3,1,0,0,3,42,40,61807,47368,44,57,67282,46633
334,34,0,1,1,0,0,3,48,43,61807,47369,80,41,67282,46636
335,34,1,0,0,3,1,0,92,78,61808,47369,91,77,67285,46636
336,34,0,2,1,0,0,3,21,24,61808,47371,22,106,67285,46639
337,34,0,0,2,1,2,1,81,52,61808,47371,93,67,67286,46640
338,34,4,0,0,3,1,0,108,62,61812,47371,105,29,67289,46640
339,34,4,2,0,3,1,0,110,38,61816,47373,121,39,67292,46640
340,35,0,0,2,1,2,1,48,43,61816,47373,81,50,67293,46641
341,35,0,1,1,0,0,3,91,59,61816,47374,101,72,67293,46644
342,35,3,1,0,3,1,0,89,44,61819,47375,117,31,67296,46644
343,35,2,0,0,3,1,0,83,52,61821,47375,96,37,67299,46644
344,35,6,0,0,3,1,0,92,47,61827,47375,116,54,67302,46644
345,35,1,0,0,3,1,0,110,52,61828,47375,119,40,67305,46644
346,35,4,1,0,3,1,0,84,78,61832,47376,87,9,67308,46644
347,35,3,0,0,3,1,0,81,49,61835,47376,106,29,67311,46644
348,35,1,0,0,3,1,0,111,38,61836,47376,124,15,67314,46644
349,35,3,1,0,3,1,0,114,54,61839,47377,119,77,67317,46644
350,36,0,1,1,0,0,3,108,63,61839,47378,105,57,67317,46647
351,36,0,4,1,0,0,3,14,37,61839,47382,13,106,67317,46650
352,36,1,1,2,1,2,1,43,41,61840,47383,45,40,67318,46651
353,36,0,1,1,0,0,3,43,35,61840,47384,53,60,67318,46654
354,36,0,0,2,1,2,1,21,24,61840,47384,23,42,67319,46655
355,36,0,1,1,0,0,3,40,37,61840,47385,56,109,67319,46658
356,36,1,3,1,0,0,3,112,73,61841,47388,110,70,67319,46661
357,36,0,3,1,0,0,3,70,68,61841,47391,81,87,67319,46664
358,36,0,1,1,0,0,3,73,63,61841,47392,81,52,67319,46667
359,36,2,3,1,0,0,3,94,81,61843,47395,91,73,67319,46670
360,37,1,1,2,1,2,1,111,53,61844,47396,120,51,67320,46671
361,37,1,0,0,3,1,0,82,49,61845,47396,109,9,67323,46671
362,37,0,0,2,1,2,1,84,78,61845,47396,88,78,67324,46672
363,37,1,0,0,3,1,0,92,59,61846,47396,104,40,67327,46672
364,37,1,1,2,1,2,1,49,44,61847,47397,82,16,67328,46673
365,37,2,1,0,3,1,0,91,45,61849,47398,120,37,67331,46673
366,37,2,0,0,3,1,0,94,47,61851,47398,119,31,67334,46673
367,37,2,1,0,3,1,0,116,55,61853,47399,122,29,67337,46673
368,37,0,2,1,0,0,3,83,54,61853,47401,96,57,67337,46676
369,37,0,0,2,1,2,1,111,38,61853,47401,125,73,67338,46677
370,38,3,2,0,3,1,0,46,43,61856,47403,48,109,67341,46677
371,38,2,2,2,1,2,1,42,39,61858,47405,57,58,67342,46678
372,38,0,0,2,1,2,1,70,68,61858,47405,82,43,67343,46679
373,38,2,2,2,1,2,1,23,26,61860,47407,24,41,67344,46680
374,38,1,5,1,0,0,3,15,42,61861,47412,13,63,67344,46683
375,38,1,0,0,3,1,0,74,63,61862,47412,84,70,67347,46683
376,38,1,2,1,0,0,3,44,37,61863,47414,53,109,67347,46686
377,38,2,1,0,3,1,0,110,64,61865,47415,108,87,67350,46686
378,38,1,3,1,0,0,3,95,84,61866,47418,91,55,67350,46689
379,38,2,5,1,0,0,3,114,78,61868,47423,110,76,67350,46692
0,1,2,1,0,3,1,0,2,1,61870,47424,3,109,67353,46692
1,1,0,1,1,0,0,3,46,44,61870,47425,48,112,67353,46695
2,1,2,0,0,3,1,0,116,78,61872,47425,113,43,67356,46695
3,1,2,1,0,3,1,0,76,64,61874,47426,87,37,67359,46695
4,1,2,1,0,3,1,0,96,48,61876,47427,122,76,67362,46695
5,1,0,2,1,0,0,3,0,2,61876,47429,0,76,67362,46698
6,1,3,0,0,3,1,0,119,55,61879,47429,125,57,67365,46698
7,1,0,0,2,1,2,1,83,54,61879,47429,97,59,67366,46699
8,1,2,0,0,3,1,0,25,26,61881,47429,27,0,67369,46699
9,1,2,1,0,3,1,0,94,60,61883,47430,107,41,67372,46699
10,2,2,4,1,0,0,3,51,48,61885,47434,82,90,67372,46702
11,2,4,1,0,3,1,0,115,54,61889,47435,123,70,67375,46702
12,2,3,0,0,3,1,0,113,64,61892,47435,111,0,67378,46702
13,2,2,0,0,3,1,0,44,39,61894,47435,60,16,67381,46702
14,2,2,2,2,1,2,1,72,70,61896,47437,83,32,67382,46703
15,2,0,3,1,0,0,3,82,52,61896,47440,109,81,67382,46706
16,2,2,5,1,0,0,3,86,83,61898,47445,88,66,67382,46709
17,2,3,1,0,3,1,0,114,39,61901,47446,128,51,67385,46709
18,2,1,4,1,0,0,3,1,4,61902,47450,0,3,67385,46712
19,2,3,1,0,3,1,0,94,46,61905,47451,123,55,67388,46712
20,3,1,1,2,1,2,1,117,79,61906,47452,114,113,67389,46713
21,3,2,0,0,3,1,0,121,55,61908,47452,128,37,67392,46713
22,3,2,2,2,1,2,1,27,28,61910,47454,28,110,67393,46714
23,3,1,1,2,1,2,1,95,61,61911,47455,108,52,67394,46715
24,3,2,0,0,3,1,0,4,1,61913,47455,6,0,67397,46715
25,3,3,0,0,3,1,0,99,48,61916,47455,125,59,67400,46715
26,3,2,0,0,3,1,0,2,2,61918,47455,3,41,67403,46715
27,3,1,1,2,1,2,1,95,47,61919,47456,124,58,67404,46716
28,3,0,3,1,0,0,3,46,47,61919,47459,48,46,67404,46719
29,3,1,3,1,0,0,3,84,57,61920,47462,97,79,67404,46722
30,4,2,2,2,1,2,1,78,66,61922,47464,88,33,67405,46723
31,4,2,1,0,3,1,0,53,49,61924,47465,85,76,67408,46723
32,4,0,0,2,1,2,1,86,83,61924,47465,89,4,67409,46724
33,4,0,7,1,0,0,3,1,11,61924,47472,0,84,67409,46727
34,4,0,2,1,0,0,3,44,41,61924,47474,60,69,67409,46730
35,4,1,2,1,0,0,3,73,72,61925,47476,83,19,67409,46733
36,4,0,0,2,1,2,1,82,52,61925,47476,110,56,67410,46734
37,4,2,1,0,3,1,0,117,55,61927,47477,126,0,67413,46734
38,4,2,0,0,3,1,0,115,64,61929,47477,114,70,67416,46734
39,4,1,2,1,0,0,3,115,41,61930,47479,128,93,67416,46737
40,5,1,0,0,3,1,0,96,47,61931,47479,127,46,67419,46737
41,5,3,3,2,1,2,1,76,75,61934,47482,84,111,67420,46738
42,5,1,2,1,0,0,3,54,51,61935,47484,85,116,67420,46741
43,5,3,1,0,3,1,0,102,49,61938,47485,128,41,67423,46741
44,5,1,1,2,1,2,1,3,3,61939,47486,4,53,67424,46742
45,5,1,1,2,1,2,1,122,56,61940,47487,129,1,67425,46743
46,5,4,3,0,3,1,0,88,60,61944,47490,100,37,67428,46743
47,5,0,2,1,0,0,3,46,49,61944,47492,48,82,67428,46746
48,5,2,2,2,1,2,1,29,30,61946,47494,29,1,67429,46747
49,5,2,1,0,3,1,0,119,80,61948,47495,117,69,67432,46747
50,6,0,2,1,0,0,3,86,85,61948,47497,89,96,67432,46750
51,6,1,0,0,3,1,0,116,41,61949,47497,131,33,67435,46750
52,6,0,1,1,0,0,3,29,31,61949,47498,29,119,67435,46753
53,6,2,0,0,3,1,0,46,41,61951,47498,63,76,67438,46753
54,6,1,1,2,1,2,1,79,67,61952,47499,89,85,67439,46754
55,6,2,0,0,3,1,0,84,52,61954,47499,113,59,67442,46754
56,6,2,1,0,3,1,0,6,2,61956,47500,9,4,67445,46754
57,6,2,2,2,1,2,1,3,13,61958,47502,1,71,67446,46755
58,6,5,0,0,3,1,0,120,64,61963,47502,117,58,67449,46755
59,6,2,2,2,1,2,1,97,63,61965,47504,109,57,67450,46756
60,7,0,1,1,0,0,3,54,52,61965,47505,85,40,67450,46759
61,7,0,3,1,0,0,3,119,83,61965,47508,117,85,67450,46762
62,7,3,1,0,3,1,0,91,61,61968,47509,103,1,67453,46762
63,7,1,4,1,0,0,3,77,79,61969,47513,84,4,67453,46765
64,7,1,1,2,1,2,1,85,53,61970,47514,114,47,67454,46766
65,7,4,0,0,3,1,0,126,56,61974,47514,132,4,67457,46766
66,7,2,2,2,1,2,1,48,51,61976,47516,49,20,67458,46767
67,7,2,0,0,3,1,0,98,47,61978,47516,130,53,67461,46767
68,7,3,2,0,3,1,0,120,57,61981,47518,129,111,67464,46767
69,7,0,0,2,1,2,1,102,49,61981,47518,129,70,67465,46768
70,8,2,0,0,3,1,0,122,64,61983,47518,120,96,67468,46768
71,8,2,1,0,3,1,0,81,68,61985,47519,92,41,67471,46768
72,8,1,0,0,3,1,0,117,41,61986,47519,134,76,67474,46768
73,8,2,1,0,3,1,0,48,42,61988,47520,66,71,67477,46768
74,8,4,2,0,3,1,0,101,65,61992,47522,112,119,67480,46768
75,8,2,1,0,3,1,0,88,86,61994,47523,92,59,67483,46768
76,8,3,2,0,3,1,0,9,4,61997,47525,12,57,67486,46768
77,8,1,2,1,0,0,3,4,5,61998,47527,4,36,67486,46771
78,8,2,1,0,3,1,0,5,14,62000,47528,4,58,67489,46771
79,8,3,3,2,1,2,1,32,34,62003,47531,30,86,67490,46772
80,9,1,0,0,3,1,0,49,51,62004,47531,52,40,67493,46772
81,9,4,2,0,3,1,0,123,85,62008,47533,120,4,67496,46772
82,9,2,0,0,3,1,0,128,56,62010,47533,135,20,67499,46772
83,9,1,0,0,3,1,0,78,79,62011,47533,87,4,67502,46772
84,9,0,0,2,1,2,1,85,53,62011,47533,115,2,67503,46773
85,9,1,2,1,0,0,3,55,54,62012,47535,85,73,67503,46776
86,9,2,0,0,3,1,0,122,57,62014,47535,132,47,67506,46776
87,9,3,2,0,3,1,0,94,63,62017,47537,106,111,67509,46776
88,9,0,1,1,0,0,3,98,48,62017,47538,130,88,67509,46779
89,9,2,0,0,3,1,0,104,49,62019,47538,132,53,67512,46779
90,10,1,1,2,1,2,1,49,43,62020,47539,67,87,67513,46780
91,10,0,3,1,0,0,3,81,71,62020,47542,92,61,67513,46783
92,10,1,2,1,0,0,3,102,67,62021,47544,112,99,67513,46786
93,10,1,0,0,3,1,0,89,86,62022,47544,95,57,67516,46786
94,10,2,0,0,3,1,0,11,4,62024,47544,15,36,67519,46786
95,10,4,0,0,3,1,0,126,57,62028,47544,135,41,67522,46786
96,10,3,3,2,1,2,1,7,8,62031,47547,5,21,67523,46787
97,10,1,1,2,1,2,1,118,42,62032,47548,135,72,67524,46788
98,10,1,2,1,0,0,3,6,16,62033,47550,4,79,67524,46791
99,10,1,0,0,3,1,0,123,64,62034,47550,123,59,67527,46791
100,11,0,1,1,0,0,3,94,64,62034,47551,106,122,67527,46794
101,11,0,2,1,0,0,3,118,44,62034,47553,135,76,67527,46797
102,11,2,1,0,3,1,0,130,57,62036,47554,138,41,67530,46797
103,11,1,0,0,3,1,0,8,8,62037,47554,8,40,67533,46797
104,11,2,1,0,3,1,0,13,5,62039,47555,18,53,67536,46797
105,11,0,2,1,0,0,3,104,51,62039,47557,132,50,67536,46800
106,11,3,4,1,0,0,3,52,55,62042,47561,52,5,67536,46803
107,11,0,3,1,0,0,3,98,51,62042,47564,130,90,67536,46806
108,11,1,1,2,1,2,1,33,35,62043,47565,31,89,67537,46807
109,11,0,0,2,1,2,1,78,79,62043,47565,88,60,67538,46808
110,12,1,0,0,3,1,0,86,53,62044,47565,118,79,67541,46808
111,12,2,0,0,3,1,0,125,85,62046,47565,123,4,67544,46808
112,12,2,0,0,3,1,0,91,86,62048,47565,98,4,67547,46808
113,12,2,1,0,3,1,0,51,44,62050,47566,70,61,67550,46808
114,12,2,1,0,3,1,0,83,72,62052,47567,95,21,67553,46808
115,12,0,0,2,1,2,1,55,54,62052,47567,86,112,67554,46809
116,12,1,1,2,1,2,1,95,65,62053,47568,107,73,67555,46810
117,12,1,1,2,1,2,1,124,65,62054,47569,124,6,67556,46811
118,12,2,1,0,3,1,0,104,68,62056,47570,115,36,67559,46811
119,12,3,0,0,3,1,0,129,57,62059,47570,138,99,67562,46811
120,13,0,1,1,0,0,3,13,6,62059,47571,18,63,67562,46814
121,13,1,1,2,1,2,1,119,45,62060,47572,136,51,67563,46815
122,13,0,1,1,0,0,3,130,58,62060,47573,138,60,67563,46818
123,13,0,2,1,0,0,3,8,10,62060,47575,8,125,67563,46821
124,13,1,1,2,1,2,1,53,56,62061,47576,53,74,67564,46822
125,13,2,0,0,3,1,0,8,16,62063,47576,7,40,67567,46822
126,13,4,1,0,3,1,0,37,36,62067,47577,34,41,67570,46822
127,13,1,0,0,3,1,0,99,51,62068,47577,133,76,67573,46822
128,13,1,1,2,1,2,1,79,80,62069,47578,89,91,67574,46823
129,13,0,0,2,1,2,1,124,65,62069,47578,125,54,67575,46824
130,14,1,1,2,1,2,1,96,66,62070,47579,108,62,67576,46825
131,14,1,1,2,1,2,1,92,87,62071,47580,99,22,67577,46826
132,14,1,3,1,0,0,3,87,56,62072,47583,118,115,67577,46829
133,14,1,1,2,1,2,1,52,45,62073,47584,71,90,67578,46830
134,14,2,2,2,1,2,1,85,74,62075,47586,96,7,67579,46831
135,14,3,0,0,3,1,0,58,54,62078,47586,89,4,67582,46831
136,14,1,1,2,1,2,1,126,86,62079,47587,124,37,67583,46832
137,14,1,0,0,3,1,0,130,57,62080,47587,141,79,67586,46832
138,14,4,3,0,3,1,0,108,71,62084,47590,118,4,67589,46832
139,14,2,4,1,0,0,3,106,55,62086,47594,132,102,67589,46835
140,15,0,2,1,0,0,3,79,82,62086,47596,89,128,67589,46838
141,15,2,2,2,1,2,1,10,12,62088,47598,9,116,67590,46839
142,15,3,3,2,1,2,1,133,61,62091,47601,139,80,67591,46840
143,15,2,1,0,3,1,0,126,66,62093,47602,128,76,67594,46840
144,15,2,1,0,3,1,0,87,75,62095,47603,99,51,67597,46840
145,15,2,1,0,3,1,0,15,7,62097,47604,21,40,67600,46840
146,15,2,0,0,3,1,0,55,56,62099,47604,56,41,67603,46840
147,15,0,1,1,0,0,3,8,17,62099,47605,7,66,67603,46843
148,15,1,0,0,3,1,0,38,36,62100,47605,37,74,67606,46843
149,15,3,3,2,1,2,1,129,89,62103,47608,125,61,67607,46844
150,16,0,0,2,1,2,1,87,56,62103,47608,119,5,67608,46845
151,16,0,1,1,0,0,3,58,55,62103,47609,89,40,67608,46848
152,16,3,0,0,3,1,0,111,71,62106,47609,121,62,67611,46848
153,16,1,1,2,1,2,1,93,88,62107,47610,100,41,67612,46849
154,16,2,0,0,3,1,0,108,55,62109,47610,135,4,67615,46849
155,16,0,0,2,1,2,1,96,66,62109,47610,109,55,67616,46850
156,16,0,2,1,0,0,3,99,53,62109,47612,133,25,67616,46853
157,16,4,0,0,3,1,0,134,57,62113,47612,144,7,67619,46853
158,16,4,2,0,3,1,0,137,63,62117,47614,142,91,67622,46853
159,16,2,2,2,1,2,1,121,47,62119,47616,137,91,67623,46854
160,17,1,2,1,0,0,3,11,14,62120,47618,9,83,67623,46857
161,17,1,1,2,1,2,1,88,76,62121,47619,100,103,67624,46858
162,17,1,0,0,3,1,0,80,82,62122,47619,92,51,67627,46858
163,17,1,4,1,0,0,3,53,49,62123,47623,71,131,67627,46861
164,17,4,1,0,3,1,0,19,8,62127,47624,24,74,67630,46861
165,17,4,0,0,3,1,0,130,66,62131,47624,131,41,67633,46861
166,17,1,1,2,1,2,1,56,57,62132,47625,57,62,67634,46862
167,17,0,1,1,0,0,3,8,18,62132,47626,7,79,67634,46865
168,17,4,1,0,3,1,0,42,37,62136,47627,40,66,67637,46865
169,17,1,0,0,3,1,0,130,89,62137,47627,128,116,67640,46865
170,18,0,0,2,1,2,1,58,55,62137,47627,90,56,67641,46866
171,18,1,0,0,3,1,0,112,71,62138,47627,124,4,67644,46866
172,18,3,0,0,3,1,0,137,57,62141,47627,147,91,67647,46866
173,18,2,0,0,3,1,0,139,63,62143,47627,145,40,67650,46866
174,18,2,0,0,3,1,0,89,56,62145,47627,122,62,67653,46866
175,18,2,0,0,3,1,0,95,88,62147,47627,103,7,67656,46866
176,18,3,0,0,3,1,0,124,47,62150,47627,140,41,67659,46866
177,18,3,1,0,3,1,0,99,67,62153,47628,112,25,67662,46866
178,18,1,3,1,0,0,3,100,56,62154,47631,133,8,67662,46869
179,18,1,0,0,3,1,0,109,55,62155,47631,138,91,67665,46869
180,19,0,3,1,0,0,3,11,17,62155,47634,9,65,67665,46872
181,19,0,0,2,1,2,1,80,82,62155,47634,93,75,67666,46873
182,19,0,0,2,1,2,1,42,37,62155,47634,41,80,67667,46874
183,19,2,1,0,3,1,0,55,50,62157,47635,74,41,67670,46874
184,19,1,4,1,0,0,3,89,80,62158,47639,100,134,67670,46877
185,19,0,3,1,0,0,3,19,11,62158,47642,24,106,67670,46880
186,19,4,0,0,3,1,0,134,66,62162,47642,134,51,67673,46880
187,19,4,3,0,3,1,0,12,21,62166,47645,10,116,67676,46880
188,19,3,0,0,3,1,0,59,57,62169,47645,60,83,67679,46880
189,19,1,1,2,1,2,1,131,90,62170,47646,129,67,67680,46881
190,20,3,0,0,3,1,0,137,66,62173,47646,137,4,67683,46881
191,20,4,2,0,3,1,0,141,59,62177,47648,150,40,67686,46881
192,20,2,3,1,0,0,3,102,59,62179,47651,133,78,67686,46884
193,20,1,0,0,3,1,0,56,50,62180,47651,77,56,67689,46884
194,20,0,3,1,0,0,3,89,59,62180,47654,122,83,67689,46887
195,20,1,0,0,3,1,0,96,88,62181,47654,106,91,67692,46887
196,20,2,2,2,1,2,1,82,84,62183,47656,94,107,67693,46888
197,20,1,2,1,0,0,3,59,57,62184,47658,90,68,67693,46891
198,20,0,2,1,0,0,3,12,23,62184,47660,10,28,67693,46894
199,20,1,0,0,3,1,0,125,47,62185,47660,143,8,67696,46894
200,21,1,1,2,1,2,1,140,64,62186,47661,146,68,67697,46895
201,21,1,1,2,1,2,1,110,56,62187,47662,139,135,67698,46896
202,21,1,3,1,0,0,3,20,14,62188,47665,24,94,67698,46899
203,21,1,0,0,3,1,0,43,37,62189,47665,44,41,67701,46899
204,21,1,1,2,1,2,1,60,58,62190,47666,61,63,67702,46900
205,21,0,0,2,1,2,1,131,90,62190,47666,130,42,67703,46901
206,21,1,2,1,0,0,3,90,82,62191,47668,100,119,67703,46904
207,21,3,1,0,3,1,0,14,18,62194,47669,12,7,67706,46904
208,21,1,0,0,3,1,0,100,67,62195,47669,115,83,67709,46904
209,21,3,3,2,1,2,1,115,74,62198,47672,125,52,67710,46905
210,22,1,0,0,3,1,0,91,82,62199,47672,103,83,67713,46905
211,22,0,2,1,0,0,3,82,86,62199,47674,94,86,67713,46908
212,22,1,1,2,1,2,1,126,48,62200,47675,144,29,67714,46909
213,22,1,2,1,0,0,3,13,25,62201,47677,10,11,67714,46912
214,22,0,2,1,0,0,3,59,59,62201,47679,90,81,67714,46915
215,22,3,3,2,1,2,1,92,62,62204,47682,123,5,67715,46916
216,22,3,0,0,3,1,0,59,50,62207,47682,80,107,67718,46916
217,22,3,1,0,3,1,0,144,60,62210,47683,153,91,67721,46916
218,22,0,1,1,0,0,3,96,89,62210,47684,106,43,67721,46919
219,22,4,2,0,3,1,0,141,68,62214,47686,140,68,67724,46919
220,23,2,0,0,3,1,0,117,74,62216,47686,128,41,67727,46919
221,23,3,0,0,3,1,0,105,59,62219,47686,136,68,67730,46919
222,23,3,1,0,3,1,0,143,65,62222,47687,149,119,67733,46919
223,23,1,2,1,0,0,3,44,39,62223,47689,44,66,67733,46922
224,23,1,0,0,3,1,0,61,58,62224,47689,64,56,67736,46922
225,23,0,0,2,1,2,1,100,67,62224,47689,116,43,67737,46923
226,23,0,1,1,0,0,3,14,19,62224,47690,12,55,67737,46926
227,23,2,2,2,1,2,1,22,16,62226,47692,25,136,67738,46927
228,23,0,0,2,1,2,1,110,56,62226,47692,140,95,67739,46928
229,23,1,0,0,3,1,0,132,90,62227,47692,133,7,67742,46928
230,24,1,0,0,3,1,0,127,48,62228,47692,147,66,67745,46928
231,24,1,2,1,0,0,3,118,76,62229,47694,128,94,67745,46931
232,24,3,1,0,3,1,0,95,63,62232,47695,126,81,67748,46931
233,24,3,1,0,3,1,0,147,61,62235,47696,156,68,67751,46931
234,24,1,2,1,0,0,3,92,84,62236,47698,103,8,67751,46934
235,24,0,2,1,0,0,3,13,27,62236,47700,10,110,67751,46937
236,24,0,4,1,0,0,3,59,54,62236,47704,80,71,67751,46940
237,24,3,3,2,1,2,1,99,92,62239,47707,107,87,67752,46941
238,24,3,0,0,3,1,0,144,68,62242,47707,143,43,67755,46941
239,24,1,3,1,0,0,3,23,19,62243,47710,25,32,67755,46944
240,25,0,1,1,0,0,3,82,87,62243,47711,94,98,67755,46947
241,25,2,3,1,0,0,3,16,22,62245,47714,12,14,67755,46950
242,25,1,1,2,1,2,1,106,60,62246,47715,137,42,67756,46951
243,25,1,1,2,1,2,1,133,91,62247,47716,134,57,67757,46952
244,25,2,0,0,3,1,0,61,59,62249,47716,93,43,67760,46952
245,25,0,2,1,0,0,3,61,60,62249,47718,64,122,67760,46955
246,25,1,0,0,3,1,0,148,61,62250,47718,159,32,67763,46955
247,25,3,2,0,3,1,0,113,58,62253,47720,143,7,67766,46955
248,25,2,2,2,1,2,1,102,69,62255,47722,117,84,67767,46956
249,25,1,1,2,1,2,1,144,66,62256,47723,150,56,67768,46957
250,26,0,0,2,1,2,1,144,68,62256,47723,144,95,67769,46958
251,26,3,0,0,3,1,0,95,84,62259,47723,106,87,67772,46958
252,26,0,0,2,1,2,1,23,19,62259,47723,26,67,67773,46959
253,26,2,0,0,3,1,0,101,92,62261,47723,110,43,67776,46959
254,26,2,1,0,3,1,0,61,55,62263,47724,83,68,67779,46959
255,26,0,1,1,0,0,3,13,28,62263,47725,10,74,67779,46962
256,26,0,2,1,0,0,3,44,41,62263,47727,44,46,67779,46965
257,26,1,1,2,1,2,1,17,23,62264,47728,13,111,67780,46966
258,26,0,2,1,0,0,3,127,50,62264,47730,147,139,67780,46969
259,26,0,1,1,0,0,3,118,77,62264,47731,128,84,67780,46972
260,27,1,0,0,3,1,0,107,60,62265,47731,140,122,67783,46972
261,27,1,1,2,1,2,1,96,64,62266,47732,127,58,67784,46973
262,27,1,0,0,3,1,0,149,61,62267,47732,162,84,67787,46973
263,27,0,1,1,0,0,3,113,59,62267,47733,143,45,67787,46976
264,27,2,1,0,3,1,0,63,60,62269,47734,96,56,67790,46976
265,27,2,0,0,3,1,0,104,69,62271,47734,120,14,67793,46976
266,27,4,2,0,3,1,0,65,62,62275,47736,67,8,67796,46976
267,27,0,0,2,1,2,1,82,87,62275,47736,95,8,67797,46977
268,27,1,0,0,3,1,0,134,91,62276,47736,137,32,67800,46977
269,27,1,0,0,3,1,0,145,66,62277,47736,153,98,67803,46977
270,28,0,2,1,0,0,3,23,21,62277,47738,26,98,67803,46980
271,28,3,0,0,3,1,0,64,55,62280,47738,86,46,67806,46980
272,28,2,1,0,3,1,0,19,24,62282,47739,16,67,67809,46980
273,28,3,1,0,3,1,0,16,29,62285,47740,13,43,67812,46980
274,28,0,2,1,0,0,3,95,86,62285,47742,106,87,67812,46983
275,28,2,4,1,0,0,3,129,54,62287,47746,147,77,67812,46986
276,28,3,1,0,3,1,0,121,78,62290,47747,131,68,67815,46986
277,28,0,1,1,0,0,3,101,93,62290,47748,110,142,67815,46989
278,28,0,1,1,0,0,3,44,42,62290,47749,44,114,67815,46992
279,28,3,2,0,3,1,0,147,70,62293,47751,147,87,67818,46992
280,29,3,1,0,3,1,0,47,43,62296,47752,47,8,67821,46992
281,29,0,2,1,0,0,3,63,62,62296,47754,96,101,67821,46995
282,29,1,1,2,1,2,1,105,70,62297,47755,121,57,67822,46996
283,29,1,2,1,0,0,3,135,93,62298,47757,137,48,67822,46999
284,29,1,0,0,3,1,0,83,87,62299,47757,98,58,67825,46999
285,29,5,0,0,3,1,0,70,62,62304,47757,70,14,67828,46999
286,29,1,0,0,3,1,0,108,60,62305,47757,143,8,67831,46999
287,29,0,1,1,0,0,3,145,67,62305,47758,153,87,67831,47002
288,29,0,1,1,0,0,3,96,65,62305,47759,127,145,67831,47005
289,29,1,1,2,1,2,1,114,60,62306,47760,144,123,67832,47006
290,30,2,1,0,3,1,0,149,71,62308,47761,150,32,67835,47006
291,30,3,0,0,3,1,0,66,62,62311,47761,99,67,67838,47006
292,30,1,0,0,3,1,0,96,86,62312,47761,109,14,67841,47006
293,30,2,0,0,3,1,0,103,93,62314,47761,113,87,67844,47006
294,30,2,0,0,3,1,0,66,55,62316,47761,89,8,67847,47006
295,30,0,2,1,0,0,3,121,80,62316,47763,131,126,67847,47009
296,30,2,4,1,0,0,3,98,69,62318,47767,127,117,67847,47012
297,30,2,1,0,3,1,0,151,62,62320,47768,165,77,67850,47012
298,30,1,2,1,0,0,3,17,31,62321,47770,13,49,67850,47015
299,30,0,0,2,1,2,1,135,93,62321,47770,138,88,67851,47016
300,31,0,2,1,0,0,3,83,89,62321,47772,98,51,67851,47019
301,31,3,0,0,3,1,0,132,54,62324,47772,150,68,67854,47019
302,31,0,2,1,0,0,3,17,33,62324,47774,13,104,67854,47022
303,31,2,1,0,3,1,0,49,44,62326,47775,50,58,67857,47022
304,31,0,0,2,1,2,1,70,62,62326,47775,71,88,67858,47023
305,31,3,0,0,3,1,0,26,21,62329,47775,29,57,67861,47023
306,31,3,2,0,3,1,0,117,62,62332,47777,147,77,67864,47023
307,31,2,0,0,3,1,0,147,67,62334,47777,156,145,67867,47023
308,31,1,0,0,3,1,0,109,60,62335,47777,146,43,67870,47023
309,31,2,2,2,1,2,1,21,26,62337,47779,17,99,67871,47024
310,32,0,1,1,0,0,3,66,63,62337,47780,99,17,67871,47027
311,32,2,2,2,1,2,1,137,95,62339,47782,139,68,67872,47028
312,32,2,0,0,3,1,0,119,62,62341,47782,150,49,67875,47028
313,32,1,3,1,0,0,3,97,89,62342,47785,109,107,67875,47031
314,32,0,2,1,0,0,3,66,57,62342,47787,89,11,67875,47034
315,32,1,2,1,0,0,3,99,71,62343,47789,127,35,67875,47037
316,32,2,1,0,3,1,0,123,81,62345,47790,134,88,67878,47037
317,32,1,0,0,3,1,0,106,70,62346,47790,124,117,67881,47037
318,32,2,0,0,3,1,0,153,62,62348,47790,168,8,67884,47037
319,32,1,2,1,0,0,3,104,95,62349,47792,113,129,67884,47040
320,33,1,1,2,1,2,1,18,34,62350,47793,14,59,67885,47041
321,33,3,1,0,3,1,0,152,72,62353,47794,153,51,67888,47041
322,33,1,1,2,1,2,1,84,90,62354,47795,99,78,67889,47042
323,33,2,4,1,0,0,3,23,30,62356,47799,17,71,67889,47045
324,33,3,5,1,0,0,3,29,26,62359,47804,29,91,67889,47048
325,33,2,1,0,3,1,0,51,45,62361,47805,53,57,67892,47048
326,33,0,4,1,0,0,3,70,66,62361,47809,71,102,67892,47051
327,33,4,2,0,3,1,0,151,69,62365,47811,159,87,67895,47051
328,33,1,0,0,3,1,0,133,54,62366,47811,153,43,67898,47051
329,33,0,2,1,0,0,3,109,62,62366,47813,146,148,67898,47054
330,34,1,2,1,0,0,3,105,97,62367,47815,113,62,67898,47057
331,34,1,2,1,0,0,3,67,59,62368,47817,89,20,67898,47060
332,34,0,2,1,0,0,3,106,72,62368,47819,124,105,67898,47063
333,34,3,0,0,3,1,0,136,54,62371,47819,156,8,67901,47063
334,34,1,1,2,1,2,1,110,63,62372,47820,147,118,67902,47064
335,34,2,1,0,3,1,0,101,72,62374,47821,130,49,67905,47064
336,34,0,1,1,0,0,3,66,64,62374,47822,99,14,67905,47067
337,34,3,3,2,1,2,1,122,65,62377,47825,151,36,67906,47068
338,34,1,0,0,3,1,0,154,62,62378,47825,171,68,67909,47068
339,34,0,1,1,0,0,3,123,82,62378,47826,134,110,67909,47071
340,35,2,0,0,3,1,0,154,72,62380,47826,156,129,67912,47071
341,35,0,3,1,0,0,3,84,93,62380,47829,99,94,67912,47074
342,35,0,0,2,1,2,1,137,95,62380,47829,140,119,67913,47075
343,35,4,0,0,3,1,0,33,26,62384,47829,32,43,67916,47075
344,35,2,1,0,3,1,0,72,67,62386,47830,74,71,67919,47075
345,35,0,2,1,0,0,3,23,32,62386,47832,17,90,67919,47078
346,35,1,0,0,3,1,0,98,89,62387,47832,112,78,67922,47078
347,35,2,0,0,3,1,0,53,45,62389,47832,56,88,67925,47078
348,35,1,1,2,1,2,1,68,60,62390,47833,90,58,67926,47079
349,35,1,3,1,0,0,3,19,37,62391,47836,14,151,67926,47082
350,36,0,0,2,1,2,1,105,97,62391,47836,114,69,67927,47083
351,36,5,3,0,3,1,0,115,66,62396,47839,150,8,67930,47083
352,36,4,1,0,3,1,0,105,73,62400,47840,133,110,67933,47083
353,36,2,0,0,3,1,0,108,72,62402,47840,127,49,67936,47083
354,36,0,1,1,0,0,3,66,65,62402,47841,99,39,67936,47086
355,36,1,0,0,3,1,0,137,54,62403,47841,159,105,67939,47086
356,36,3,3,2,1,2,1,125,68,62406,47844,152,21,67940,47087
357,36,1,0,0,3,1,0,155,62,62407,47844,174,51,67943,47087
358,36,3,4,1,0,0,3,126,86,62410,47848,134,17,67943,47090
359,36,3,0,0,3,1,0,154,69,62413,47848,162,62,67946,47090
360,37,2,2,2,1,2,1,35,28,62415,47850,33,89,67947,47091
361,37,4,1,0,3,1,0,141,96,62419,47851,143,90,67950,47091
362,37,2,1,0,3,1,0,70,61,62421,47852,93,129,67953,47091
363,37,1,2,1,0,0,3,85,95,62422,47854,99,46,67953,47094
364,37,0,1,1,0,0,3,98,90,62422,47855,112,74,67953,47097
365,37,0,1,1,0,0,3,23,33,62422,47856,17,97,67953,47100
366,37,4,2,0,3,1,0,23,39,62426,47858,17,58,67956,47100
367,37,2,5,1,0,0,3,74,72,62428,47863,74,122,67956,47103
368,37,1,1,2,1,2,1,54,46,62429,47864,57,79,67957,47104
369,37,0,1,1,0,0,3,154,73,62429,47865,156,154,67957,47107
370,38,3,3,2,1,2,1,118,69,62432,47868,151,50,67958,47108
371,38,2,1,0,3,1,0,107,74,62434,47869,136,51,67961,47108
372,38,3,0,0,3,1,0,158,62,62437,47869,177,62,67964,47108
373,38,1,0,0,3,1,0,106,97,62438,47869,117,110,67967,47108
374,38,1,0,0,3,1,0,126,68,62439,47869,155,69,67970,47108
375,38,5,1,0,3,1,0,159,70,62444,47870,165,21,67973,47108
376,38,2,1,0,3,1,0,68,66,62446,47871,102,105,67976,47108
377,38,2,0,0,3,1,0,110,72,62448,47871,130,8,67979,47108
378,38,2,1,0,3,1,0,139,55,62450,47872,162,17,67982,47108
379,38,2,2,2,1,2,1,128,88,62452,47874,135,40,67983,47109
0,1,0,1,1,0,0,3,68,67,62452,47875,102,157,67983,47112
1,1,2,0,0,3,1,0,156,73,62454,47875,159,97,67986,47112
2,1,3,1,0,3,1,0,142,56,62457,47876,165,90,67989,47112
3,1,0,0,2,1,2,1,70,61,62457,47876,94,22,67990,47113
4,1,1,1,2,1,2,1,96,85,62458,47877,92,51,67991,47114
5,1,1,2,1,0,0,3,107,99,62459,47879,117,125,67991,47117
6,1,1,0,0,3,1,0,33,45,62460,47879,42,79,67994,47117
7,1,0,0,2,1,2,1,54,46,62460,47879,58,106,67995,47118
8,1,2,0,0,3,1,0,120,69,62462,47879,154,0,67998,47118
9,1,1,1,2,1,2,1,24,40,62463,47880,18,63,67999,47119
10,2,0,1,1,0,0,3,0,1,62463,47881,0,113,67999,47122
11,2,2,0,0,3,1,0,160,62,62465,47881,180,89,68002,47122
12,2,2,0,0,3,1,0,76,72,62467,47881,77,40,68005,47122
13,2,3,0,0,3,1,0,129,68,62470,47881,158,26,68008,47122
14,2,7,0,0,3,1,0,148,96,62477,47881,146,17,68011,47122
15,2,0,0,2,1,2,1,128,88,62477,47881,136,59,68012,47123
16,2,1,2,1,0,0,3,99,92,62478,47883,112,54,68012,47126
17,2,0,1,1,0,0,3,159,71,62478,47884,165,77,68012,47129
18,2,4,5,1,0,0,3,114,77,62482,47889,130,132,68012,47132
19,2,2,1,0,3,1,0,37,29,62484,47890,36,40,68015,47132
20,3,2,2,2,1,2,1,35,47,62486,47892,43,1,68016,47133
21,3,0,1,1,0,0,3,142,57,62486,47893,165,160,68016,47136
22,3,2,3,1,0,0,3,70,70,62488,47896,102,82,68016,47139
23,3,0,0,2,1,2,1,24,40,62488,47896,19,52,68017,47140
24,3,1,0,0,3,1,0,108,99,62489,47896,120,90,68020,47140
25,3,2,0,0,3,1,0,158,73,62491,47896,162,63,68023,47140
26,3,0,1,1,0,0,3,70,62,62491,47897,94,100,68023,47143
27,3,1,0,0,3,1,0,121,69,62492,47897,157,125,68026,47143
28,3,1,1,2,1,2,1,97,86,62493,47898,93,107,68027,47144
29,3,0,1,1,0,0,3,54,47,62493,47899,58,25,68027,47147
30,4,2,2,2,1,2,1,2,3,62495,47901,1,133,68028,47148
31,4,3,3,2,1,2,1,162,74,62498,47904,166,41,68029,47149
32,4,3,0,0,3,1,0,163,62,62501,47904,183,26,68032,47149
33,4,2,2,2,1,2,1,39,31,62503,47906,37,60,68033,47150
34,4,1,2,1,0,0,3,115,79,62504,47908,130,116,68033,47153
35,4,2,0,0,3,1,0,150,96,62506,47908,149,54,68036,47153
36,4,0,0,2,1,2,1,128,88,62506,47908,137,18,68037,47154
37,4,1,2,1,0,0,3,100,94,62507,47910,112,43,68037,47157
38,4,2,1,0,3,1,0,78,73,62509,47911,80,77,68040,47157
39,4,0,1,1,0,0,3,129,69,62509,47912,158,92,68040,47160
40,5,2,0,0,3,1,0,160,73,62511,47912,165,25,68043,47160
41,5,0,3,1,0,0,3,70,65,62511,47915,94,163,68043,47163
42,5,0,1,1,0,0,3,24,41,62511,47916,19,128,68043,47166
43,5,1,1,2,1,2,1,55,48,62512,47917,59,101,68044,47167
44,5,1,4,1,0,0,3,151,100,62513,47921,149,66,68044,47170
45,5,1,1,2,1,2,1,71,71,62514,47922,103,2,68045,47171
46,5,1,1,2,1,2,1,36,48,62515,47923,44,134,68046,47172
47,5,0,1,1,0,0,3,108,100,62515,47924,120,55,68046,47175
48,5,4,2,0,3,1,0,125,71,62519,47926,160,82,68049,47175
49,5,0,4,1,0,0,3,97,90,62519,47930,93,93,68049,47178
50,6,1,0,0,3,1,0,40,31,62520,47930,40,66,68052,47178
51,6,2,0,0,3,1,0,144,57,62522,47930,168,77,68055,47178
52,6,3,0,0,3,1,0,5,3,62525,47930,4,41,68058,47178
53,6,3,2,0,3,1,0,132,71,62528,47932,161,18,68061,47178
54,6,1,1,2,1,2,1,126,72,62529,47933,161,27,68062,47179
55,6,1,2,1,0,0,3,116,81,62530,47935,130,63,68062,47182
56,6,1,0,0,3,1,0,79,73,62531,47935,83,54,68065,47182
57,6,3,2,0,3,1,0,166,64,62534,47937,186,116,68068,47182
58,6,3,0,0,3,1,0,131,88,62537,47937,140,107,68071,47182
59,6,2,1,0,3,1,0,164,75,62539,47938,169,43,68074,47182
60,7,3,0,0,3,1,0,163,73,62542,47938,168,77,68077,47182
61,7,1,1,2,1,2,1,25,42,62543,47939,20,164,68078,47183
62,7,0,2,1,0,0,3,131,90,62543,47941,140,96,68078,47186
63,7,1,0,0,3,1,0,56,48,62544,47941,62,92,68081,47186
64,7,2,2,2,1,2,1,102,96,62546,47943,113,56,68082,47187
65,7,2,1,0,3,1,0,99,91,62548,47944,96,27,68085,47187
66,7,1,3,1,0,0,3,41,34,62549,47947,40,137,68085,47190
67,7,1,0,0,3,1,0,71,65,62550,47947,97,82,68088,47190
68,7,2,2,2,1,2,1,153,102,62552,47949,150,129,68089,47191
69,7,1,1,2,1,2,1,109,101,62553,47950,121,3,68090,47192
70,8,0,4,1,0,0,3,5,7,62553,47954,4,69,68090,47195
71,8,1,3,1,0,0,3,117,84,62554,47957,130,21,68090,47198
72,8,0,0,2,1,2,1,79,73,62554,47957,84,117,68091,47199
73,8,2,0,0,3,1,0,128,72,62556,47957,164,54,68094,47199
74,8,2,0,0,3,1,0,168,64,62558,47957,189,41,68097,47199
75,8,1,2,1,0,0,3,72,73,62559,47959,103,66,68097,47202
76,8,6,2,0,3,1,0,170,77,62565,47961,172,25,68100,47202
77,8,2,1,0,3,1,0,134,72,62567,47962,164,43,68103,47202
78,8,0,1,1,0,0,3,36,49,62567,47963,44,110,68103,47205
79,8,1,1,2,1,2,1,145,58,62568,47964,169,102,68104,47206
80,9,3,1,0,3,1,0,28,43,62571,47965,23,3,68107,47206
81,9,1,0,0,3,1,0,100,91,62572,47965,99,77,68110,47206
82,9,3,0,0,3,1,0,134,90,62575,47965,143,92,68113,47206
83,9,1,1,2,1,2,1,72,66,62576,47966,98,130,68114,47207
84,9,1,0,0,3,1,0,57,48,62577,47966,65,82,68117,47207
85,9,2,0,0,3,1,0,165,73,62579,47966,171,27,68120,47207
86,9,1,0,0,3,1,0,154,102,62580,47966,153,56,68123,47207
87,9,1,0,0,3,1,0,110,101,62581,47966,124,164,68126,47207
88,9,1,1,2,1,2,1,103,97,62582,47967,114,138,68127,47208
89,9,1,1,2,1,2,1,42,35,62583,47968,41,97,68128,47209
90,10,2,0,0,3,1,0,172,77,62585,47968,175,117,68131,47209
91,10,0,2,1,0,0,3,5,9,62585,47970,4,167,68131,47212
92,10,2,0,0,3,1,0,119,84,62587,47970,133,110,68134,47212
93,10,2,4,1,0,0,3,130,76,62589,47974,164,69,68134,47215
94,10,3,1,0,3,1,0,82,74,62592,47975,87,102,68137,47215
95,10,0,0,2,1,2,1,72,73,62592,47975,104,22,68138,47216
96,10,0,0,2,1,2,1,57,48,62592,47975,66,55,68139,47217
97,10,0,2,1,0,0,3,145,60,62592,47977,169,44,68139,47220
98,10,1,1,2,1,2,1,37,50,62593,47978,45,26,68140,47221
99,10,4,2,0,3,1,0,138,74,62597,47980,167,69,68143,47221
100,11,0,0,2,1,2,1,28,43,62597,47980,24,56,68144,47222
101,11,2,2,2,1,2,1,84,76,62599,47982,88,139,68145,47223
102,11,1,1,2,1,2,1,104,98,62600,47983,115,70,68146,47224
103,11,2,1,0,3,1,0,74,74,62602,47984,107,27,68149,47224
104,11,1,1,2,1,2,1,101,92,62603,47985,100,93,68150,47225
105,11,2,1,0,3,1,0,7,10,62605,47986,7,97,68153,47225
106,11,7,0,0,3,1,0,175,64,62612,47986,192,82,68156,47225
107,11,0,1,1,0,0,3,134,91,62612,47987,143,133,68156,47228
108,11,2,2,2,1,2,1,156,104,62614,47989,154,27,68157,47229
109,11,3,0,0,3,1,0,168,73,62617,47989,174,43,68160,47229
110,12,1,2,1,0,0,3,73,68,62618,47991,98,120,68160,47232
111,12,0,3,1,0,0,3,138,77,62618,47994,167,170,68160,47235
112,12,0,1,1,0,0,3,57,49,62618,47995,66,25,68160,47238
113,12,3,3,2,1,2,1,175,80,62621,47998,176,70,68161,47239
114,12,1,1,2,1,2,1,131,77,62622,47999,165,78,68162,47240
115,12,0,2,1,0,0,3,119,86,62622,48001,133,6,68162,47243
116,12,1,2,1,0,0,3,43,37,62623,48003,41,105,68162,47246
117,12,1,1,2,1,2,1,38,51,62624,48004,46,57,68163,47247
118,12,1,1,2,1,2,1,146,61,62625,48005,170,111,68164,47248
119,12,1,1,2,1,2,1,111,102,62626,48006,125,45,68165,47249
120,13,2,1,0,3,1,0,30,44,62628,48007,27,27,68168,47249
121,13,0,0,2,1,2,1,74,74,62628,48007,108,98,68169,47250
122,13,0,4,1,0,0,3,104,102,62628,48011,115,108,68169,47253
123,13,2,0,0,3,1,0,148,61,62630,48011,173,93,68172,47253
124,13,0,0,2,1,2,1,7,10,62630,48011,8,57,68173,47254
125,13,0,3,1,0,0,3,38,54,62630,48014,46,73,68173,47257
126,13,2,1,0,3,1,0,103,93,62632,48015,103,82,68176,47257
127,13,2,1,0,3,1,0,177,65,62634,48016,195,43,68179,47257
128,13,4,2,0,3,1,0,172,75,62638,48018,177,111,68182,47257
129,13,1,1,2,1,2,1,85,77,62639,48019,89,134,68183,47258
130,14,0,0,2,1,2,1,134,91,62639,48019,144,171,68184,47259
131,14,2,2,2,1,2,1,174,77,62641,48021,178,26,68185,47260
132,14,2,2,2,1,2,1,59,51,62643,48023,67,46,68186,47261
133,14,2,2,2,1,2,1,177,82,62645,48025,177,7,68187,47262
134,14,1,2,1,0,0,3,120,88,62646,48027,133,101,68187,47265
135,14,1,0,0,3,1,0,112,102,62647,48027,128,139,68190,47265
136,14,3,2,0,3,1,0,76,70,62650,48029,101,27,68193,47265
137,14,1,2,1,0,0,3,157,106,62651,48031,154,96,68193,47268
138,14,0,2,1,0,0,3,104,104,62651,48033,115,81,68193,47271
139,14,1,3,1,0,0,3,44,40,62652,48036,41,60,68193,47274
140,15,2,1,0,3,1,0,105,94,62654,48037,106,26,68196,47274
141,15,3,0,0,3,1,0,141,77,62657,48037,170,57,68199,47274
142,15,1,1,2,1,2,1,178,66,62658,48038,196,61,68200,47275
143,15,0,0,2,1,2,1,120,88,62658,48038,134,71,68201,47276
144,15,1,2,1,0,0,3,132,79,62659,48040,165,30,68201,47279
145,15,0,1,1,0,0,3,112,103,62659,48041,128,123,68201,47282
146,15,1,4,1,0,0,3,39,58,62660,48045,46,111,68201,47285
147,15,2,0,0,3,1,0,150,61,62662,48045,176,134,68204,47285
148,15,0,0,2,1,2,1,7,10,62662,48045,9,44,68205,47286
149,15,0,2,1,0,0,3,74,76,62662,48047,108,114,68205,47289
150,16,1,3,1,0,0,3,105,107,62663,48050,115,174,68205,47292
151,16,2,0,0,3,1,0,179,82,62665,48050,180,82,68208,47292
152,16,1,1,2,1,2,1,31,45,62666,48051,28,28,68209,47293
153,16,0,0,2,1,2,1,174,77,62666,48051,179,140,68210,47294
154,16,0,1,1,0,0,3,44,41,62666,48052,41,84,68210,47297
155,16,1,1,2,1,2,1,135,92,62667,48053,145,8,68211,47298
156,16,3,3,2,1,2,1,79,73,62670,48056,102,47,68212,47299
157,16,2,1,0,3,1,0,61,52,62672,48057,70,73,68215,47299
158,16,2,2,2,1,2,1,87,79,62674,48059,90,97,68216,47300
159,16,2,2,2,1,2,1,159,108,62676,48061,155,102,68217,47301
160,17,3,0,0,3,1,0,144,77,62679,48061,173,61,68220,47301
161,17,0,1,1,0,0,3,132,80,62679,48062,165,126,68220,47304
162,17,5,0,0,3,1,0,110,94,62684,48062,109,71,68223,47304
163,17,2,2,2,1,2,1,114,105,62686,48064,129,58,68224,47305
164,17,0,0,2,1,2,1,74,76,62686,48064,109,45,68225,47306
165,17,1,0,0,3,1,0,121,88,62687,48064,137,111,68228,47306
166,17,1,2,1,0,0,3,151,63,62688,48066,176,29,68228,47309
167,17,0,0,2,1,2,1,7,10,62688,48066,10,31,68229,47310
168,17,1,4,1,0,0,3,40,62,62689,48070,46,137,68229,47313
169,17,1,1,2,1,2,1,179,67,62690,48071,197,115,68230,47314
170,18,1,1,2,1,2,1,32,46,62691,48072,29,98,68231,47315
171,18,1,1,2,1,2,1,62,53,62692,48073,71,141,68232,47316
172,18,3,1,0,3,1,0,162,109,62695,48074,158,73,68235,47316
173,18,3,1,0,3,1,0,47,42,62698,48075,44,82,68238,47316
174,18,2,1,0,3,1,0,107,108,62700,48076,118,28,68241,47316
175,18,2,2,2,1,2,1,176,79,62702,48078,180,103,68242,47317
176,18,4,3,0,3,1,0,139,95,62706,48081,148,47,68245,47317
177,18,1,1,2,1,2,1,80,74,62707,48082,103,85,68246,47318
178,18,1,0,0,3,1,0,88,79,62708,48082,93,8,68249,47318
179,18,1,3,1,0,0,3,180,85,62709,48085,180,177,68249,47321
180,19,0,0,2,1,2,1,7,10,62709,48085,11,116,68250,47322
181,19,1,1,2,1,2,1,111,95,62710,48086,110,127,68251,47323
182,19,0,1,1,0,0,3,144,78,62710,48087,173,140,68251,47326
183,19,0,2,1,0,0,3,121,90,62710,48089,137,64,68251,47329
184,19,0,1,1,0,0,3,151,64,62710,48090,176,61,68251,47332
185,19,2,3,1,0,0,3,42,65,62712,48093,46,48,68251,47335
186,19,2,2,2,1,2,1,134,82,62714,48095,166,72,68252,47336
187,19,3,3,2,1,2,1,117,108,62717,48098,130,30,68253,47337
188,19,1,2,1,0,0,3,75,78,62718,48100,109,114,68253,47340
189,19,4,0,0,3,1,0,183,67,62722,48100,200,31,68256,47340
190,20,2,1,0,3,1,0,109,109,62724,48101,121,30,68259,47340
191,20,3,1,0,3,1,0,147,79,62727,48102,176,141,68262,47340
192,20,1,1,2,1,2,1,89,80,62728,48103,94,48,68263,47341
193,20,1,2,1,0,0,3,122,92,62729,48105,137,31,68263,47344
194,20,0,1,1,0,0,3,162,110,62729,48106,158,51,68263,47347
195,20,2,0,0,3,1,0,185,67,62731,48106,203,85,68266,47347
196,20,1,0,0,3,1,0,48,42,62732,48106,47,61,68269,47347
197,20,1,1,2,1,2,1,140,96,62733,48107,149,128,68270,47348
198,20,1,2,1,0,0,3,8,12,62734,48109,11,101,68270,47351
199,20,2,1,0,3,1,0,182,86,62736,48110,183,73,68273,47351
200,21,1,1,2,1,2,1,118,109,62737,48111,131,115,68274,47352
201,21,1,1,2,1,2,1,177,80,62738,48112,181,9,68275,47353
202,21,3,1,0,3,1,0,35,47,62741,48113,32,116,68278,47353
203,21,0,0,2,1,2,1,134,82,62741,48113,167,178,68279,47354
204,21,2,1,0,3,1,0,113,96,62743,48114,113,31,68282,47354
205,21,2,1,0,3,1,0,44,66,62745,48115,49,103,68285,47354
206,21,2,1,0,3,1,0,82,75,62747,48116,106,72,68288,47354
207,21,5,1,0,3,1,0,67,54,62752,48117,74,64,68291,47354
208,21,1,2,1,0,0,3,76,80,62753,48119,109,143,68291,47357
209,21,3,1,0,3,1,0,154,65,62756,48120,179,82,68294,47357
210,22,1,3,1,0,0,3,49,45,62757,48123,47,54,68294,47360
211,22,3,1,0,3,1,0,188,68,62760,48124,206,141,68297,47360
212,22,3,2,0,3,1,0,143,98,62763,48126,152,61,68300,47360
213,22,1,2,1,0,0,3,110,111,62764,48128,121,131,68300,47363
214,22,3,1,0,3,1,0,185,87,62767,48129,186,101,68303,47363
215,22,1,1,2,1,2,1,90,81,62768,48130,95,31,68304,47364
216,22,2,0,0,3,1,0,10,12,62770,48130,14,31,68307,47364
217,22,3,0,0,3,1,0,165,110,62773,48130,161,48,68310,47364
218,22,0,1,1,0,0,3,147,80,62773,48131,176,76,68310,47367
219,22,0,1,1,0,0,3,122,93,62773,48132,137,88,68310,47370
220,23,1,3,1,0,0,3,36,50,62774,48135,32,118,68310,47373
221,23,3,1,0,3,1,0,116,97,62777,48136,116,143,68313,47373
222,23,1,1,2,1,2,1,155,66,62778,48137,180,10,68314,47374
223,23,1,1,2,1,2,1,68,55,62779,48138,75,73,68315,47375
224,23,5,2,0,3,1,0,123,111,62784,48140,134,31,68318,47375
225,23,0,0,2,1,2,1,177,80,62784,48140,182,83,68319,47376
226,23,0,1,1,0,0,3,134,83,62784,48141,167,106,68319,47379
227,23,1,4,1,0,0,3,83,79,62785,48145,106,119,68319,47382
228,23,2,1,0,3,1,0,78,81,62787,48146,112,64,68322,47382
229,23,2,2,2,1,2,1,46,68,62789,48148,50,179,68323,47383
230,24,2,1,0,3,1,0,190,69,62791,48149,209,61,68326,47383
231,24,1,1,2,1,2,1,50,46,62792,48150,48,132,68327,47384
232,24,3,0,0,3,1,0,13,12,62795,48150,17,88,68330,47384
233,24,2,1,0,3,1,0,149,81,62797,48151,179,48,68333,47384
234,24,2,0,0,3,1,0,157,66,62799,48151,183,31,68336,47384
235,24,1,1,2,1,2,1,144,99,62800,48152,153,55,68337,47385
236,24,2,0,0,3,1,0,187,87,62802,48152,189,31,68340,47385
237,24,1,2,1,0,0,3,111,113,62803,48154,121,122,68340,47388
238,24,1,1,2,1,2,1,91,82,62804,48155,96,77,68341,47389
239,24,1,0,0,3,1,0,123,93,62805,48155,140,101,68344,47389
240,25,0,0,2,1,2,1,78,81,62805,48155,113,142,68345,47390
241,25,1,2,1,0,0,3,112,115,62806,48157,121,34,68345,47393
242,25,0,0,2,1,2,1,116,97,62806,48157,117,11,68346,47394
243,25,1,0,0,3,1,0,47,68,62807,48157,53,101,68349,47394
244,25,1,2,1,0,0,3,84,81,62808,48159,106,67,68349,47397
245,25,0,3,1,0,0,3,36,53,62808,48162,32,109,68349,47400
246,25,0,1,1,0,0,3,165,111,62808,48163,161,121,68349,47403
247,25,1,0,0,3,1,0,69,55,62809,48163,78,143,68352,47403
248,25,1,1,2,1,2,1,178,81,62810,48164,183,180,68353,47404
249,25,2,0,0,3,1,0,125,111,62812,48164,137,83,68356,47404
250,26,2,0,0,3,1,0,93,82,62814,48164,99,73,68359,47404
251,26,2,2,2,1,2,1,159,68,62816,48166,184,35,68360,47405
252,26,0,0,2,1,2,1,47,68,62816,48166,54,49,68361,47406
253,26,0,0,2,1,2,1,78,81,62816,48166,114,133,68362,47407
254,26,1,1,2,1,2,1,14,13,62817,48167,18,78,68363,47408
255,26,0,0,2,1,2,1,123,93,62817,48167,141,62,68364,47409
256,26,3,2,0,3,1,0,137,85,62820,48169,170,55,68367,47409
257,26,2,2,2,1,2,1,189,89,62822,48171,190,123,68368,47410
258,26,4,0,0,3,1,0,153,81,62826,48171,182,121,68371,47410
259,26,1,0,0,3,1,0,191,69,62827,48171,212,31,68374,47410
260,27,0,1,1,0,0,3,116,98,62827,48172,117,183,68374,47413
261,27,1,1,2,1,2,1,113,116,62828,48173,122,12,68375,47414
262,27,0,0,2,1,2,1,84,81,62828,48173,107,102,68376,47415
263,27,4,1,0,3,1,0,40,54,62832,48174,35,83,68379,47415
264,27,0,2,1,0,0,3,125,113,62832,48176,137,91,68379,47418
265,27,2,0,0,3,1,0,52,46,62834,48176,51,143,68382,47418
266,27,1,1,2,1,2,1,166,112,62835,48177,162,32,68383,47419
267,27,0,2,1,0,0,3,69,57,62835,48179,78,112,68383,47422
268,27,2,1,0,3,1,0,146,100,62837,48180,156,142,68386,47422
269,27,0,2,1,0,0,3,178,83,62837,48182,183,70,68386,47425
270,28,1,0,0,3,1,0,79,81,62838,48182,117,49,68389,47425
271,28,3,1,0,3,1,0,162,69,62841,48183,187,73,68392,47425
272,28,3,1,0,3,1,0,17,14,62844,48184,21,31,68395,47425
273,28,1,0,0,3,1,0,192,69,62845,48184,215,78,68398,47425
274,28,2,0,0,3,1,0,155,81,62847,48184,185,35,68401,47425
275,28,2,2,2,1,2,1,139,87,62849,48186,171,122,68402,47426
276,28,1,1,2,1,2,1,190,90,62850,48187,191,63,68403,47427
277,28,0,2,1,0,0,3,123,95,62850,48189,141,58,68403,47430
278,28,0,1,1,0,0,3,47,69,62850,48190,54,136,68403,47433
279,28,1,0,0,3,1,0,94,82,62851,48190,102,123,68406,47433
280,29,1,0,0,3,1,0,179,83,62852,48190,186,143,68409,47433
281,29,1,1,2,1,2,1,126,114,62853,48191,138,103,68410,47434
282,29,1,3,1,0,0,3,114,119,62854,48194,122,115,68410,47437
283,29,1,0,0,3,1,0,41,54,62855,48194,38,91,68413,47437
284,29,1,2,1,0,0,3,85,83,62856,48196,107,61,68413,47440
285,29,1,1,2,1,2,1,167,113,62857,48197,163,84,68414,47441
286,29,1,2,1,0,0,3,117,100,62858,48199,117,145,68414,47444
287,29,3,3,2,1,2,1,55,49,62861,48202,52,33,68415,47445
288,29,2,0,0,3,1,0,148,100,62863,48202,159,70,68418,47445
289,29,2,0,0,3,1,0,194,69,62865,48202,218,12,68421,47445
290,30,2,0,0,3,1,0,128,114,62867,48202,141,73,68424,47445
291,30,1,0,0,3,1,0,124,95,62868,48202,144,183,68427,47445
292,30,0,3,1,0,0,3,55,52,62868,48205,52,126,68427,47448
293,30,0,1,1,0,0,3,47,70,62868,48206,54,94,68427,47451
294,30,1,3,1,0,0,3,140,90,62869,48209,171,52,68427,47454
295,30,4,0,0,3,1,0,159,81,62873,48209,188,12,68430,47454
296,30,2,1,0,3,1,0,87,84,62875,48210,110,31,68433,47454
297,30,1,1,2,1,2,1,70,58,62876,48211,79,137,68434,47455
298,30,3,0,0,3,1,0,193,90,62879,48211,194,122,68437,47455
299,30,1,1,2,1,2,1,163,70,62880,48212,188,71,68438,47456
300,31,0,0,2,1,2,1,94,82,62880,48212,103,34,68439,47457
301,31,2,0,0,3,1,0,196,69,62882,48212,221,115,68442,47457
302,31,1,1,2,1,2,1,42,55,62883,48213,39,62,68443,47458
303,31,2,1,0,3,1,0,119,101,62885,48214,120,78,68446,47458
304,31,1,1,2,1,2,1,180,84,62886,48215,187,64,68447,47459
305,31,1,1,2,1,2,1,80,82,62887,48216,118,104,68448,47460
306,31,2,2,2,1,2,1,19,16,62889,48218,22,85,68449,47461
307,31,0,3,1,0,0,3,114,122,62889,48221,122,146,68449,47464
308,31,0,0,2,1,2,1,167,113,62889,48221,164,146,68450,47465
309,31,0,1,1,0,0,3,148,101,62889,48222,159,38,68450,47468
310,32,2,1,0,3,1,0,142,91,62891,48223,174,146,68453,47468
311,32,2,1,0,3,1,0,169,114,62893,48224,167,137,68456,47468
312,32,2,2,2,1,2,1,89,86,62895,48226,111,13,68457,47469
313,32,3,2,0,3,1,0,58,54,62898,48228,55,31,68460,47469
314,32,3,1,0,3,1,0,131,115,62901,48229,144,34,68463,47469
315,32,1,0,0,3,1,0,125,95,62902,48229,147,52,68466,47469
316,32,2,1,0,3,1,0,72,59,62904,48230,82,183,68469,47469
317,32,1,1,2,1,2,1,160,82,62905,48231,189,95,68470,47470
318,32,1,3,1,0,0,3,149,104,62906,48234,159,76,68470,47473
319,32,4,2,0,3,1,0,197,92,62910,48236,197,71,68473,47473
320,33,1,2,1,0,0,3,143,93,62911,48238,174,129,68473,47476
321,33,1,0,0,3,1,0,81,82,62912,48238,121,76,68476,47476
322,33,0,3,1,0,0,3,42,58,62912,48241,39,140,68476,47479
323,33,1,1,2,1,2,1,95,83,62913,48242,104,39,68477,47480
324,33,3,2,0,3,1,0,199,71,62916,48244,224,122,68480,47480
325,33,2,2,2,1,2,1,49,72,62918,48246,55,65,68481,47481
326,33,2,2,2,1,2,1,121,103,62920,48248,121,63,68482,47482
327,33,4,0,0,3,1,0,164,82,62924,48248,192,85,68485,47482
328,33,1,3,1,0,0,3,164,73,62925,48251,188,81,68485,47485
329,33,4,2,0,3,1,0,23,18,62929,48253,25,146,68488,47485
330,34,0,1,1,0,0,3,95,84,62929,48254,104,186,68488,47488
331,34,0,0,2,1,2,1,42,58,62929,48254,40,53,68489,47489
332,34,2,0,0,3,1,0,182,84,62931,48254,190,81,68492,47489
333,34,0,1,1,0,0,3,58,55,62931,48255,55,107,68492,47492
334,34,1,1,2,1,2,1,90,87,62932,48256,112,116,68493,47493
335,34,3,1,0,3,1,0,152,105,62935,48257,162,34,68496,47493
336,34,0,0,2,1,2,1,169,114,62935,48257,168,96,68497,47494
337,34,3,0,0,3,1,0,200,92,62938,48257,200,146,68500,47494
338,34,4,0,0,3,1,0,118,122,62942,48257,125,85,68503,47494
339,34,0,1,1,0,0,3,72,60,62942,48258,82,16,68503,47497
340,35,1,1,2,1,2,1,200,72,62943,48259,225,77,68504,47498
341,35,2,1,0,3,1,0,166,74,62945,48260,191,140,68507,47498
342,35,2,2,2,1,2,1,83,84,62947,48262,122,40,68508,47499
343,35,2,3,1,0,0,3,51,75,62949,48265,55,34,68508,47502
344,35,2,3,1,0,0,3,123,106,62951,48268,121,68,68508,47505
345,35,1,4,1,0,0,3,144,97,62952,48272,174,74,68508,47508
346,35,2,3,1,0,0,3,25,21,62954,48275,25,125,68508,47511
347,35,2,2,2,1,2,1,127,97,62956,48277,148,147,68509,47512
348,35,1,2,1,0,0,3,165,84,62957,48279,192,132,68509,47515
349,35,5,1,0,3,1,0,136,116,62962,48280,147,63,68512,47515
350,36,1,2,1,0,0,3,170,116,62963,48282,168,189,68512,47518
351,36,0,1,1,0,0,3,95,85,62963,48283,104,119,68512,47521
352,36,3,2,0,3,1,0,45,60,62966,48285,43,146,68515,47521
353,36,2,1,0,3,1,0,60,56,62968,48286,58,16,68518,47521
354,36,0,1,1,0,0,3,118,123,62968,48287,125,56,68518,47524
355,36,1,4,1,0,0,3,91,91,62969,48291,112,84,68518,47527
356,36,2,0,0,3,1,0,74,60,62971,48291,85,96,68521,47527
357,36,2,1,0,3,1,0,184,85,62973,48292,193,107,68524,47527
358,36,3,0,0,3,1,0,155,105,62976,48292,165,85,68527,47527
359,36,3,2,0,3,1,0,203,94,62979,48294,203,34,68530,47527
360,37,3,1,0,3,1,0,203,73,62982,48295,228,147,68533,47527
361,37,3,2,0,3,1,0,139,118,62985,48297,150,132,68536,47527
362,37,1,1,2,1,2,1,26,22,62986,48298,26,75,68537,47528
363,37,2,2,2,1,2,1,129,99,62988,48300,149,41,68538,47529
364,37,0,1,1,0,0,3,51,76,62988,48301,55,80,68538,47532
365,37,0,1,1,0,0,3,144,98,62988,48302,174,37,68538,47535
366,37,2,3,1,0,0,3,125,109,62990,48305,121,128,68538,47538
367,37,1,1,2,1,2,1,84,85,62991,48306,123,69,68539,47539
368,37,3,0,0,3,1,0,169,74,62994,48306,194,63,68542,47539
369,37,1,2,1,0,0,3,166,86,62995,48308,192,143,68542,47542
370,38,2,2,2,1,2,1,62,58,62997,48310,59,190,68543,47543
371,38,1,3,1,0,0,3,92,94,62998,48313,112,149,68543,47546
372,38,4,3,0,3,1,0,122,126,63002,48316,128,107,68546,47546
373,38,3,0,0,3,1,0,158,105,63005,48316,168,96,68549,47546
374,38,2,2,2,1,2,1,97,87,63007,48318,105,86,68550,47547
375,38,4,3,0,3,1,0,174,119,63011,48321,171,16,68553,47547
376,38,5,0,0,3,1,0,79,60,63016,48321,88,34,68556,47547
377,38,1,2,1,0,0,3,185,87,63017,48323,193,59,68556,47550
378,38,2,4,1,0,0,3,205,98,63019,48327,203,122,68556,47553
379,38,3,1,0,3,1,0,48,61,63022,48328,46,84,68559,47553
0,1,1,1,2,1,2,1,63,59,63023,48329,60,144,68560,47554
1,1,2,1,0,3,1,0,168,87,63025,48330,195,69,68563,47554
2,1,0,1,1,0,0,3,203,74,63025,48331,228,110,68563,47557
3,1,1,3,1,0,0,3,27,25,63026,48334,26,99,68563,47560
4,1,2,0,0,3,1,0,160,105,63028,48334,171,149,68566,47560
5,1,1,2,1,0,0,3,1,2,63029,48336,0,66,68566,47563
6,1,1,0,0,3,1,0,175,119,63030,48336,174,69,68569,47563
7,1,1,0,0,3,1,0,126,109,63031,48336,124,84,68572,47563
8,1,5,2,0,3,1,0,102,89,63036,48338,108,0,68575,47563
9,1,2,1,0,3,1,0,50,62,63038,48339,49,147,68578,47563
10,2,0,1,1,0,0,3,85,96,63038,48340,99,40,68578,47566
11,2,2,1,0,3,1,0,171,75,63040,48341,197,16,68581,47566
12,2,2,1,0,3,1,0,187,88,63042,48342,196,190,68584,47566
13,2,2,0,0,3,1,0,94,94,63044,48342,115,0,68587,47566
14,2,1,2,1,0,0,3,1,2,63045,48344,0,135,68587,47569
15,2,4,0,0,3,1,0,88,85,63049,48344,126,122,68590,47569
16,2,2,0,0,3,1,0,141,118,63051,48344,153,41,68593,47569
17,2,2,2,2,1,2,1,207,100,63053,48346,204,76,68594,47570
18,2,3,1,0,3,1,0,82,61,63056,48347,91,128,68597,47570
19,2,0,1,1,0,0,3,144,99,63056,48348,174,62,68597,47573
20,3,1,0,0,3,1,0,161,105,63057,48348,174,84,68600,47573
21,3,0,2,1,0,0,3,1,4,63057,48350,0,147,68600,47576
22,3,1,1,2,1,2,1,204,75,63058,48351,229,100,68601,47577
23,3,2,2,2,1,2,1,65,61,63060,48353,61,67,68602,47578
24,3,2,2,2,1,2,1,29,27,63062,48355,27,148,68603,47579
25,3,2,2,2,1,2,1,128,111,63064,48357,125,1,68604,47580
26,3,2,2,2,1,2,1,52,64,63066,48359,50,70,68605,47581
27,3,2,0,0,3,1,0,170,87,63068,48359,198,110,68608,47581
28,3,1,0,0,3,1,0,176,119,63069,48359,177,149,68611,47581
29,3,2,0,0,3,1,0,104,89,63071,48359,111,69,68614,47581
30,4,1,2,1,0,0,3,145,101,63072,48361,174,19,68614,47584
31,4,3,2,0,3,1,0,174,77,63075,48363,200,62,68617,47584
32,4,0,1,1,0,0,3,88,86,63075,48364,126,138,68617,47587
33,4,1,1,2,1,2,1,95,95,63076,48365,116,42,68618,47588
34,4,1,0,0,3,1,0,86,96,63077,48365,102,0,68621,47588
35,4,0,2,1,0,0,3,141,120,63077,48367,153,193,68621,47591
36,4,2,2,2,1,2,1,189,90,63079,48369,197,41,68622,47592
37,4,2,0,0,3,1,0,84,61,63081,48369,94,76,68625,47592
38,4,0,1,1,0,0,3,1,3,63081,48370,0,131,68625,47595
39,4,5,0,0,3,1,0,212,100,63086,48370,207,122,68628,47595
40,5,2,3,1,0,0,3,147,104,63088,48373,174,152,68628,47598
41,5,0,0,2,1,2,1,1,3,63088,48373,1,149,68629,47599
42,5,1,0,0,3,1,0,89,86,63089,48373,129,67,68632,47599
43,5,2,0,0,3,1,0,163,105,63091,48373,177,69,68635,47599
44,5,1,0,0,3,1,0,177,119,63092,48373,180,42,68638,47599
45,5,1,1,2,1,2,1,205,76,63093,48374,230,1,68639,47600
46,5,2,0,0,3,1,0,172,87,63095,48374,201,84,68642,47600
47,5,0,1,1,0,0,3,128,112,63095,48375,125,44,68642,47603
48,5,2,1,0,3,1,0,106,90,63097,48376,114,147,68645,47603
49,5,0,1,1,0,0,3,29,28,63097,48377,27,73,68645,47606
50,6,5,1,0,3,1,0,194,91,63102,48378,200,1,68648,47606
51,6,2,1,0,3,1,0,214,101,63104,48379,210,193,68651,47606
52,6,1,0,0,3,1,0,142,120,63105,48379,156,152,68654,47606
53,6,1,2,1,0,0,3,87,98,63106,48381,102,113,68654,47609
54,6,1,2,1,0,0,3,66,63,63107,48383,61,125,68654,47612
55,6,1,1,2,1,2,1,53,65,63108,48384,51,101,68655,47613
56,6,2,1,0,3,1,0,86,62,63110,48385,97,62,68658,47613
57,6,1,4,1,0,0,3,178,123,63111,48389,180,134,68658,47616
58,6,2,0,0,3,1,0,3,4,63113,48389,3,19,68661,47616
59,6,2,1,0,3,1,0,97,96,63115,48390,119,76,68664,47616
60,7,2,1,0,3,1,0,3,4,63117,48391,4,67,68667,47616
61,7,1,1,2,1,2,1,90,87,63118,48392,130,43,68668,47617
62,7,1,0,0,3,1,0,30,28,63119,48392,30,44,68671,47617
63,7,2,4,1,0,0,3,130,116,63121,48396,125,150,68671,47620
64,7,1,1,2,1,2,1,107,91,63122,48397,115,139,68672,47621
65,7,1,1,2,1,2,1,148,105,63123,48398,175,85,68673,47622
66,7,3,1,0,3,1,0,208,77,63126,48399,233,69,68676,47622
67,7,2,0,0,3,1,0,174,87,63128,48399,204,1,68679,47622
68,7,3,0,0,3,1,0,166,105,63131,48399,180,73,68682,47622
69,7,0,4,1,0,0,3,174,81,63131,48403,200,152,68682,47625
70,8,3,1,0,3,1,0,197,92,63134,48404,203,19,68685,47625
71,8,1,1,2,1,2,1,87,63,63135,48405,98,153,68686,47626
72,8,0,1,1,0,0,3,87,99,63135,48406,102,65,68686,47629
73,8,3,0,0,3,1,0,100,96,63138,48406,122,1,68689,47629
74,8,2,0,0,3,1,0,5,4,63140,48406,6,76,68692,47629
75,8,3,2,0,3,1,0,145,122,63143,48408,159,101,68695,47629
76,8,1,1,2,1,2,1,67,64,63144,48409,62,114,68696,47630
77,8,2,1,0,3,1,0,216,102,63146,48410,213,134,68699,47630
78,8,2,1,0,3,1,0,55,66,63148,48411,54,125,68702,47630
79,8,0,0,2,1,2,1,178,123,63148,48411,181,194,68703,47631
80,9,2,0,0,3,1,0,32,28,63150,48411,33,85,68706,47631
81,9,1,2,1,0,0,3,4,6,63151,48413,4,72,68706,47634
82,9,1,1,2,1,2,1,131,117,63152,48414,126,140,68707,47635
83,9,4,1,0,3,1,0,111,92,63156,48415,118,43,68710,47635
84,9,2,0,0,3,1,0,210,77,63158,48415,236,73,68713,47635
85,9,2,1,0,3,1,0,176,82,63160,48416,203,44,68716,47635
86,9,1,0,0,3,1,0,149,105,63161,48416,178,1,68719,47635
87,9,1,2,1,0,0,3,167,107,63162,48418,180,153,68719,47638
88,9,3,0,0,3,1,0,177,87,63165,48418,207,67,68722,47638
89,9,0,1,1,0,0,3,90,88,63165,48419,130,155,68722,47641
90,10,0,1,1,0,0,3,87,100,63165,48420,102,143,68722,47644
91,10,2,1,0,3,1,0,102,97,63167,48421,125,125,68725,47644
92,10,2,1,0,3,1,0,7,5,63169,48422,9,1,68728,47644
93,10,0,2,1,0,0,3,67,66,63169,48424,62,137,68728,47647
94,10,1,0,0,3,1,0,177,82,63170,48424,206,101,68731,47647
95,10,2,0,0,3,1,0,218,102,63172,48424,216,65,68734,47647
96,10,3,1,0,3,1,0,200,93,63175,48425,206,114,68737,47647
97,10,1,0,0,3,1,0,56,66,63176,48425,57,194,68740,47647
98,10,3,3,2,1,2,1,90,66,63179,48428,99,86,68741,47648
99,10,1,1,2,1,2,1,112,93,63180,48429,119,20,68742,47649
100,11,2,1,0,3,1,0,212,78,63182,48430,239,67,68745,47649
101,11,1,0,0,3,1,0,179,123,63183,48430,184,153,68748,47649
102,11,4,1,0,3,1,0,171,108,63187,48431,183,1,68751,47649
103,11,3,0,0,3,1,0,90,100,63190,48431,105,73,68754,47649
104,11,0,0,2,1,2,1,4,6,63190,48431,5,44,68755,47650
105,11,0,0,2,1,2,1,145,122,63190,48431,160,156,68756,47651
106,11,0,0,2,1,2,1,149,105,63190,48431,179,45,68757,47652
107,11,1,3,1,0,0,3,178,90,63191,48434,207,156,68757,47655
108,11,1,1,2,1,2,1,91,89,63192,48435,131,77,68758,47656
109,11,0,1,1,0,0,3,131,118,63192,48436,126,23,68758,47659
110,12,0,2,1,0,0,3,67,68,63192,48438,62,75,68758,47662
111,12,0,0,2,1,2,1,177,82,63192,48438,207,74,68759,47663
112,12,0,1,1,0,0,3,90,67,63192,48439,99,146,68759,47666
113,12,1,3,1,0,0,3,33,31,63193,48442,33,197,68759,47669
114,12,2,2,2,1,2,1,9,7,63195,48444,10,87,68760,47670
115,12,1,0,0,3,1,0,132,118,63196,48444,129,101,68763,47670
116,12,2,0,0,3,1,0,202,93,63198,48444,209,125,68766,47670
117,12,1,0,0,3,1,0,57,66,63199,48444,60,1,68769,47670
118,12,1,0,0,3,1,0,219,102,63200,48444,219,114,68772,47670
119,12,0,2,1,0,0,3,112,95,63200,48446,119,140,68772,47673
120,13,2,2,2,1,2,1,92,102,63202,48448,106,154,68773,47674
121,13,1,0,0,3,1,0,213,78,63203,48448,242,156,68776,47674
122,13,0,2,1,0,0,3,67,70,63203,48450,62,159,68776,47677
123,13,0,1,1,0,0,3,102,98,63203,48451,125,70,68776,47680
124,13,1,2,1,0,0,3,5,8,63204,48453,5,104,68776,47683
125,13,2,2,2,1,2,1,173,110,63206,48455,184,24,68777,47684
126,13,2,1,0,3,1,0,147,123,63208,48456,163,45,68780,47684
127,13,1,1,2,1,2,1,179,91,63209,48457,208,66,68781,47685
128,13,1,0,0,3,1,0,150,105,63210,48457,182,77,68784,47685
129,13,4,0,0,3,1,0,183,123,63214,48457,187,1,68787,47685
130,14,2,0,0,3,1,0,92,67,63216,48457,102,75,68790,47685
131,14,4,1,0,3,1,0,181,83,63220,48458,210,77,68793,47685
132,14,2,3,1,0,0,3,93,92,63222,48461,131,117,68793,47688
133,14,3,2,0,3,1,0,12,9,63225,48463,13,44,68796,47688
134,14,1,2,1,0,0,3,148,125,63226,48465,163,4,68796,47691
135,14,0,2,1,0,0,3,202,95,63226,48467,209,77,68796,47694
136,14,1,0,0,3,1,0,34,31,63227,48467,36,125,68799,47694
137,14,0,3,1,0,0,3,132,121,63227,48470,129,200,68799,47697
138,14,1,1,2,1,2,1,58,67,63228,48471,61,141,68800,47698
139,14,2,1,0,3,1,0,221,103,63230,48472,222,146,68803,47698
140,15,0,2,1,0,0,3,179,93,63230,48474,208,203,68803,47701
141,15,1,1,2,1,2,1,93,68,63231,48475,103,155,68804,47702
142,15,1,0,0,3,1,0,184,123,63232,48475,190,87,68807,47702
143,15,3,2,0,3,1,0,95,104,63235,48477,109,159,68810,47702
144,15,3,0,0,3,1,0,105,98,63238,48477,128,66,68813,47702
145,15,3,0,0,3,1,0,176,110,63241,48477,187,117,68816,47702
146,15,0,2,1,0,0,3,12,11,63241,48479,13,107,68816,47705
147,15,0,1,1,0,0,3,67,71,63241,48480,62,27,68816,47708
148,15,1,3,1,0,0,3,113,98,63242,48483,119,48,68816,47711
149,15,0,0,2,1,2,1,5,8,63242,48483,6,157,68817,47712
150,16,0,1,1,0,0,3,148,126,63242,48484,163,78,68817,47715
151,16,4,1,0,3,1,0,136,122,63246,48485,132,1,68820,47715
152,16,0,4,1,0,0,3,150,109,63246,48489,182,149,68820,47718
153,16,1,0,0,3,1,0,94,92,63247,48489,134,77,68823,47718
154,16,3,0,0,3,1,0,37,31,63250,48489,39,4,68826,47718
155,16,1,1,2,1,2,1,182,84,63251,48490,211,45,68827,47719
156,16,0,0,2,1,2,1,221,103,63251,48490,223,156,68828,47720
157,16,3,1,0,3,1,0,216,79,63254,48491,245,141,68831,47720
158,16,1,1,2,1,2,1,180,94,63255,48492,209,78,68832,47721
159,16,1,1,2,1,2,1,59,68,63256,48493,62,71,68833,47722
160,17,2,3,1,0,0,3,97,107,63258,48496,109,30,68833,47725
161,17,2,3,1,0,0,3,7,11,63260,48499,6,206,68833,47728
162,17,1,3,1,0,0,3,106,101,63261,48502,128,162,68833,47731
163,17,2,0,0,3,1,0,178,110,63263,48502,190,107,68836,47731
164,17,1,1,2,1,2,1,68,72,63264,48503,63,49,68837,47732
165,17,2,0,0,3,1,0,204,95,63266,48503,212,87,68840,47732
166,17,2,4,1,0,0,3,14,15,63268,48507,13,160,68840,47735
167,17,2,0,0,3,1,0,115,98,63270,48507,122,66,68843,47735
168,17,0,1,1,0,0,3,93,69,63270,48508,103,120,68843,47738
169,17,1,2,1,0,0,3,185,125,63271,48510,190,128,68843,47741
170,18,2,3,1,0,0,3,150,129,63273,48513,163,81,68843,47744
171,18,2,1,0,3,1,0,152,110,63275,48514,185,77,68846,47744
172,18,3,3,2,1,2,1,97,95,63278,48517,135,157,68847,47745
173,18,3,0,0,3,1,0,219,79,63281,48517,248,45,68850,47745
174,18,0,0,2,1,2,1,180,94,63281,48517,210,5,68851,47746
175,18,0,1,1,0,0,3,182,85,63281,48518,211,81,68851,47749
176,18,1,3,1,0,0,3,137,125,63282,48521,132,144,68851,47752
177,18,2,2,2,1,2,1,61,70,63284,48523,63,2,68852,47753
178,18,0,1,1,0,0,3,37,32,63284,48524,39,152,68852,47756
179,18,2,1,0,3,1,0,223,104,63286,48525,226,71,68855,47756
180,19,2,1,0,3,1,0,9,12,63288,48526,9,120,68858,47756
181,19,1,3,1,0,0,3,179,113,63289,48529,190,131,68858,47759
182,19,1,1,2,1,2,1,205,96,63290,48530,213,161,68859,47760
183,19,0,1,1,0,0,3,185,126,63290,48531,190,52,68859,47763
184,19,0,2,1,0,0,3,106,103,63290,48533,128,90,68859,47766
185,19,0,1,1,0,0,3,97,108,63290,48534,109,110,68859,47769
186,19,1,5,1,0,0,3,15,20,63291,48539,13,165,68859,47772
187,19,0,1,1,0,0,3,68,73,63291,48540,63,69,68859,47775
188,19,0,1,1,0,0,3,93,70,63291,48541,103,33,68859,47778
189,19,1,2,1,0,0,3,116,100,63292,48543,122,209,68859,47781
190,20,1,1,2,1,2,1,107,104,63293,48544,129,153,68860,47782
191,20,4,2,0,3,1,0,97,72,63297,48546,106,2,68863,47782
192,20,3,1,0,3,1,0,226,105,63300,48547,229,52,68866,47782
193,20,4,0,0,3,1,0,154,129,63304,48547,166,69,68869,47782
194,20,1,1,2,1,2,1,98,96,63305,48548,136,34,68870,47783
195,20,1,1,2,1,2,1,206,97,63306,48549,214,46,68871,47784
196,20,0,4,1,0,0,3,152,114,63306,48553,185,212,68871,47787
197,20,2,2,2,1,2,1,99,110,63308,48555,110,132,68872,47788
198,20,2,1,0,3,1,0,11,13,63310,48556,12,81,68875,47788
199,20,2,0,0,3,1,0,184,85,63312,48556,214,144,68878,47788
200,21,0,0,2,1,2,1,15,20,63312,48556,14,78,68879,47789
201,21,2,2,2,1,2,1,39,34,63314,48558,40,162,68880,47790
202,21,2,0,0,3,1,0,181,113,63316,48558,193,71,68883,47790
203,21,0,2,1,0,0,3,61,72,63316,48560,63,84,68883,47793
204,21,1,1,2,1,2,1,186,127,63317,48561,191,6,68884,47794
205,21,4,1,0,3,1,0,184,95,63321,48562,213,110,68887,47794
206,21,1,1,2,1,2,1,69,74,63322,48563,64,91,68888,47795
207,21,2,4,1,0,0,3,118,104,63324,48567,122,168,68888,47798
208,21,4,1,0,3,1,0,141,126,63328,48568,135,120,68891,47798
209,21,1,0,0,3,1,0,220,79,63329,48568,251,157,68894,47798
210,22,1,1,2,1,2,1,12,14,63330,48569,13,70,68895,47799
211,22,1,1,2,1,2,1,108,105,63331,48570,130,53,68896,47800
212,22,3,1,0,3,1,0,209,98,63334,48571,217,2,68899,47800
213,22,0,4,1,0,0,3,98,100,63334,48575,136,215,68899,47803
214,22,5,1,0,3,1,0,231,106,63339,48576,232,34,68902,47803
215,22,0,0,2,1,2,1,154,129,63339,48576,167,145,68903,47804
216,22,0,0,2,1,2,1,97,72,63339,48576,107,47,68904,47805
217,22,0,0,2,1,2,1,152,114,63339,48576,186,133,68905,47806
218,22,3,2,0,3,1,0,102,112,63342,48578,113,81,68908,47806
219,22,3,0,0,3,1,0,187,85,63345,48578,217,153,68911,47806
220,23,0,2,1,0,0,3,61,74,63345,48580,63,160,68911,47809
221,23,1,0,0,3,1,0,16,20,63346,48580,17,84,68914,47809
222,23,2,1,0,3,1,0,71,75,63348,48581,67,78,68917,47809
223,23,2,1,0,3,1,0,183,114,63350,48582,196,6,68920,47809
224,23,1,0,0,3,1,0,187,127,63351,48582,194,110,68923,47809
225,23,1,0,0,3,1,0,221,79,63352,48582,254,91,68926,47809
226,23,0,2,1,0,0,3,141,128,63352,48584,135,165,68926,47812
227,23,0,2,1,0,0,3,184,97,63352,48586,213,171,68926,47815
228,23,2,2,2,1,2,1,120,106,63354,48588,123,72,68927,47816
229,23,1,1,2,1,2,1,40,35,63355,48589,41,121,68928,47817
230,24,1,1,2,1,2,1,103,113,63356,48590,114,146,68929,47818
231,24,0,0,2,1,2,1,154,129,63356,48590,168,134,68930,47819
232,24,3,3,2,1,2,1,74,78,63359,48593,68,154,68931,47820
233,24,1,0,0,3,1,0,232,106,63360,48593,235,6,68934,47820
234,24,1,2,1,0,0,3,98,74,63361,48595,107,113,68934,47823
235,24,0,2,1,0,0,3,16,22,63361,48597,17,218,68934,47826
236,24,2,2,2,1,2,1,63,76,63363,48599,64,71,68935,47827
237,24,1,1,2,1,2,1,188,86,63364,48600,218,122,68936,47828
238,24,0,0,2,1,2,1,108,105,63364,48600,131,35,68937,47829
239,24,2,1,0,3,1,0,211,99,63366,48601,220,81,68940,47829
240,25,5,2,0,3,1,0,189,99,63371,48603,216,47,68943,47829
241,25,1,3,1,0,0,3,13,17,63372,48606,13,163,68943,47832
242,25,1,2,1,0,0,3,41,37,63373,48608,41,5,68943,47835
243,25,1,1,2,1,2,1,99,101,63374,48609,137,54,68944,47836
244,25,1,0,0,3,1,0,222,79,63375,48609,257,171,68947,47836
245,25,2,1,0,3,1,0,190,87,63377,48610,221,91,68950,47836
246,25,0,0,2,1,2,1,120,106,63377,48610,124,79,68951,47837
247,25,0,1,1,0,0,3,152,115,63377,48611,186,87,68951,47840
248,25,1,3,1,0,0,3,142,131,63378,48614,135,75,68951,47843
249,25,2,1,0,3,1,0,185,115,63380,48615,199,154,68954,47843
250,26,0,0,2,1,2,1,103,113,63380,48615,115,219,68955,47844
251,26,3,1,0,3,1,0,77,79,63383,48616,71,113,68958,47844
252,26,3,1,0,3,1,0,190,128,63386,48617,197,81,68961,47844
253,26,0,0,2,1,2,1,98,74,63386,48617,108,7,68962,47845
254,26,3,2,0,3,1,0,66,78,63389,48619,67,35,68965,47845
255,26,2,3,1,0,0,3,110,108,63391,48622,131,149,68965,47848
256,26,2,1,0,3,1,0,156,130,63393,48623,171,122,68968,47848
257,26,0,0,2,1,2,1,16,22,63393,48623,18,135,68969,47849
258,26,5,0,0,3,1,0,216,99,63398,48623,223,71,68972,47849
259,26,1,1,2,1,2,1,233,107,63399,48624,236,166,68973,47850
260,27,1,3,1,0,0,3,42,40,63400,48627,41,166,68973,47853
261,27,1,0,0,3,1,0,191,87,63401,48627,224,75,68976,47853
262,27,0,0,2,1,2,1,142,131,63401,48627,136,88,68977,47854
263,27,1,1,2,1,2,1,14,18,63402,48628,14,80,68978,47855
264,27,2,0,0,3,1,0,122,106,63404,48628,127,5,68981,47855
265,27,1,0,0,3,1,0,100,101,63405,48628,140,91,68984,47855
266,27,2,0,0,3,1,0,154,115,63407,48628,189,47,68987,47855
267,27,2,0,0,3,1,0,224,79,63409,48628,260,154,68990,47855
268,27,0,2,1,0,0,3,189,101,63409,48630,216,57,68990,47858
269,27,1,1,2,1,2,1,186,116,63410,48631,200,172,68991,47859
270,28,4,1,0,3,1,0,220,100,63414,48632,226,149,68994,47859
271,28,0,3,1,0,0,3,77,82,63414,48635,71,84,68994,47862
272,28,3,1,0,3,1,0,236,108,63417,48636,239,113,68997,47862
273,28,1,1,2,1,2,1,99,75,63418,48637,109,136,68998,47863
274,28,0,0,2,1,2,1,103,113,63418,48637,116,8,68999,47864
275,28,1,0,0,3,1,0,157,130,63419,48637,174,35,69002,47864
276,28,0,2,1,0,0,3,110,110,63419,48639,131,222,69002,47867
277,28,2,0,0,3,1,0,68,78,63421,48639,70,166,69005,47867
278,28,2,0,0,3,1,0,18,22,63423,48639,21,122,69008,47867
279,28,3,1,0,3,1,0,193,129,63426,48640,200,71,69011,47867
280,29,1,0,0,3,1,0,225,79,63427,48640,263,57,69014,47867
281,29,1,1,2,1,2,1,43,41,63428,48641,42,85,69015,47868
282,29,2,1,0,3,1,0,195,130,63430,48642,203,88,69018,47868
283,29,0,0,2,1,2,1,100,101,63430,48642,141,167,69019,47869
284,29,2,1,0,3,1,0,16,19,63432,48643,17,5,69022,47869
285,29,1,1,2,1,2,1,187,117,63433,48644,201,48,69023,47870
286,29,1,2,1,0,0,3,155,117,63434,48646,189,169,69023,47873
287,29,3,2,0,3,1,0,160,132,63437,48648,177,75,69026,47873
288,29,2,0,0,3,1,0,191,101,63439,48648,219,80,69029,47873
289,29,0,1,1,0,0,3,142,132,63439,48649,136,175,69029,47876
290,30,0,0,2,1,2,1,43,41,63439,48649,43,72,69030,47877
291,30,1,1,2,1,2,1,221,101,63440,48650,227,155,69031,47878
292,30,2,0,0,3,1,0,112,110,63442,48650,134,88,69034,47878
293,30,1,2,1,0,0,3,78,84,63443,48652,71,11,69034,47881
294,30,0,1,1,0,0,3,122,107,63443,48653,127,116,69034,47884
295,30,0,0,2,1,2,1,18,22,63443,48653,22,150,69035,47885
296,30,1,4,1,0,0,3,100,79,63444,48657,109,225,69035,47888
297,30,1,1,2,1,2,1,69,79,63445,48658,71,123,69036,47889
298,30,3,1,0,3,1,0,239,109,63448,48659,242,91,69039,47889
299,30,1,1,2,1,2,1,192,88,63449,48660,225,137,69040,47890
300,31,1,3,1,0,0,3,17,22,63450,48663,17,60,69040,47893
301,31,1,0,0,3,1,0,226,79,63451,48663,266,35,69043,47893
302,31,3,1,0,3,1,0,158,118,63454,48664,192,175,69046,47893
303,31,4,0,0,3,1,0,164,132,63458,48664,180,5,69049,47893
304,31,2,1,0,3,1,0,114,111,63460,48665,137,167,69052,47893
305,31,3,1,0,3,1,0,103,102,63463,48666,144,72,69055,47893
306,31,1,4,1,0,0,3,192,105,63464,48670,219,172,69055,47896
307,31,1,1,2,1,2,1,188,118,63465,48671,202,86,69056,47897
308,31,1,2,1,0,0,3,196,132,63466,48673,203,78,69056,47900
309,31,0,1,1,0,0,3,103,114,63466,48674,116,51,69056,47903
310,32,0,1,1,0,0,3,18,23,63466,48675,22,158,69056,47906
311,32,1,0,0,3,1,0,104,102,63467,48675,147,11,69059,47906
312,32,0,1,1,0,0,3,69,80,63467,48676,71,94,69059,47909
313,32,1,2,1,0,0,3,193,90,63468,48678,225,228,69059,47912
314,32,2,0,0,3,1,0,45,41,63470,48678,46,150,69062,47912
315,32,2,1,0,3,1,0,102,80,63472,48679,112,80,69065,47912
316,32,3,0,0,3,1,0,242,109,63475,48679,245,51,69068,47912
317,32,2,0,0,3,1,0,124,107,63477,48679,130,123,69071,47912
318,32,0,3,1,0,0,3,142,135,63477,48682,136,140,69071,47915
319,32,1,1,2,1,2,1,222,102,63478,48683,228,89,69072,47916
320,33,0,1,1,0,0,3,103,115,63478,48684,116,81,69072,47919
321,33,4,1,0,3,1,0,21,23,63482,48685,20,94,69075,47919
322,33,2,0,0,3,1,0,198,132,63484,48685,206,175,69078,47919
323,33,3,3,2,1,2,1,117,114,63487,48688,138,173,69079,47920
324,33,0,0,2,1,2,1,158,118,63487,48688,193,117,69080,47921
325,33,1,2,1,0,0,3,79,86,63488,48690,71,8,69080,47924
326,33,4,0,0,3,1,0,230,79,63492,48690,269,72,69083,47924
327,33,3,1,0,3,1,0,191,119,63495,48691,205,60,69086,47924
328,33,2,0,0,3,1,0,194,105,63497,48691,222,35,69089,47924
329,33,0,1,1,0,0,3,124,108,63497,48692,130,170,69089,47927
330,34,6,0,0,3,1,0,248,109,63503,48692,248,89,69092,47927
331,34,0,0,2,1,2,1,69,80,63503,48692,72,87,69093,47928
332,34,2,2,2,1,2,1,144,137,63505,48694,137,81,69094,47929
333,34,2,1,0,3,1,0,160,119,63507,48695,196,150,69097,47929
334,34,5,1,0,3,1,0,109,103,63512,48696,150,8,69100,47929
335,34,1,0,0,3,1,0,46,41,63513,48696,49,51,69103,47929
336,34,1,0,0,3,1,0,165,132,63514,48696,183,158,69106,47929
337,34,3,0,0,3,1,0,233,79,63517,48696,272,140,69109,47929
338,34,3,2,0,3,1,0,225,104,63520,48698,231,81,69112,47929
339,34,0,0,2,1,2,1,193,90,63520,48698,226,12,69113,47930
340,35,3,1,0,3,1,0,201,133,63523,48699,209,123,69116,47930
341,35,0,2,1,0,0,3,18,25,63523,48701,22,75,69116,47933
342,35,1,0,0,3,1,0,118,114,63524,48701,141,117,69119,47933
343,35,2,0,0,3,1,0,105,115,63526,48701,119,94,69122,47933
344,35,2,1,0,3,1,0,126,109,63528,48702,133,140,69125,47933
345,35,1,3,1,0,0,3,103,83,63529,48705,112,63,69125,47936
346,35,1,2,1,0,0,3,192,121,63530,48707,205,231,69125,47939
347,35,1,0,0,3,1,0,226,104,63531,48707,234,175,69128,47939
348,35,2,1,0,3,1,0,81,87,63533,48708,74,170,69131,47939
349,35,1,0,0,3,1,0,22,23,63534,48708,23,35,69134,47939
350,36,1,5,1,0,0,3,161,124,63535,48713,196,84,69134,47942
351,36,0,0,2,1,2,1,109,103,63535,48713,151,151,69135,47943
352,36,2,0,0,3,1,0,235,79,63537,48713,275,12,69138,47943
353,36,0,0,2,1,2,1,46,41,63537,48713,50,90,69139,47944
354,36,3,3,2,1,2,1,196,93,63540,48716,227,9,69140,47945
355,36,1,0,0,3,1,0,70,80,63541,48716,75,51,69143,47945
356,36,2,0,0,3,1,0,146,137,63543,48716,140,87,69146,47945
357,36,2,0,0,3,1,0,196,105,63545,48716,225,158,69149,47945
358,36,2,3,1,0,0,3,167,135,63547,48719,183,176,69149,47948
359,36,2,1,0,3,1,0,250,110,63549,48720,251,81,69152,47948
360,37,2,1,0,3,1,0,203,134,63551,48721,212,35,69155,47948
361,37,0,1,1,0,0,3,105,116,63551,48722,119,173,69155,47951
362,37,3,0,0,3,1,0,229,104,63554,48722,237,117,69158,47951
363,37,0,3,1,0,0,3,126,112,63554,48725,133,97,69158,47954
364,37,1,3,1,0,0,3,23,26,63555,48728,23,143,69158,47957
365,37,0,0,2,1,2,1,192,121,63555,48728,206,76,69159,47958
366,37,0,1,1,0,0,3,18,26,63555,48729,22,66,69159,47961
367,37,1,1,2,1,2,1,119,115,63556,48730,142,124,69160,47962
368,37,2,1,0,3,1,0,83,88,63558,48731,77,231,69163,47962
369,37,1,2,1,0,0,3,104,85,63559,48733,112,178,69163,47965
370,38,5,0,0,3,1,0,240,79,63564,48733,278,87,69166,47965
371,38,3,1,0,3,1,0,73,81,63567,48734,78,158,69169,47965
372,38,4,0,0,3,1,0,254,110,63571,48734,254,9,69172,47965
373,38,1,3,1,0,0,3,197,96,63572,48737,227,179,69172,47968
374,38,1,2,1,0,0,3,168,137,63573,48739,183,84,69172,47971
375,38,0,0,2,1,2,1,109,103,63573,48739,152,91,69173,47972
376,38,2,1,0,3,1,0,48,42,63575,48740,53,84,69176,47972
377,38,1,2,1,0,0,3,162,126,63576,48742,196,15,69176,47975
378,38,2,4,1,0,0,3,198,109,63578,48746,225,154,69176,47978
379,38,3,2,0,3,1,0,149,139,63581,48748,143,51,69179,47978
0,1,4,0,0,3,1,0,233,104,63585,48748,240,124,69182,47978
1,1,2,1,0,3,1,0,242,80,63587,48749,281,154,69185,47978
2,1,3,2,0,3,1,0,200,98,63590,48751,230,84,69188,47978
3,1,3,4,1,0,0,3,122,119,63593,48755,142,146,69188,47981
4,1,1,0,0,3,1,0,106,116,63594,48755,122,0,69191,47981
5,1,2,0,0,3,1,0,111,103,63596,48755,155,158,69194,47981
6,1,0,1,1,0,0,3,48,43,63596,48756,53,90,69194,47984
7,1,3,1,0,3,1,0,171,138,63599,48757,186,80,69197,47984
8,1,0,1,1,0,0,3,149,140,63599,48758,143,69,69197,47987
9,1,2,2,2,1,2,1,17,44,63601,48760,14,179,69198,47988
10,2,0,1,1,0,0,3,198,110,63601,48761,225,234,69198,47991
11,2,4,2,0,3,1,0,258,112,63605,48763,257,173,69201,47991
12,2,1,1,2,1,2,1,204,135,63606,48764,213,77,69202,47992
13,2,2,2,2,1,2,1,124,128,63608,48766,129,180,69203,47993
14,2,1,3,1,0,0,3,1,3,63609,48769,0,100,69203,47996
15,2,1,0,0,3,1,0,193,121,63610,48769,209,117,69206,47996
16,2,2,1,0,3,1,0,128,113,63612,48770,136,84,69209,47996
17,2,0,3,1,0,0,3,73,84,63612,48773,78,12,69209,47999
18,2,5,1,0,3,1,0,109,86,63617,48774,115,91,69212,47999
19,2,2,0,0,3,1,0,164,126,63619,48774,199,35,69215,47999
20,3,3,1,0,3,1,0,245,81,63622,48775,284,69,69218,47999
21,3,0,3,1,0,0,3,149,143,63622,48778,143,182,69218,48002
22,3,2,1,0,3,1,0,108,117,63624,48779,125,80,69221,48002
23,3,2,1,0,3,1,0,124,120,63626,48780,145,84,69224,48002
24,3,1,1,2,1,2,1,112,104,63627,48781,156,147,69225,48003
25,3,0,1,1,0,0,3,200,99,63627,48782,230,127,69225,48006
26,3,3,2,0,3,1,0,236,106,63630,48784,243,90,69228,48006
27,3,1,2,1,0,0,3,18,46,63631,48786,14,161,69228,48009
28,3,2,1,0,3,1,0,50,44,63633,48787,56,0,69231,48009
29,3,1,0,0,3,1,0,172,138,63634,48787,189,154,69234,48009
30,4,0,1,1,0,0,3,128,114,63634,48788,136,176,69234,48012
31,4,3,0,0,3,1,0,201,110,63637,48788,228,12,69237,48012
32,4,3,1,0,3,1,0,261,113,63640,48789,260,91,69240,48012
33,4,1,2,1,0,0,3,165,128,63641,48791,199,120,69240,48015
34,4,3,0,0,3,1,0,127,128,63644,48791,132,84,69243,48015
35,4,1,1,2,1,2,1,2,4,63645,48792,1,78,69244,48016
36,4,2,0,0,3,1,0,75,84,63647,48792,81,100,69247,48016
37,4,0,0,2,1,2,1,109,86,63647,48792,116,36,69248,48017
38,4,2,1,0,3,1,0,206,136,63649,48793,216,234,69251,48017
39,4,1,0,0,3,1,0,194,121,63650,48793,212,180,69254,48017
40,5,2,0,0,3,1,0,202,99,63652,48793,233,147,69257,48017
41,5,2,0,0,3,1,0,110,117,63654,48793,128,90,69260,48017
42,5,0,1,1,0,0,3,124,121,63654,48794,145,81,69260,48020
43,5,2,1,0,3,1,0,114,105,63656,48795,159,69,69263,48020
44,5,0,2,1,0,0,3,50,46,63656,48797,56,164,69263,48023
45,5,0,0,2,1,2,1,172,138,63656,48797,190,183,69264,48024
46,5,4,0,0,3,1,0,249,81,63660,48797,287,80,69267,48024
47,5,0,0,2,1,2,1,18,46,63660,48797,15,85,69268,48025
48,5,4,0,0,3,1,0,240,106,63664,48797,246,0,69271,48025
49,5,2,2,2,1,2,1,167,130,63666,48799,200,155,69272,48026
50,6,0,1,1,0,0,3,149,144,63666,48800,143,237,69272,48029
51,6,2,0,0,3,1,0,263,113,63668,48800,263,120,69275,48029
52,6,3,1,0,3,1,0,112,87,63671,48801,119,180,69278,48029
53,6,1,1,2,1,2,1,173,139,63672,48802,191,13,69279,48030
54,6,1,1,2,1,2,1,207,137,63673,48803,217,92,69280,48031
55,6,2,0,0,3,1,0,203,110,63675,48803,231,36,69283,48031
56,6,1,0,0,3,1,0,76,84,63676,48803,84,127,69286,48031
57,6,0,0,2,1,2,1,194,121,63676,48803,213,177,69287,48032
58,6,1,3,1,0,0,3,3,7,63677,48806,1,87,69287,48035
59,6,2,1,0,3,1,0,129,129,63679,48807,135,90,69290,48035
60,7,0,2,1,0,0,3,18,48,63679,48809,15,123,69290,48038
61,7,0,3,1,0,0,3,167,133,63679,48812,200,150,69290,48041
62,7,0,3,1,0,0,3,50,49,63679,48815,56,240,69290,48044
63,7,1,0,0,3,1,0,125,121,63680,48815,148,183,69293,48044
64,7,0,1,1,0,0,3,110,118,63680,48816,128,103,69293,48047
65,7,2,1,0,3,1,0,131,130,63682,48817,138,0,69296,48047
66,7,1,1,2,1,2,1,129,115,63683,48818,137,82,69297,48048
67,7,4,3,0,3,1,0,206,102,63687,48821,236,69,69300,48048
68,7,2,1,0,3,1,0,114,88,63689,48822,122,155,69303,48048
69,7,2,1,0,3,1,0,242,107,63691,48823,249,164,69306,48048
70,8,1,3,1,0,0,3,264,116,63692,48826,263,183,69306,48051
71,8,1,1,2,1,2,1,19,49,63693,48827,16,91,69307,48052
72,8,2,1,0,3,1,0,251,82,63695,48828,290,127,69310,48052
73,8,0,0,2,1,2,1,194,121,63695,48828,214,88,69311,48053
74,8,0,0,2,1,2,1,173,139,63695,48828,192,37,69312,48054
75,8,1,2,1,0,0,3,208,139,63696,48830,217,83,69312,48057
76,8,1,1,2,1,2,1,204,111,63697,48831,232,93,69313,48058
77,8,2,1,0,3,1,0,78,85,63699,48832,87,0,69316,48058
78,8,1,3,1,0,0,3,115,108,63700,48835,159,180,69316,48061
79,8,1,4,1,0,0,3,150,148,63701,48839,143,88,69316,48064
80,9,2,1,0,3,1,0,131,116,63703,48840,140,103,69319,48064
81,9,1,0,0,3,1,0,207,102,63704,48840,239,240,69322,48064
82,9,3,1,0,3,1,0,170,134,63707,48841,203,13,69325,48064
83,9,2,1,0,3,1,0,127,122,63709,48842,151,164,69328,48064
84,9,3,5,1,0,0,3,134,135,63712,48847,138,158,69328,48067
85,9,1,2,1,0,0,3,4,9,63713,48849,1,186,69328,48070
86,9,0,0,2,1,2,1,50,49,63713,48849,57,124,69329,48071
87,9,2,2,2,1,2,1,116,90,63715,48851,123,151,69330,48072
88,9,1,1,2,1,2,1,111,119,63716,48852,129,70,69331,48073
89,9,4,1,0,3,1,0,246,108,63720,48853,252,82,69334,48073
90,10,3,0,0,3,1,0,176,139,63723,48853,195,180,69337,48073
91,10,1,1,2,1,2,1,116,109,63724,48854,160,94,69338,48074
92,10,1,1,2,1,2,1,195,122,63725,48855,215,1,69339,48075
93,10,2,1,0,3,1,0,210,140,63727,48856,220,88,69342,48075
94,10,4,1,0,3,1,0,255,83,63731,48857,293,91,69345,48075
95,10,4,1,0,3,1,0,208,112,63735,48858,235,83,69348,48075
96,10,2,0,0,3,1,0,266,116,63737,48858,266,37,69351,48075
97,10,0,1,1,0,0,3,19,50,63737,48859,16,91,69351,48078
98,10,1,3,1,0,0,3,79,88,63738,48862,87,186,69351,48081
99,10,1,3,1,0,0,3,151,151,63739,48865,143,130,69351,48084
100,11,0,1,1,0,0,3,111,120,63739,48866,129,161,69351,48087
101,11,2,1,0,3,1,0,257,84,63741,48867,296,186,69354,48087
102,11,3,0,0,3,1,0,130,122,63744,48867,154,103,69357,48087
103,11,2,0,0,3,1,0,6,9,63746,48867,4,124,69360,48087
104,11,0,0,2,1,2,1,50,49,63746,48867,58,187,69361,48088
105,11,2,1,0,3,1,0,210,113,63748,48868,238,70,69364,48088
106,11,1,0,0,3,1,0,208,102,63749,48868,242,13,69367,48088
107,11,1,0,0,3,1,0,132,116,63750,48868,143,164,69370,48088
108,11,2,2,2,1,2,1,172,136,63752,48870,204,89,69371,48089
109,11,2,1,0,3,1,0,136,136,63754,48871,141,82,69374,48089
110,12,5,1,0,3,1,0,121,91,63759,48872,126,83,69377,48089
111,12,1,1,2,1,2,1,267,117,63760,48873,267,152,69378,48090
112,12,0,4,1,0,0,3,19,54,63760,48877,16,40,69378,48093
113,12,1,2,1,0,0,3,117,111,63761,48879,160,243,69378,48096
114,12,1,1,2,1,2,1,177,140,63762,48880,196,131,69379,48097
115,12,1,2,1,0,0,3,152,153,63763,48882,143,183,69379,48100
116,12,0,3,1,0,0,3,79,91,63763,48885,87,94,69379,48103
117,12,1,1,2,1,2,1,196,123,63764,48886,216,92,69380,48104
118,12,3,0,0,3,1,0,213,140,63767,48886,223,1,69383,48104
119,12,3,0,0,3,1,0,249,108,63770,48886,255,94,69386,48104
120,13,1,0,0,3,1,0,118,111,63771,48886,163,83,69389,48104
121,13,1,2,1,0,0,3,173,138,63772,48888,204,189,69389,48107
122,13,3,0,0,3,1,0,260,84,63775,48888,299,13,69392,48107
123,13,3,2,0,3,1,0,135,118,63778,48890,146,70,69395,48107
124,13,2,1,0,3,1,0,132,123,63780,48891,157,187,69398,48107
125,13,3,1,0,3,1,0,114,121,63783,48892,132,82,69401,48107
126,13,0,2,1,0,0,3,6,11,63783,48894,4,92,69401,48110
127,13,0,4,1,0,0,3,50,53,63783,48898,58,164,69401,48113
128,13,3,1,0,3,1,0,213,114,63786,48899,241,103,69404,48113
129,13,2,2,2,1,2,1,210,104,63788,48901,243,165,69405,48114
130,14,2,1,0,3,1,0,123,92,63790,48902,129,124,69408,48114
131,14,1,4,1,0,0,3,51,57,63791,48906,58,186,69408,48117
132,14,0,1,1,0,0,3,152,154,63791,48907,143,155,69408,48120
133,14,0,2,1,0,0,3,114,123,63791,48909,132,97,69408,48123
134,14,2,1,0,3,1,0,138,137,63793,48910,144,131,69411,48123
135,14,1,1,2,1,2,1,7,12,63794,48911,5,93,69412,48124
136,14,3,1,0,3,1,0,180,141,63797,48912,199,243,69415,48124
137,14,3,2,0,3,1,0,252,110,63800,48914,258,13,69418,48124
138,14,1,1,2,1,2,1,268,118,63801,48915,268,71,69419,48125
139,14,4,2,0,3,1,0,217,142,63805,48917,226,164,69422,48125
140,15,3,0,0,3,1,0,271,118,63808,48917,271,165,69425,48125
141,15,3,1,0,3,1,0,263,85,63811,48918,302,97,69428,48125
142,15,2,1,0,3,1,0,212,105,63813,48919,246,1,69431,48125
143,15,0,2,1,0,0,3,213,116,63813,48921,241,190,69431,48128
144,15,1,1,2,1,2,1,20,55,63814,48922,17,84,69432,48129
145,15,2,0,0,3,1,0,137,118,63816,48922,149,92,69435,48129
146,15,3,0,0,3,1,0,82,91,63819,48922,90,40,69438,48129
147,15,2,1,0,3,1,0,198,124,63821,48923,219,82,69441,48129
148,15,0,0,2,1,2,1,118,111,63821,48923,164,104,69442,48130
149,15,1,0,0,3,1,0,174,138,63822,48923,207,94,69445,48130
150,16,2,1,0,3,1,0,9,13,63824,48924,8,13,69448,48130
151,16,1,2,1,0,0,3,138,120,63825,48926,149,158,69448,48133
152,16,0,5,1,0,0,3,138,142,63825,48931,144,192,69448,48136
153,16,1,3,1,0,0,3,133,126,63826,48934,157,134,69448,48139
154,16,0,0,2,1,2,1,114,123,63826,48934,133,41,69449,48140
155,16,0,2,1,0,0,3,152,156,63826,48936,143,127,69449,48143
156,16,1,3,1,0,0,3,124,95,63827,48939,129,246,69449,48146
157,16,2,0,0,3,1,0,219,142,63829,48939,229,104,69452,48146
158,16,2,1,0,3,1,0,200,125,63831,48940,222,71,69455,48146
159,16,1,0,0,3,1,0,253,110,63832,48940,261,186,69458,48146
160,17,2,0,0,3,1,0,53,57,63834,48940,61,84,69461,48146
161,17,0,0,2,1,2,1,212,105,63834,48940,247,98,69462,48147
162,17,1,0,0,3,1,0,264,85,63835,48940,305,190,69465,48147
163,17,0,1,1,0,0,3,82,92,63835,48941,90,168,69465,48150
164,17,2,1,0,3,1,0,120,112,63837,48942,167,93,69468,48150
165,17,5,3,0,3,1,0,276,121,63842,48945,274,92,69471,48150
166,17,0,3,1,0,0,3,20,58,63842,48948,17,97,69471,48153
167,17,2,0,0,3,1,0,176,138,63844,48948,210,1,69474,48153
168,17,3,4,1,0,0,3,183,145,63847,48952,199,85,69474,48156
169,17,3,1,0,3,1,0,216,117,63850,48953,244,164,69477,48156
170,18,2,1,0,3,1,0,135,127,63852,48954,160,41,69480,48156
171,18,3,0,0,3,1,0,222,142,63855,48954,232,158,69483,48156
172,18,4,3,0,3,1,0,142,145,63859,48957,147,71,69486,48156
173,18,3,3,2,1,2,1,203,128,63862,48960,223,193,69487,48157
174,18,1,1,2,1,2,1,153,157,63863,48961,144,14,69488,48158
175,18,3,1,0,3,1,0,256,111,63866,48962,264,127,69491,48158
176,18,0,0,2,1,2,1,138,120,63866,48962,150,135,69492,48159
177,18,1,0,0,3,1,0,125,95,63867,48962,132,104,69495,48159
178,18,0,2,1,0,0,3,9,15,63867,48964,8,249,69495,48162
179,18,0,1,1,0,0,3,114,124,63867,48965,133,189,69495,48165
180,19,1,0,0,3,1,0,54,57,63868,48965,64,85,69498,48165
181,19,2,1,0,3,1,0,278,122,63870,48966,277,93,69501,48165
182,19,1,2,1,0,0,3,177,140,63871,48968,210,171,69501,48168
183,19,1,4,1,0,0,3,121,116,63872,48972,167,101,69501,48171
184,19,0,1,1,0,0,3,183,146,63872,48973,199,193,69501,48174
185,19,1,0,0,3,1,0,217,117,63873,48973,247,1,69504,48174
186,19,0,0,2,1,2,1,82,92,63873,48973,91,93,69505,48175
187,19,1,0,0,3,1,0,213,105,63874,48973,250,84,69508,48175
188,19,3,0,0,3,1,0,267,85,63877,48973,308,97,69511,48175
189,19,1,2,1,0,0,3,21,60,63878,48975,17,167,69511,48178
190,20,0,1,1,0,0,3,9,16,63878,48976,8,100,69511,48181
191,20,3,1,0,3,1,0,225,143,63881,48977,235,127,69514,48181
192,20,4,1,0,3,1,0,146,146,63885,48978,150,104,69517,48181
193,20,2,1,0,3,1,0,219,118,63887,48979,250,101,69520,48181
194,20,0,0,2,1,2,1,138,120,63887,48979,151,42,69521,48182
195,20,4,1,0,3,1,0,86,93,63891,48980,94,85,69524,48182
196,20,3,1,0,3,1,0,281,123,63894,48981,280,14,69527,48182
197,20,0,1,1,0,0,3,177,141,63894,48982,210,196,69527,48185
198,20,2,1,0,3,1,0,205,129,63896,48983,226,249,69530,48185
199,20,2,2,2,1,2,1,127,97,63898,48985,133,190,69531,48186
200,21,0,3,1,0,0,3,121,119,63898,48988,167,170,69531,48189
201,21,1,2,1,0,0,3,214,107,63899,48990,250,196,69531,48192
202,21,2,0,0,3,1,0,269,85,63901,48990,311,158,69534,48192
203,21,2,2,2,1,2,1,185,148,63903,48992,200,2,69535,48193
204,21,0,1,1,0,0,3,153,158,63903,48993,144,174,69535,48196
205,21,1,3,1,0,0,3,22,63,63904,48996,17,74,69535,48199
206,21,2,0,0,3,1,0,116,124,63906,48996,136,93,69538,48199
207,21,1,0,0,3,1,0,55,57,63907,48996,67,135,69541,48199
208,21,1,0,0,3,1,0,136,127,63908,48996,163,93,69544,48199
209,21,1,0,0,3,1,0,257,111,63909,48996,267,84,69547,48199
210,22,0,1,1,0,0,3,219,119,63909,48997,250,130,69547,48202
211,22,3,0,0,3,1,0,228,143,63912,48997,238,14,69550,48202
212,22,1,1,2,1,2,1,128,98,63913,48998,134,102,69551,48203
213,22,1,1,2,1,2,1,147,147,63914,48999,151,101,69552,48204
214,22,4,1,0,3,1,0,13,17,63918,49000,11,42,69555,48204
215,22,3,3,2,1,2,1,208,132,63921,49003,227,105,69556,48205
216,22,0,2,1,0,0,3,86,95,63921,49005,94,252,69556,48208
217,22,2,1,0,3,1,0,179,142,63923,49006,213,190,69559,48208
218,22,3,2,0,3,1,0,141,122,63926,49008,154,196,69562,48208
219,22,1,1,2,1,2,1,282,124,63927,49009,281,86,69563,48209
220,23,1,7,1,0,0,3,117,131,63928,49016,136,199,69563,48212
221,23,0,1,1,0,0,3,214,108,63928,49017,250,96,69563,48215
222,23,2,0,0,3,1,0,138,127,63930,49017,166,84,69566,48215
223,23,2,6,1,0,0,3,24,69,63932,49023,17,161,69566,48218
224,23,0,1,1,0,0,3,185,149,63932,49024,200,77,69566,48221
225,23,1,1,2,1,2,1,56,58,63933,49025,68,94,69567,48222
226,23,0,0,2,1,2,1,121,119,63933,49025,168,136,69568,48223
227,23,1,0,0,3,1,0,154,158,63934,49025,147,2,69571,48223
228,23,1,0,0,3,1,0,270,85,63935,49025,314,174,69574,48223
229,23,4,0,0,3,1,0,261,111,63939,49025,270,170,69577,48223
230,24,2,0,0,3,1,0,284,124,63941,49025,284,105,69580,48223
231,24,3,0,0,3,1,0,211,132,63944,49025,230,136,69583,48223
232,24,0,2,1,0,0,3,13,19,63944,49027,11,199,69583,48226
233,24,1,3,1,0,0,3,155,161,63945,49030,147,105,69583,48229
234,24,1,3,1,0,0,3,87,98,63946,49033,94,133,69583,48232
235,24,2,0,0,3,1,0,230,143,63948,49033,241,42,69586,48232
236,24,5,3,0,3,1,0,133,101,63953,49036,137,14,69589,48232
237,24,3,1,0,3,1,0,144,123,63956,49037,157,101,69592,48232
238,24,0,2,1,0,0,3,147,149,63956,49039,151,255,69592,48235
239,24,1,1,2,1,2,1,220,120,63957,49040,251,191,69593,48236
240,25,4,1,0,3,1,0,274,86,63961,49041,317,86,69596,48236
241,25,1,0,0,3,1,0,139,127,63962,49041,169,2,69599,48236
242,25,1,2,1,0,0,3,57,60,63963,49043,68,164,69599,48239
243,25,0,1,1,0,0,3,117,132,63963,49044,136,177,69599,48242
244,25,1,1,2,1,2,1,145,124,63964,49045,158,85,69600,48243
245,25,5,0,0,3,1,0,29,69,63969,49045,20,105,69603,48243
246,25,1,3,1,0,0,3,122,122,63970,49048,168,202,69603,48246
247,25,1,2,1,0,0,3,180,144,63971,49050,213,80,69603,48249
248,25,4,1,0,3,1,0,265,112,63975,49051,273,94,69606,48249
249,25,2,1,0,3,1,0,216,109,63977,49052,253,170,69609,48249
250,26,0,2,1,0,0,3,284,126,63977,49054,284,108,69609,48252
251,26,2,0,0,3,1,0,276,86,63979,49054,320,42,69612,48252
252,26,1,1,2,1,2,1,156,162,63980,49055,148,97,69613,48253
253,26,1,1,2,1,2,1,186,150,63981,49056,201,102,69614,48254
254,26,1,2,1,0,0,3,14,21,63982,49058,11,88,69614,48257
255,26,0,1,1,0,0,3,87,99,63982,49059,94,194,69614,48260
256,26,2,0,0,3,1,0,124,122,63984,49059,171,14,69617,48260
257,26,1,0,0,3,1,0,221,120,63985,49059,254,136,69620,48260
258,26,1,3,1,0,0,3,231,146,63986,49062,241,202,69620,48263
259,26,2,2,2,1,2,1,213,134,63988,49064,231,95,69621,48264
260,27,1,2,1,0,0,3,266,114,63989,49066,273,205,69621,48267
261,27,3,1,0,3,1,0,148,125,63992,49067,161,14,69624,48267
262,27,3,1,0,3,1,0,219,110,63995,49068,256,133,69627,48267
263,27,0,0,2,1,2,1,139,127,63995,49068,170,171,69628,48268
264,27,0,2,1,0,0,3,57,62,63995,49070,68,108,69628,48271
265,27,1,5,1,0,0,3,148,154,63996,49075,151,180,69628,48274
266,27,1,1,2,1,2,1,181,145,63997,49076,214,256,69629,48275
267,27,3,1,0,3,1,0,136,102,64000,49077,140,86,69632,48275
268,27,0,0,2,1,2,1,14,21,64000,49077,12,81,69633,48276
269,27,0,2,1,0,0,3,117,134,64000,49079,136,167,69633,48279
270,28,2,1,0,3,1,0,278,87,64002,49080,323,194,69636,48279
271,28,0,1,1,0,0,3,186,151,64002,49081,201,100,69636,48282
272,28,0,1,1,0,0,3,87,100,64002,49082,94,105,69636,48285
273,28,7,1,0,3,1,0,238,147,64009,49083,244,108,69639,48285
274,28,1,0,0,3,1,0,214,134,64010,49083,234,88,69642,48285
275,28,3,0,0,3,1,0,287,126,64013,49083,287,2,69645,48285
276,28,4,0,0,3,1,0,128,122,64017,49083,174,42,69648,48285
277,28,1,3,1,0,0,3,30,72,64018,49086,20,139,69648,48288
278,28,0,3,1,0,0,3,156,165,64018,49089,148,205,69648,48291
279,28,3,1,0,3,1,0,224,121,64021,49090,257,95,69651,48291
280,29,2,2,2,1,2,1,138,104,64023,49092,141,181,69652,48292
281,29,1,0,0,3,1,0,220,110,64024,49092,259,108,69655,48292
282,29,2,3,1,0,0,3,59,65,64026,49095,68,208,69655,48295
283,29,4,1,0,3,1,0,121,135,64030,49096,139,133,69658,48295
284,29,0,1,1,0,0,3,14,22,64030,49097,12,174,69658,48298
285,29,0,1,1,0,0,3,148,126,64030,49098,161,259,69658,48301
286,29,0,0,2,1,2,1,148,154,64030,49098,152,168,69659,48302
287,29,3,0,0,3,1,0,142,127,64033,49098,173,14,69662,48302
288,29,4,1,0,3,1,0,185,146,64037,49099,217,86,69665,48302
289,29,3,1,0,3,1,0,269,115,64040,49100,276,81,69668,48302
290,30,1,2,1,0,0,3,88,102,64041,49102,94,171,69668,48305
291,30,2,0,0,3,1,0,271,115,64043,49102,279,42,69671,48305
292,30,2,2,2,1,2,1,140,106,64045,49104,142,140,69672,48306
293,30,0,5,1,0,0,3,186,156,64045,49109,201,111,69672,48309
294,30,1,0,0,3,1,0,215,134,64046,49109,237,105,69675,48309
295,30,1,3,1,0,0,3,157,168,64047,49112,148,91,69675,48312
296,30,1,2,1,0,0,3,129,124,64048,49114,174,5,69675,48315
297,30,1,1,2,1,2,1,31,73,64049,49115,21,195,69676,48316
298,30,1,1,2,1,2,1,288,127,64050,49116,288,260,69677,48317
299,30,1,2,1,0,0,3,239,149,64051,49118,244,103,69677,48320
300,31,1,1,2,1,2,1,60,66,64052,49119,69,15,69678,48321
301,31,1,1,2,1,2,1,143,128,64053,49120,174,82,69679,48322
302,31,2,0,0,3,1,0,280,87,64055,49120,326,133,69682,48322
303,31,2,2,2,1,2,1,150,128,64057,49122,162,175,69683,48323
304,31,3,0,0,3,1,0,188,146,64060,49122,220,108,69686,48323
305,31,2,1,0,3,1,0,16,23,64062,49123,15,181,69689,48323
306,31,4,0,0,3,1,0,224,110,64066,49123,262,86,69692,48323
307,31,0,3,1,0,0,3,121,138,64066,49126,139,208,69692,48326
308,31,2,3,1,0,0,3,150,157,64068,49129,152,98,69692,48329
309,31,0,3,1,0,0,3,224,124,64068,49132,257,211,69692,48332
310,32,2,2,2,1,2,1,241,151,64070,49134,245,196,69693,48333
311,32,1,1,2,1,2,1,272,116,64071,49135,280,112,69694,48334
312,32,0,0,2,1,2,1,157,168,64071,49135,149,106,69695,48335
313,32,4,0,0,3,1,0,154,157,64075,49135,155,133,69698,48335
314,32,1,1,2,1,2,1,141,107,64076,49136,143,6,69699,48336
315,32,1,2,1,0,0,3,216,136,64077,49138,237,45,69699,48339
316,32,0,2,1,0,0,3,31,75,64077,49140,21,263,69699,48342
317,32,2,2,2,1,2,1,188,158,64079,49142,202,172,69700,48343
318,32,2,1,0,3,1,0,90,103,64081,49143,97,103,69703,48343
319,32,3,0,0,3,1,0,291,127,64084,49143,291,140,69706,48343
320,33,3,2,0,3,1,0,146,130,64087,49145,177,106,69709,48343
321,33,5,4,0,3,1,0,221,140,64092,49149,240,181,69712,48343
322,33,2,2,2,1,2,1,92,105,64094,49151,98,212,69713,48344
323,33,2,1,0,3,1,0,190,147,64096,49152,223,91,69716,48344
324,33,1,2,1,0,0,3,151,130,64097,49154,162,9,69716,48347
325,33,1,2,1,0,0,3,225,112,64098,49156,262,48,69716,48350
326,33,6,2,0,3,1,0,230,126,64104,49158,260,86,69719,48350
327,33,1,3,1,0,0,3,130,127,64105,49161,174,101,69719,48353
328,33,4,0,0,3,1,0,284,87,64109,49161,329,108,69722,48353
329,33,1,4,1,0,0,3,32,79,64110,49165,21,211,69722,48356
330,34,2,2,2,1,2,1,148,132,64112,49167,178,264,69723,48357
331,34,1,1,2,1,2,1,142,108,64113,49168,144,104,69724,48358
332,34,1,3,1,0,0,3,273,119,64114,49171,280,175,69724,48361
333,34,1,2,1,0,0,3,189,160,64115,49173,202,136,69724,48364
334,34,2,0,0,3,1,0,159,168,64117,49173,152,175,69727,48364
335,34,1,1,2,1,2,1,17,24,64118,49174,16,197,69728,48365
336,34,1,0,0,3,1,0,155,157,64119,49174,158,15,69731,48365
337,34,1,3,1,0,0,3,61,69,64120,49177,69,85,69731,48368
338,34,4,0,0,3,1,0,125,138,64124,49177,142,140,69734,48368
339,34,0,1,1,0,0,3,241,152,64124,49178,245,215,69734,48371
340,35,3,1,0,3,1,0,294,128,64127,49179,294,91,69737,48371
341,35,1,1,2,1,2,1,285,88,64128,49180,330,102,69738,48372
342,35,1,1,2,1,2,1,191,148,64129,49181,224,113,69739,48373
343,35,3,1,0,3,1,0,64,70,64132,49182,72,106,69742,48373
344,35,0,1,1,0,0,3,32,80,64132,49183,21,12,69742,48376
345,35,2,2,2,1,2,1,94,107,64134,49185,99,176,69743,48377
346,35,1,0,0,3,1,0,190,160,64135,49185,205,181,69746,48377
347,35,1,1,2,1,2,1,131,128,64136,49186,175,87,69747,48378
348,35,7,3,0,3,1,0,237,129,64143,49189,263,104,69750,48378
349,35,1,4,1,0,0,3,226,116,64144,49193,262,214,69750,48381
350,36,3,2,0,3,1,0,224,142,64147,49195,243,175,69753,48381
351,36,1,1,2,1,2,1,149,133,64148,49196,179,198,69754,48382
352,36,1,2,1,0,0,3,242,154,64149,49198,245,88,69754,48385
353,36,1,1,2,1,2,1,152,131,64150,49199,163,137,69755,48386
354,36,3,2,0,3,1,0,158,159,64153,49201,161,48,69758,48386
355,36,1,0,0,3,1,0,160,168,64154,49201,155,108,69761,48386
356,36,0,5,1,0,0,3,142,113,64154,49206,144,218,69761,48389
357,36,3,1,0,3,1,0,128,139,64157,49207,145,15,69764,48389
358,36,1,0,0,3,1,0,18,24,64158,49207,19,140,69767,48389
359,36,3,1,0,3,1,0,276,120,64161,49208,283,264,69770,48389
360,37,3,5,1,0,0,3,134,133,64164,49213,175,217,69770,48392
361,37,4,1,0,3,1,0,298,129,64168,49214,297,176,69773,48392
362,37,0,1,1,0,0,3,64,71,64168,49215,72,116,69773,48395
363,37,3,0,0,3,1,0,229,116,64171,49215,265,106,69776,48395
364,37,6,2,0,3,1,0,100,109,64177,49217,102,91,69779,48395
365,37,3,0,0,3,1,0,288,88,64180,49217,333,12,69782,48395
366,37,1,1,2,1,2,1,192,149,64181,49218,225,105,69783,48396
367,37,2,1,0,3,1,0,192,161,64183,49219,208,102,69786,48396
368,37,1,3,1,0,0,3,238,132,64184,49222,263,184,69786,48399
369,37,2,0,0,3,1,0,34,80,64186,49222,24,87,69789,48399
370,38,1,0,0,3,1,0,150,133,64187,49222,182,137,69792,48399
371,38,1,2,1,0,0,3,129,141,64188,49224,145,267,69792,48402
372,38,2,1,0,3,1,0,160,160,64190,49225,164,198,69795,48402
373,38,2,4,1,0,0,3,154,135,64192,49229,163,221,69795,48405
374,38,3,2,0,3,1,0,279,122,64195,49231,286,108,69798,48405
375,38,5,2,0,3,1,0,247,156,64200,49233,248,140,69801,48405
376,38,5,3,0,3,1,0,147,116,64205,49236,147,88,69804,48405
377,38,2,2,2,1,2,1,226,144,64207,49238,244,16,69805,48406
378,38,2,1,0,3,1,0,162,169,64209,49239,158,48,69808,48406
379,38,3,1,0,3,1,0,21,25,64212,49240,22,175,69811,48406
0,1,3,0,0,3,1,0,291,88,64215,49240,336,91,69814,48406
1,1,1,3,1,0,0,3,84,91,64216,49243,77,224,69814,48409
2,1,0,1,1,0,0,3,150,134,64216,49244,182,220,69814,48412
3,1,1,1,2,1,2,1,130,142,64217,49245,146,103,69815,48413
4,1,0,3,1,0,0,3,21,28,64217,49248,22,201,69815,48416
5,1,3,0,0,3,1,0,250,156,64220,49248,251,176,69818,48416
6,1,0,0,2,1,2,1,238,132,64220,49248,264,1,69819,48417
7,1,2,1,0,3,1,0,156,136,64222,49249,166,0,69822,48417
8,1,0,0,2,1,2,1,100,109,64222,49249,103,109,69823,48418
9,1,1,2,1,0,0,3,193,151,64223,49251,225,140,69823,48421
10,2,0,1,1,0,0,3,0,1,64223,49252,0,109,69823,48424
11,2,2,4,1,0,0,3,194,165,64225,49256,208,270,69823,48427
12,2,1,3,1,0,0,3,280,125,64226,49259,286,187,69823,48430
13,2,3,0,0,3,1,0,150,116,64229,49259,150,88,69826,48430
14,2,1,2,1,0,0,3,135,135,64230,49261,175,178,69826,48433
15,2,0,0,2,1,2,1,21,28,64230,49261,23,52,69827,48434
16,2,1,2,1,0,0,3,227,146,64231,49263,244,108,69827,48437
17,2,2,1,0,3,1,0,231,117,64233,49264,268,91,69830,48437
18,2,3,1,0,3,1,0,301,130,64236,49265,300,116,69833,48437
19,2,3,2,0,3,1,0,3,2,64239,49267,3,140,69836,48437
20,3,3,0,0,3,1,0,294,88,64242,49267,339,140,69839,48437
21,3,2,0,0,3,1,0,252,156,64244,49267,254,1,69842,48437
22,3,2,1,0,3,1,0,152,135,64246,49268,185,88,69845,48437
23,3,1,0,0,3,1,0,161,160,64247,49268,167,12,69848,48437
24,3,0,5,1,0,0,3,84,96,64247,49273,77,179,69848,48440
25,3,1,0,0,3,1,0,194,151,64248,49273,228,109,69851,48440
26,3,4,1,0,3,1,0,242,133,64252,49274,267,201,69854,48440
27,3,0,1,1,0,0,3,0,2,64252,49275,0,106,69854,48443
28,3,0,3,1,0,0,3,130,145,64252,49278,146,227,69854,48446
29,3,1,1,2,1,2,1,157,137,64253,49279,167,221,69855,48447
30,4,0,2,1,0,0,3,21,30,64253,49281,23,190,69855,48450
31,4,2,1,0,3,1,0,229,147,64255,49282,247,109,69858,48450
32,4,3,0,0,3,1,0,283,125,64258,49282,289,52,69861,48450
33,4,1,3,1,0,0,3,101,112,64259,49285,103,273,69861,48453
34,4,2,1,0,3,1,0,233,118,64261,49286,271,140,69864,48453
35,4,6,0,0,3,1,0,307,130,64267,49286,303,0,69867,48453
36,4,0,2,1,0,0,3,3,4,64267,49288,3,94,69867,48456
37,4,2,2,2,1,2,1,152,118,64269,49290,151,109,69868,48457
38,4,1,1,2,1,2,1,136,136,64270,49291,176,117,69869,48458
39,4,2,3,1,0,0,3,196,168,64272,49294,208,181,69869,48461
40,5,1,1,2,1,2,1,131,146,64273,49295,147,191,69870,48462
41,5,0,4,1,0,0,3,0,6,64273,49299,0,224,69870,48465
42,5,5,1,0,3,1,0,157,136,64278,49300,188,12,69873,48465
43,5,0,1,1,0,0,3,161,161,64278,49301,167,91,69873,48468
44,5,1,1,2,1,2,1,197,169,64279,49302,209,141,69874,48469
45,5,0,0,2,1,2,1,84,96,64279,49302,78,110,69875,48470
46,5,1,0,0,3,1,0,295,88,64280,49302,342,179,69878,48470
47,5,1,4,1,0,0,3,243,137,64281,49306,267,230,69878,48473
48,5,2,0,0,3,1,0,235,118,64283,49306,274,1,69881,48473
49,5,2,3,1,0,0,3,196,154,64285,49309,228,109,69881,48476
50,6,3,1,0,3,1,0,286,126,64288,49310,292,140,69884,48476
51,6,2,3,1,0,0,3,5,7,64290,49313,3,233,69884,48479
52,6,4,0,0,3,1,0,299,88,64294,49313,345,109,69887,48479
53,6,2,0,0,3,1,0,159,137,64296,49313,170,201,69890,48479
54,6,0,2,1,0,0,3,161,163,64296,49315,167,144,69890,48482
55,6,2,0,0,3,1,0,23,30,64298,49315,26,0,69893,48482
56,6,0,3,1,0,0,3,84,99,64298,49318,78,184,69893,48485
57,6,1,0,0,3,1,0,253,156,64299,49318,257,109,69896,48485
58,6,0,1,1,0,0,3,101,113,64299,49319,103,112,69896,48488
59,6,1,1,2,1,2,1,230,148,64300,49320,248,118,69897,48489
60,7,4,0,0,3,1,0,200,154,64304,49320,231,110,69900,48489
61,7,0,1,1,0,0,3,197,170,64304,49321,209,115,69900,48492
62,7,3,0,0,3,1,0,310,130,64307,49321,306,94,69903,48492
63,7,1,2,1,0,0,3,1,8,64308,49323,0,194,69903,48495
64,7,2,1,0,3,1,0,138,137,64310,49324,179,179,69906,48495
65,7,6,1,0,3,1,0,249,138,64316,49325,270,91,69909,48495
66,7,1,1,2,1,2,1,6,8,64317,49326,4,13,69910,48496
67,7,2,2,2,1,2,1,154,120,64319,49328,152,53,69911,48497
68,7,0,2,1,0,0,3,235,120,64319,49330,274,227,69911,48500
69,7,2,2,2,1,2,1,159,138,64321,49332,189,274,69912,48501
70,8,1,2,1,0,0,3,300,90,64322,49334,345,187,69912,48504
71,8,0,1,1,0,0,3,286,127,64322,49335,292,236,69912,48507
72,8,2,1,0,3,1,0,232,149,64324,49336,251,140,69915,48507
73,8,2,1,0,3,1,0,133,147,64326,49337,150,1,69918,48507
74,8,2,3,1,0,0,3,163,166,64328,49340,167,112,69918,48510
75,8,2,2,2,1,2,1,25,32,64330,49342,27,110,69919,48511
76,8,3,1,0,3,1,0,162,138,64333,49343,173,118,69922,48511
77,8,0,0,2,1,2,1,101,113,64333,49343,104,145,69923,48512
78,8,3,2,0,3,1,0,256,158,64336,49345,260,201,69926,48512
79,8,1,0,0,3,1,0,85,99,64337,49345,81,0,69929,48512
80,9,5,0,0,3,1,0,167,138,64342,49345,176,13,69932,48512
81,9,0,0,2,1,2,1,310,130,64342,49345,307,195,69933,48513
82,9,3,2,0,3,1,0,141,139,64345,49347,182,53,69936,48513
83,9,1,0,0,3,1,0,160,138,64346,49347,192,115,69939,48513
84,9,0,3,1,0,0,3,1,11,64346,49350,0,182,69939,48516
85,9,0,0,2,1,2,1,235,120,64346,49350,275,113,69940,48517
86,9,0,1,1,0,0,3,6,9,64346,49351,4,94,69940,48520
87,9,0,1,1,0,0,3,154,121,64346,49352,152,230,69940,48523
88,9,2,6,1,0,0,3,202,160,64348,49358,231,277,69940,48526
89,9,3,0,0,3,1,0,252,138,64351,49358,273,94,69943,48526
90,10,3,2,0,3,1,0,259,160,64354,49360,263,110,69946,48526
91,10,3,0,0,3,1,0,163,138,64357,49360,195,53,69949,48526
92,10,1,2,1,0,0,3,134,149,64358,49362,150,190,69949,48529
93,10,2,1,0,3,1,0,165,167,64360,49363,170,0,69952,48529
94,10,1,4,1,0,0,3,142,143,64361,49367,182,204,69952,48532
95,10,3,0,0,3,1,0,235,149,64364,49367,254,110,69955,48532
96,10,2,3,1,0,0,3,199,173,64366,49370,209,239,69955,48535
97,10,4,1,0,3,1,0,304,91,64370,49371,348,1,69958,48535
98,10,1,0,0,3,1,0,287,127,64371,49371,295,13,69961,48535
99,10,0,1,1,0,0,3,101,114,64371,49372,104,143,69961,48538
100,11,0,2,1,0,0,3,235,122,64371,49374,275,280,69961,48541
101,11,1,0,0,3,1,0,288,127,64372,49374,298,115,69964,48541
102,11,1,5,1,0,0,3,2,16,64373,49379,0,193,69964,48544
103,11,2,1,0,3,1,0,27,33,64375,49380,30,182,69967,48544
104,11,3,1,0,3,1,0,313,131,64378,49381,310,94,69970,48544
105,11,4,1,0,3,1,0,171,139,64382,49382,179,145,69973,48544
106,11,1,0,0,3,1,0,7,9,64383,49382,7,113,69976,48544
107,11,2,1,0,3,1,0,204,161,64385,49383,234,118,69979,48544
108,11,2,1,0,3,1,0,156,122,64387,49384,155,94,69982,48544
109,11,1,2,1,0,0,3,86,101,64388,49386,81,198,69982,48547
110,12,2,3,1,0,0,3,136,152,64390,49389,150,16,69982,48550
111,12,0,2,1,0,0,3,199,175,64390,49391,209,113,69982,48553
112,12,1,1,2,1,2,1,260,161,64391,49392,264,111,69983,48554
113,12,2,1,0,3,1,0,167,168,64393,49393,173,53,69986,48554
114,12,0,0,2,1,2,1,142,143,64393,49393,183,240,69987,48555
115,12,2,4,1,0,0,3,237,153,64395,49397,254,233,69987,48558
116,12,2,1,0,3,1,0,306,92,64397,49398,351,0,69990,48558
117,12,1,1,2,1,2,1,164,139,64398,49399,196,2,69991,48559
118,12,0,2,1,0,0,3,101,116,64398,49401,104,207,69991,48562
119,12,3,0,0,3,1,0,255,138,64401,49401,276,143,69994,48562
120,13,2,1,0,3,1,0,290,128,64403,49402,301,193,69997,48562
121,13,2,1,0,3,1,0,315,132,64405,49403,313,207,70000,48562
122,13,0,1,1,0,0,3,27,34,64405,49404,30,116,70000,48565
123,13,1,2,1,0,0,3,3,18,64406,49406,0,97,70000,48568
124,13,3,2,0,3,1,0,174,141,64409,49408,182,280,70003,48568
125,13,1,1,2,1,2,1,8,10,64410,49409,8,183,70004,48569
126,13,1,1,2,1,2,1,157,123,64411,49410,156,146,70005,48570
127,13,0,1,1,0,0,3,204,162,64411,49411,234,97,70005,48573
128,13,2,0,0,3,1,0,262,161,64413,49411,267,118,70008,48573
129,13,2,3,1,0,0,3,88,104,64415,49414,81,118,70008,48576
130,14,3,0,0,3,1,0,139,152,64418,49414,153,113,70011,48576
131,14,2,1,0,3,1,0,144,144,64420,49415,186,2,70014,48576
132,14,0,2,1,0,0,3,101,118,64420,49417,104,56,70014,48579
133,14,1,3,1,0,0,3,168,171,64421,49420,173,201,70014,48582
134,14,1,1,2,1,2,1,200,176,64422,49421,210,234,70015,48583
135,14,0,0,2,1,2,1,235,122,64422,49421,276,112,70016,48584
136,14,0,1,1,0,0,3,204,163,64422,49422,234,243,70016,48587
137,14,1,1,2,1,2,1,256,139,64423,49423,277,184,70017,48588
138,14,3,0,0,3,1,0,309,92,64426,49423,354,16,70020,48588
139,14,1,0,0,3,1,0,165,139,64427,49423,199,0,70023,48588
140,15,3,1,0,3,1,0,293,129,64430,49424,304,2,70026,48588
141,15,0,1,1,0,0,3,315,133,64430,49425,313,283,70026,48591
142,15,1,1,2,1,2,1,158,124,64431,49426,157,119,70027,48592
143,15,2,2,2,1,2,1,5,20,64433,49428,1,208,70028,48593
144,15,1,1,2,1,2,1,140,153,64434,49429,154,98,70029,48594
145,15,3,0,0,3,1,0,240,153,64437,49429,257,97,70032,48594
146,15,5,0,0,3,1,0,267,161,64442,49429,270,146,70035,48594
147,15,1,2,1,0,0,3,175,143,64443,49431,182,196,70035,48597
148,15,0,3,1,0,0,3,27,37,64443,49434,30,146,70035,48600
149,15,0,1,1,0,0,3,88,105,64443,49435,81,119,70035,48603
150,16,2,2,2,1,2,1,170,173,64445,49437,174,114,70036,48604
151,16,0,0,2,1,2,1,309,92,64445,49437,355,202,70037,48605
152,16,0,0,2,1,2,1,144,144,64445,49437,187,235,70038,48606
153,16,0,0,2,1,2,1,315,133,64445,49437,314,185,70039,48607
154,16,2,2,2,1,2,1,10,12,64447,49439,9,57,70040,48608
155,16,2,0,0,3,1,0,206,163,64449,49439,237,0,70043,48608
156,16,2,1,0,3,1,0,103,119,64451,49440,107,16,70046,48608
157,16,2,1,0,3,1,0,237,123,64453,49441,279,118,70049,48608
158,16,1,3,1,0,0,3,257,142,64454,49444,277,115,70049,48611
159,16,1,2,1,0,0,3,201,178,64455,49446,210,122,70049,48614
160,17,1,3,1,0,0,3,268,164,64456,49449,270,149,70049,48617
161,17,1,3,1,0,0,3,159,127,64457,49452,157,246,70049,48620
162,17,1,0,0,3,1,0,294,129,64458,49452,307,98,70052,48620
163,17,3,0,0,3,1,0,91,105,64461,49452,84,208,70055,48620
164,17,0,3,1,0,0,3,140,156,64461,49455,154,286,70055,48623
165,17,1,0,0,3,1,0,28,37,64462,49455,33,146,70058,48623
166,17,0,0,2,1,2,1,240,153,64462,49455,258,120,70059,48624
167,17,0,1,1,0,0,3,175,144,64462,49456,182,100,70059,48627
168,17,1,2,1,0,0,3,6,22,64463,49458,1,5,70059,48630
169,17,3,3,2,1,2,1,168,142,64466,49461,200,197,70060,48631
170,18,2,3,1,0,0,3,146,147,64468,49464,187,121,70060,48634
171,18,0,1,1,0,0,3,170,174,64468,49465,174,188,70060,48637
172,18,4,0,0,3,1,0,261,142,64472,49465,280,16,70063,48637
173,18,1,0,0,3,1,0,202,178,64473,49465,213,0,70066,48637
174,18,3,2,0,3,1,0,318,135,64476,49467,317,114,70069,48637
175,18,1,0,0,3,1,0,104,119,64477,49467,110,202,70072,48637
176,18,2,2,2,1,2,1,12,14,64479,49469,10,116,70073,48638
177,18,4,0,0,3,1,0,210,163,64483,49469,240,57,70076,48638
178,18,0,2,1,0,0,3,237,125,64483,49471,279,125,70076,48641
179,18,1,0,0,3,1,0,310,92,64484,49471,358,235,70079,48641
180,19,0,1,1,0,0,3,28,38,64484,49472,33,249,70079,48644
181,19,1,1,2,1,2,1,241,154,64485,49473,259,209,70080,48645
182,19,1,2,1,0,0,3,169,144,64486,49475,200,101,70080,48648
183,19,1,0,0,3,1,0,7,22,64487,49475,4,146,70083,48648
184,19,1,2,1,0,0,3,141,158,64488,49477,154,152,70083,48651
185,19,1,1,2,1,2,1,295,130,64489,49478,308,101,70084,48652
186,19,2,0,0,3,1,0,177,144,64491,49478,185,5,70087,48652
187,19,0,0,2,1,2,1,159,127,64491,49478,158,121,70088,48653
188,19,0,0,2,1,2,1,268,164,64491,49478,271,198,70089,48654
189,19,1,3,1,0,0,3,92,108,64492,49481,84,289,70089,48657
190,20,1,1,2,1,2,1,147,148,64493,49482,188,153,70090,48658
191,20,1,1,2,1,2,1,242,155,64494,49483,260,203,70091,48659
192,20,3,0,0,3,1,0,162,127,64497,49483,161,121,70094,48659
193,20,1,0,0,3,1,0,238,125,64498,49483,282,16,70097,48659
194,20,2,0,0,3,1,0,320,135,64500,49483,320,57,70100,48659
195,20,2,5,1,0,0,3,14,19,64502,49488,10,201,70100,48662
196,20,3,2,0,3,1,0,10,24,64505,49490,7,114,70103,48662
197,20,1,0,0,3,1,0,203,178,64506,49490,216,101,70106,48662
198,20,1,2,1,0,0,3,296,132,64507,49492,308,128,70106,48665
199,20,0,1,1,0,0,3,170,175,64507,49493,174,292,70106,48668
200,21,0,1,1,0,0,3,169,145,64507,49494,200,252,70106,48671
201,21,3,0,0,3,1,0,144,158,64510,49494,157,0,70109,48671
202,21,5,1,0,3,1,0,266,143,64515,49495,283,146,70112,48671
203,21,0,3,1,0,0,3,92,111,64515,49498,84,19,70112,48674
204,21,3,1,0,3,1,0,180,145,64518,49499,188,188,70115,48674
205,21,1,1,2,1,2,1,211,164,64519,49500,241,6,70116,48675
206,21,1,1,2,1,2,1,105,120,64520,49501,111,117,70117,48676
207,21,1,2,1,0,0,3,171,177,64521,49503,174,212,70117,48679
208,21,1,1,2,1,2,1,269,165,64522,49504,272,236,70118,48680
209,21,1,0,0,3,1,0,311,92,64523,49504,361,121,70121,48680
210,22,0,3,1,0,0,3,105,123,64523,49507,111,131,70121,48683
211,22,0,2,1,0,0,3,147,150,64523,49509,188,295,70121,48686
212,22,1,1,2,1,2,1,15,20,64524,49510,11,204,70122,48687
213,22,3,0,0,3,1,0,165,127,64527,49510,164,0,70125,48687
214,22,3,1,0,3,1,0,323,136,64530,49511,323,121,70128,48687
215,22,1,1,2,1,2,1,29,39,64531,49512,34,102,70129,48688
216,22,1,4,1,0,0,3,243,159,64532,49516,260,60,70129,48691
217,22,0,1,1,0,0,3,203,179,64532,49517,216,156,70129,48694
218,22,2,1,0,3,1,0,240,126,64534,49518,285,201,70132,48694
219,22,0,1,1,0,0,3,296,133,64534,49519,308,117,70132,48697
220,23,1,1,2,1,2,1,181,146,64535,49520,189,118,70133,48698
221,23,1,1,2,1,2,1,270,166,64536,49521,273,20,70134,48699
222,23,0,1,1,0,0,3,92,112,64536,49522,84,239,70134,48702
223,23,1,0,0,3,1,0,170,145,64537,49522,203,146,70137,48702
224,23,1,2,1,0,0,3,145,160,64538,49524,157,191,70137,48705
225,23,1,1,2,1,2,1,212,165,64539,49525,242,213,70138,48706
226,23,7,0,0,3,1,0,318,92,64546,49525,364,101,70141,48706
227,23,2,0,0,3,1,0,173,177,64548,49525,177,6,70144,48706
228,23,0,2,1,0,0,3,10,26,64548,49527,7,255,70144,48709
229,23,1,2,1,0,0,3,267,145,64549,49529,283,124,70144,48712
230,24,0,2,1,0,0,3,243,161,64549,49531,260,298,70144,48715
231,24,0,4,1,0,0,3,15,24,64549,49535,11,216,70144,48718
232,24,1,1,2,1,2,1,30,40,64550,49536,35,132,70145,48719
233,24,4,1,0,3,1,0,327,137,64554,49537,326,201,70148,48719
234,24,0,0,2,1,2,1,105,123,64554,49537,112,103,70149,48720
235,24,2,1,0,3,1,0,272,167,64556,49538,276,121,70152,48720
236,24,0,1,1,0,0,3,147,151,64556,49539,188,127,70152,48723
237,24,2,0,0,3,1,0,183,146,64558,49539,192,60,70155,48723
238,24,2,0,0,3,1,0,167,127,64560,49539,167,156,70158,48723
239,24,5,2,0,3,1,0,301,135,64565,49541,311,0,70161,48723
240,25,0,2,1,0,0,3,212,167,64565,49543,242,242,70161,48726
241,25,2,1,0,3,1,0,149,152,64567,49544,191,103,70164,48726
242,25,2,0,0,3,1,0,205,179,64569,49544,219,204,70167,48726
243,25,0,1,1,0,0,3,167,128,64569,49545,167,301,70167,48729
244,25,3,2,0,3,1,0,13,28,64572,49547,10,20,70170,48729
245,25,2,1,0,3,1,0,147,161,64574,49548,160,101,70173,48729
246,25,1,0,0,3,1,0,328,137,64575,49548,329,6,70176,48729
247,25,1,1,2,1,2,1,171,146,64576,49549,204,192,70177,48730
248,25,1,0,0,3,1,0,241,126,64577,49549,288,117,70180,48730
249,25,2,0,0,3,1,0,269,145,64579,49549,286,60,70183,48730
250,26,2,0,0,3,1,0,149,161,64581,49549,163,127,70186,48730
251,26,2,0,0,3,1,0,274,167,64583,49549,279,0,70189,48730
252,26,2,3,1,0,0,3,32,43,64585,49552,35,9,70189,48733
253,26,1,0,0,3,1,0,244,161,64586,49552,263,146,70192,48733
254,26,0,3,1,0,0,3,105,126,64586,49555,112,204,70192,48736
255,26,2,1,0,3,1,0,94,113,64588,49556,87,118,70195,48736
256,26,2,1,0,3,1,0,185,147,64590,49557,195,156,70198,48736
257,26,0,2,1,0,0,3,301,137,64590,49559,311,219,70198,48739
258,26,0,5,1,0,0,3,173,182,64590,49564,177,258,70198,48742
259,26,2,0,0,3,1,0,320,92,64592,49564,367,132,70201,48742
260,27,1,0,0,3,1,0,16,24,64593,49564,14,121,70204,48742
261,27,0,1,1,0,0,3,269,146,64593,49565,286,304,70204,48745
262,27,2,4,1,0,0,3,330,141,64595,49569,329,245,70204,48748
263,27,2,1,0,3,1,0,207,180,64597,49570,222,103,70207,48748
264,27,0,2,1,0,0,3,212,169,64597,49572,242,195,70207,48751
265,27,1,2,1,0,0,3,172,148,64598,49574,204,120,70207,48754
266,27,3,0,0,3,1,0,16,28,64601,49574,13,60,70210,48754
267,27,4,1,0,3,1,0,171,129,64605,49575,170,20,70213,48754
268,27,0,0,2,1,2,1,241,126,64605,49575,289,205,70214,48755
269,27,1,1,2,1,2,1,150,153,64606,49576,192,102,70215,48756
270,28,3,0,0,3,1,0,304,137,64609,49576,314,118,70218,48756
271,28,1,0,0,3,1,0,95,113,64610,49576,90,146,70221,48756
272,28,1,0,0,3,1,0,245,161,64611,49576,266,0,70224,48756
273,28,0,1,1,0,0,3,149,162,64611,49577,163,135,70224,48759
274,28,2,2,2,1,2,1,175,184,64613,49579,178,205,70225,48760
275,28,4,1,0,3,1,0,36,44,64617,49580,38,120,70228,48760
276,28,1,1,2,1,2,1,106,127,64618,49581,113,10,70229,48761
277,28,2,0,0,3,1,0,322,92,64620,49581,370,156,70232,48761
278,28,0,1,1,0,0,3,207,181,64620,49582,222,222,70232,48764
279,28,0,0,2,1,2,1,274,167,64620,49582,280,259,70233,48765
280,29,1,2,1,0,0,3,213,171,64621,49584,242,105,70233,48768
281,29,0,0,2,1,2,1,16,24,64621,49584,15,305,70234,48769
282,29,0,5,1,0,0,3,185,152,64621,49589,195,208,70234,48772
283,29,0,5,1,0,0,3,95,118,64621,49594,90,138,70234,48775
284,29,1,2,1,0,0,3,17,30,64622,49596,13,106,70234,48778
285,29,3,2,0,3,1,0,244,128,64625,49598,292,146,70237,48778
286,29,1,2,1,0,0,3,172,131,64626,49600,170,198,70237,48781
287,29,0,2,1,0,0,3,36,46,64626,49602,38,248,70237,48784
288,29,1,1,2,1,2,1,270,147,64627,49603,287,122,70238,48785
289,29,1,0,0,3,1,0,331,141,64628,49603,332,127,70241,48785
290,30,1,1,2,1,2,1,150,163,64629,49604,164,249,70242,48786
291,30,6,2,0,3,1,0,276,149,64635,49606,290,0,70245,48786
292,30,2,0,0,3,1,0,247,161,64637,49606,269,20,70248,48786
293,30,3,0,0,3,1,0,277,167,64640,49606,283,60,70251,48786
294,30,1,1,2,1,2,1,208,182,64641,49607,223,11,70252,48787
295,30,0,4,1,0,0,3,175,188,64641,49611,178,121,70252,48790
296,30,2,0,0,3,1,0,174,148,64643,49611,207,156,70255,48790
297,30,1,1,2,1,2,1,107,128,64644,49612,114,260,70256,48791
298,30,2,1,0,3,1,0,152,154,64646,49613,195,120,70259,48791
299,30,3,1,0,3,1,0,325,93,64649,49614,373,222,70262,48791
300,31,2,4,1,0,0,3,19,34,64651,49618,13,308,70262,48794
301,31,1,1,2,1,2,1,17,25,64652,49619,16,139,70263,48795
302,31,0,2,1,0,0,3,304,139,64652,49621,314,201,70263,48798
303,31,0,0,2,1,2,1,185,152,64652,49621,196,128,70264,48799
304,31,1,0,0,3,1,0,173,131,64653,49621,173,208,70267,48799
305,31,1,0,0,3,1,0,37,46,64654,49621,41,122,70270,48799
306,31,1,0,0,3,1,0,96,118,64655,49621,93,106,70273,48799
307,31,2,1,0,3,1,0,333,142,64657,49622,335,146,70276,48799
308,31,1,2,1,0,0,3,214,173,64658,49624,242,208,70276,48802
309,31,1,1,2,1,2,1,245,129,64659,49625,293,106,70277,48803
310,32,2,1,0,3,1,0,177,189,64661,49626,181,156,70280,48803
311,32,0,0,2,1,2,1,152,154,64661,49626,196,122,70281,48804
312,32,1,0,0,3,1,0,209,182,64662,49626,226,20,70284,48804
313,32,0,0,2,1,2,1,174,148,64662,49626,208,209,70285,48805
314,32,0,0,2,1,2,1,247,161,64662,49626,270,12,70286,48806
315,32,2,2,2,1,2,1,109,130,64664,49628,115,1,70287,48807
316,32,2,0,0,3,1,0,152,163,64666,49628,167,60,70290,48807
317,32,0,0,2,1,2,1,245,129,64666,49628,294,261,70291,48808
318,32,3,0,0,3,1,0,328,93,64669,49628,376,120,70294,48808
319,32,0,0,2,1,2,1,276,149,64669,49628,291,250,70295,48809
320,33,4,0,0,3,1,0,281,167,64673,49628,286,106,70298,48809
321,33,0,3,1,0,0,3,19,37,64673,49631,13,142,70298,48812
322,33,1,0,0,3,1,0,186,152,64674,49631,199,122,70301,48812
323,33,0,0,2,1,2,1,17,25,64674,49631,17,147,70302,48813
324,33,2,1,0,3,1,0,306,140,64676,49632,317,128,70305,48813
325,33,1,1,2,1,2,1,38,47,64677,49633,42,309,70306,48814
326,33,3,4,1,0,0,3,250,165,64680,49637,270,211,70306,48817
327,33,1,1,2,1,2,1,174,132,64681,49638,174,223,70307,48818
328,33,0,1,1,0,0,3,96,119,64681,49639,93,109,70307,48821
329,33,4,2,0,3,1,0,337,144,64685,49641,338,156,70310,48821
330,34,0,3,1,0,0,3,17,28,64685,49644,17,253,70310,48824
331,34,1,0,0,3,1,0,110,130,64686,49644,118,201,70313,48824
332,34,0,1,1,0,0,3,245,130,64686,49645,294,4,70313,48827
333,34,0,0,2,1,2,1,177,189,64686,49645,182,123,70314,48828
334,34,1,2,1,0,0,3,215,175,64687,49647,242,23,70314,48831
335,34,1,2,1,0,0,3,153,156,64688,49649,196,212,70314,48834
336,34,4,0,0,3,1,0,280,149,64692,49649,294,120,70317,48834
337,34,2,1,0,3,1,0,176,149,64694,49650,211,122,70320,48834
338,34,0,1,1,0,0,3,328,94,64694,49651,376,264,70320,48837
339,34,3,1,0,3,1,0,212,183,64697,49652,229,60,70323,48837
340,35,4,1,0,3,1,0,310,141,64701,49653,320,147,70326,48837
341,35,2,3,1,0,0,3,283,170,64703,49656,286,312,70326,48840
342,35,4,1,0,3,1,0,42,48,64707,49657,45,109,70329,48840
343,35,4,1,0,3,1,0,190,153,64711,49658,202,106,70332,48840
344,35,3,1,0,3,1,0,179,150,64714,49659,214,128,70335,48840
345,35,1,2,1,0,0,3,153,165,64715,49661,167,226,70335,48843
346,35,1,3,1,0,0,3,97,122,64716,49664,93,15,70335,48846
347,35,3,3,2,1,2,1,22,40,64719,49667,14,157,70336,48847
348,35,3,0,0,3,1,0,253,165,64722,49667,273,264,70339,48847
349,35,0,1,1,0,0,3,174,133,64722,49668,174,214,70339,48850
350,36,4,1,0,3,1,0,249,131,64726,49669,297,60,70342,48850
351,36,3,1,0,3,1,0,331,95,64729,49670,379,123,70345,48850
352,36,0,4,1,0,0,3,215,179,64729,49674,242,215,70345,48853
353,36,1,1,2,1,2,1,281,150,64730,49675,295,143,70346,48854
354,36,2,0,0,3,1,0,19,28,64732,49675,20,4,70349,48854
355,36,2,1,0,3,1,0,155,157,64734,49676,199,23,70352,48854
356,36,2,3,1,0,0,3,214,186,64736,49679,229,204,70352,48857
357,36,2,2,2,1,2,1,339,146,64738,49681,339,123,70353,48858
358,36,1,0,0,3,1,0,111,130,64739,49681,121,120,70356,48858
359,36,0,1,1,0,0,3,177,190,64739,49682,182,256,70356,48861
360,37,1,0,0,3,1,0,23,40,64740,49682,17,128,70359,48861
361,37,1,2,1,0,0,3,284,172,64741,49684,286,112,70359,48864
362,37,0,1,1,0,0,3,253,166,64741,49685,273,109,70359,48867
363,37,1,2,1,0,0,3,154,167,64742,49687,167,150,70359,48870
364,37,2,2,2,1,2,1,44,50,64744,49689,46,215,70360,48871
365,37,2,1,0,3,1,0,176,134,64746,49690,177,15,70363,48871
366,37,0,1,1,0,0,3,97,123,64746,49691,93,160,70363,48874
367,37,1,1,2,1,2,1,180,151,64747,49692,215,227,70364,48875
368,37,0,0,2,1,2,1,310,141,64747,49692,321,313,70365,48876
369,37,0,2,1,0,0,3,190,155,64747,49694,202,267,70365,48879
370,38,2,1,0,3,1,0,333,96,64749,49695,382,60,70368,48879
371,38,1,2,1,0,0,3,215,188,64750,49697,229,126,70368,48882
372,38,1,0,0,3,1,0,178,190,64751,49697,185,143,70371,48882
373,38,1,0,0,3,1,0,156,157,64752,49697,202,4,70374,48882
374,38,1,0,0,3,1,0,216,179,64753,49697,245,123,70377,48882
375,38,2,1,0,3,1,0,341,147,64755,49698,342,23,70380,48882
376,38,5,1,0,3,1,0,254,132,64760,49699,300,204,70383,48882
377,38,3,1,0,3,1,0,22,29,64763,49700,23,120,70386,48882
378,38,2,3,1,0,0,3,283,153,64765,49703,295,218,70386,48885
379,38,0,1,1,0,0,3,111,131,64765,49704,121,259,70386,48888
0,1,2,3,1,0,0,3,158,160,64767,49707,202,316,70386,48891
1,1,1,2,1,0,0,3,284,155,64768,49709,295,270,70386,48894
2,1,0,1,1,0,0,3,176,135,64768,49710,177,262,70386,48897
3,1,0,1,1,0,0,3,154,168,64768,49711,167,18,70386,48900
4,1,2,0,0,3,1,0,66,71,64770,49711,75,109,70389,48900
5,1,2,2,2,1,2,1,131,101,64772,49713,150,161,70390,48901
6,1,1,0,0,3,1,0,112,131,64773,49713,124,218,70393,48901
7,1,4,0,0,3,1,0,184,151,64777,49713,218,9,70396,48901
8,1,1,1,2,1,2,1,191,156,64778,49714,203,205,70397,48902
9,1,2,1,0,3,1,0,256,133,64780,49715,303,128,70400,48902
10,2,2,0,0,3,1,0,335,96,64782,49715,385,215,70403,48902
11,2,3,2,0,3,1,0,344,149,64785,49717,345,227,70406,48902
12,2,1,0,0,3,1,0,23,29,64786,49717,26,86,70409,48902
13,2,2,2,2,1,2,1,180,192,64788,49719,186,113,70410,48903
14,2,6,1,0,3,1,0,259,167,64794,49720,276,150,70413,48903
15,2,0,0,2,1,2,1,18,26,64794,49720,23,124,70414,48904
16,2,2,1,0,3,1,0,217,189,64796,49721,232,48,70417,48904
17,2,2,2,2,1,2,1,286,174,64798,49723,287,127,70418,48905
18,2,1,0,0,3,1,0,217,179,64799,49723,248,120,70421,48905
19,2,3,3,2,1,2,1,313,144,64802,49726,322,144,70422,48906
20,3,2,1,0,3,1,0,258,134,64804,49727,306,262,70425,48906
21,3,0,3,1,0,0,3,154,171,64804,49730,167,221,70425,48909
22,3,1,2,1,0,0,3,132,103,64805,49732,150,319,70425,48912
23,3,1,0,0,3,1,0,260,167,64806,49732,279,161,70428,48912
24,3,0,1,1,0,0,3,184,152,64806,49733,218,112,70428,48915
25,3,0,0,2,1,2,1,158,160,64806,49733,203,49,70429,48916
26,3,1,0,0,3,1,0,285,155,64807,49733,298,9,70432,48916
27,3,3,0,0,3,1,0,194,156,64810,49733,206,270,70435,48916
28,3,5,3,0,3,1,0,117,134,64815,49736,127,128,70438,48916
29,3,1,0,0,3,1,0,177,135,64816,49736,180,18,70441,48916
30,4,0,1,1,0,0,3,286,175,64816,49737,287,89,70441,48919
31,4,1,0,0,3,1,0,345,149,64817,49737,348,205,70444,48919
32,4,0,5,1,0,0,3,18,31,64817,49742,23,123,70444,48922
33,4,2,2,2,1,2,1,315,146,64819,49744,323,151,70445,48923
34,4,1,0,0,3,1,0,218,189,64820,49744,235,124,70448,48923
35,4,2,1,0,3,1,0,337,97,64822,49745,388,113,70451,48923
36,4,1,1,2,1,2,1,218,180,64823,49746,249,128,70452,48924
37,4,0,1,1,0,0,3,66,72,64823,49747,75,218,70452,48927
38,4,1,1,2,1,2,1,181,193,64824,49748,187,228,70453,48928
39,4,2,0,0,3,1,0,25,29,64826,49748,29,144,70456,48928
40,5,3,1,0,3,1,0,120,135,64829,49749,130,49,70459,48928
41,5,2,0,0,3,1,0,134,103,64831,49749,153,112,70462,48928
42,5,3,0,0,3,1,0,263,167,64834,49749,282,18,70465,48928
43,5,0,1,1,0,0,3,194,157,64834,49750,206,224,70465,48931
44,5,1,3,1,0,0,3,178,138,64835,49753,180,273,70465,48934
45,5,2,0,0,3,1,0,156,171,64837,49753,170,262,70468,48934
46,5,0,2,1,0,0,3,158,162,64837,49755,203,164,70468,48937
47,5,4,1,0,3,1,0,289,156,64841,49756,301,128,70471,48937
48,5,2,2,2,1,2,1,260,136,64843,49758,307,145,70472,48938
49,5,0,2,1,0,0,3,18,33,64843,49760,23,322,70472,48941
50,6,2,1,0,3,1,0,288,176,64845,49761,290,205,70475,48941
51,6,1,2,1,0,0,3,219,182,64846,49763,249,221,70475,48944
52,6,0,0,2,1,2,1,184,152,64846,49763,219,129,70476,48945
53,6,0,0,2,1,2,1,181,193,64846,49763,188,124,70477,48946
54,6,2,0,0,3,1,0,220,189,64848,49763,238,151,70480,48946
55,6,2,0,0,3,1,0,339,97,64850,49763,391,124,70483,48946
56,6,3,0,0,3,1,0,348,149,64853,49763,351,89,70486,48946
57,6,4,0,0,3,1,0,319,146,64857,49763,326,9,70489,48946
58,6,0,2,1,0,0,3,25,31,64857,49765,29,116,70489,48949
59,6,1,1,2,1,2,1,67,73,64858,49766,76,229,70490,48950
60,7,3,1,0,3,1,0,322,147,64861,49767,329,221,70493,48950
61,7,3,1,0,3,1,0,342,98,64864,49768,394,273,70496,48950
62,7,2,0,0,3,1,0,290,176,64866,49768,293,112,70499,48950
63,7,2,1,0,3,1,0,158,172,64868,49769,173,164,70502,48950
64,7,0,1,1,0,0,3,158,163,64868,49770,203,132,70502,48953
65,7,2,0,0,3,1,0,265,167,64870,49770,285,145,70505,48953
66,7,1,2,1,0,0,3,19,35,64871,49772,23,131,70505,48956
67,7,1,0,0,3,1,0,135,103,64872,49772,156,49,70508,48956
68,7,1,4,1,0,0,3,121,139,64873,49776,130,232,70508,48959
69,7,2,1,0,3,1,0,196,158,64875,49777,209,18,70511,48959
70,8,3,2,0,3,1,0,181,140,64878,49779,183,9,70514,48959
71,8,2,0,0,3,1,0,183,193,64880,49779,191,124,70517,48959
72,8,0,2,1,0,0,3,219,184,64880,49781,249,325,70517,48962
73,8,0,2,1,0,0,3,67,75,64880,49783,76,265,70517,48965
74,8,1,3,1,0,0,3,221,192,64881,49786,238,92,70517,48968
75,8,0,1,1,0,0,3,184,153,64881,49787,219,127,70517,48971
76,8,1,0,0,3,1,0,290,156,64882,49787,304,205,70520,48971
77,8,3,1,0,3,1,0,263,137,64885,49788,310,151,70523,48971
78,8,2,0,0,3,1,0,350,149,64887,49788,354,116,70526,48971
79,8,1,2,1,0,0,3,26,33,64888,49790,29,227,70526,48974
80,9,0,2,1,0,0,3,322,149,64888,49792,329,21,70526,48977
81,9,1,1,2,1,2,1,343,99,64889,49793,395,132,70527,48978
82,9,0,3,1,0,0,3,219,187,64889,49796,249,276,70527,48981
83,9,3,3,2,1,2,1,22,38,64892,49799,24,50,70528,48982
84,9,2,2,2,1,2,1,160,174,64894,49801,174,133,70529,48983
85,9,1,5,1,0,0,3,159,168,64895,49806,203,148,70529,48986
86,9,0,2,1,0,0,3,135,105,64895,49808,156,224,70529,48989
87,9,1,1,2,1,2,1,266,168,64896,49809,286,113,70530,48990
88,9,1,0,0,3,1,0,291,176,64897,49809,296,232,70533,48990
89,9,0,0,2,1,2,1,196,158,64897,49809,210,117,70534,48991
90,10,3,0,0,3,1,0,187,153,64900,49809,222,92,70537,48991
91,10,1,2,1,0,0,3,68,77,64901,49811,76,328,70537,48994
92,10,1,1,2,1,2,1,182,141,64902,49812,184,206,70538,48995
93,10,2,2,2,1,2,1,123,141,64904,49814,131,125,70539,48996
94,10,2,1,0,3,1,0,185,194,64906,49815,194,151,70542,48996
95,10,2,2,2,1,2,1,223,194,64908,49817,239,165,70543,48997
96,10,0,3,1,0,0,3,26,36,64908,49820,29,12,70543,49000
97,10,3,2,0,3,1,0,266,139,64911,49822,313,127,70546,49000
98,10,1,1,2,1,2,1,351,150,64912,49823,355,266,70547,49001
99,10,0,3,1,0,0,3,290,159,64912,49826,304,230,70547,49004
100,11,5,1,0,3,1,0,356,151,64917,49827,358,50,70550,49004
101,11,5,0,0,3,1,0,296,176,64922,49827,299,132,70553,49004
102,11,1,1,2,1,2,1,267,169,64923,49828,287,267,70554,49005
103,11,3,1,0,3,1,0,346,100,64926,49829,398,113,70557,49005
104,11,4,1,0,3,1,0,294,160,64930,49830,307,21,70560,49005
105,11,0,2,1,0,0,3,159,170,64930,49832,203,120,70560,49008
106,11,0,0,2,1,2,1,135,105,64930,49832,157,13,70561,49009
107,11,1,4,1,0,0,3,197,162,64931,49836,210,136,70561,49012
108,11,1,2,1,0,0,3,161,176,64932,49838,174,151,70561,49015
109,11,0,1,1,0,0,3,219,188,64932,49839,249,235,70561,49018
110,12,1,1,2,1,2,1,23,39,64933,49840,25,207,70562,49019
111,12,1,2,1,0,0,3,183,143,64934,49842,184,95,70562,49022
112,12,2,2,2,1,2,1,28,38,64936,49844,30,114,70563,49023
113,12,1,2,1,0,0,3,224,196,64937,49846,239,279,70563,49026
114,12,4,1,0,3,1,0,191,154,64941,49847,225,230,70566,49026
115,12,2,2,2,1,2,1,161,172,64943,49849,204,126,70567,49027
116,12,2,1,0,3,1,0,70,78,64945,49850,79,165,70570,49027
117,12,4,1,0,3,1,0,326,150,64949,49851,332,127,70573,49027
118,12,1,1,2,1,2,1,124,142,64950,49852,132,225,70574,49028
119,12,0,2,1,0,0,3,266,141,64950,49854,313,331,70574,49031
120,13,1,0,0,3,1,0,220,188,64951,49854,252,267,70577,49031
121,13,2,0,0,3,1,0,348,100,64953,49854,401,21,70580,49031
122,13,3,0,0,3,1,0,299,176,64956,49854,302,13,70583,49031
123,13,2,1,0,3,1,0,137,106,64958,49855,160,120,70586,49031
124,13,0,0,2,1,2,1,161,176,64958,49855,175,208,70587,49032
125,13,3,2,0,3,1,0,73,80,64961,49857,82,151,70590,49032
126,13,0,0,2,1,2,1,356,151,64961,49857,359,152,70591,49033
127,13,1,1,2,1,2,1,295,161,64962,49858,308,236,70592,49034
128,13,1,1,2,1,2,1,225,197,64963,49859,240,128,70593,49035
129,13,0,0,2,1,2,1,185,194,64963,49859,195,137,70594,49036
130,14,2,2,2,1,2,1,30,40,64965,49861,31,51,70595,49037
131,14,0,3,1,0,0,3,267,172,64965,49864,287,334,70595,49040
132,14,4,1,0,3,1,0,201,163,64969,49865,213,126,70598,49040
133,14,2,1,0,3,1,0,268,142,64971,49866,316,95,70601,49040
134,14,1,1,2,1,2,1,24,40,64972,49867,26,115,70602,49041
135,14,0,0,2,1,2,1,124,142,64972,49867,133,166,70603,49042
136,14,2,1,0,3,1,0,185,144,64974,49868,187,132,70606,49042
137,14,1,1,2,1,2,1,162,173,64975,49869,205,226,70607,49043
138,14,2,2,2,1,2,1,328,152,64977,49871,333,231,70608,49044
139,14,1,2,1,0,0,3,192,156,64978,49873,225,282,70608,49047
140,15,1,0,0,3,1,0,349,100,64979,49873,404,231,70611,49047
141,15,4,0,0,3,1,0,360,151,64983,49873,362,13,70614,49047
142,15,2,2,2,1,2,1,187,196,64985,49875,196,268,70615,49048
143,15,2,2,2,1,2,1,297,163,64987,49877,309,129,70616,49049
144,15,3,3,2,1,2,1,127,145,64990,49880,134,209,70617,49050
145,15,2,1,0,3,1,0,75,81,64992,49881,85,126,70620,49050
146,15,1,1,2,1,2,1,138,107,64993,49882,161,153,70621,49051
147,15,1,3,1,0,0,3,221,191,64994,49885,252,154,70621,49054
148,15,1,1,2,1,2,1,226,198,64995,49886,241,22,70622,49055
149,15,0,0,2,1,2,1,268,142,64995,49886,317,138,70623,49056
150,16,1,0,0,3,1,0,300,176,64996,49886,305,166,70626,49056
151,16,0,1,1,0,0,3,185,145,64996,49887,187,337,70626,49059
152,16,0,0,2,1,2,1,30,40,64996,49887,32,154,70627,49060
153,16,3,1,0,3,1,0,270,173,64999,49888,290,51,70630,49060
154,16,0,2,1,0,0,3,24,42,64999,49890,26,123,70630,49063
155,16,2,0,0,3,1,0,203,163,65001,49890,216,95,70633,49063
156,16,0,1,1,0,0,3,187,197,65001,49891,196,285,70633,49066
157,16,3,2,0,3,1,0,331,154,65004,49893,336,132,70636,49066
158,16,1,0,0,3,1,0,193,156,65005,49893,228,226,70639,49066
159,16,0,0,2,1,2,1,161,176,65005,49893,176,237,70640,49067
160,17,3,1,0,3,1,0,300,164,65008,49894,312,115,70643,49067
161,17,2,4,1,0,0,3,77,85,65010,49898,85,132,70643,49070
162,17,3,1,0,3,1,0,229,199,65013,49899,244,154,70646,49070
163,17,0,1,1,0,0,3,268,143,65013,49900,317,212,70646,49073
164,17,1,0,0,3,1,0,361,151,65014,49900,365,22,70649,49073
165,17,1,1,2,1,2,1,128,146,65015,49901,135,139,70650,49074
166,17,1,1,2,1,2,1,222,192,65016,49902,253,14,70651,49075
167,17,1,1,2,1,2,1,163,174,65017,49903,206,232,70652,49076
168,17,0,0,2,1,2,1,138,107,65017,49903,162,127,70653,49077
169,17,1,0,0,3,1,0,350,100,65018,49903,407,268,70656,49077
170,18,0,0,2,1,2,1,24,42,65018,49903,27,238,70657,49078
171,18,2,2,2,1,2,1,195,158,65020,49905,229,338,70658,49079
172,18,0,2,1,0,0,3,161,178,65020,49907,176,229,70658,49082
173,18,1,0,0,3,1,0,188,197,65021,49907,199,132,70661,49082
174,18,0,1,1,0,0,3,270,174,65021,49908,290,98,70661,49085
175,18,2,0,0,3,1,0,205,163,65023,49908,219,154,70664,49085
176,18,3,1,0,3,1,0,334,155,65026,49909,339,123,70667,49085
177,18,0,0,2,1,2,1,30,40,65026,49909,33,167,70668,49086
178,18,3,0,0,3,1,0,188,145,65029,49909,190,51,70671,49086
179,18,1,0,0,3,1,0,301,176,65030,49909,308,285,70674,49086
180,19,2,1,0,3,1,0,352,101,65032,49910,410,132,70677,49086
181,19,1,0,0,3,1,0,164,174,65033,49910,209,14,70680,49086
182,19,0,1,1,0,0,3,77,86,65033,49911,85,235,70680,49089
183,19,0,0,2,1,2,1,229,199,65033,49911,245,213,70681,49090
184,19,1,1,2,1,2,1,301,165,65034,49912,313,140,70682,49091
185,19,0,2,1,0,0,3,138,109,65034,49914,162,271,70682,49094
186,19,2,6,1,0,0,3,130,152,65036,49920,135,157,70682,49097
187,19,2,0,0,3,1,0,224,192,65038,49920,256,115,70685,49097
188,19,3,2,0,3,1,0,364,153,65041,49922,368,127,70688,49097
189,19,2,1,0,3,1,0,270,144,65043,49923,320,22,70691,49097
190,20,3,2,0,3,1,0,337,157,65046,49925,342,140,70694,49097
191,20,1,2,1,0,0,3,225,194,65047,49927,256,101,70694,49100
192,20,0,0,2,1,2,1,301,176,65047,49927,309,124,70695,49101
193,20,0,5,1,0,0,3,24,47,65047,49932,27,160,70695,49104
194,20,1,1,2,1,2,1,31,41,65048,49933,34,128,70696,49105
195,20,3,3,2,1,2,1,273,177,65051,49936,291,133,70697,49106
196,20,2,2,2,1,2,1,190,199,65053,49938,200,52,70698,49107
197,20,2,1,0,3,1,0,366,154,65055,49939,371,229,70701,49107
198,20,0,2,1,0,0,3,229,201,65055,49941,245,241,70701,49110
199,20,3,0,0,3,1,0,355,101,65058,49941,413,154,70704,49110
200,21,3,0,0,3,1,0,133,152,65061,49941,138,115,70707,49110
201,21,4,0,0,3,1,0,209,163,65065,49941,222,167,70710,49110
202,21,0,0,2,1,2,1,270,144,65065,49941,321,286,70711,49111
203,21,3,4,1,0,0,3,167,178,65068,49945,209,216,70711,49114
204,21,0,4,1,0,0,3,161,182,65068,49949,176,17,70711,49117
205,21,3,3,2,1,2,1,198,161,65071,49952,230,272,70712,49118
206,21,2,3,1,0,0,3,140,112,65073,49955,162,25,70712,49121
207,21,1,0,0,3,1,0,189,145,65074,49955,193,235,70715,49121
208,21,1,2,1,0,0,3,302,167,65075,49957,313,341,70715,49124
209,21,1,3,1,0,0,3,78,89,65076,49960,85,135,70715,49127
210,22,2,2,2,1,2,1,80,91,65078,49962,86,155,70716,49128
211,22,3,0,0,3,1,0,369,154,65081,49962,374,133,70719,49128
212,22,3,3,2,1,2,1,358,104,65084,49965,414,102,70720,49129
213,22,0,0,2,1,2,1,31,41,65084,49965,35,141,70721,49130
214,22,1,1,2,1,2,1,226,195,65085,49966,257,217,70722,49131
215,22,1,1,2,1,2,1,230,202,65086,49967,246,125,70723,49132
216,22,0,1,1,0,0,3,301,177,65086,49968,309,131,70723,49135
217,22,1,1,2,1,2,1,338,158,65087,49969,343,242,70724,49136
218,22,0,1,1,0,0,3,24,48,65087,49970,27,232,70724,49139
219,22,0,1,1,0,0,3,190,200,65087,49971,200,163,70724,49142
220,23,1,0,0,3,1,0,303,167,65088,49971,316,52,70727,49142
221,23,0,3,1,0,0,3,167,181,65088,49974,209,275,70727,49145
222,23,0,0,2,1,2,1,273,177,65088,49974,292,287,70728,49146
223,23,0,1,1,0,0,3,140,113,65088,49975,162,238,70728,49149
224,23,1,1,2,1,2,1,162,183,65089,49976,177,136,70729,49150
225,23,0,1,1,0,0,3,209,164,65089,49977,222,20,70729,49153
226,23,2,1,0,3,1,0,200,162,65091,49978,233,25,70732,49153
227,23,1,0,0,3,1,0,190,145,65092,49978,196,167,70735,49153
228,23,0,3,1,0,0,3,133,155,65092,49981,138,344,70735,49156
229,23,3,0,0,3,1,0,273,144,65095,49981,324,115,70738,49156
230,24,3,0,0,3,1,0,361,104,65098,49981,417,20,70741,49156
231,24,2,1,0,3,1,0,192,201,65100,49982,203,102,70744,49156
232,24,1,3,1,0,0,3,201,165,65101,49985,233,245,70744,49159
233,24,1,4,1,0,0,3,32,45,65102,49989,35,220,70744,49162
234,24,1,0,0,3,1,0,227,195,65103,49989,260,155,70747,49162
235,24,2,1,0,3,1,0,232,203,65105,49990,249,232,70750,49162
236,24,3,0,0,3,1,0,83,91,65108,49990,89,125,70753,49162
237,24,2,1,0,3,1,0,303,178,65110,49991,312,133,70756,49162
238,24,0,0,2,1,2,1,369,154,65110,49991,375,142,70757,49163
239,24,2,1,0,3,1,0,340,159,65112,49992,346,131,70760,49163
240,25,3,0,0,3,1,0,276,144,65115,49992,327,52,70763,49163
241,25,2,0,0,3,1,0,192,145,65117,49992,199,163,70766,49163
242,25,2,3,1,0,0,3,26,51,65119,49995,27,278,70766,49166
243,25,1,0,0,3,1,0,210,164,65120,49995,225,115,70769,49166
244,25,0,0,2,1,2,1,167,181,65120,49995,210,137,70770,49167
245,25,0,1,1,0,0,3,162,184,65120,49996,177,347,70770,49170
246,25,1,1,2,1,2,1,134,156,65121,49997,139,26,70771,49171
247,25,0,4,1,0,0,3,140,117,65121,50001,162,290,70771,49174
248,25,3,3,2,1,2,1,276,180,65124,50004,293,239,70772,49175
249,25,2,0,0,3,1,0,305,167,65126,50004,319,167,70775,49175
250,26,2,1,0,3,1,0,194,202,65128,50005,206,239,70778,49175
251,26,3,3,2,1,2,1,86,94,65131,50008,90,103,70779,49176
252,26,1,0,0,3,1,0,277,144,65132,50008,330,125,70782,49176
253,26,3,0,0,3,1,0,308,167,65135,50008,322,278,70785,49176
254,26,3,0,0,3,1,0,195,145,65138,50008,202,155,70788,49176
255,26,2,1,0,3,1,0,229,196,65140,50009,263,131,70791,49176
256,26,0,0,2,1,2,1,232,203,65140,50009,250,21,70792,49177
257,26,1,2,1,0,0,3,33,47,65141,50011,35,136,70792,49180
258,26,3,1,0,3,1,0,204,166,65144,50012,236,220,70795,49180
259,26,1,2,1,0,0,3,370,156,65145,50014,375,350,70795,49183
260,27,4,1,0,3,1,0,365,105,65149,50015,420,167,70798,49183
261,27,1,0,0,3,1,0,141,117,65150,50015,165,137,70801,49183
262,27,1,2,1,0,0,3,168,183,65151,50017,210,248,70801,49186
263,27,2,0,0,3,1,0,164,184,65153,50017,180,115,70804,49186
264,27,1,2,1,0,0,3,211,166,65154,50019,225,166,70804,49189
265,27,2,0,0,3,1,0,305,178,65156,50019,315,26,70807,49189
266,27,1,2,1,0,0,3,27,53,65157,50021,27,145,70807,49192
267,27,1,1,2,1,2,1,135,157,65158,50022,140,291,70808,49193
268,27,1,1,2,1,2,1,277,181,65159,50023,294,233,70809,49194
269,27,2,1,0,3,1,0,342,160,65161,50024,349,52,70812,49194
270,28,2,1,0,3,1,0,196,203,65163,50025,209,220,70815,49194
271,28,3,5,1,0,0,3,138,162,65166,50030,140,139,70815,49197
272,28,2,1,0,3,1,0,35,48,65168,50031,38,278,70818,49197
273,28,2,3,1,0,0,3,197,148,65170,50034,202,134,70818,49200
274,28,2,0,0,3,1,0,234,203,65172,50034,253,350,70821,49200
275,28,1,1,2,1,2,1,205,167,65173,50035,237,156,70822,49201
276,28,2,1,0,3,1,0,88,95,65175,50036,93,21,70825,49201
277,28,4,1,0,3,1,0,312,168,65179,50037,325,103,70828,49201
278,28,4,2,0,3,1,0,374,158,65183,50039,378,167,70831,49201
279,28,2,3,1,0,0,3,279,147,65185,50042,330,242,70831,49204
280,29,0,3,1,0,0,3,168,186,65185,50045,210,118,70831,49207
281,29,2,0,0,3,1,0,231,196,65187,50045,266,137,70834,49207
282,29,1,0,0,3,1,0,366,105,65188,50045,423,52,70837,49207
283,29,1,0,0,3,1,0,212,166,65189,50045,228,248,70840,49207
284,29,1,3,1,0,0,3,142,120,65190,50048,165,169,70840,49210
285,29,1,4,1,0,0,3,343,164,65191,50052,349,294,70840,49213
286,29,0,1,1,0,0,3,27,54,65191,50053,27,29,70840,49216
287,29,1,1,2,1,2,1,278,182,65192,50054,295,146,70841,49217
288,29,2,1,0,3,1,0,166,185,65194,50055,183,125,70844,49217
289,29,0,1,1,0,0,3,305,179,65194,50056,315,236,70844,49220
290,30,1,1,2,1,2,1,280,148,65195,50057,331,168,70845,49221
291,30,0,2,1,0,0,3,196,205,65195,50059,209,353,70845,49224
292,30,2,1,0,3,1,0,90,96,65197,50060,96,294,70848,49224
293,30,2,2,2,1,2,1,345,166,65199,50062,350,221,70849,49225
294,30,0,4,1,0,0,3,234,207,65199,50066,253,245,70849,49228
295,30,1,0,0,3,1,0,36,48,65200,50066,41,236,70852,49228
296,30,3,2,0,3,1,0,30,56,65203,50068,30,103,70855,49228
297,30,2,1,0,3,1,0,199,149,65205,50069,205,139,70858,49228
298,30,4,0,0,3,1,0,142,162,65209,50069,143,156,70861,49228
299,30,4,1,0,3,1,0,209,168,65213,50070,240,134,70864,49228
300,31,0,0,2,1,2,1,142,120,65213,50070,166,147,70865,49229
301,31,2,1,0,3,1,0,368,106,65215,50071,426,248,70868,49229
302,31,0,1,1,0,0,3,212,167,65215,50072,228,281,70868,49232
303,31,0,1,1,0,0,3,278,183,65215,50073,295,24,70868,49235
304,31,3,2,0,3,1,0,234,198,65218,50075,269,52,70871,49235
305,31,2,1,0,3,1,0,198,206,65220,50076,212,29,70874,49235
306,31,0,0,2,1,2,1,305,179,65220,50076,316,170,70875,49236
307,31,2,2,2,1,2,1,314,170,65222,50078,326,126,70876,49237
308,31,1,1,2,1,2,1,375,159,65223,50079,379,138,70877,49238
309,31,3,0,0,3,1,0,169,185,65226,50079,186,156,70880,49238
310,32,2,1,0,3,1,0,38,49,65228,50080,44,353,70883,49238
311,32,1,0,0,3,1,0,346,166,65229,50080,353,168,70886,49238
312,32,1,0,0,3,1,0,281,148,65230,50080,334,236,70889,49238
313,32,1,1,2,1,2,1,200,150,65231,50081,206,119,70890,49239
314,32,0,0,2,1,2,1,278,183,65231,50081,296,135,70891,49240
315,32,2,0,0,3,1,0,214,167,65233,50081,231,138,70894,49240
316,32,0,0,2,1,2,1,142,162,65233,50081,144,104,70895,49241
317,32,1,3,1,0,0,3,169,189,65234,50084,210,297,70895,49244
318,32,1,3,1,0,0,3,31,59,65235,50087,30,248,70895,49247
319,32,0,0,2,1,2,1,209,168,65235,50087,241,53,70896,49248
320,33,1,1,2,1,2,1,143,121,65236,50088,167,249,70897,49249
321,33,1,2,1,0,0,3,315,172,65237,50090,326,159,70897,49252
322,33,1,0,0,3,1,0,199,206,65238,50090,215,24,70900,49252
323,33,3,0,0,3,1,0,172,185,65241,50090,189,139,70903,49252
324,33,1,1,2,1,2,1,235,199,65242,50091,270,127,70904,49253
325,33,2,4,1,0,0,3,92,100,65244,50095,96,32,70904,49256
326,33,0,1,1,0,0,3,234,208,65244,50096,253,150,70904,49259
327,33,2,1,0,3,1,0,370,107,65246,50097,429,221,70907,49259
328,33,1,1,2,1,2,1,306,180,65247,50098,317,282,70908,49260
329,33,1,2,1,0,0,3,376,161,65248,50100,379,173,70908,49263
330,34,3,1,0,3,1,0,175,186,65251,50101,192,53,70911,49263
331,34,3,0,0,3,1,0,349,166,65254,50101,356,119,70914,49263
332,34,1,1,2,1,2,1,307,181,65255,50102,318,354,70915,49264
333,34,0,2,1,0,0,3,31,61,65255,50104,30,300,70915,49267
334,34,1,1,2,1,2,1,39,50,65256,50105,45,139,70916,49268
335,34,1,1,2,1,2,1,170,190,65257,50106,211,105,70917,49269
336,34,1,2,1,0,0,3,215,169,65258,50108,231,239,70917,49272
337,34,2,0,0,3,1,0,202,150,65260,50108,209,249,70920,49272
338,34,2,0,0,3,1,0,211,168,65262,50108,244,168,70923,49272
339,34,0,1,1,0,0,3,278,184,65262,50109,296,130,70923,49275
340,35,1,1,2,1,2,1,371,108,65263,50110,430,151,70924,49276
341,35,0,4,1,0,0,3,170,194,65263,50114,211,35,70924,49279
342,35,0,0,2,1,2,1,235,199,65263,50114,271,249,70925,49280
343,35,1,0,0,3,1,0,93,100,65264,50114,99,221,70928,49280
344,35,1,3,1,0,0,3,316,175,65265,50117,326,176,70928,49283
345,35,2,2,2,1,2,1,144,164,65267,50119,145,25,70929,49284
346,35,3,3,2,1,2,1,146,124,65270,50122,168,140,70930,49285
347,35,1,1,2,1,2,1,235,209,65271,50123,254,283,70931,49286
348,35,2,1,0,3,1,0,378,162,65273,50124,382,119,70934,49286
349,35,2,1,0,3,1,0,283,149,65275,50125,337,135,70937,49286
350,36,2,1,0,3,1,0,213,169,65277,50126,247,139,70940,49286
351,36,1,2,1,0,0,3,200,208,65278,50128,215,242,70940,49289
352,36,0,1,1,0,0,3,278,185,65278,50129,296,252,70940,49292
353,36,3,2,0,3,1,0,205,152,65281,50131,212,130,70943,49292
354,36,1,2,1,0,0,3,216,171,65282,50133,231,56,70943,49295
355,36,1,3,1,0,0,3,32,64,65283,50136,30,171,70943,49298
356,36,1,2,1,0,0,3,40,52,65284,50138,45,303,70943,49301
357,36,2,0,0,3,1,0,351,166,65286,50138,359,354,70946,49301
358,36,4,1,0,3,1,0,179,187,65290,50139,195,105,70949,49301
359,36,2,0,0,3,1,0,309,181,65292,50139,321,159,70952,49301
360,37,3,2,0,3,1,0,238,201,65295,50141,274,35,70955,49301
361,37,1,1,2,1,2,1,236,210,65296,50142,255,120,70956,49302
362,37,0,0,2,1,2,1,144,164,65296,50142,146,284,70957,49303
363,37,0,0,2,1,2,1,170,194,65296,50142,212,141,70958,49304
364,37,1,0,0,3,1,0,147,124,65297,50142,171,221,70961,49304
365,37,4,1,0,3,1,0,97,101,65301,50143,102,151,70964,49304
366,37,2,0,0,3,1,0,285,149,65303,50143,340,25,70967,49304
367,37,1,1,2,1,2,1,372,109,65304,50144,431,177,70968,49305
368,37,4,1,0,3,1,0,382,163,65308,50145,385,249,70971,49305
369,37,3,3,2,1,2,1,319,178,65311,50148,327,136,70972,49306
370,38,0,0,2,1,2,1,32,64,65311,50148,31,160,70973,49307
371,38,3,2,0,3,1,0,182,189,65314,50150,198,303,70976,49307
372,38,3,1,0,3,1,0,208,153,65317,50151,215,242,70979,49307
373,38,2,0,0,3,1,0,218,171,65319,50151,234,354,70982,49307
374,38,2,1,0,3,1,0,311,182,65321,50152,324,56,70985,49307
375,38,0,0,2,1,2,1,278,185,65321,50152,297,140,70986,49308
376,38,2,3,1,0,0,3,42,55,65323,50155,45,255,70986,49311
377,38,2,1,0,3,1,0,353,167,65325,50156,362,105,70989,49311
378,38,3,1,0,3,1,0,216,170,65328,50157,250,130,70992,49311
379,38,1,2,1,0,0,3,201,210,65329,50159,215,174,70992,49314
0,1,0,1,1,0,0,3,147,125,65329,50160,171,357,70992,49317
1,1,3,4,1,0,0,3,281,189,65332,50164,297,306,70992,49320
2,1,1,0,0,3,1,0,239,201,65333,50164,277,255,70995,49320
3,1,3,3,2,1,2,1,356,170,65336,50167,363,141,70996,49321
4,1,0,1,1,0,0,3,201,211,65336,50168,215,12,70996,49324
5,1,0,3,1,0,0,3,218,174,65336,50171,234,245,70996,49327
6,1,2,3,1,0,0,3,44,58,65338,50174,45,180,70996,49330
7,1,2,1,0,3,1,0,210,154,65340,50175,218,130,70999,49330
8,1,1,1,2,1,2,1,98,124,65341,50176,94,137,71000,49331
9,1,4,0,0,3,1,0,315,182,65345,50176,327,36,71003,49331
10,2,1,0,0,3,1,0,183,189,65346,50176,201,35,71006,49331
11,2,1,0,0,3,1,0,286,149,65347,50176,343,12,71009,49331
12,2,4,3,0,3,1,0,376,112,65351,50179,434,306,71012,49331
13,2,1,1,2,1,2,1,320,179,65352,50180,328,285,71013,49332
14,2,2,3,1,0,0,3,218,173,65354,50183,250,154,71013,49335
15,2,1,2,1,0,0,3,202,213,65355,50185,215,252,71013,49338
16,2,2,1,0,3,1,0,238,211,65357,50186,258,221,71016,49338
17,2,0,1,1,0,0,3,50,59,65357,50187,41,63,71016,49341
18,2,4,1,0,3,1,0,148,165,65361,50188,149,141,71019,49341
19,2,1,3,1,0,0,3,240,204,65362,50191,277,108,71019,49344
20,3,0,0,2,1,2,1,281,189,65362,50191,298,358,71020,49345
21,3,2,0,0,3,1,0,384,163,65364,50191,388,141,71023,49345
22,3,1,0,0,3,1,0,316,182,65365,50191,330,174,71026,49345
23,3,1,2,1,0,0,3,239,213,65366,50193,258,183,71026,49348
24,3,3,4,1,0,0,3,25,28,65369,50197,23,140,71026,49351
25,3,1,3,1,0,0,3,148,128,65370,50200,171,123,71026,49354
26,3,2,1,0,3,1,0,46,59,65372,50201,48,245,71029,49354
27,3,4,2,0,3,1,0,360,172,65376,50203,366,130,71032,49354
28,3,0,1,1,0,0,3,98,125,65376,50204,94,258,71032,49357
29,3,1,2,1,0,0,3,211,156,65377,50206,218,39,71032,49360
30,4,3,1,0,3,1,0,205,214,65380,50207,218,141,71035,49360
31,4,0,1,1,0,0,3,240,205,65380,50208,277,15,71035,49363
32,4,2,1,0,3,1,0,378,113,65382,50209,437,63,71038,49363
33,4,0,2,1,0,0,3,286,151,65382,50211,343,255,71038,49366
34,4,3,0,0,3,1,0,151,165,65385,50211,152,35,71041,49366
35,4,1,2,1,0,0,3,184,191,65386,50213,201,288,71041,49369
36,4,1,4,1,0,0,3,51,63,65387,50217,41,309,71041,49372
37,4,1,0,0,3,1,0,219,174,65388,50217,237,154,71044,49372
38,4,2,2,2,1,2,1,220,175,65390,50219,251,222,71045,49373
39,4,2,0,0,3,1,0,322,179,65392,50219,331,108,71048,49373
40,5,0,0,2,1,2,1,98,125,65392,50219,95,175,71049,49374
41,5,1,2,1,0,0,3,26,30,65393,50221,23,361,71049,49377
42,5,0,2,1,0,0,3,360,174,65393,50223,366,186,71049,49380
43,5,2,1,0,3,1,0,283,190,65395,50224,301,141,71052,49380
44,5,0,0,2,1,2,1,239,213,65395,50224,259,141,71053,49381
45,5,1,0,0,3,1,0,317,182,65396,50224,333,245,71056,49381
46,5,0,1,1,0,0,3,384,164,65396,50225,388,126,71056,49384
47,5,1,0,0,3,1,0,149,128,65397,50225,174,130,71059,49384
48,5,1,3,1,0,0,3,47,62,65398,50228,48,42,71059,49387
49,5,2,1,0,3,1,0,213,157,65400,50229,221,258,71062,49387
50,6,2,0,0,3,1,0,380,113,65402,50229,440,35,71065,49387
51,6,1,3,1,0,0,3,220,177,65403,50232,237,258,71065,49390
52,6,1,4,1,0,0,3,152,169,65404,50236,152,189,71065,49393
53,6,2,1,0,3,1,0,386,165,65406,50237,391,15,71068,49393
54,6,4,0,0,3,1,0,326,179,65410,50237,334,141,71071,49393
55,6,0,1,1,0,0,3,51,64,65410,50238,41,291,71071,49396
56,6,1,0,0,3,1,0,241,205,65411,50238,280,141,71074,49396
57,6,1,1,2,1,2,1,206,215,65412,50239,219,64,71075,49397
58,6,1,3,1,0,0,3,287,154,65413,50242,343,225,71075,49400
59,6,3,2,0,3,1,0,152,130,65416,50244,177,154,71078,49400
60,7,1,0,0,3,1,0,48,62,65417,50244,51,108,71081,49400
61,7,2,0,0,3,1,0,100,125,65419,50244,98,141,71084,49400
62,7,1,2,1,0,0,3,240,215,65420,50246,259,261,71084,49403
63,7,1,0,0,3,1,0,284,190,65421,50246,304,175,71087,49403
64,7,1,1,2,1,2,1,361,175,65422,50247,367,127,71088,49404
65,7,3,1,0,3,1,0,223,176,65425,50248,254,42,71091,49404
66,7,2,2,2,1,2,1,186,193,65427,50250,202,246,71092,49405
67,7,0,0,2,1,2,1,213,157,65427,50250,222,310,71093,49406
68,7,1,2,1,0,0,3,318,184,65428,50252,333,364,71093,49409
69,7,0,2,1,0,0,3,26,32,65428,50254,23,133,71093,49412
70,8,3,3,2,1,2,1,329,182,65431,50257,335,190,71094,49413
71,8,2,0,0,3,1,0,388,165,65433,50257,394,64,71097,49413
72,8,2,1,0,3,1,0,382,114,65435,50258,443,141,71100,49413
73,8,3,4,1,0,0,3,155,173,65438,50262,152,261,71100,49416
74,8,2,0,0,3,1,0,208,215,65440,50262,222,35,71103,49416
75,8,0,0,2,1,2,1,220,177,65440,50262,238,292,71104,49417
76,8,1,0,0,3,1,0,242,205,65441,50262,283,154,71107,49417
77,8,5,1,0,3,1,0,157,131,65446,50263,180,141,71110,49417
78,8,2,2,2,1,2,1,289,156,65448,50265,344,43,71111,49418
79,8,0,0,2,1,2,1,26,32,65448,50265,24,226,71112,49419
80,9,0,1,1,0,0,3,100,126,65448,50266,98,136,71112,49422
81,9,1,1,2,1,2,1,52,65,65449,50267,42,365,71113,49423
82,9,2,2,2,1,2,1,320,186,65451,50269,334,109,71114,49424
83,9,3,1,0,3,1,0,243,216,65454,50270,262,15,71117,49424
84,9,2,1,0,3,1,0,188,194,65456,50271,205,141,71120,49424
85,9,7,1,0,3,1,0,230,177,65463,50272,257,175,71123,49424
86,9,1,1,2,1,2,1,49,63,65464,50273,52,311,71124,49425
87,9,1,1,2,1,2,1,214,158,65465,50274,223,128,71125,49426
88,9,2,1,0,3,1,0,363,176,65467,50275,370,261,71128,49426
89,9,1,2,1,0,0,3,285,192,65468,50277,304,249,71128,49429
90,10,0,1,1,0,0,3,157,132,65468,50278,180,67,71128,49432
91,10,1,2,1,0,0,3,27,34,65469,50280,24,264,71128,49435
92,10,2,2,2,1,2,1,390,167,65471,50282,395,191,71129,49436
93,10,3,2,0,3,1,0,211,217,65474,50284,225,141,71132,49436
94,10,2,1,0,3,1,0,384,115,65476,50285,446,141,71135,49436
95,10,4,0,0,3,1,0,333,182,65480,50285,338,154,71138,49436
96,10,1,1,2,1,2,1,221,178,65481,50286,239,44,71139,49437
97,10,1,2,1,0,0,3,156,175,65482,50288,152,229,71139,49440
98,10,0,4,1,0,0,3,242,209,65482,50292,283,295,71139,49443
99,10,1,0,0,3,1,0,290,156,65483,50292,347,35,71142,49443
100,11,2,1,0,3,1,0,365,177,65485,50293,373,311,71145,49443
101,11,1,2,1,0,0,3,189,196,65486,50295,205,267,71145,49446
102,11,0,1,1,0,0,3,214,159,65486,50296,223,368,71145,49449
103,11,0,2,1,0,0,3,230,179,65486,50298,257,131,71145,49452
104,11,1,3,1,0,0,3,244,219,65487,50301,262,178,71145,49455
105,11,2,2,2,1,2,1,54,67,65489,50303,43,137,71146,49456
106,11,2,1,0,3,1,0,102,127,65491,50304,101,15,71149,49456
107,11,1,1,2,1,2,1,286,193,65492,50305,305,110,71150,49457
108,11,1,2,1,0,0,3,291,158,65493,50307,347,252,71150,49460
109,11,0,1,1,0,0,3,49,64,65493,50308,52,144,71150,49463
110,12,3,1,0,3,1,0,159,176,65496,50309,155,141,71153,49463
111,12,0,4,1,0,0,3,27,38,65496,50313,24,157,71153,49466
112,12,2,1,0,3,1,0,322,187,65498,50314,337,67,71156,49466
113,12,0,0,2,1,2,1,390,167,65498,50314,396,142,71157,49467
114,12,5,2,0,3,1,0,216,219,65503,50316,228,229,71160,49467
115,12,4,2,0,3,1,0,337,184,65507,50318,341,44,71163,49467
116,12,0,0,2,1,2,1,221,178,65507,50318,240,192,71164,49468
117,12,0,0,2,1,2,1,242,209,65507,50318,284,36,71165,49469
118,12,2,0,0,3,1,0,159,132,65509,50318,183,295,71168,49469
119,12,1,0,0,3,1,0,385,115,65510,50318,449,261,71171,49469
120,13,1,3,1,0,0,3,231,182,65511,50321,257,371,71171,49472
121,13,1,1,2,1,2,1,292,159,65512,50322,348,312,71172,49473
122,13,0,3,1,0,0,3,214,162,65512,50325,223,270,71172,49476
123,13,2,2,2,1,2,1,191,198,65514,50327,206,111,71173,49477
124,13,3,0,0,3,1,0,368,177,65517,50327,376,15,71176,49477
125,13,1,2,1,0,0,3,160,178,65518,50329,155,255,71176,49480
126,13,1,0,0,3,1,0,103,127,65519,50329,104,229,71179,49480
127,13,2,1,0,3,1,0,223,179,65521,50330,243,178,71182,49480
128,13,2,2,2,1,2,1,56,69,65523,50332,44,132,71183,49481
129,13,1,1,2,1,2,1,50,65,65524,50333,53,143,71184,49482
130,14,0,3,1,0,0,3,27,41,65524,50336,24,195,71184,49485
131,14,0,1,1,0,0,3,244,220,65524,50337,262,160,71184,49488
132,14,0,1,1,0,0,3,286,194,65524,50338,305,47,71184,49491
133,14,2,2,2,1,2,1,387,117,65526,50340,450,138,71185,49492
134,14,2,1,0,3,1,0,324,188,65528,50341,340,36,71188,49492
135,14,3,0,0,3,1,0,340,184,65531,50341,344,178,71191,49492
136,14,0,1,1,0,0,3,159,133,65531,50342,183,264,71191,49495
137,14,1,2,1,0,0,3,391,169,65532,50344,396,144,71191,49498
138,14,1,3,1,0,0,3,104,130,65533,50347,104,298,71191,49501
139,14,4,3,0,3,1,0,220,222,65537,50350,231,144,71194,49501
140,15,0,0,2,1,2,1,324,188,65537,50350,341,299,71195,49502
141,15,3,2,0,3,1,0,234,184,65540,50352,260,67,71198,49502
142,15,1,1,2,1,2,1,243,210,65541,50353,285,313,71199,49503
143,15,3,1,0,3,1,0,343,185,65544,50354,347,371,71202,49503
144,15,2,2,2,1,2,1,58,71,65546,50356,45,144,71203,49504
145,15,2,2,2,1,2,1,162,180,65548,50358,156,133,71204,49505
146,15,0,1,1,0,0,3,50,66,65548,50359,53,18,71204,49508
147,15,2,1,0,3,1,0,216,163,65550,50360,226,229,71207,49508
148,15,0,1,1,0,0,3,223,180,65550,50361,243,114,71207,49511
149,15,2,3,1,0,0,3,193,201,65552,50364,206,267,71207,49514
150,16,3,0,0,3,1,0,30,41,65555,50364,27,47,71210,49514
151,16,1,2,1,0,0,3,392,171,65556,50366,396,117,71210,49517
152,16,0,1,1,0,0,3,244,221,65556,50367,262,147,71210,49520
153,16,3,3,2,1,2,1,107,133,65559,50370,105,161,71211,49521
154,16,0,0,2,1,2,1,292,159,65559,50370,349,139,71212,49522
155,16,2,1,0,3,1,0,195,202,65561,50371,209,195,71215,49522
156,16,3,1,0,3,1,0,390,118,65564,50372,453,178,71218,49522
157,16,3,1,0,3,1,0,371,178,65567,50373,379,36,71221,49522
158,16,1,1,2,1,2,1,287,195,65568,50374,306,271,71222,49523
159,16,1,2,1,0,0,3,221,224,65569,50376,231,258,71222,49526
160,17,1,2,1,0,0,3,224,182,65570,50378,243,374,71222,49529
161,17,1,4,1,0,0,3,288,199,65571,50382,306,302,71222,49532
162,17,2,1,0,3,1,0,245,211,65573,50383,288,133,71225,49532
163,17,4,0,0,3,1,0,328,188,65577,50383,344,144,71228,49532
164,17,1,2,1,0,0,3,217,165,65578,50385,226,39,71228,49535
165,17,5,0,0,3,1,0,239,184,65583,50385,263,267,71231,49535
166,17,2,3,1,0,0,3,60,74,65585,50388,45,147,71231,49538
167,17,1,1,2,1,2,1,160,134,65586,50389,184,19,71232,49539
168,17,1,2,1,0,0,3,163,182,65587,50391,156,316,71232,49542
169,17,0,0,2,1,2,1,343,185,65587,50391,348,68,71233,49543
170,18,1,2,1,0,0,3,31,43,65588,50393,27,261,71233,49546
171,18,0,2,1,0,0,3,50,68,65588,50395,53,71,71233,49549
172,18,2,1,0,3,1,0,246,222,65590,50396,265,139,71236,49549
173,18,0,2,1,0,0,3,371,180,65590,50398,379,164,71236,49552
174,18,1,1,2,1,2,1,196,203,65591,50399,210,230,71237,49553
175,18,0,0,2,1,2,1,292,159,65591,50399,350,148,71238,49554
176,18,5,0,0,3,1,0,244,184,65596,50399,266,117,71241,49554
177,18,4,0,0,3,1,0,394,118,65600,50399,456,133,71244,49554
178,18,0,1,1,0,0,3,60,75,65600,50400,45,181,71244,49557
179,18,1,3,1,0,0,3,393,174,65601,50403,396,274,71244,49560
180,19,0,2,1,0,0,3,221,226,65601,50405,231,270,71244,49563
181,19,1,0,0,3,1,0,344,185,65602,50405,351,316,71247,49563
182,19,1,1,2,1,2,1,329,189,65603,50406,345,196,71248,49564
183,19,3,0,0,3,1,0,248,211,65606,50406,291,139,71251,49564
184,19,1,0,0,3,1,0,289,199,65607,50406,309,39,71254,49564
185,19,5,1,0,3,1,0,229,183,65612,50407,246,19,71257,49564
186,19,1,0,0,3,1,0,218,165,65613,50407,229,147,71260,49564
187,19,2,1,0,3,1,0,109,134,65615,50408,108,144,71263,49564
188,19,1,2,1,0,0,3,372,182,65616,50410,379,377,71263,49567
189,19,2,0,0,3,1,0,162,134,65618,50410,187,47,71266,49567
190,20,5,1,0,3,1,0,349,186,65623,50411,354,148,71269,49567
191,20,2,1,0,3,1,0,165,183,65625,50412,159,164,71272,49567
192,20,0,2,1,0,0,3,393,176,65625,50414,396,233,71272,49570
193,20,3,2,0,3,1,0,295,161,65628,50416,353,181,71275,49570
194,20,1,1,2,1,2,1,197,204,65629,50417,211,72,71276,49571
195,20,2,2,2,1,2,1,33,45,65631,50419,28,134,71277,49572
196,20,1,1,2,1,2,1,61,76,65632,50420,46,275,71278,49573
197,20,1,3,1,0,0,3,247,225,65633,50423,265,305,71278,49576
198,20,2,1,0,3,1,0,396,119,65635,50424,459,117,71281,49576
199,20,1,2,1,0,0,3,245,186,65636,50426,266,42,71281,49579
200,21,0,1,1,0,0,3,33,46,65636,50427,28,273,71281,49582
201,21,1,3,1,0,0,3,51,71,65637,50430,53,150,71281,49585
202,21,0,0,2,1,2,1,289,199,65637,50430,310,145,71282,49586
203,21,0,7,1,0,0,3,218,172,65637,50437,229,199,71282,49589
204,21,1,1,2,1,2,1,330,190,65638,50438,346,135,71283,49590
205,21,2,0,0,3,1,0,164,134,65640,50438,190,181,71286,49590
206,21,0,0,2,1,2,1,229,183,65640,50438,247,140,71287,49591
207,21,3,0,0,3,1,0,112,134,65643,50438,111,47,71290,49591
208,21,1,1,2,1,2,1,373,183,65644,50439,380,262,71291,49592
209,21,2,1,0,3,1,0,395,177,65646,50440,399,377,71294,49592
210,22,2,1,0,3,1,0,199,205,65648,50441,214,19,71297,49592
211,22,2,2,2,1,2,1,223,228,65650,50443,232,118,71298,49593
212,22,4,2,0,3,1,0,169,185,65654,50445,162,305,71301,49593
213,22,3,0,0,3,1,0,399,119,65657,50445,462,233,71304,49593
214,22,1,1,2,1,2,1,296,162,65658,50446,354,73,71305,49594
215,22,2,2,2,1,2,1,247,188,65660,50448,267,146,71306,49595
216,22,5,1,0,3,1,0,354,187,65665,50449,357,42,71309,49595
217,22,4,0,0,3,1,0,65,76,65669,50449,49,164,71312,49595
218,22,0,2,1,0,0,3,248,213,65669,50451,291,278,71312,49598
219,22,2,4,1,0,0,3,231,187,65671,50455,247,319,71312,49601
220,23,2,3,1,0,0,3,375,186,65673,50458,380,153,71312,49604
221,23,1,2,1,0,0,3,290,201,65674,50460,310,202,71312,49607
222,23,1,3,1,0,0,3,219,175,65675,50463,229,151,71312,49610
223,23,2,1,0,3,1,0,114,135,65677,50464,114,377,71315,49610
224,23,1,2,1,0,0,3,52,73,65678,50466,53,143,71315,49613
225,23,1,1,2,1,2,1,34,47,65679,50467,29,182,71316,49614
226,23,1,0,0,3,1,0,248,225,65680,50467,268,135,71319,49614
227,23,2,3,1,0,0,3,397,180,65682,50470,399,50,71319,49617
228,23,0,1,1,0,0,3,164,135,65682,50471,190,265,71319,49620
229,23,4,2,0,3,1,0,334,192,65686,50473,349,273,71322,49620
230,24,2,1,0,3,1,0,67,77,65688,50474,52,42,71325,49620
231,24,0,3,1,0,0,3,199,208,65688,50477,214,149,71325,49623
232,24,2,1,0,3,1,0,249,189,65690,50478,270,305,71328,49623
233,24,0,0,2,1,2,1,248,213,65690,50478,292,74,71329,49624
234,24,2,0,0,3,1,0,401,119,65692,50478,465,19,71332,49624
235,24,1,5,1,0,0,3,232,192,65693,50483,247,236,71332,49627
236,24,0,1,1,0,0,3,169,186,65693,50484,162,121,71332,49630
237,24,0,1,1,0,0,3,223,229,65693,50485,232,322,71332,49633
238,24,2,1,0,3,1,0,356,188,65695,50486,360,278,71335,49633
239,24,1,0,0,3,1,0,297,162,65696,50486,357,164,71338,49633
240,25,1,2,1,0,0,3,35,49,65697,50488,29,325,71338,49636
241,25,1,1,2,1,2,1,200,209,65698,50489,215,183,71339,49637
242,25,1,2,1,0,0,3,53,75,65699,50491,53,380,71339,49640
243,25,1,1,2,1,2,1,291,202,65700,50492,311,274,71340,49641
244,25,2,3,1,0,0,3,250,228,65702,50495,268,268,71340,49644
245,25,4,0,0,3,1,0,379,186,65706,50495,383,50,71343,49644
246,25,1,1,2,1,2,1,220,176,65707,50496,230,122,71344,49645
247,25,2,1,0,3,1,0,116,136,65709,50497,117,135,71347,49645
248,25,4,1,0,3,1,0,253,190,65713,50498,273,143,71350,49645
249,25,2,1,0,3,1,0,336,193,65715,50499,352,151,71353,49645
250,26,2,0,0,3,1,0,358,188,65717,50499,363,153,71356,49645
251,26,2,1,0,3,1,0,399,181,65719,50500,402,164,71359,49645
252,26,2,7,1,0,0,3,69,84,65721,50507,52,205,71359,49648
253,26,3,4,1,0,0,3,226,233,65724,50511,232,308,71359,49651
254,26,0,1,1,0,0,3,164,136,65724,50512,190,45,71359,49654
255,26,1,2,1,0,0,3,298,164,65725,50514,357,152,71359,49657
256,26,2,1,0,3,1,0,234,193,65727,50515,250,74,71362,49657
257,26,0,0,2,1,2,1,248,213,65727,50515,293,237,71363,49658
258,26,2,0,0,3,1,0,403,119,65729,50515,468,278,71366,49658
259,26,3,0,0,3,1,0,172,186,65732,50515,165,19,71369,49658
260,27,1,4,1,0,0,3,70,88,65733,50519,52,277,71369,49661
261,27,1,1,2,1,2,1,292,203,65734,50520,312,20,71370,49662
262,27,0,2,1,0,0,3,200,211,65734,50522,215,383,71370,49665
263,27,0,1,1,0,0,3,53,76,65734,50523,53,138,71370,49668
264,27,0,2,1,0,0,3,116,138,65734,50525,117,328,71370,49671
265,27,1,4,1,0,0,3,251,232,65735,50529,268,125,71370,49674
266,27,1,0,0,3,1,0,221,176,65736,50529,233,183,71373,49674
267,27,3,3,2,1,2,1,339,196,65739,50532,353,144,71374,49675
268,27,2,1,0,3,1,0,381,187,65741,50533,386,151,71377,49675
269,27,3,2,0,3,1,0,256,192,65744,50535,276,268,71380,49675
270,28,4,0,0,3,1,0,407,119,65748,50535,471,50,71383,49675
271,28,2,2,2,1,2,1,37,51,65750,50537,30,153,71384,49676
272,28,4,2,0,3,1,0,230,235,65754,50539,235,164,71387,49676
273,28,2,1,0,3,1,0,360,189,65756,50540,366,237,71390,49676
274,28,2,0,0,3,1,0,300,164,65758,50540,360,308,71393,49676
275,28,3,1,0,3,1,0,402,182,65761,50541,405,45,71396,49676
276,28,1,2,1,0,0,3,235,195,65762,50543,250,156,71396,49679
277,28,3,3,2,1,2,1,175,189,65765,50546,166,75,71397,49680
278,28,2,3,1,0,0,3,250,216,65767,50549,293,208,71397,49683
279,28,1,2,1,0,0,3,165,138,65768,50551,190,281,71397,49686
280,29,1,2,1,0,0,3,222,178,65769,50553,233,271,71397,49689
281,29,1,3,1,0,0,3,252,235,65770,50556,268,386,71397,49692
282,29,1,1,2,1,2,1,201,212,65771,50557,216,139,71398,49693
283,29,6,0,0,3,1,0,345,196,65777,50557,356,20,71401,49693
284,29,1,3,1,0,0,3,293,206,65778,50560,312,147,71401,49696
285,29,1,2,1,0,0,3,71,90,65779,50562,52,154,71401,49699
286,29,2,2,2,1,2,1,55,78,65781,50564,54,278,71402,49700
287,29,3,2,0,3,1,0,119,140,65784,50566,120,125,71405,49700
288,29,2,0,0,3,1,0,258,192,65786,50566,279,328,71408,49700
289,29,0,2,1,0,0,3,381,189,65786,50568,386,186,71408,49703
290,30,4,1,0,3,1,0,411,120,65790,50569,474,164,71411,49703
291,30,4,2,0,3,1,0,179,191,65794,50571,169,50,71414,49703
292,30,0,3,1,0,0,3,360,192,65794,50574,366,281,71414,49706
293,30,1,2,1,0,0,3,346,198,65795,50576,356,159,71414,49709
294,30,2,0,0,3,1,0,39,51,65797,50576,33,75,71417,49709
295,30,0,1,1,0,0,3,230,236,65797,50577,235,211,71417,49712
296,30,1,2,1,0,0,3,166,140,65798,50579,190,240,71417,49715
297,30,3,0,0,3,1,0,238,195,65801,50579,253,45,71420,49715
298,30,2,2,2,1,2,1,252,218,65803,50581,294,154,71421,49716
299,30,2,1,0,3,1,0,404,183,65805,50582,408,308,71424,49716
300,31,2,1,0,3,1,0,73,91,65807,50583,55,271,71427,49716
301,31,4,2,0,3,1,0,304,166,65811,50585,363,386,71430,49716
302,31,0,0,2,1,2,1,293,206,65811,50585,313,140,71431,49717
303,31,1,2,1,0,0,3,253,237,65812,50587,268,331,71431,49720
304,31,2,1,0,3,1,0,383,190,65814,50588,389,125,71434,49720
305,31,2,0,0,3,1,0,260,192,65816,50588,282,154,71437,49720
306,31,1,2,1,0,0,3,202,214,65817,50590,216,150,71437,49723
307,31,3,1,0,3,1,0,225,179,65820,50591,236,20,71440,49723
308,31,0,3,1,0,0,3,55,81,65820,50594,54,189,71440,49726
309,31,2,2,2,1,2,1,121,142,65822,50596,121,282,71441,49727
310,32,1,2,1,0,0,3,361,194,65823,50598,366,153,71441,49730
311,32,0,3,1,0,0,3,39,54,65823,50601,33,311,71441,49733
312,32,2,2,2,1,2,1,413,122,65825,50603,475,212,71442,49734
313,32,2,0,0,3,1,0,255,237,65827,50603,271,45,71445,49734
314,32,0,0,2,1,2,1,230,236,65827,50603,236,51,71446,49735
315,32,1,1,2,1,2,1,294,207,65828,50604,314,76,71447,49736
316,32,2,2,2,1,2,1,168,142,65830,50606,191,160,71448,49737
317,32,1,3,1,0,0,3,253,221,65831,50609,294,157,71448,49740
318,32,2,2,2,1,2,1,406,185,65833,50611,409,282,71449,49741
319,32,3,1,0,3,1,0,349,199,65836,50612,359,164,71452,49741
320,33,6,2,0,3,1,0,266,194,65842,50614,285,20,71455,49741
321,33,3,1,0,3,1,0,307,167,65845,50615,366,125,71458,49741
322,33,1,1,2,1,2,1,203,215,65846,50616,217,332,71459,49742
323,33,3,0,0,3,1,0,241,195,65849,50616,256,140,71462,49742
324,33,2,1,0,3,1,0,385,191,65851,50617,392,76,71465,49742
325,33,1,3,1,0,0,3,74,94,65852,50620,55,243,71465,49745
326,33,3,3,2,1,2,1,182,194,65855,50623,170,387,71466,49746
327,33,0,0,2,1,2,1,253,221,65855,50623,295,272,71467,49747
328,33,3,0,0,3,1,0,228,179,65858,50623,239,154,71470,49747
329,33,0,4,1,0,0,3,55,85,65858,50627,54,285,71470,49750
330,34,1,1,2,1,2,1,122,143,65859,50628,122,213,71471,49751
331,34,1,1,2,1,2,1,231,237,65860,50629,237,154,71472,49752
332,34,5,1,0,3,1,0,312,168,65865,50630,369,160,71475,49752
333,34,2,3,1,0,0,3,170,145,65867,50633,191,160,71475,49755
334,34,2,1,0,3,1,0,41,55,65869,50634,36,45,71478,49755
335,34,2,0,0,3,1,0,296,207,65871,50634,317,164,71481,49755
336,34,2,1,0,3,1,0,257,238,65873,50635,274,51,71484,49755
337,34,2,1,0,3,1,0,408,186,65875,50636,412,189,71487,49755
338,34,2,2,2,1,2,1,387,193,65877,50638,393,286,71488,49756
339,34,2,1,0,3,1,0,415,123,65879,50639,478,272,71491,49756
340,35,1,0,0,3,1,0,267,194,65880,50639,288,160,71494,49756
341,35,1,2,1,0,0,3,183,196,65881,50641,170,285,71494,49759
342,35,2,1,0,3,1,0,172,146,65883,50642,194,332,71497,49759
343,35,0,0,2,1,2,1,349,199,65883,50642,360,244,71498,49760
344,35,3,1,0,3,1,0,77,95,65886,50643,58,20,71501,49760
345,35,1,2,1,0,0,3,242,197,65887,50645,256,157,71501,49763
346,35,1,6,1,0,0,3,56,91,65888,50651,54,314,71501,49766
347,35,1,1,2,1,2,1,229,180,65889,50652,240,77,71502,49767
348,35,2,1,0,3,1,0,255,222,65891,50653,298,387,71505,49767
349,35,2,1,0,3,1,0,363,195,65893,50654,369,140,71508,49767
350,36,1,1,2,1,2,1,313,169,65894,50655,370,214,71509,49768
351,36,1,2,1,0,0,3,42,57,65895,50657,36,128,71509,49771
352,36,0,3,1,0,0,3,257,241,65895,50660,274,289,71509,49774
353,36,2,0,0,3,1,0,410,186,65897,50660,415,154,71512,49774
354,36,3,2,0,3,1,0,206,217,65900,50662,220,51,71515,49774
355,36,2,1,0,3,1,0,389,194,65902,50663,396,244,71518,49774
356,36,0,1,1,0,0,3,231,238,65902,50664,237,192,71518,49777
357,36,1,1,2,1,2,1,57,92,65903,50665,55,165,71519,49778
358,36,1,5,1,0,0,3,123,148,65904,50670,122,275,71519,49781
359,36,2,0,0,3,1,0,417,123,65906,50670,481,160,71522,49781
360,37,1,2,1,0,0,3,173,148,65907,50672,194,217,71522,49784
361,37,2,0,0,3,1,0,351,199,65909,50672,363,332,71525,49784
362,37,2,0,0,3,1,0,365,195,65911,50672,372,20,71528,49784
363,37,1,4,1,0,0,3,243,201,65912,50676,256,288,71528,49787
364,37,5,0,0,3,1,0,188,196,65917,50676,173,157,71531,49787
365,37,1,2,1,0,0,3,256,224,65918,50678,298,54,71531,49790
366,37,3,0,0,3,1,0,126,148,65921,50678,125,45,71534,49790
367,37,2,0,0,3,1,0,233,238,65923,50678,240,387,71537,49790
368,37,4,0,0,3,1,0,300,207,65927,50678,320,160,71540,49790
369,37,2,3,1,0,0,3,231,183,65929,50681,240,317,71540,49793
370,38,1,1,2,1,2,1,43,58,65930,50682,37,161,71541,49794
371,38,3,0,0,3,1,0,316,169,65933,50682,373,140,71544,49794
372,38,0,2,1,0,0,3,267,196,65933,50684,288,292,71544,49797
373,38,1,3,1,0,0,3,418,126,65934,50687,481,320,71544,49800
374,38,3,1,0,3,1,0,413,187,65937,50688,418,275,71547,49800
375,38,1,3,1,0,0,3,58,95,65938,50691,55,247,71547,49803
376,38,1,1,2,1,2,1,207,218,65939,50692,221,166,71548,49804
377,38,3,0,0,3,1,0,260,241,65942,50692,277,77,71551,49804
378,38,3,4,1,0,0,3,80,99,65945,50696,58,131,71551,49807
379,38,0,1,1,0,0,3,188,197,65945,50697,173,195,71551,49810
0,1,1,0,0,3,1,0,301,207,65946,50697,323,166,71554,49810
1,1,3,0,0,3,1,0,129,148,65949,50697,128,320,71557,49810
2,1,0,2,1,0,0,3,173,150,65949,50699,194,335,71557,49813
3,1,4,1,0,3,1,0,264,242,65953,50700,280,23,71560,49813
4,1,1,1,2,1,2,1,189,198,65954,50701,174,141,71561,49814
5,1,3,0,0,3,1,0,421,126,65957,50701,484,161,71564,49814
6,1,2,0,0,3,1,0,318,169,65959,50701,376,160,71567,49814
7,1,2,5,1,0,0,3,25,45,65961,50706,17,295,71567,49817
8,1,0,2,1,0,0,3,256,226,65961,50708,298,3,71567,49820
9,1,1,4,1,0,0,3,366,199,65962,50712,372,220,71567,49823
10,2,2,4,1,0,0,3,233,187,65964,50716,240,223,71567,49826
11,2,2,3,1,0,0,3,245,204,65966,50719,256,7,71567,49829
12,2,0,2,1,0,0,3,233,240,65966,50721,240,278,71567,49832
13,2,4,3,0,3,1,0,355,202,65970,50724,366,247,71570,49832
14,2,1,4,1,0,0,3,1,4,65971,50728,0,157,71570,49835
15,2,1,0,0,3,1,0,130,148,65972,50728,131,195,71573,49835
16,2,0,2,1,0,0,3,44,52,65972,50730,46,291,71573,49838
17,2,6,0,0,3,1,0,419,187,65978,50730,421,157,71576,49838
18,2,2,2,2,1,2,1,391,196,65980,50732,397,388,71577,49839
19,2,4,1,0,3,1,0,211,219,65984,50733,224,131,71580,49839
20,3,1,2,1,0,0,3,302,209,65985,50735,323,164,71580,49842
21,3,4,1,0,3,1,0,193,199,65989,50736,177,23,71583,49842
22,3,0,1,1,0,0,3,256,227,65989,50737,298,323,71583,49845
23,3,5,2,0,3,1,0,272,198,65994,50739,291,141,71586,49845
24,3,1,0,0,3,1,0,26,45,65995,50739,20,160,71589,49845
25,3,1,1,2,1,2,1,367,200,65996,50740,373,296,71590,49846
26,3,1,0,0,3,1,0,174,150,65997,50740,197,77,71593,49846
27,3,3,0,0,3,1,0,321,169,66000,50740,379,3,71596,49846
28,3,1,2,1,0,0,3,265,244,66001,50742,280,169,71596,49849
29,3,2,1,0,3,1,0,423,127,66003,50743,487,335,71599,49849
30,4,4,1,0,3,1,0,423,188,66007,50744,424,223,71602,49849
31,4,1,2,1,0,0,3,356,204,66008,50746,366,294,71602,49852
32,4,3,0,0,3,1,0,248,204,66011,50746,259,278,71605,49852
33,4,1,1,2,1,2,1,45,53,66012,50747,47,389,71606,49853
34,4,3,4,1,0,0,3,214,223,66015,50751,224,160,71606,49856
35,4,2,2,2,1,2,1,3,6,66017,50753,1,248,71607,49857
36,4,2,3,1,0,0,3,235,190,66019,50756,240,144,71607,49860
37,4,3,2,0,3,1,0,259,229,66022,50758,301,131,71610,49860
38,4,5,2,0,3,1,0,396,198,66027,50760,400,7,71613,49860
39,4,0,0,2,1,2,1,130,148,66027,50760,132,158,71614,49861
40,5,3,3,2,1,2,1,196,202,66030,50763,178,170,71615,49862
41,5,1,3,1,0,0,3,273,201,66031,50766,291,167,71615,49865
42,5,0,2,1,0,0,3,265,246,66031,50768,280,299,71615,49868
43,5,2,1,0,3,1,0,369,201,66033,50769,376,160,71618,49868
44,5,4,2,0,3,1,0,237,242,66037,50771,243,23,71621,49868
45,5,1,2,1,0,0,3,27,47,66038,50773,20,338,71621,49871
46,5,2,2,2,1,2,1,176,152,66040,50775,198,4,71622,49872
47,5,3,2,0,3,1,0,305,211,66043,50777,326,195,71625,49872
48,5,1,1,2,1,2,1,424,128,66044,50778,488,78,71626,49873
49,5,3,3,2,1,2,1,324,172,66047,50781,380,324,71627,49874
50,6,1,2,1,0,0,3,46,55,66048,50783,47,226,71627,49877
51,6,2,2,2,1,2,1,358,206,66050,50785,367,132,71628,49878
52,6,3,2,0,3,1,0,217,225,66053,50787,227,144,71631,49878
53,6,1,2,1,0,0,3,260,231,66054,50789,301,297,71631,49881
54,6,1,4,1,0,0,3,4,10,66055,50793,1,392,71631,49884
55,6,3,4,1,0,0,3,238,194,66058,50797,240,281,71631,49887
56,6,0,2,1,0,0,3,423,190,66058,50799,424,163,71631,49890
57,6,2,0,0,3,1,0,398,198,66060,50799,403,248,71634,49890
58,6,1,1,2,1,2,1,249,205,66061,50800,260,159,71635,49891
59,6,3,1,0,3,1,0,133,149,66064,50801,135,7,71638,49891
60,7,0,0,2,1,2,1,196,202,66064,50801,179,196,71639,49892
61,7,2,0,0,3,1,0,239,242,66066,50801,246,167,71642,49892
62,7,0,3,1,0,0,3,27,50,66066,50804,20,7,71642,49895
63,7,0,0,2,1,2,1,176,152,66066,50804,199,249,71643,49896
64,7,1,1,2,1,2,1,370,202,66067,50805,377,393,71644,49897
65,7,1,1,2,1,2,1,274,202,66068,50806,292,300,71645,49898
66,7,1,3,1,0,0,3,266,249,66069,50809,280,327,71645,49901
67,7,0,0,2,1,2,1,238,194,66069,50809,241,24,71646,49902
68,7,0,1,1,0,0,3,217,226,66069,50810,227,341,71646,49905
69,7,2,2,2,1,2,1,326,174,66071,50812,381,79,71647,49906
70,8,0,2,1,0,0,3,46,57,66071,50814,47,284,71647,49909
71,8,0,0,2,1,2,1,4,10,66071,50814,2,227,71648,49910
72,8,2,0,0,3,1,0,426,128,66073,50814,491,144,71651,49910
73,8,0,1,1,0,0,3,305,212,66073,50815,326,10,71651,49913
74,8,4,2,0,3,1,0,362,208,66077,50817,370,170,71654,49913
75,8,3,0,0,3,1,0,401,198,66080,50817,406,132,71657,49913
76,8,1,2,1,0,0,3,250,207,66081,50819,260,163,71657,49916
77,8,0,2,1,0,0,3,133,151,66081,50821,135,166,71657,49919
78,8,1,0,0,3,1,0,261,231,66082,50821,304,159,71660,49919
79,8,1,3,1,0,0,3,424,193,66083,50824,424,300,71660,49922
80,9,0,3,1,0,0,3,196,205,66083,50827,179,303,71660,49925
81,9,1,1,2,1,2,1,28,51,66084,50828,21,394,71661,49926
82,9,0,2,1,0,0,3,274,204,66084,50830,292,82,71661,49929
83,9,1,3,1,0,0,3,371,205,66085,50833,377,199,71661,49932
84,9,1,0,0,3,1,0,218,226,66086,50833,230,24,71664,49932
85,9,2,0,0,3,1,0,328,174,66088,50833,384,249,71667,49932
86,9,2,2,2,1,2,1,241,244,66090,50835,247,8,71668,49933
87,9,4,0,0,3,1,0,428,193,66094,50835,427,327,71671,49933
88,9,2,2,2,1,2,1,240,196,66096,50837,242,168,71672,49934
89,9,1,2,1,0,0,3,267,251,66097,50839,280,135,71672,49937
90,10,1,2,1,0,0,3,5,12,66098,50841,2,287,71672,49940
91,10,2,1,0,3,1,0,428,129,66100,50842,494,170,71675,49940
92,10,3,1,0,3,1,0,365,209,66103,50843,373,163,71678,49940
93,10,1,1,2,1,2,1,134,152,66104,50844,136,145,71679,49941
94,10,0,0,2,1,2,1,176,152,66104,50844,200,11,71680,49942
95,10,0,0,2,1,2,1,401,198,66104,50844,407,167,71681,49943
96,10,0,4,1,0,0,3,46,61,66104,50848,47,344,71681,49946
97,10,1,2,1,0,0,3,251,209,66105,50850,260,303,71681,49949
98,10,1,1,2,1,2,1,306,213,66106,50851,327,160,71682,49950
99,10,1,1,2,1,2,1,262,232,66107,50852,305,228,71683,49951
100,11,1,0,0,3,1,0,197,205,66108,50852,182,11,71686,49951
101,11,4,1,0,3,1,0,50,62,66112,50853,50,8,71689,49951
102,11,2,3,1,0,0,3,242,199,66114,50856,242,202,71689,49954
103,11,1,2,1,0,0,3,372,207,66115,50858,377,85,71689,49957
104,11,1,3,1,0,0,3,242,247,66116,50861,247,306,71689,49960
105,11,3,0,0,3,1,0,277,204,66119,50861,295,249,71692,49960
106,11,1,5,1,0,0,3,219,231,66120,50866,230,330,71692,49963
107,11,2,1,0,3,1,0,430,194,66122,50867,430,168,71695,49963
108,11,1,3,1,0,0,3,268,254,66123,50870,280,397,71695,49966
109,11,2,2,2,1,2,1,330,176,66125,50872,385,136,71696,49967
110,12,0,0,2,1,2,1,262,232,66125,50872,306,25,71697,49968
111,12,1,1,2,1,2,1,29,52,66126,50873,22,288,71698,49969
112,12,1,1,2,1,2,1,429,130,66127,50874,495,229,71699,49970
113,12,1,1,2,1,2,1,307,214,66128,50875,328,168,71700,49971
114,12,2,2,2,1,2,1,270,256,66130,50877,281,304,71701,49972
115,12,1,0,0,3,1,0,366,209,66131,50877,376,344,71704,49972
116,12,0,0,2,1,2,1,176,152,66131,50877,201,146,71705,49973
117,12,2,2,2,1,2,1,7,14,66133,50879,3,164,71706,49974
118,12,1,2,1,0,0,3,135,154,66134,50881,136,171,71706,49977
119,12,3,1,0,3,1,0,404,199,66137,50882,410,170,71709,49977
120,13,1,1,2,1,2,1,308,215,66138,50883,329,86,71710,49978
121,13,3,1,0,3,1,0,254,210,66141,50884,263,25,71713,49978
122,13,0,4,1,0,0,3,176,156,66141,50888,201,400,71713,49981
123,13,1,1,2,1,2,1,243,200,66142,50889,243,165,71714,49982
124,13,2,0,0,3,1,0,31,52,66144,50889,25,160,71717,49982
125,13,1,1,2,1,2,1,243,248,66145,50890,248,203,71718,49983
126,13,2,1,0,3,1,0,368,210,66147,50891,379,8,71721,49983
127,13,1,2,1,0,0,3,198,207,66148,50893,182,307,71721,49986
128,13,4,1,0,3,1,0,281,205,66152,50894,298,330,71724,49986
129,13,2,0,0,3,1,0,374,207,66154,50894,380,344,71727,49986
130,14,2,1,0,3,1,0,52,63,66156,50895,53,136,71730,49986
131,14,0,3,1,0,0,3,429,133,66156,50898,495,252,71730,49989
132,14,1,2,1,0,0,3,136,156,66157,50900,136,309,71730,49992
133,14,2,2,2,1,2,1,221,233,66159,50902,231,230,71731,49993
134,14,3,2,0,3,1,0,333,178,66162,50904,388,288,71734,49993
135,14,1,1,2,1,2,1,431,195,66163,50905,431,171,71735,49994
136,14,3,2,0,3,1,0,407,201,66166,50907,413,146,71738,49994
137,14,2,3,1,0,0,3,256,213,66168,50910,263,171,71738,49997
138,14,1,2,1,0,0,3,8,16,66169,50912,3,163,71738,50000
139,14,0,2,1,0,0,3,262,234,66169,50914,306,14,71738,50003
140,15,6,2,0,3,1,0,374,212,66175,50916,382,25,71741,50003
141,15,5,1,0,3,1,0,286,206,66180,50917,301,171,71744,50003
142,15,1,4,1,0,0,3,244,252,66181,50921,248,347,71744,50006
143,15,0,0,2,1,2,1,308,215,66181,50921,330,166,71745,50007
144,15,1,1,2,1,2,1,271,257,66182,50922,282,289,71746,50008
145,15,0,3,1,0,0,3,176,159,66182,50925,201,174,71746,50011
146,15,1,0,0,3,1,0,408,201,66183,50925,416,171,71749,50011
147,15,0,1,1,0,0,3,8,17,66183,50926,3,89,71749,50014
148,15,0,2,1,0,0,3,31,54,66183,50928,25,310,71749,50017
149,15,4,1,0,3,1,0,433,134,66187,50929,498,203,71752,50017
150,16,1,2,1,0,0,3,245,254,66188,50931,248,17,71752,50020
151,16,3,0,0,3,1,0,289,206,66191,50931,304,136,71755,50020
152,16,1,3,1,0,0,3,53,66,66192,50934,53,333,71755,50023
153,16,2,1,0,3,1,0,376,208,66194,50935,383,252,71758,50023
154,16,2,1,0,3,1,0,200,208,66196,50936,185,163,71761,50023
155,16,1,1,2,1,2,1,244,201,66197,50937,244,90,71762,50024
156,16,2,2,2,1,2,1,223,235,66199,50939,232,204,71763,50025
157,16,2,1,0,3,1,0,258,214,66201,50940,266,309,71766,50025
158,16,1,2,1,0,0,3,432,197,66202,50942,431,11,71766,50028
159,16,1,3,1,0,0,3,334,181,66203,50945,388,403,71766,50031
160,17,1,4,1,0,0,3,32,58,66204,50949,25,233,71766,50034
161,17,2,0,0,3,1,0,273,257,66206,50949,285,166,71769,50034
162,17,2,0,0,3,1,0,336,181,66208,50949,391,174,71772,50034
163,17,2,2,2,1,2,1,410,203,66210,50951,417,310,71773,50035
164,17,0,2,1,0,0,3,176,161,66210,50953,201,292,71773,50038
165,17,1,2,1,0,0,3,263,236,66211,50955,306,350,71773,50041
166,17,2,1,0,3,1,0,138,157,66213,50956,139,25,71776,50041
167,17,1,0,0,3,1,0,309,215,66214,50956,333,146,71779,50041
168,17,3,1,0,3,1,0,436,135,66217,50957,501,171,71782,50041
169,17,2,1,0,3,1,0,10,18,66219,50958,6,171,71785,50041
170,18,3,0,0,3,1,0,379,208,66222,50958,386,333,71788,50041
171,18,1,0,0,3,1,0,224,235,66223,50958,235,90,71791,50041
172,18,0,0,2,1,2,1,244,201,66223,50958,245,12,71792,50042
173,18,2,1,0,3,1,0,260,215,66225,50959,269,204,71795,50042
174,18,6,0,0,3,1,0,438,197,66231,50959,434,252,71798,50042
175,18,4,1,0,3,1,0,57,67,66235,50960,56,17,71801,50042
176,18,1,1,2,1,2,1,201,209,66236,50961,186,137,71802,50043
177,18,0,0,2,1,2,1,289,206,66236,50961,305,164,71803,50044
178,18,2,0,0,3,1,0,376,212,66238,50961,385,403,71806,50044
179,18,0,2,1,0,0,3,245,256,66238,50963,248,313,71806,50047
180,19,2,2,2,1,2,1,34,60,66240,50965,26,175,71807,50048
181,19,4,3,0,3,1,0,414,206,66244,50968,420,12,71810,50048
182,19,0,3,1,0,0,3,336,184,66244,50971,391,236,71810,50051
183,19,0,0,2,1,2,1,263,236,66244,50971,307,311,71811,50052
184,19,2,1,0,3,1,0,311,216,66246,50972,336,25,71814,50052
185,19,2,0,0,3,1,0,438,135,66248,50972,504,166,71817,50052
186,19,1,0,0,3,1,0,274,257,66249,50972,288,146,71820,50052
187,19,3,1,0,3,1,0,141,158,66252,50973,142,350,71823,50052
188,19,2,1,0,3,1,0,381,209,66254,50974,389,171,71826,50052
189,19,0,2,1,0,0,3,176,163,66254,50976,201,174,71826,50055
190,20,1,1,2,1,2,1,245,202,66255,50977,246,253,71827,50056
191,20,1,2,1,0,0,3,225,237,66256,50979,235,316,71827,50059
192,20,0,2,1,0,0,3,260,217,66256,50981,269,406,71827,50062
193,20,4,0,0,3,1,0,380,212,66260,50981,388,17,71830,50062
194,20,0,1,1,0,0,3,10,19,66260,50982,6,207,71830,50065
195,20,0,3,1,0,0,3,57,70,66260,50985,56,167,71830,50068
196,20,1,3,1,0,0,3,290,209,66261,50988,305,295,71830,50071
197,20,1,1,2,1,2,1,246,257,66262,50989,249,172,71831,50072
198,20,2,0,0,3,1,0,440,197,66264,50989,437,137,71834,50072
199,20,3,1,0,3,1,0,417,207,66267,50990,423,90,71837,50072
200,21,0,2,1,0,0,3,311,218,66267,50992,336,314,71837,50075
201,21,1,2,1,0,0,3,202,211,66268,50994,186,15,71837,50078
202,21,3,3,2,1,2,1,293,212,66271,50997,306,176,71838,50079
203,21,2,0,0,3,1,0,440,135,66273,50997,507,333,71841,50079
204,21,2,1,0,3,1,0,276,258,66275,50998,291,350,71844,50079
205,21,1,1,2,1,2,1,35,61,66276,50999,27,175,71845,50080
206,21,4,0,0,3,1,0,340,184,66280,50999,394,25,71848,50080
207,21,2,0,0,3,1,0,265,236,66282,50999,310,90,71851,50080
208,21,0,3,1,0,0,3,176,166,66282,51002,201,169,71851,50083
209,21,1,0,0,3,1,0,382,209,66283,51002,392,146,71854,50083
210,22,1,1,2,1,2,1,226,238,66284,51003,236,18,71855,50084
211,22,0,0,2,1,2,1,245,202,66284,51003,247,168,71856,50085
212,22,1,0,0,3,1,0,441,197,66285,51003,440,406,71859,50085
213,22,2,0,0,3,1,0,12,19,66287,51003,9,316,71862,50085
214,22,3,0,0,3,1,0,420,207,66290,51003,426,207,71865,50085
215,22,0,1,1,0,0,3,246,258,66290,51004,249,239,71865,50088
216,22,2,1,0,3,1,0,262,218,66292,51005,272,253,71868,50088
217,22,1,2,1,0,0,3,58,72,66293,51007,56,175,71868,50091
218,22,3,1,0,3,1,0,383,213,66296,51008,391,295,71871,50091
219,22,2,1,0,3,1,0,143,159,66298,51009,145,137,71874,50091
220,23,3,0,0,3,1,0,314,218,66301,51009,339,15,71877,50091
221,23,0,1,1,0,0,3,246,259,66301,51010,249,179,71877,50094
222,23,1,0,0,3,1,0,383,209,66302,51010,395,175,71880,50094
223,23,2,2,2,1,2,1,278,260,66304,51012,292,91,71881,50095
224,23,1,1,2,1,2,1,203,212,66305,51013,187,170,71882,50096
225,23,2,2,2,1,2,1,178,168,66307,51015,202,208,71883,50097
226,23,0,3,1,0,0,3,340,187,66307,51018,394,317,71883,50100
227,23,4,2,0,3,1,0,297,214,66311,51020,309,350,71886,50100
228,23,0,0,2,1,2,1,35,61,66311,51020,28,334,71887,50101
229,23,3,0,0,3,1,0,443,135,66314,51020,510,25,71890,50101
230,24,2,2,2,1,2,1,14,21,66316,51022,10,138,71891,50102
231,24,2,0,0,3,1,0,228,238,66318,51022,239,295,71894,50102
232,24,1,1,2,1,2,1,144,160,66319,51023,146,407,71895,50103
233,24,0,2,1,0,0,3,262,220,66319,51025,272,242,71895,50106
234,24,0,2,1,0,0,3,58,74,66319,51027,56,149,71895,50109
235,24,1,0,0,3,1,0,266,236,66320,51027,313,253,71898,50109
236,24,3,0,0,3,1,0,386,213,66323,51027,394,168,71901,50109
237,24,2,0,0,3,1,0,443,197,66325,51027,443,18,71904,50109
238,24,1,2,1,0,0,3,421,209,66326,51029,426,319,71904,50112
239,24,3,2,0,3,1,0,248,204,66329,51031,250,175,71907,50112
240,25,3,0,0,3,1,0,446,135,66332,51031,513,15,71910,50112
241,25,3,3,2,1,2,1,206,215,66335,51034,188,351,71911,50113
242,25,1,0,0,3,1,0,247,259,66336,51034,252,170,71914,50113
243,25,5,1,0,3,1,0,302,215,66341,51035,312,25,71917,50113
244,25,1,2,1,0,0,3,315,220,66342,51037,339,337,71917,50116
245,25,1,1,2,1,2,1,279,261,66343,51038,293,176,71918,50117
246,25,1,1,2,1,2,1,341,188,66344,51039,395,209,71919,50118
247,25,0,3,1,0,0,3,35,64,66344,51042,28,94,71919,50121
248,25,1,2,1,0,0,3,179,170,66345,51044,202,320,71919,50124
249,26,1,1,2,1,2,1,15,22,66346,51045,11,19,71920,50125
250,26,2,0,0,3,1,0,268,236,66348,51045,316,175,71923,50125
251,26,3,1,0,3,1,0,449,136,66351,51046,516,295,71926,50125
252,26,1,0,0,3,1,0,422,209,66352,51046,429,168,71929,50125
253,26,0,2,1,0,0,3,144,162,66352,51048,146,322,71929,50128
254,26,3,3,2,1,2,1,318,223,66355,51051,340,139,71930,50129
255,26,4,2,0,3,1,0,62,76,66359,51053,59,179,71933,50129
256,26,2,2,2,1,2,1,264,222,66361,51055,273,150,71934,50130
257,26,3,1,0,3,1,0,446,198,66364,51056,446,170,71937,50130
258,26,1,0,0,3,1,0,387,213,66365,51056,397,242,71940,50130
259,27,3,2,0,3,1,0,386,211,66368,51058,398,25,71943,50130
260,27,3,1,0,3,1,0,305,216,66371,51059,315,15,71946,50130
261,27,3,2,0,3,1,0,209,217,66374,51061,191,94,71949,50130
262,27,1,4,1,0,0,3,36,68,66375,51065,28,256,71949,50133
263,27,1,1,2,1,2,1,280,262,66376,51066,294,210,71950,50134
264,27,3,1,0,3,1,0,231,239,66379,51067,242,176,71953,50134
265,27,1,2,1,0,0,3,249,206,66380,51069,250,323,71953,50137
266,27,2,0,0,3,1,0,181,170,66382,51069,205,337,71956,50137
267,27,1,3,1,0,0,3,248,262,66383,51072,252,410,71956,50140
268,27,0,1,1,0,0,3,341,189,66383,51073,395,354,71956,50143
269,28,1,2,1,0,0,3,182,172,66384,51075,205,171,71956,50146
270,28,2,3,1,0,0,3,64,79,66386,51078,59,173,71956,50149
271,28,2,1,0,3,1,0,17,23,66388,51079,14,150,71959,50149
272,28,0,2,1,0,0,3,144,164,66388,51081,146,245,71959,50152
273,28,0,1,1,0,0,3,449,137,66388,51082,516,22,71959,50155
274,28,0,1,1,0,0,3,268,237,66388,51083,316,298,71959,50158
275,28,1,0,0,3,1,0,265,222,66389,51083,276,179,71962,50158
276,28,2,3,1,0,0,3,320,226,66391,51086,340,325,71962,50161
277,28,0,2,1,0,0,3,422,211,66391,51088,429,357,71962,50164
278,28,2,1,0,3,1,0,389,214,66393,51089,400,175,71965,50164
279,29,1,1,2,1,2,1,342,190,66394,51090,396,177,71966,50165
280,29,4,3,0,3,1,0,450,201,66398,51093,449,25,71969,50165
281,29,1,1,2,1,2,1,281,263,66399,51094,295,257,71970,50166
282,29,2,2,2,1,2,1,38,70,66401,51096,29,140,71971,50167
283,29,2,2,2,1,2,1,211,219,66403,51098,192,338,71972,50168
284,29,2,1,0,3,1,0,388,212,66405,51099,401,15,71975,50168
285,29,3,2,0,3,1,0,308,218,66408,51101,318,210,71978,50168
286,29,0,2,1,0,0,3,248,264,66408,51103,252,97,71978,50171
287,29,2,2,2,1,2,1,251,208,66410,51105,251,411,71979,50172
288,29,0,1,1,0,0,3,231,240,66410,51106,242,326,71979,50175
289,30,3,2,0,3,1,0,20,25,66413,51108,17,25,71982,50175
290,30,1,3,1,0,0,3,183,175,66414,51111,205,328,71982,50178
291,30,0,1,1,0,0,3,268,238,66414,51112,316,182,71982,50181
292,30,1,0,0,3,1,0,390,214,66415,51112,403,150,71985,50181
293,30,3,1,0,3,1,0,452,138,66418,51113,519,171,71988,50181
294,30,0,1,1,0,0,3,144,165,66418,51114,146,301,71988,50184
295,30,0,2,1,0,0,3,265,224,66418,51116,276,360,71988,50187
296,30,1,0,0,3,1,0,423,211,66419,51116,432,173,71991,50187
297,30,2,3,1,0,0,3,322,229,66421,51119,340,248,71991,50190
298,30,0,1,1,0,0,3,38,71,66421,51120,29,178,71991,50193
0,1,2,0,0,3,1,0,310,218,66423,51120,321,0,71994,50193
1,1,0,0,2,1,2,1,0,0,66423,51120,1,26,71995,50194
2,1,1,1,2,1,2,1,1,1,66424,51121,1,1,71996,50195
3,1,2,0,0,3,1,0,2,0,66426,51121,3,0,71999,50195
4,1,1,1,2,1,2,1,35,81,66427,51122,25,30,72000,50196
5,1,1,1,2,1,2,1,1,1,66428,51123,1,10,72001,50197
6,1,1,0,0,3,1,0,1,0,66429,51123,3,0,72004,50197
7,1,0,4,1,0,0,3,23,37,66429,51127,17,181,72004,50200
8,1,0,0,2,1,2,1,0,0,66429,51127,1,1,72005,50201
9,1,2,3,1,0,0,3,34,67,66431,51130,31,59,72005,50204
10,1,1,2,1,0,0,3,252,210,66432,51132,251,3,72005,50207
11,2,2,0,0,3,1,0,22,27,66434,51132,26,0,72008,50207
12,2,4,1,0,3,1,0,4,1,66438,51133,3,0,72011,50207
13,2,0,0,2,1,2,1,0,0,66438,51133,1,249,72012,50208
14,2,2,1,0,3,1,0,46,38,66440,51134,56,0,72015,50208
15,2,1,1,2,1,2,1,212,220,66441,51135,193,1,72016,50209
16,2,1,1,2,1,2,1,1,1,66442,51136,1,26,72017,50210
17,2,1,1,2,1,2,1,65,80,66443,51137,60,1,72018,50211
18,2,2,1,0,3,1,0,2,1,66445,51138,3,182,72021,50211
19,2,1,1,2,1,2,1,1,1,66446,51139,1,1,72022,50212
20,2,0,3,1,0,0,3,0,3,66446,51142,0,11,72022,50215
21,2,0,0,2,1,2,1,97,101,66446,51142,103,17,72023,50216
22,3,1,1,2,1,2,1,253,211,66447,51143,252,27,72024,50217
23,3,1,0,0,3,1,0,2,0,66448,51143,6,1,72027,50217
24,3,0,0,2,1,2,1,0,0,66448,51143,2,60,72028,50218
25,3,1,0,0,3,1,0,2,1,66449,51143,4,17,72031,50218
26,3,2,0,0,3,1,0,2,0,66451,51143,4,0,72034,50218
27,3,1,0,0,3,1,0,3,0,66452,51143,6,181,72037,50218
28,3,1,2,1,0,0,3,1,2,66453,51145,1,3,72037,50221
29,3,0,2,1,0,0,3,2,3,66453,51147,3,13,72037,50224
30,3,0,0,2,1,2,1,310,218,66453,51147,322,27,72038,50225
31,3,2,0,0,3,1,0,3,1,66455,51147,4,1,72041,50225
32,3,1,1,2,1,2,1,24,38,66456,51148,18,31,72042,50226
33,4,4,0,0,3,1,0,5,1,66460,51148,4,0,72045,50226
34,4,0,0,2,1,2,1,4,1,66460,51148,4,12,72046,50227
35,4,3,1,0,3,1,0,49,39,66463,51149,59,0,72049,50227
36,4,1,2,1,0,0,3,213,222,66464,51151,193,185,72049,50230
37,4,2,4,1,0,0,3,3,5,66466,51155,1,4,72049,50233
38,4,0,2,1,0,0,3,35,83,66466,51157,25,252,72049,50236
39,4,2,1,0,3,1,0,24,28,66468,51158,29,1,72052,50236
40,4,1,0,0,3,1,0,35,67,66469,51158,34,0,72055,50236
41,4,1,1,2,1,2,1,98,102,66470,51159,104,1,72056,50237
42,4,3,1,0,3,1,0,3,4,66473,51160,3,3,72059,50237
43,4,3,1,0,3,1,0,68,81,66476,51161,63,1,72062,50237
44,5,1,1,2,1,2,1,1,1,66477,51162,3,18,72063,50238
45,5,0,0,2,1,2,1,2,1,66477,51162,5,2,72064,50239
46,5,1,0,0,3,1,0,254,211,66478,51162,255,13,72067,50239
47,5,1,0,0,3,1,0,50,39,66479,51162,62,252,72070,50239
48,5,4,0,0,3,1,0,6,0,66483,51162,7,1,72073,50239
49,5,0,0,2,1,2,1,24,38,66483,51162,19,1,72074,50240
50,5,1,0,0,3,1,0,2,2,66484,51162,4,0,72077,50240
51,5,1,1,2,1,2,1,3,4,66485,51163,4,28,72078,50241
52,5,0,0,2,1,2,1,3,1,66485,51163,5,61,72079,50242
53,5,1,1,2,1,2,1,4,5,66486,51164,4,28,72080,50243
54,5,2,1,0,3,1,0,215,223,66488,51165,196,3,72083,50243
55,6,0,1,1,0,0,3,3,6,66488,51166,1,34,72083,50246
56,6,1,1,2,1,2,1,311,219,66489,51167,323,1,72084,50247
57,6,2,0,0,3,1,0,70,81,66491,51167,66,181,72087,50247
58,6,1,0,0,3,1,0,99,102,66492,51167,107,1,72090,50247
59,6,1,0,0,3,1,0,36,67,66493,51167,37,3,72093,50247
60,6,4,1,0,3,1,0,28,29,66497,51168,32,12,72096,50247
61,6,2,0,0,3,1,0,7,1,66499,51168,7,1,72099,50247
62,6,2,0,0,3,1,0,37,83,66501,51168,28,185,72102,50247
63,6,2,1,0,3,1,0,5,1,66503,51169,9,4,72105,50247
64,6,1,0,0,3,1,0,5,1,66504,51169,7,0,72108,50247
65,6,2,2,2,1,2,1,4,2,66506,51171,7,2,72109,50248
66,7,1,5,1,0,0,3,4,6,66507,51176,5,15,72109,50251
67,7,1,2,1,0,0,3,5,7,66508,51178,4,21,72109,50254
68,7,2,3,1,0,0,3,5,7,66510,51181,4,64,72109,50257
69,7,2,0,0,3,1,0,4,2,66512,51181,7,28,72112,50257
70,7,2,2,2,1,2,1,5,8,66514,51183,2,3,72113,50258
71,7,3,2,0,3,1,0,9,2,66517,51185,10,3,72116,50258
72,7,0,2,1,0,0,3,215,225,66517,51187,196,255,72116,50261
73,7,2,0,0,3,1,0,52,39,66519,51187,65,1,72119,50261
74,7,2,1,0,3,1,0,256,212,66521,51188,258,1,72122,50261
75,7,3,0,0,3,1,0,5,1,66524,51188,8,28,72125,50261
76,7,3,1,0,3,1,0,4,2,66527,51189,6,13,72128,50261
77,8,0,0,2,1,2,1,5,1,66527,51189,9,35,72129,50262
78,8,1,0,0,3,1,0,38,83,66528,51189,31,181,72132,50262
79,8,1,2,1,0,0,3,37,69,66529,51191,37,4,72132,50265
80,8,1,0,0,3,1,0,71,81,66530,51191,69,3,72135,50265
81,8,1,1,2,1,2,1,100,103,66531,51192,108,1,72136,50266
82,8,3,0,0,3,1,0,27,38,66534,51192,22,0,72139,50266
83,8,2,2,2,1,2,1,6,4,66536,51194,8,2,72140,50267
84,8,3,0,0,3,1,0,10,1,66539,51194,10,1,72143,50267
85,8,1,5,1,0,0,3,6,6,66540,51199,9,16,72143,50270
86,8,1,0,0,3,1,0,6,1,66541,51199,10,4,72146,50270
87,8,2,1,0,3,1,0,313,220,66543,51200,326,185,72149,50270
88,9,2,1,0,3,1,0,7,8,66545,51201,7,28,72152,50270
89,9,2,2,2,1,2,1,6,8,66547,51203,6,29,72153,50271
90,9,1,1,2,1,2,1,6,8,66548,51204,5,182,72154,50272
91,9,3,1,0,3,1,0,7,3,66551,51205,10,1,72157,50272
92,9,0,0,2,1,2,1,6,4,66551,51205,9,65,72158,50273
93,9,2,0,0,3,1,0,30,29,66553,51205,35,255,72161,50273
94,9,2,2,2,1,2,1,7,10,66555,51207,3,3,72162,50274
95,9,1,0,0,3,1,0,10,2,66556,51207,13,21,72165,50274
96,9,2,1,0,3,1,0,54,40,66558,51208,68,3,72168,50274
97,9,2,1,0,3,1,0,258,213,66560,51209,261,3,72171,50274
98,9,1,1,2,1,2,1,5,3,66561,51210,7,16,72172,50275
99,10,2,1,0,3,1,0,315,221,66563,51211,329,4,72175,50275
100,10,0,1,1,0,0,3,71,82,66563,51212,69,4,72175,50278
101,10,1,1,2,1,2,1,38,70,66564,51213,38,2,72176,50279
102,10,2,1,0,3,1,0,29,39,66566,51214,25,185,72179,50279
103,10,4,2,0,3,1,0,42,85,66570,51216,34,1,72182,50279
104,10,1,1,2,1,2,1,7,7,66571,51217,10,4,72183,50280
105,10,0,1,1,0,0,3,215,226,66571,51218,196,19,72183,50283
106,10,0,4,1,0,0,3,5,5,66571,51222,9,7,72183,50286
107,10,1,0,0,3,1,0,7,1,66572,51222,13,2,72186,50286
108,10,2,1,0,3,1,0,12,2,66574,51223,13,0,72189,50286
109,10,3,0,0,3,1,0,103,103,66577,51223,111,35,72192,50286
110,11,3,0,0,3,1,0,33,29,66580,51223,38,3,72195,50286
111,11,1,0,0,3,1,0,8,8,66581,51223,10,1,72198,50286
112,11,0,1,1,0,0,3,6,9,66581,51224,6,3,72198,50289
113,11,1,1,2,1,2,1,7,5,66582,51225,10,183,72199,50290
114,11,3,1,0,3,1,0,15,3,66585,51226,16,21,72202,50290
115,11,3,2,0,3,1,0,10,12,66588,51228,6,255,72205,50290
116,11,0,0,2,1,2,1,10,2,66588,51228,14,66,72206,50291
117,11,0,0,2,1,2,1,54,40,66588,51228,69,30,72207,50292
118,11,1,2,1,0,0,3,259,215,66589,51230,261,31,72207,50295
119,11,4,0,0,3,1,0,9,3,66593,51230,10,3,72210,50295
120,11,0,0,2,1,2,1,7,3,66593,51230,11,17,72211,50296
121,12,4,1,0,3,1,0,319,222,66597,51231,332,3,72214,50296
122,12,2,1,0,3,1,0,8,9,66599,51232,8,1,72217,50296
123,12,0,0,2,1,2,1,103,103,66599,51232,112,31,72218,50297
124,12,1,0,0,3,1,0,39,70,66600,51232,41,3,72221,50297
125,12,3,0,0,3,1,0,32,39,66603,51232,28,7,72224,50297
126,12,3,0,0,3,1,0,36,29,66606,51232,41,2,72227,50297
127,12,0,2,1,0,0,3,42,87,66606,51234,34,5,72227,50300
128,12,0,0,2,1,2,1,7,7,66606,51234,11,5,72228,50301
129,12,0,1,1,0,0,3,7,2,66606,51235,13,7,72228,50304
130,12,4,3,0,3,1,0,219,229,66610,51238,199,35,72231,50304
131,12,2,1,0,3,1,0,261,216,66612,51239,264,4,72234,50304
132,13,1,0,0,3,1,0,11,2,66613,51239,17,1,72237,50304
133,13,0,1,1,0,0,3,5,6,66613,51240,9,258,72237,50307
134,13,3,1,0,3,1,0,11,9,66616,51241,13,183,72240,50307
135,13,1,1,2,1,2,1,7,10,66617,51242,7,20,72241,50308
136,13,0,1,1,0,0,3,71,83,66617,51243,69,24,72241,50311
137,13,0,0,2,1,2,1,7,3,66617,51243,12,186,72242,50312
138,13,1,1,2,1,2,1,8,6,66618,51244,11,18,72243,50313
139,13,2,2,2,1,2,1,17,5,66620,51246,17,67,72244,50314
140,13,4,1,0,3,1,0,14,13,66624,51247,9,3,72247,50314
141,13,3,0,0,3,1,0,57,40,66627,51247,72,31,72250,50314
142,13,0,0,2,1,2,1,9,3,66627,51247,11,4,72251,50315
143,14,1,0,0,3,1,0,320,222,66628,51247,335,5,72254,50315
144,14,1,2,1,0,0,3,9,11,66629,51249,8,10,72254,50318
145,14,2,3,1,0,0,3,41,73,66631,51252,41,34,72254,50321
146,14,0,0,2,1,2,1,7,3,66631,51252,13,8,72255,50322
147,14,1,3,1,0,0,3,33,42,66632,51255,28,6,72255,50325
148,14,1,1,2,1,2,1,37,30,66633,51256,42,68,72256,50326
149,14,2,2,2,1,2,1,44,89,66635,51258,35,6,72257,50327
150,14,1,1,2,1,2,1,8,8,66636,51259,12,4,72258,50328
151,14,0,1,1,0,0,3,219,230,66636,51260,199,7,72258,50331
152,14,1,0,0,3,1,0,262,216,66637,51260,267,2,72261,50331
153,14,2,2,2,1,2,1,9,4,66639,51262,14,36,72262,50332
154,15,1,3,1,0,0,3,12,12,66640,51265,13,7,72262,50335
155,15,2,1,0,3,1,0,73,84,66642,51266,72,18,72265,50335
156,15,3,0,0,3,1,0,106,103,66645,51266,115,258,72268,50335
157,15,2,1,0,3,1,0,10,7,66647,51267,14,3,72271,50335
158,15,3,1,0,3,1,0,20,6,66650,51268,20,31,72274,50335
159,15,1,2,1,0,0,3,15,15,66651,51270,9,23,72274,50338
160,15,1,1,2,1,2,1,12,3,66652,51271,18,187,72275,50339
161,15,0,0,2,1,2,1,5,6,66652,51271,10,2,72276,50340
162,15,2,1,0,3,1,0,11,4,66654,51272,14,183,72279,50340
163,15,1,2,1,0,0,3,45,91,66655,51274,35,10,72279,50343
164,15,3,1,0,3,1,0,60,41,66658,51275,75,1,72282,50343
165,16,2,1,0,3,1,0,11,5,66660,51276,17,4,72285,50343
166,16,0,0,2,1,2,1,7,10,66660,51276,8,9,72286,50344
167,16,2,0,0,3,1,0,322,222,66662,51276,338,34,72289,50344
168,16,3,0,0,3,1,0,12,11,66665,51276,11,6,72292,50344
169,16,3,3,2,1,2,1,10,6,66668,51279,14,3,72293,50345
170,16,2,1,0,3,1,0,35,43,66670,51280,31,68,72296,50345
171,16,1,4,1,0,0,3,9,12,66671,51284,12,39,72296,50348
172,16,0,0,2,1,2,1,219,230,66671,51284,200,7,72297,50349
173,16,3,2,0,3,1,0,265,218,66674,51286,270,5,72300,50349
174,16,3,1,0,3,1,0,40,31,66677,51287,45,10,72303,50349
175,16,1,1,2,1,2,1,42,74,66678,51288,42,25,72304,50350
176,17,0,2,1,0,0,3,322,224,66678,51290,338,21,72304,50353
177,17,1,2,1,0,0,3,74,86,66679,51292,72,6,72304,50356
178,17,0,1,1,0,0,3,106,104,66679,51293,115,186,72304,50359
179,17,1,1,2,1,2,1,43,75,66680,51294,43,11,72305,50360
180,17,2,3,1,0,0,3,22,9,66682,51297,20,12,72305,50363
181,17,4,2,0,3,1,0,49,93,66686,51299,38,2,72308,50363
182,17,1,1,2,1,2,1,16,16,66687,51300,10,188,72309,50364
183,17,1,1,2,1,2,1,61,42,66688,51301,76,24,72310,50365
184,17,0,1,1,0,0,3,5,7,66688,51302,10,4,72310,50368
185,17,1,1,2,1,2,1,11,8,66689,51303,15,8,72311,50369
186,17,1,2,1,0,0,3,13,5,66690,51305,18,6,72311,50372
187,18,2,0,0,3,1,0,14,12,66692,51305,16,68,72314,50372
188,18,1,0,0,3,1,0,8,10,66693,51305,11,4,72317,50372
189,18,4,1,0,3,1,0,16,12,66697,51306,14,7,72320,50372
190,18,3,1,0,3,1,0,13,7,66700,51307,17,5,72323,50372
191,18,1,1,2,1,2,1,36,44,66701,51308,32,26,72324,50373
192,18,3,0,0,3,1,0,43,31,66704,51308,48,34,72327,50373
193,18,1,2,1,0,0,3,10,14,66705,51310,12,261,72327,50376
194,18,1,1,2,1,2,1,220,231,66706,51311,201,7,72328,50377
195,18,1,0,0,3,1,0,12,4,66707,51311,17,10,72331,50377
196,18,1,1,2,1,2,1,266,219,66708,51312,271,40,72332,50378
197,18,1,0,0,3,1,0,12,5,66709,51312,20,31,72335,50378
198,19,1,0,0,3,1,0,23,9,66710,51312,23,186,72338,50378
199,19,3,1,0,3,1,0,325,225,66713,51313,341,6,72341,50378
200,19,1,1,2,1,2,1,75,87,66714,51314,73,9,72342,50379
201,19,2,3,1,0,0,3,108,107,66716,51317,115,5,72342,50382
202,19,1,1,2,1,2,1,44,76,66717,51318,44,25,72343,50383
203,19,0,2,1,0,0,3,11,10,66717,51320,15,15,72343,50386
204,19,1,0,0,3,1,0,50,93,66718,51320,41,6,72346,50386
205,19,0,1,1,0,0,3,16,17,66718,51321,10,24,72346,50389
206,19,1,0,0,3,1,0,14,5,66719,51321,21,4,72349,50389
207,19,3,0,0,3,1,0,64,42,66722,51321,79,11,72352,50389
208,19,0,1,1,0,0,3,5,8,66722,51322,10,191,72352,50392
209,20,1,1,2,1,2,1,44,32,66723,51323,49,27,72353,50393
210,20,2,1,0,3,1,0,10,11,66725,51324,14,10,72356,50393
211,20,0,1,1,0,0,3,16,13,66725,51325,14,264,72356,50396
212,20,2,2,2,1,2,1,15,9,66727,51327,18,35,72357,50397
213,20,1,1,2,1,2,1,11,15,66728,51328,13,6,72358,50398
214,20,5,3,0,3,1,0,225,234,66733,51331,204,31,72361,50398
215,20,2,1,0,3,1,0,268,220,66735,51332,274,68,72364,50398
216,20,1,0,0,3,1,0,13,4,66736,51332,20,40,72367,50398
217,20,2,0,0,3,1,0,14,5,66738,51332,23,7,72370,50398
218,20,3,3,2,1,2,1,17,15,66741,51335,17,8,72371,50399
219,20,3,3,2,1,2,1,39,47,66744,51338,33,5,72372,50400
220,21,0,2,1,0,0,3,44,78,66744,51340,44,27,72372,50403
221,21,2,0,0,3,1,0,77,87,66746,51340,76,5,72375,50403
222,21,1,1,2,1,2,1,109,108,66747,51341,116,7,72376,50404
223,21,2,1,0,3,1,0,13,11,66749,51342,18,25,72379,50404
224,21,1,0,0,3,1,0,51,93,66750,51342,44,9,72382,50404
225,21,2,1,0,3,1,0,18,18,66752,51343,13,15,72385,50404
226,21,0,0,2,1,2,1,14,5,66752,51343,22,187,72386,50405
227,21,2,1,0,3,1,0,66,43,66754,51344,82,6,72389,50405
228,21,2,0,0,3,1,0,7,8,66756,51344,13,11,72392,50405
229,21,1,1,2,1,2,1,24,10,66757,51345,24,192,72393,50406
230,21,2,0,0,3,1,0,327,225,66759,51345,344,4,72396,50406
231,22,2,1,0,3,1,0,68,44,66761,51346,85,27,72399,50406
232,22,1,1,2,1,2,1,15,6,66762,51347,24,265,72400,50407
233,22,2,1,0,3,1,0,111,109,66764,51348,119,31,72403,50407
234,22,1,2,1,0,0,3,11,13,66765,51350,14,7,72403,50410
235,22,1,0,0,3,1,0,226,234,66766,51350,207,27,72406,50410
236,22,0,2,1,0,0,3,18,20,66766,51352,13,9,72406,50413
237,22,1,1,2,1,2,1,45,33,66767,51353,50,6,72407,50414
238,22,1,1,2,1,2,1,17,14,66768,51354,15,6,72408,50415
239,22,3,0,0,3,1,0,16,4,66771,51354,23,192,72411,50415
240,22,1,1,2,1,2,1,18,16,66772,51355,18,8,72412,50416
241,22,0,0,2,1,2,1,77,87,66772,51355,77,11,72413,50417
242,23,1,2,1,0,0,3,40,49,66773,51357,33,9,72413,50420
243,23,0,0,2,1,2,1,13,11,66773,51357,19,12,72414,50421
244,23,1,1,2,1,2,1,269,221,66774,51358,275,10,72415,50422
245,23,1,0,0,3,1,0,25,10,66775,51358,27,35,72418,50422
246,23,1,1,2,1,2,1,45,79,66776,51359,45,9,72419,50423
247,23,1,0,0,3,1,0,16,9,66777,51359,21,187,72422,50423
248,23,0,0,2,1,2,1,14,5,66777,51359,23,41,72423,50424
249,23,0,0,2,1,2,1,327,225,66777,51359,345,16,72424,50425
250,23,1,0,0,3,1,0,12,15,66778,51359,16,7,72427,50425
251,23,1,1,2,1,2,1,8,9,66779,51360,14,26,72428,50426
252,23,1,0,0,3,1,0,52,93,66780,51360,47,68,72431,50426
253,24,1,1,2,1,2,1,112,110,66781,51361,120,17,72432,50427
254,24,1,1,2,1,2,1,19,17,66782,51362,19,13,72433,50428
255,24,2,2,2,1,2,1,47,35,66784,51364,51,11,72434,50429
256,24,0,1,1,0,0,3,15,7,66784,51365,24,10,72434,50432
257,24,4,0,0,3,1,0,72,44,66788,51365,88,27,72437,50432
258,24,1,1,2,1,2,1,26,11,66789,51366,28,10,72438,50433
259,24,0,1,1,0,0,3,226,235,66789,51367,207,9,72438,50436
260,24,3,2,0,3,1,0,21,22,66792,51369,16,11,72441,50436
261,24,1,1,2,1,2,1,78,88,66793,51370,78,193,72442,50437
262,24,0,0,2,1,2,1,52,93,66793,51370,48,9,72443,50438
263,24,0,1,1,0,0,3,45,80,66793,51371,45,268,72443,50441
264,25,1,1,2,1,2,1,15,6,66794,51372,24,7,72444,50442
265,25,3,0,0,3,1,0,19,4,66797,51372,26,9,72447,50442
266,25,1,1,2,1,2,1,14,12,66798,51373,20,36,72448,50443
267,25,1,2,1,0,0,3,9,11,66799,51375,14,71,72448,50446
268,25,0,1,1,0,0,3,12,16,66799,51376,16,34,72448,50449
269,25,0,1,1,0,0,3,16,10,66799,51377,21,29,72448,50452
270,25,1,0,0,3,1,0,328,225,66800,51377,348,27,72451,50452
271,25,3,1,0,3,1,0,14,14,66803,51378,17,9,72454,50452
272,25,1,2,1,0,0,3,270,223,66804,51380,275,190,72454,50455
273,25,0,0,2,1,2,1,17,14,66804,51380,16,42,72455,50456
274,25,0,1,1,0,0,3,40,50,66804,51381,33,10,72455,50459
275,26,0,0,2,1,2,1,328,225,66804,51381,349,43,72456,50460
276,26,0,1,1,0,0,3,78,89,66804,51382,78,12,72456,50463
277,26,1,0,0,3,1,0,113,110,66805,51382,123,13,72459,50463
278,26,1,1,2,1,2,1,46,81,66806,51383,46,12,72460,50464
279,26,4,0,0,3,1,0,25,22,66810,51383,19,10,72463,50464
280,26,2,0,0,3,1,0,14,16,66812,51383,19,27,72466,50464
281,26,1,2,1,0,0,3,15,14,66813,51385,20,14,72466,50467
282,26,1,1,2,1,2,1,16,8,66814,51386,25,191,72467,50468
283,26,0,1,1,0,0,3,26,12,66814,51387,28,12,72467,50471
284,26,1,0,0,3,1,0,53,93,66815,51387,51,17,72470,50471
285,26,1,0,0,3,1,0,48,35,66816,51387,54,193,72473,50471
286,27,2,1,0,3,1,0,18,11,66818,51388,24,71,72476,50471
287,27,0,0,2,1,2,1,15,6,66818,51388,25,269,72477,50472
288,27,2,0,0,3,1,0,228,235,66820,51388,210,36,72480,50472
289,27,2,2,2,1,2,1,11,13,66822,51390,15,11,72481,50473
290,27,1,0,0,3,1,0,41,50,66823,51390,36,29,72484,50473
291,27,2,1,0,3,1,0,21,18,66825,51391,22,7,72487,50473
292,27,3,1,0,3,1,0,273,224,66828,51392,278,27,72490,50473
293,27,2,3,1,0,0,3,74,47,66830,51395,88,12,72490,50476
294,27,1,0,0,3,1,0,15,14,66831,51395,20,9,72493,50476
295,27,0,1,1,0,0,3,17,15,66831,51396,16,13,72493,50479
296,27,3,3,2,1,2,1,22,7,66834,51399,27,35,72494,50480
297,28,0,0,2,1,2,1,26,12,66834,51399,29,13,72495,50481
298,28,1,1,2,1,2,1,42,51,66835,51400,37,14,72496,50482
299,28,2,0,0,3,1,0,55,93,66837,51400,54,12,72499,50482
300,28,2,0,0,3,1,0,115,110,66839,51400,126,12,72502,50482
301,28,0,0,2,1,2,1,46,81,66839,51400,47,11,72503,50483
302,28,0,1,1,0,0,3,16,9,66839,51401,25,17,72503,50486
303,28,1,0,0,3,1,0,329,225,66840,51401,352,191,72506,50486
304,28,0,1,1,0,0,3,15,15,66840,51402,20,46,72506,50489
305,28,0,1,1,0,0,3,14,17,66840,51403,19,196,72506,50492
306,28,2,1,0,3,1,0,80,90,66842,51404,81,12,72509,50492
307,28,1,1,2,1,2,1,49,36,66843,51405,55,18,72510,50493
308,29,1,1,2,1,2,1,23,8,66844,51406,28,37,72511,50494
309,29,2,1,0,3,1,0,27,23,66846,51407,22,71,72514,50494
310,29,2,1,0,3,1,0,17,7,66848,51408,28,35,72517,50494
311,29,2,0,0,3,1,0,19,15,66850,51408,19,27,72520,50494
312,29,0,0,2,1,2,1,21,18,66850,51408,23,12,72521,50495
313,29,3,1,0,3,1,0,21,12,66853,51409,27,7,72524,50495
314,29,2,0,0,3,1,0,230,235,66855,51409,213,27,72527,50495
315,29,0,0,2,1,2,1,49,36,66855,51409,56,10,72528,50496
316,29,1,0,0,3,1,0,75,47,66856,51409,91,12,72531,50496
317,29,1,2,1,0,0,3,274,226,66857,51411,278,272,72531,50499
318,29,2,1,0,3,1,0,17,15,66859,51412,23,13,72534,50499
319,30,2,1,0,3,1,0,48,82,66861,51413,50,12,72537,50499
320,30,1,1,2,1,2,1,231,236,66862,51414,214,13,72538,50500
321,30,1,1,2,1,2,1,15,18,66863,51415,20,12,72539,50501
322,30,0,1,1,0,0,3,115,111,66863,51416,126,15,72539,50504
323,30,0,1,1,0,0,3,11,14,66863,51417,15,16,72539,50507
324,30,0,0,2,1,2,1,55,93,66863,51417,55,18,72540,50508
325,30,0,0,2,1,2,1,26,12,66863,51417,30,47,72541,50509
326,30,0,0,2,1,2,1,42,51,66863,51417,38,19,72542,50510
327,30,1,0,0,3,1,0,17,9,66864,51417,28,196,72545,50510
328,30,1,1,2,1,2,1,330,226,66865,51418,353,30,72546,50511
329,30,1,0,0,3,1,0,81,90,66866,51418,84,14,72549,50511
330,31,1,1,2,1,2,1,18,16,66867,51419,24,273,72550,50512
331,31,2,0,0,3,1,0,29,23,66869,51419,25,37,72553,50512
332,31,0,0,2,1,2,1,75,47,66869,51419,92,72,72554,50513
333,31,2,1,0,3,1,0,17,16,66871,51420,23,35,72557,50513
334,31,0,2,1,0,0,3,274,228,66871,51422,278,30,72557,50516
335,31,3,2,0,3,1,0,24,14,66874,51424,30,27,72560,50516
336,31,0,0,2,1,2,1,49,36,66874,51424,57,192,72561,50517
337,31,1,1,2,1,2,1,18,8,66875,51425,29,13,72562,50518
338,31,2,2,2,1,2,1,23,20,66877,51427,24,14,72563,50519
339,31,1,0,0,3,1,0,24,8,66878,51427,31,10,72566,50519
340,31,3,1,0,3,1,0,22,16,66881,51428,22,7,72569,50519
341,32,1,1,2,1,2,1,232,237,66882,51429,215,16,72570,50520
342,32,2,1,0,3,1,0,17,19,66884,51430,23,12,72573,50520
343,32,0,1,1,0,0,3,22,17,66884,51431,22,17,72573,50523
344,32,1,1,2,1,2,1,43,52,66885,51432,39,13,72574,50524
345,32,1,0,0,3,1,0,18,9,66886,51432,31,30,72577,50524
346,32,0,2,1,0,0,3,55,95,66886,51434,55,10,72577,50527
347,32,3,0,0,3,1,0,333,226,66889,51434,356,16,72580,50527
348,32,1,2,1,0,0,3,82,92,66890,51436,84,50,72580,50530
349,32,1,0,0,3,1,0,49,82,66891,51436,53,196,72583,50530
350,32,1,1,2,1,2,1,12,15,66892,51437,16,20,72584,50531
351,32,1,0,0,3,1,0,116,111,66893,51437,129,18,72587,50531
352,33,0,4,1,0,0,3,18,20,66893,51441,24,199,72587,50534
353,33,1,1,2,1,2,1,27,13,66894,51442,31,274,72588,50535
354,33,3,1,0,3,1,0,26,21,66897,51443,27,30,72591,50535
355,33,1,1,2,1,2,1,25,15,66898,51444,31,14,72592,50536
356,33,3,2,0,3,1,0,85,94,66901,51446,87,72,72595,50536
357,33,2,2,2,1,2,1,14,17,66903,51448,17,36,72596,50537
358,33,1,0,0,3,1,0,18,16,66904,51448,26,27,72599,50537
359,33,1,2,1,0,0,3,30,25,66905,51450,25,13,72599,50540
360,33,4,0,0,3,1,0,79,47,66909,51450,95,192,72602,50540
361,33,1,0,0,3,1,0,25,8,66910,51450,34,14,72605,50540
362,33,1,1,2,1,2,1,19,9,66911,51451,30,31,72606,50541
363,34,1,0,0,3,1,0,275,228,66912,51451,281,13,72609,50541
364,34,1,0,0,3,1,0,233,237,66913,51451,218,12,72612,50541
365,34,1,0,0,3,1,0,50,36,66914,51451,60,17,72615,50541
366,34,1,0,0,3,1,0,56,95,66915,51451,58,37,72618,50541
367,34,0,1,1,0,0,3,43,53,66915,51452,39,19,72618,50544
368,34,2,2,2,1,2,1,118,113,66917,51454,130,11,72619,50545
369,34,3,1,0,3,1,0,21,10,66920,51455,34,16,72622,50545
370,34,1,1,2,1,2,1,18,20,66921,51456,24,19,72623,50546
371,34,4,0,0,3,1,0,337,226,66925,51456,359,13,72626,50546
372,34,2,2,2,1,2,1,24,19,66927,51458,23,21,72627,50547
373,34,0,1,1,0,0,3,49,83,66927,51459,53,53,72627,50550
374,35,0,0,2,1,2,1,118,113,66927,51459,131,31,72628,50551
375,35,0,1,1,0,0,3,19,10,66927,51460,30,17,72628,50554
376,35,4,1,0,3,1,0,89,95,66931,51461,90,36,72631,50554
377,35,3,1,0,3,1,0,28,9,66934,51462,37,13,72634,50554
378,35,0,0,2,1,2,1,14,17,66934,51462,18,32,72635,50555
379,35,0,2,1,0,0,3,30,27,66934,51464,25,30,72635,50558
380,35,3,1,0,3,1,0,30,14,66937,51465,34,13,72638,50558
381,35,0,0,2,1,2,1,18,20,66937,51465,25,193,72639,50559
382,35,1,2,1,0,0,3,27,23,66938,51467,27,202,72639,50562
383,35,2,0,0,3,1,0,81,47,66940,51467,98,14,72642,50562
384,35,1,2,1,0,0,3,19,18,66941,51469,26,277,72642,50565
385,36,1,2,1,0,0,3,44,55,66942,51471,39,40,72642,50568
386,36,0,4,1,0,0,3,24,23,66942,51475,23,15,72642,50571
387,36,1,2,1,0,0,3,338,228,66943,51477,359,75,72642,50574
388,36,1,1,2,1,2,1,22,11,66944,51478,35,20,72643,50575
389,36,1,1,2,1,2,1,50,84,66945,51479,54,12,72644,50576
390,36,1,0,0,3,1,0,19,20,66946,51479,28,30,72647,50576
391,36,2,2,2,1,2,1,52,38,66948,51481,61,17,72648,50577
392,36,0,1,1,0,0,3,25,16,66948,51482,31,56,72648,50580
393,36,1,2,1,0,0,3,19,22,66949,51484,24,16,72648,50583
394,36,1,1,2,1,2,1,234,238,66950,51485,219,22,72649,50584
395,36,1,1,2,1,2,1,276,229,66951,51486,282,20,72650,50585
396,37,4,1,0,3,1,0,34,15,66955,51487,37,14,72653,50585
397,37,1,1,2,1,2,1,57,96,66956,51488,59,37,72654,50586
398,37,1,1,2,1,2,1,29,10,66957,51489,38,18,72655,50587
399,37,2,2,2,1,2,1,91,97,66959,51491,91,278,72656,50588
400,37,0,2,1,0,0,3,30,29,66959,51493,25,20,72656,50591
401,37,1,1,2,1,2,1,28,24,66960,51494,28,14,72657,50592
402,37,0,0,2,1,2,1,118,113,66960,51494,132,33,72658,50593
403,37,1,0,0,3,1,0,20,10,66961,51494,33,31,72661,50593
404,37,1,2,1,0,0,3,82,49,66962,51496,98,16,72661,50596
405,37,2,1,0,3,1,0,16,18,66964,51497,21,193,72664,50596
406,37,1,1,2,1,2,1,20,19,66965,51498,27,203,72665,50597
407,38,2,1,0,3,1,0,46,56,66967,51499,42,278,72668,50597
408,38,1,2,1,0,0,3,23,13,66968,51501,35,43,72668,50600
409,38,1,0,0,3,1,0,235,238,66969,51501,222,75,72671,50600
410,38,3,1,0,3,1,0,22,21,66972,51502,31,37,72674,50600
411,38,1,1,2,1,2,1,25,24,66973,51503,24,21,72675,50601
412,38,0,0,2,1,2,1,29,10,66973,51503,39,13,72676,50602
413,38,1,2,1,0,0,3,20,24,66974,51505,24,33,72676,50605
414,38,1,1,2,1,2,1,277,230,66975,51506,283,18,72677,50606
415,38,2,0,0,3,1,0,27,16,66977,51506,34,16,72680,50606
416,38,2,2,2,1,2,1,54,40,66979,51508,62,57,72681,50607
417,38,1,3,1,0,0,3,29,27,66980,51511,28,23,72681,50610
418,39,0,1,1,0,0,3,57,97,66980,51512,59,36,72681,50613
419,39,3,1,0,3,1,0,121,114,66983,51513,135,15,72684,50613
420,39,3,1,0,3,1,0,37,16,66986,51514,40,18,72687,50613
421,39,3,2,0,3,1,0,19,20,66989,51516,24,20,72690,50613
422,39,1,1,2,1,2,1,21,20,66990,51517,28,15,72691,50614
423,39,0,3,1,0,0,3,91,100,66990,51520,91,34,72691,50617
424,39,4,1,0,3,1,0,342,229,66994,51521,362,16,72694,50617
425,39,1,0,0,3,1,0,31,29,66995,51521,28,193,72697,50617
426,39,2,2,2,1,2,1,84,51,66997,51523,99,204,72698,50618
427,39,4,0,0,3,1,0,54,84,67001,51523,57,14,72701,50618
428,39,1,1,2,1,2,1,21,11,67002,51524,34,23,72702,50619
429,40,3,2,0,3,1,0,25,23,67005,51526,34,57,72705,50619
430,40,1,0,0,3,1,0,26,24,67006,51526,27,43,72708,50619
431,40,0,1,1,0,0,3,20,25,67006,51527,24,78,72708,50622
432,40,2,1,0,3,1,0,56,41,67008,51528,65,37,72711,50622
433,40,3,0,0,3,1,0,32,10,67011,51528,42,21,72714,50622
434,40,0,1,1,0,0,3,235,239,67011,51529,222,16,72714,50625
435,40,2,2,2,1,2,1,25,15,67013,51531,36,34,72715,50626
436,40,1,0,0,3,1,0,47,56,67014,51531,45,18,72718,50626
437,40,2,0,0,3,1,0,279,230,67016,51531,286,16,72721,50626
438,40,0,1,1,0,0,3,27,17,67016,51532,34,26,72721,50629
439,40,2,3,1,0,0,3,31,30,67018,51535,28,281,72721,50632
440,41,1,1,2,1,2,1,122,115,67019,51536,136,205,72722,50633
441,41,1,3,1,0,0,3,32,32,67020,51539,28,18,72722,50636
442,41,0,0,2,1,2,1,21,11,67020,51539,35,19,72723,50637
443,41,2,2,2,1,2,1,344,231,67022,51541,363,21,72724,50638
444,41,0,0,2,1,2,1,91,100,67022,51541,92,16,72725,50639
445,41,3,2,0,3,1,0,40,18,67025,51543,43,36,72728,50639
446,41,1,2,1,0,0,3,58,99,67026,51545,59,37,72728,50642
447,41,3,1,0,3,1,0,24,21,67029,51546,31,16,72731,50642
448,41,1,2,1,0,0,3,55,86,67030,51548,57,196,72731,50645
449,41,0,1,1,0,0,3,19,21,67030,51549,24,17,72731,50648
450,41,5,0,0,3,1,0,89,51,67035,51549,102,23,72734,50648
451,42,1,1,2,1,2,1,28,18,67036,51550,35,282,72735,50649
452,42,2,3,1,0,0,3,22,28,67038,51553,24,46,72735,50652
453,42,1,1,2,1,2,1,26,16,67039,51554,37,79,72736,50653
454,42,2,1,0,3,1,0,49,57,67041,51555,48,37,72739,50653
455,42,2,3,1,0,0,3,58,44,67043,51558,65,24,72739,50656
456,42,0,2,1,0,0,3,279,232,67043,51560,286,19,72739,50659
457,42,3,2,0,3,1,0,29,26,67046,51562,30,34,72742,50659
458,42,1,0,0,3,1,0,33,10,67047,51562,45,18,72745,50659
459,42,3,2,0,3,1,0,238,241,67050,51564,225,26,72748,50659
460,42,1,0,0,3,1,0,32,30,67051,51564,31,57,72751,50659
461,42,3,0,0,3,1,0,28,23,67054,51564,37,16,72754,50659
0,1,2,2,2,1,2,1,267,226,67056,51566,277,20,72755,50660
1,1,1,2,1,0,0,3,145,167,67057,51568,146,37,72755,50663
2,1,1,2,1,0,0,3,29,25,67058,51570,37,208,72755,50666
3,1,0,0,2,1,2,1,12,28,67058,51570,13,24,72756,50667
4,1,2,1,0,3,1,0,31,27,67060,51571,33,18,72759,50667
5,1,1,2,1,0,0,3,92,102,67061,51573,92,39,72759,50670
6,1,2,1,0,3,1,0,124,116,67063,51574,139,0,72762,50670
7,1,2,0,0,3,1,0,30,18,67065,51574,38,0,72765,50670
8,1,4,1,0,3,1,0,25,12,67069,51575,38,24,72768,50670
9,1,3,1,0,3,1,0,241,242,67072,51576,228,0,72771,50670
10,1,2,0,0,3,1,0,45,58,67074,51576,40,17,72774,50670
11,2,2,2,2,1,2,1,34,32,67076,51578,32,17,72775,50671
12,2,2,3,1,0,0,3,2,3,67078,51581,0,22,72775,50674
13,2,0,0,2,1,2,1,49,57,67078,51581,49,178,72776,50675
14,2,0,1,1,0,0,3,24,22,67078,51582,31,15,72776,50678
15,2,1,1,2,1,2,1,1,1,67079,51583,1,21,72777,50679
16,2,1,0,0,3,1,0,41,18,67080,51583,46,26,72780,50679
17,2,3,2,0,3,1,0,61,101,67083,51585,62,79,72783,50679
18,2,0,0,2,1,2,1,33,10,67083,51585,46,47,72784,50680
19,2,0,1,1,0,0,3,26,17,67083,51586,37,199,72784,50683
20,2,1,2,1,0,0,3,1,2,67084,51588,0,100,72784,50686
21,2,1,1,2,1,2,1,280,233,67085,51589,287,22,72785,50687
22,3,1,1,2,1,2,1,26,13,67086,51590,39,18,72786,50688
23,3,2,1,0,3,1,0,47,59,67088,51591,43,79,72789,50688
24,3,1,1,2,1,2,1,30,26,67089,51592,38,18,72790,50689
25,3,2,3,1,0,0,3,14,31,67091,51595,13,21,72790,50692
26,3,1,4,1,0,0,3,32,31,67092,51599,33,23,72790,50695
27,3,0,0,2,1,2,1,92,102,67092,51599,93,1,72791,50696
28,3,0,2,1,0,0,3,49,59,67092,51601,49,3,72791,50699
29,3,3,2,0,3,1,0,27,24,67095,51603,34,37,72794,50699
30,3,6,0,0,3,1,0,273,226,67101,51603,280,0,72797,50699
31,3,1,0,0,3,1,0,146,167,67102,51603,149,199,72800,50699
32,3,2,0,0,3,1,0,282,233,67104,51603,290,24,72803,50699
33,4,1,0,0,3,1,0,42,18,67105,51603,49,15,72806,50699
34,4,2,1,0,3,1,0,36,33,67107,51604,35,24,72809,50699
35,4,2,1,0,3,1,0,32,19,67109,51605,41,100,72812,50699
36,4,1,3,1,0,0,3,3,6,67110,51608,0,29,72812,50702
37,4,0,1,1,0,0,3,1,3,67110,51609,0,24,72812,50705
38,4,0,1,1,0,0,3,1,2,67110,51610,1,25,72812,50708
39,4,2,0,0,3,1,0,63,101,67112,51610,65,47,72815,50708
40,4,2,0,0,3,1,0,243,242,67114,51610,231,22,72818,50708
41,4,0,2,1,0,0,3,33,12,67114,51612,46,42,72818,50711
42,4,1,3,1,0,0,3,125,119,67115,51615,139,181,72818,50714
43,4,0,1,1,0,0,3,26,18,67115,51616,37,211,72818,50717
44,5,2,2,2,1,2,1,148,169,67117,51618,150,24,72819,50718
45,5,0,1,1,0,0,3,30,27,67117,51619,38,202,72819,50721
46,5,1,1,2,1,2,1,15,32,67118,51620,14,4,72820,50722
47,5,4,2,0,3,1,0,36,33,67122,51622,36,18,72823,50722
48,5,2,1,0,3,1,0,94,103,67124,51623,96,79,72826,50722
49,5,3,0,0,3,1,0,52,59,67127,51623,52,1,72829,50722
50,5,1,1,2,1,2,1,28,25,67128,51624,35,1,72830,50723
51,5,4,2,0,3,1,0,30,15,67132,51626,42,37,72833,50723
52,5,0,0,2,1,2,1,273,226,67132,51626,281,19,72834,50724
53,5,2,1,0,3,1,0,35,13,67134,51627,49,21,72837,50724
54,5,0,0,2,1,2,1,282,233,67134,51627,291,25,72838,50725
55,6,1,1,2,1,2,1,27,19,67135,51628,38,43,72839,50726
56,6,1,3,1,0,0,3,37,36,67136,51631,35,184,72839,50729
57,6,1,2,1,0,0,3,31,29,67137,51633,38,103,72839,50732
58,6,2,0,0,3,1,0,49,59,67139,51633,46,22,72842,50732
59,6,2,0,0,3,1,0,34,19,67141,51633,44,47,72845,50732
60,6,0,0,2,1,2,1,3,6,67141,51633,1,25,72846,50733
61,6,3,2,0,3,1,0,4,5,67144,51635,3,37,72849,50733
62,6,1,2,1,0,0,3,2,4,67145,51637,1,214,72849,50736
63,6,2,0,0,3,1,0,44,18,67147,51637,52,24,72852,50736
64,6,1,2,1,0,0,3,244,244,67148,51639,231,18,72852,50739
65,6,3,2,0,3,1,0,128,121,67151,51641,142,29,72855,50739
66,7,2,2,2,1,2,1,96,105,67153,51643,97,19,72856,50740
67,7,1,2,1,0,0,3,274,228,67154,51645,281,217,72856,50743
68,7,0,1,1,0,0,3,35,14,67154,51646,49,205,72856,50746
69,7,1,0,0,3,1,0,16,32,67155,51646,17,43,72859,50746
70,7,1,3,1,0,0,3,37,36,67156,51649,36,7,72859,50749
71,7,2,4,1,0,0,3,130,125,67158,51653,142,27,72859,50752
72,7,3,3,2,1,2,1,37,22,67161,51656,45,26,72860,50753
73,7,1,1,2,1,2,1,4,7,67162,51657,2,104,72861,50754
74,7,1,1,2,1,2,1,29,26,67163,51658,36,26,72862,50755
75,7,5,3,0,3,1,0,68,104,67168,51661,68,21,72865,50755
76,7,1,2,1,0,0,3,31,17,67169,51663,42,4,72865,50758
77,8,0,2,1,0,0,3,27,21,67169,51665,38,28,72865,50761
78,8,1,0,0,3,1,0,38,36,67170,51665,38,27,72868,50761
79,8,1,1,2,1,2,1,32,30,67171,51666,39,30,72869,50762
80,8,2,2,2,1,2,1,51,61,67173,51668,47,2,72870,50763
81,8,2,0,0,3,1,0,39,36,67175,51668,39,24,72873,50763
82,8,0,1,1,0,0,3,96,106,67175,51669,97,21,72873,50766
83,8,0,0,2,1,2,1,52,59,67175,51669,53,80,72874,50767
84,8,2,3,1,0,0,3,4,7,67177,51672,1,7,72874,50770
85,8,1,1,2,1,2,1,245,245,67178,51673,232,38,72875,50771
86,8,1,0,0,3,1,0,283,233,67179,51673,294,19,72878,50771
87,8,1,1,2,1,2,1,149,170,67180,51674,151,185,72879,50772
88,9,1,0,0,3,1,0,69,104,67181,51674,71,22,72882,50772
89,9,2,1,0,3,1,0,46,19,67183,51675,55,26,72885,50772
90,9,1,1,2,1,2,1,275,229,67184,51676,282,206,72886,50773
91,9,0,4,1,0,0,3,38,40,67184,51680,38,46,72886,50776
92,9,1,2,1,0,0,3,131,127,67185,51682,142,31,72886,50779
93,9,1,1,2,1,2,1,38,23,67186,51683,46,20,72887,50780
94,9,2,1,0,3,1,0,6,8,67188,51684,5,7,72890,50780
95,9,2,1,0,3,1,0,6,6,67190,51685,6,26,72893,50780
96,9,1,1,2,1,2,1,30,27,67191,51686,37,48,72894,50781
97,9,1,3,1,0,0,3,150,173,67192,51689,151,220,72894,50784
98,9,3,1,0,3,1,0,34,18,67195,51690,45,21,72897,50784
99,10,3,0,0,3,1,0,38,14,67198,51690,52,27,72900,50784
100,10,1,2,1,0,0,3,33,32,67199,51692,39,188,72900,50787
101,10,1,0,0,3,1,0,17,32,67200,51692,20,80,72903,50787
102,10,2,0,0,3,1,0,41,36,67202,51692,42,19,72906,50787
103,10,2,1,0,3,1,0,98,107,67204,51693,100,2,72909,50787
104,10,0,2,1,0,0,3,52,61,67204,51695,53,33,72909,50790
105,10,1,1,2,1,2,1,5,8,67205,51696,2,25,72910,50791
106,10,1,0,0,3,1,0,246,245,67206,51696,235,21,72913,50791
107,10,1,0,0,3,1,0,284,233,67207,51696,297,7,72916,50791
108,10,2,1,0,3,1,0,29,22,67209,51697,41,104,72919,50791
109,10,0,3,1,0,0,3,51,64,67209,51700,47,41,72919,50794
110,11,1,1,2,1,2,1,151,174,67210,51701,152,8,72920,50795
111,11,1,3,1,0,0,3,39,43,67211,51704,38,51,72920,50798
112,11,1,1,2,1,2,1,132,128,67212,51705,143,207,72921,50799
113,11,2,0,0,3,1,0,40,23,67214,51705,49,26,72924,50799
114,11,1,0,0,3,1,0,7,6,67215,51705,9,21,72927,50799
115,11,1,0,0,3,1,0,31,27,67216,51705,40,46,72930,50799
116,11,2,1,0,3,1,0,48,20,67218,51706,58,20,72933,50799
117,11,4,1,0,3,1,0,73,105,67222,51707,74,26,72936,50799
118,11,3,2,0,3,1,0,37,20,67225,51709,48,31,72939,50799
119,11,0,0,2,1,2,1,275,229,67225,51709,283,23,72940,50800
120,11,1,0,0,3,1,0,7,8,67226,51709,8,220,72943,50800
121,12,0,1,1,0,0,3,33,33,67226,51710,39,28,72943,50803
122,12,0,2,1,0,0,3,17,34,67226,51712,20,44,72943,50806
123,12,0,3,1,0,0,3,51,67,67226,51715,47,36,72943,50809
124,12,1,2,1,0,0,3,42,38,67227,51717,42,107,72943,50812
125,12,2,1,0,3,1,0,100,108,67229,51718,103,27,72946,50812
126,12,1,1,2,1,2,1,53,62,67230,51719,54,3,72947,50813
127,12,4,2,0,3,1,0,9,10,67234,51721,5,188,72950,50813
128,12,1,0,0,3,1,0,247,245,67235,51721,238,19,72953,50813
129,12,2,1,0,3,1,0,286,234,67237,51722,300,80,72956,50813
130,12,2,1,0,3,1,0,40,15,67239,51723,55,7,72959,50813
131,12,2,1,0,3,1,0,31,23,67241,51724,44,21,72962,50813
132,13,1,0,0,3,1,0,49,20,67242,51724,61,46,72965,50813
133,13,1,0,0,3,1,0,40,43,67243,51724,41,26,72968,50813
134,13,2,0,0,3,1,0,134,128,67245,51724,146,8,72971,50813
135,13,0,1,1,0,0,3,40,24,67245,51725,49,24,72971,50816
136,13,1,0,0,3,1,0,8,8,67246,51725,11,23,72974,50816
137,13,1,0,0,3,1,0,8,6,67247,51725,12,20,72977,50816
138,13,2,5,1,0,0,3,33,32,67249,51730,40,210,72977,50819
139,13,3,1,0,3,1,0,76,106,67252,51731,77,31,72980,50819
140,13,2,0,0,3,1,0,277,229,67254,51731,286,51,72983,50819
141,13,1,0,0,3,1,0,152,174,67255,51731,155,26,72986,50819
142,13,0,1,1,0,0,3,37,21,67255,51732,48,223,72986,50822
143,14,0,1,1,0,0,3,33,34,67255,51733,39,26,72986,50825
144,14,1,1,2,1,2,1,101,109,67256,51734,104,37,72987,50826
145,14,0,0,2,1,2,1,134,128,67256,51734,147,22,72988,50827
146,14,3,1,0,3,1,0,56,63,67259,51735,57,44,72991,50827
147,14,1,2,1,0,0,3,10,12,67260,51737,5,22,72991,50830
148,14,2,2,2,1,2,1,51,22,67262,51739,62,8,72992,50831
149,14,0,0,2,1,2,1,247,245,67262,51739,239,224,72993,50832
150,14,0,0,2,1,2,1,40,15,67262,51739,56,29,72994,50833
151,14,3,1,0,3,1,0,34,24,67265,51740,47,3,72997,50833
152,14,0,1,1,0,0,3,17,35,67265,51741,20,110,72997,50836
153,14,0,0,2,1,2,1,51,67,67265,51741,48,189,72998,50837
154,15,1,1,2,1,2,1,77,107,67266,51742,78,28,72999,50838
155,15,2,1,0,3,1,0,39,22,67268,51743,51,8,73002,50838
156,15,0,1,1,0,0,3,51,68,67268,51744,48,29,73002,50841
157,15,2,2,2,1,2,1,44,40,67270,51746,43,47,73003,50842
158,15,1,5,1,0,0,3,41,29,67271,51751,49,34,73003,50845
159,15,0,1,1,0,0,3,8,9,67271,51752,11,213,73003,50848
160,15,2,2,2,1,2,1,10,8,67273,51754,13,23,73004,50849
161,15,0,2,1,0,0,3,33,34,67273,51756,40,83,73004,50852
162,15,0,1,1,0,0,3,277,230,67273,51757,286,23,73004,50855
163,15,2,1,0,3,1,0,154,175,67275,51758,158,51,73007,50855
164,15,1,1,2,1,2,1,287,235,67276,51759,301,25,73008,50856
165,16,0,1,1,0,0,3,56,64,67276,51760,57,32,73008,50859
166,16,1,1,2,1,2,1,18,36,67277,51761,21,190,73009,50860
167,16,0,0,2,1,2,1,101,109,67277,51761,105,225,73010,50861
168,16,1,3,1,0,0,3,135,131,67278,51764,147,113,73010,50864
169,16,2,2,2,1,2,1,12,10,67280,51766,14,30,73011,50865
170,16,2,2,2,1,2,1,12,14,67282,51768,6,24,73012,50866
171,16,0,1,1,0,0,3,51,23,67282,51769,62,25,73012,50869
172,16,2,1,0,3,1,0,79,108,67284,51770,81,3,73015,50869
173,16,1,1,2,1,2,1,248,246,67285,51771,240,27,73016,50870
174,16,0,1,1,0,0,3,40,16,67285,51772,56,29,73016,50873
175,16,1,1,2,1,2,1,41,44,67286,51773,42,38,73017,50874
176,17,1,3,1,0,0,3,52,71,67287,51776,48,26,73017,50877
177,17,0,1,1,0,0,3,44,41,67287,51777,43,54,73017,50880
178,17,0,3,1,0,0,3,41,32,67287,51780,49,11,73017,50883
179,17,2,4,1,0,0,3,14,18,67289,51784,6,37,73017,50886
180,17,1,1,2,1,2,1,278,231,67290,51785,287,31,73018,50887
181,17,0,1,1,0,0,3,248,247,67290,51786,240,31,73018,50890
182,17,1,0,0,3,1,0,288,235,67291,51786,304,47,73021,50890
183,17,1,0,0,3,1,0,155,175,67292,51786,161,38,73024,50890
184,17,1,1,2,1,2,1,35,25,67293,51787,48,45,73025,50891
185,17,0,1,1,0,0,3,8,10,67293,51788,11,86,73025,50894
186,17,3,1,0,3,1,0,36,35,67296,51789,42,25,73028,50894
187,18,2,2,2,1,2,1,43,46,67298,51791,43,9,73029,50895
188,18,1,1,2,1,2,1,102,110,67299,51792,106,214,73030,50896
189,18,3,2,0,3,1,0,138,133,67302,51794,150,32,73033,50896
190,18,1,0,0,3,1,0,13,10,67303,51794,17,3,73036,50896
191,18,0,2,1,0,0,3,56,66,67303,51796,57,116,73036,50899
192,18,0,3,1,0,0,3,33,37,67303,51799,40,27,73036,50902
193,18,1,2,1,0,0,3,80,110,67304,51801,81,28,73036,50905
194,18,2,2,2,1,2,1,42,18,67306,51803,57,28,73037,50906
195,18,0,0,2,1,2,1,39,22,67306,51803,52,191,73038,50907
196,18,2,2,2,1,2,1,20,38,67308,51805,22,30,73039,50908
197,18,1,0,0,3,1,0,52,23,67309,51805,65,225,73042,50908
198,19,1,1,2,1,2,1,279,232,67310,51806,288,12,73043,50909
199,19,0,0,2,1,2,1,36,35,67310,51806,43,38,73044,50910
200,19,3,2,0,3,1,0,47,43,67313,51808,46,38,73047,50910
201,19,1,1,2,1,2,1,42,33,67314,51809,50,32,73048,50911
202,19,1,0,0,3,1,0,9,10,67315,51809,14,31,73051,50911
203,19,0,2,1,0,0,3,14,20,67315,51811,6,57,73051,50914
204,19,2,1,0,3,1,0,250,248,67317,51812,243,47,73054,50914
205,19,4,2,0,3,1,0,292,237,67321,51814,307,45,73057,50914
206,19,1,0,0,3,1,0,156,175,67322,51814,164,26,73060,50914
207,19,1,0,0,3,1,0,36,25,67323,51814,51,86,73063,50914
208,19,1,3,1,0,0,3,53,74,67324,51817,48,28,73063,50917
209,20,0,2,1,0,0,3,56,68,67324,51819,57,31,73063,50920
210,20,0,0,2,1,2,1,43,46,67324,51819,44,4,73064,50921
211,20,2,2,2,1,2,1,22,40,67326,51821,23,28,73065,50922
212,20,1,2,1,0,0,3,103,112,67327,51823,106,35,73065,50925
213,20,2,2,2,1,2,1,140,135,67329,51825,151,29,73066,50926
214,20,3,1,0,3,1,0,16,11,67332,51826,20,30,73069,50926
215,20,2,1,0,3,1,0,35,38,67334,51827,43,225,73072,50926
216,20,2,2,2,1,2,1,54,25,67336,51829,66,10,73073,50927
217,20,1,1,2,1,2,1,40,23,67337,51830,53,215,73074,50928
218,20,0,0,2,1,2,1,42,18,67337,51830,58,117,73075,50929
219,20,1,0,0,3,1,0,81,110,67338,51830,84,191,73078,50929
220,21,0,0,2,1,2,1,292,237,67338,51830,308,27,73079,50930
221,21,0,2,1,0,0,3,36,37,67338,51832,43,34,73079,50933
222,21,3,0,0,3,1,0,56,74,67341,51832,51,57,73082,50933
223,21,2,1,0,3,1,0,49,44,67343,51833,49,86,73085,50933
224,21,2,2,2,1,2,1,11,12,67345,51835,15,29,73086,50934
225,21,2,4,1,0,0,3,16,24,67347,51839,6,48,73086,50937
226,21,0,1,1,0,0,3,279,233,67347,51840,288,41,73086,50940
227,21,2,1,0,3,1,0,252,249,67349,51841,246,12,73089,50940
228,21,0,0,2,1,2,1,36,25,67349,51841,52,39,73090,50941
229,21,2,1,0,3,1,0,158,176,67351,51842,167,32,73093,50941
230,21,1,1,2,1,2,1,43,34,67352,51843,51,48,73094,50942
231,22,0,1,1,0,0,3,16,25,67352,51844,6,218,73094,50945
232,22,2,1,0,3,1,0,294,238,67354,51845,311,35,73097,50945
233,22,0,2,1,0,0,3,42,20,67354,51847,58,32,73097,50948
234,22,0,1,1,0,0,3,36,26,67354,51848,52,34,73097,50951
235,22,1,1,2,1,2,1,44,47,67355,51849,45,31,73098,50952
236,22,2,1,0,3,1,0,58,69,67357,51850,60,57,73101,50952
237,22,3,1,0,3,1,0,19,12,67360,51851,23,86,73104,50952
238,22,4,0,0,3,1,0,15,12,67364,51851,18,29,73107,50952
239,22,3,3,2,1,2,1,38,41,67367,51854,44,40,73108,50953
240,22,1,2,1,0,0,3,55,27,67368,51856,66,194,73108,50956
241,22,3,1,0,3,1,0,84,111,67371,51857,87,117,73111,50956
242,23,1,1,2,1,2,1,280,234,67372,51858,289,49,73112,50957
243,23,1,0,0,3,1,0,44,34,67373,51858,54,27,73115,50957
244,23,2,1,0,3,1,0,38,38,67375,51859,46,4,73118,50957
245,23,2,0,0,3,1,0,160,176,67377,51859,170,12,73121,50957
246,23,0,1,1,0,0,3,22,41,67377,51860,23,35,73121,50960
247,23,0,2,1,0,0,3,140,137,67377,51862,151,51,73121,50963
248,23,1,1,2,1,2,1,50,45,67378,51863,50,226,73122,50964
249,23,4,2,0,3,1,0,256,251,67382,51865,249,28,73125,50964
250,23,1,2,1,0,0,3,104,114,67383,51867,106,44,73125,50967
251,23,2,0,0,3,1,0,58,74,67385,51867,54,10,73128,50967
252,23,1,4,1,0,0,3,41,27,67386,51871,53,37,73128,50970
253,24,2,2,2,1,2,1,21,14,67388,51873,24,58,73129,50971
254,24,3,1,0,3,1,0,87,112,67391,51874,90,35,73132,50971
255,24,1,1,2,1,2,1,37,27,67392,51875,53,36,73133,50972
256,24,0,2,1,0,0,3,44,49,67392,51877,45,35,73133,50975
257,24,0,2,1,0,0,3,140,139,67392,51879,151,37,73133,50978
258,24,1,0,0,3,1,0,56,27,67393,51879,69,31,73136,50978
259,24,2,2,2,1,2,1,18,27,67395,51881,7,50,73137,50979
260,24,0,0,2,1,2,1,44,34,67395,51881,55,41,73138,50980
261,24,0,0,2,1,2,1,15,12,67395,51881,19,195,73139,50981
262,24,0,0,2,1,2,1,42,20,67395,51881,59,227,73140,50982
263,24,2,0,0,3,1,0,258,251,67397,51881,252,117,73143,50982
264,25,2,0,0,3,1,0,162,176,67399,51881,173,29,73146,50982
265,25,3,1,0,3,1,0,44,28,67402,51882,56,4,73149,50982
266,25,0,0,2,1,2,1,58,74,67402,51882,55,13,73150,50983
267,25,1,0,0,3,1,0,39,38,67403,51882,49,10,73153,50983
268,25,3,1,0,3,1,0,25,42,67406,51883,26,37,73156,50983
269,25,1,2,1,0,0,3,105,116,67407,51885,106,54,73156,50986
270,25,0,0,2,1,2,1,50,45,67407,51885,51,219,73157,50987
271,25,1,3,1,0,0,3,59,72,67408,51888,60,47,73157,50990
272,25,1,0,0,3,1,0,295,238,67409,51888,314,28,73160,50990
273,25,0,0,2,1,2,1,38,41,67409,51888,45,28,73161,50991
274,25,1,0,0,3,1,0,281,234,67410,51888,292,86,73164,50991
275,26,1,1,2,1,2,1,19,28,67411,51889,8,36,73165,50992
276,26,1,1,2,1,2,1,141,140,67412,51890,152,59,73166,50993
277,26,1,2,1,0,0,3,22,16,67413,51892,24,53,73166,50996
278,26,0,1,1,0,0,3,44,35,67413,51893,55,198,73166,50999
279,26,1,2,1,0,0,3,45,51,67414,51895,45,50,73166,51002
280,26,0,0,2,1,2,1,56,27,67414,51895,70,118,73167,51003
281,26,1,4,1,0,0,3,38,31,67415,51899,53,34,73167,51006
282,26,0,2,1,0,0,3,87,114,67415,51901,90,44,73167,51009
283,26,0,0,2,1,2,1,258,251,67415,51901,253,37,73168,51010
284,26,2,0,0,3,1,0,17,12,67417,51901,22,35,73171,51010
285,26,1,0,0,3,1,0,59,74,67418,51901,58,227,73174,51010
286,27,1,0,0,3,1,0,282,234,67419,51901,295,28,73177,51010
287,27,2,0,0,3,1,0,164,176,67421,51901,176,37,73180,51010
288,27,0,2,1,0,0,3,50,47,67421,51903,51,40,73180,51013
289,27,3,2,0,3,1,0,47,30,67424,51905,59,86,73183,51013
290,27,2,2,2,1,2,1,107,118,67426,51907,107,30,73184,51014
291,27,1,0,0,3,1,0,43,20,67427,51907,62,4,73187,51014
292,27,3,1,0,3,1,0,298,239,67430,51908,317,10,73190,51014
293,27,1,2,1,0,0,3,26,44,67431,51910,26,222,73190,51017
294,27,1,1,2,1,2,1,60,73,67432,51911,61,29,73191,51018
295,27,2,0,0,3,1,0,89,114,67434,51911,93,13,73194,51018
296,27,2,1,0,3,1,0,40,42,67436,51912,48,37,73197,51018
297,28,1,2,1,0,0,3,61,75,67437,51914,61,39,73197,51021
298,28,0,1,1,0,0,3,19,29,67437,51915,8,37,73197,51024
299,28,1,1,2,1,2,1,39,32,67438,51916,54,60,73198,51025
300,28,1,1,2,1,2,1,57,28,67439,51917,71,87,73199,51026
301,28,0,2,1,0,0,3,39,40,67439,51919,49,33,73199,51029
302,28,1,0,0,3,1,0,165,176,67440,51919,179,4,73202,51029
303,28,0,0,2,1,2,1,59,74,67440,51919,59,36,73203,51030
304,28,1,1,2,1,2,1,46,52,67441,51920,46,55,73204,51031
305,28,0,0,2,1,2,1,258,251,67441,51920,254,51,73205,51032
306,28,2,1,0,3,1,0,24,17,67443,51921,27,44,73208,51032
307,28,2,1,0,3,1,0,300,240,67445,51922,320,198,73211,51032
308,29,3,0,0,3,1,0,46,20,67448,51922,65,29,73214,51032
309,29,3,2,0,3,1,0,60,30,67451,51924,74,28,73217,51032
310,29,1,1,2,1,2,1,48,31,67452,51925,60,38,73218,51033
311,29,3,0,0,3,1,0,43,42,67455,51925,51,37,73221,51033
312,29,1,1,2,1,2,1,27,45,67456,51926,27,61,73222,51034
313,29,1,1,2,1,2,1,142,141,67457,51927,153,54,73223,51035
314,29,2,2,2,1,2,1,26,19,67459,51929,28,11,73224,51036
315,29,3,2,0,3,1,0,92,116,67462,51931,96,222,73227,51036
316,29,0,3,1,0,0,3,44,38,67462,51934,55,230,73227,51039
317,29,2,0,0,3,1,0,284,234,67464,51934,298,118,73230,51039
318,29,0,2,1,0,0,3,17,14,67464,51936,22,43,73230,51042
319,30,4,1,0,3,1,0,65,76,67468,51937,64,28,73233,51042
320,30,0,1,1,0,0,3,46,21,67468,51938,65,90,73233,51045
321,30,0,1,1,0,0,3,39,33,67468,51939,54,36,73233,51048
322,30,2,1,0,3,1,0,21,30,67470,51940,11,4,73236,51048
323,30,0,0,2,1,2,1,39,40,67470,51940,50,14,73237,51049
324,30,2,2,2,1,2,1,109,120,67472,51942,108,37,73238,51050
325,30,1,2,1,0,0,3,51,49,67473,51944,51,58,73238,51053
326,30,0,0,2,1,2,1,258,251,67473,51944,255,199,73239,51054
327,30,1,2,1,0,0,3,60,76,67474,51946,59,40,73239,51057
328,30,2,1,0,3,1,0,29,46,67476,51947,30,44,73242,51057
329,30,1,4,1,0,0,3,301,244,67477,51951,320,121,73242,51060
330,31,1,1,2,1,2,1,61,31,67478,51952,75,52,73243,51061
331,31,0,0,2,1,2,1,284,234,67478,51952,299,39,73244,51062
332,31,1,0,0,3,1,0,143,141,67479,51952,156,39,73247,51062
333,31,2,2,2,1,2,1,46,40,67481,51954,56,38,73248,51063
334,31,3,3,2,1,2,1,20,17,67484,51957,23,62,73249,51064
335,31,2,1,0,3,1,0,50,32,67486,51958,63,54,73252,51064
336,31,2,0,0,3,1,0,45,42,67488,51958,54,11,73255,51064
337,31,2,3,1,0,0,3,48,55,67490,51961,46,225,73255,51067
338,31,1,1,2,1,2,1,27,20,67491,51962,29,231,73256,51068
339,31,2,0,0,3,1,0,167,176,67493,51962,182,29,73259,51068
340,31,1,1,2,1,2,1,93,117,67494,51963,97,44,73260,51069
341,32,1,0,0,3,1,0,259,251,67495,51963,258,90,73263,51069
342,32,5,2,0,3,1,0,114,122,67500,51965,111,28,73266,51069
343,32,2,1,0,3,1,0,62,77,67502,51966,62,36,73269,51069
344,32,6,0,0,3,1,0,307,244,67508,51966,323,4,73272,51069
345,32,0,0,2,1,2,1,29,46,67508,51966,31,15,73273,51070
346,32,2,2,2,1,2,1,67,78,67510,51968,65,38,73274,51071
347,32,3,0,0,3,1,0,42,40,67513,51968,53,58,73277,51071
348,32,2,0,0,3,1,0,48,21,67515,51968,68,44,73280,51071
349,32,1,2,1,0,0,3,52,51,67516,51970,51,202,73280,51074
350,32,3,1,0,3,1,0,24,31,67519,51971,14,121,73283,51074
351,32,0,1,1,0,0,3,39,34,67519,51972,54,43,73283,51077
352,33,3,2,0,3,1,0,170,178,67522,51974,185,38,73286,51077
353,33,2,0,0,3,1,0,47,42,67524,51974,57,39,73289,51077
354,33,1,2,1,0,0,3,94,119,67525,51976,97,42,73289,51080
355,33,1,2,1,0,0,3,62,33,67526,51978,75,65,73289,51083
356,33,1,2,1,0,0,3,21,19,67527,51980,23,57,73289,51086
357,33,2,0,0,3,1,0,286,234,67529,51980,302,11,73292,51086
358,33,2,2,2,1,2,1,48,42,67531,51982,57,226,73293,51087
359,33,1,0,0,3,1,0,144,141,67532,51982,159,231,73296,51087
360,33,2,0,0,3,1,0,29,20,67534,51982,32,52,73299,51087
361,33,0,1,1,0,0,3,48,56,67534,51983,46,32,73299,51090
362,33,1,1,2,1,2,1,51,33,67535,51984,64,45,73300,51091
363,34,2,1,0,3,1,0,50,22,67537,51985,71,58,73303,51091
364,34,0,3,1,0,0,3,39,37,67537,51988,54,18,73303,51094
365,34,2,1,0,3,1,0,64,78,67539,51989,65,121,73306,51094
366,34,1,0,0,3,1,0,43,40,67540,51989,56,28,73309,51094
367,34,2,1,0,3,1,0,26,32,67542,51990,17,90,73312,51094
368,34,1,1,2,1,2,1,30,47,67543,51991,32,37,73313,51095
369,34,2,1,0,3,1,0,54,52,67545,51992,54,4,73316,51095
370,34,0,0,2,1,2,1,259,251,67545,51992,259,39,73317,51096
371,34,1,2,1,0,0,3,68,80,67546,51994,65,46,73317,51099
372,34,1,0,0,3,1,0,115,122,67547,51994,114,202,73320,51099
373,34,1,0,0,3,1,0,308,244,67548,51994,326,44,73323,51099
374,35,2,0,0,3,1,0,31,20,67550,51994,35,46,73326,51099
375,35,1,3,1,0,0,3,55,55,67551,51997,54,42,73326,51102
376,35,4,1,0,3,1,0,174,179,67555,51998,188,42,73329,51102
377,35,2,0,0,3,1,0,288,234,67557,51998,305,45,73332,51102
378,35,1,1,2,1,2,1,52,34,67558,51999,65,66,73333,51103
379,35,1,2,1,0,0,3,49,44,67559,52001,57,14,73333,51106
380,35,2,2,2,1,2,1,49,44,67561,52003,58,53,73334,51107
381,35,1,1,2,1,2,1,22,20,67562,52004,24,33,73335,51108
382,35,0,2,1,0,0,3,48,58,67562,52006,46,93,73335,51111
383,35,0,2,1,0,0,3,94,121,67562,52008,97,60,73335,51114
384,35,3,0,0,3,1,0,311,244,67565,52008,329,226,73338,51114
385,36,0,6,1,0,0,3,62,39,67565,52014,75,61,73338,51117
386,36,3,1,0,3,1,0,46,41,67568,52015,59,45,73341,51117
387,36,0,2,1,0,0,3,259,253,67568,52017,259,7,73341,51120
388,36,1,2,1,0,0,3,49,60,67569,52019,46,21,73341,51123
389,36,1,3,1,0,0,3,145,144,67570,52022,159,42,73341,51126
390,36,0,4,1,0,0,3,26,36,67570,52026,17,47,73341,51129
391,36,1,1,2,1,2,1,40,38,67571,52027,55,203,73342,51130
392,36,0,0,2,1,2,1,30,47,67571,52027,33,232,73343,51131
393,36,3,1,0,3,1,0,118,123,67574,52028,117,121,73346,51131
394,36,1,3,1,0,0,3,51,25,67575,52031,71,40,73346,51134
395,36,1,2,1,0,0,3,69,82,67576,52033,65,41,73346,51137
396,37,1,2,1,0,0,3,65,80,67577,52035,65,229,73346,51140
397,37,0,0,2,1,2,1,174,179,67577,52035,189,94,73347,51141
398,37,1,0,0,3,1,0,53,34,67578,52035,68,28,73350,51141
399,37,2,0,0,3,1,0,290,234,67580,52035,308,42,73353,51141
400,37,2,1,0,3,1,0,313,245,67582,52036,332,66,73356,51141
401,37,3,0,0,3,1,0,52,44,67585,52036,61,21,73359,51141
402,37,2,0,0,3,1,0,48,41,67587,52036,62,60,73362,51141
403,37,0,1,1,0,0,3,40,39,67587,52037,55,17,73362,51144
404,37,2,2,2,1,2,1,51,46,67589,52039,58,47,73363,51145
405,37,0,2,1,0,0,3,22,22,67589,52041,24,64,73363,51148
406,37,0,1,1,0,0,3,55,56,67589,52042,54,56,73363,51151
407,38,0,2,1,0,0,3,52,46,67589,52044,61,206,73363,51154
408,38,0,0,2,1,2,1,30,47,67589,52044,34,43,73364,51155
409,38,0,2,1,0,0,3,49,62,67589,52046,46,48,73364,51158
410,38,3,1,0,3,1,0,121,124,67592,52047,120,41,73367,51158
411,38,0,0,2,1,2,1,31,20,67592,52047,36,41,73368,51159
412,38,2,1,0,3,1,0,147,145,67594,52048,162,7,73371,51159
413,38,2,1,0,3,1,0,53,26,67596,52049,74,17,73374,51159
414,38,0,2,1,0,0,3,62,41,67596,52051,75,232,73374,51162
415,38,6,0,0,3,1,0,100,121,67602,52051,100,33,73377,51162
416,38,0,1,1,0,0,3,69,83,67602,52052,65,235,73377,51165
417,38,0,1,1,0,0,3,53,35,67602,52053,68,124,73377,51168
418,39,1,0,0,3,1,0,27,36,67603,52053,20,28,73380,51168
419,39,1,0,0,3,1,0,56,56,67604,52053,57,42,73383,51168
420,39,2,0,0,3,1,0,261,253,67606,52053,262,66,73386,51168
421,39,1,1,2,1,2,1,49,42,67607,52054,63,95,73387,51169
422,39,1,0,0,3,1,0,175,179,67608,52054,192,60,73390,51169
423,39,2,1,0,3,1,0,42,40,67610,52055,58,42,73393,51169
424,39,2,4,1,0,0,3,53,50,67612,52059,58,67,73393,51172
425,39,1,2,1,0,0,3,66,82,67613,52061,65,59,73393,51175
426,39,3,1,0,3,1,0,293,235,67616,52062,311,47,73396,51175
427,39,0,0,2,1,2,1,22,22,67616,52062,25,22,73397,51176
428,39,3,1,0,3,1,0,316,246,67619,52063,335,47,73400,51176
429,40,2,2,2,1,2,1,32,49,67621,52065,35,49,73401,51177
430,40,4,0,0,3,1,0,57,26,67625,52065,77,43,73404,51177
431,40,3,3,2,1,2,1,56,38,67628,52068,69,42,73405,51178
432,40,2,1,0,3,1,0,54,47,67630,52069,64,41,73408,51178
433,40,3,0,0,3,1,0,65,41,67633,52069,78,7,73411,51178
434,40,3,1,0,3,1,0,124,125,67636,52070,123,17,73414,51178
435,40,1,2,1,0,0,3,32,22,67637,52072,36,209,73414,51181
436,40,0,0,2,1,2,1,69,83,67637,52072,66,233,73415,51182
437,40,1,1,2,1,2,1,148,146,67638,52073,163,34,73416,51183
438,40,2,0,0,3,1,0,102,121,67640,52073,103,235,73419,51183
439,40,1,1,2,1,2,1,50,63,67641,52074,47,125,73420,51184
440,41,3,0,0,3,1,0,178,179,67644,52074,195,59,73423,51184
441,41,2,0,0,3,1,0,318,246,67646,52074,338,42,73426,51184
442,41,1,2,1,0,0,3,23,24,67647,52076,25,31,73426,51187
443,41,3,1,0,3,1,0,45,41,67650,52077,61,42,73429,51187
444,41,3,2,0,3,1,0,52,44,67653,52079,66,66,73432,51187
445,41,1,1,2,1,2,1,54,51,67654,52080,59,96,73433,51188
446,41,0,1,1,0,0,3,56,57,67654,52081,57,25,73433,51191
447,41,1,3,1,0,0,3,67,85,67655,52084,65,63,73433,51194
448,41,3,0,0,3,1,0,30,36,67658,52084,23,47,73436,51194
449,41,4,1,0,3,1,0,265,254,67662,52085,265,47,73439,51194
450,41,1,3,1,0,0,3,294,238,67663,52088,311,70,73439,51197
451,42,4,1,0,3,1,0,128,126,67667,52089,126,49,73442,51197
452,42,3,1,0,3,1,0,60,27,67670,52090,80,209,73445,51197
453,42,1,3,1,0,0,3,33,25,67671,52093,36,236,73445,51200
454,42,1,1,2,1,2,1,55,48,67672,52094,65,126,73446,51201
455,42,0,2,1,0,0,3,65,43,67672,52096,78,46,73446,51204
456,42,3,2,0,3,1,0,151,148,67675,52098,166,42,73449,51204
457,42,2,0,0,3,1,0,71,83,67677,52098,69,41,73452,51204
458,42,3,0,0,3,1,0,35,49,67680,52098,38,7,73455,51204
459,42,1,0,0,3,1,0,103,121,67681,52098,106,17,73458,51204
460,42,0,0,2,1,2,1,50,63,67681,52098,48,236,73459,51205
461,42,0,3,1,0,0,3,56,41,67681,52101,69,37,73459,51208
0,1,1,1,2,1,2,1,56,49,67682,52102,66,127,73460,51209
1,1,2,1,0,3,1,0,37,50,67684,52103,41,42,73463,51209
2,1,1,0,0,3,1,0,129,126,67685,52103,129,49,73466,51209
3,1,1,1,2,1,2,1,152,149,67686,52104,167,48,73467,51210
4,1,1,1,2,1,2,1,55,52,67687,52105,60,38,73468,51211
5,1,1,3,1,0,0,3,34,28,67688,52108,36,66,73468,51214
6,1,1,1,2,1,2,1,66,44,67689,52109,79,1,73469,51215
7,1,1,0,0,3,1,0,1,0,67690,52109,3,0,73472,51215
8,1,2,1,0,3,1,0,22,26,67692,52110,20,37,73475,51215
9,1,2,0,0,3,1,0,62,27,67694,52110,83,46,73478,51215
10,1,0,3,1,0,0,3,51,79,67694,52113,55,239,73478,51218
11,2,2,2,2,1,2,1,60,46,67696,52115,66,97,73479,51219
12,2,1,3,1,0,0,3,53,47,67697,52118,66,45,73479,51222
13,2,2,0,0,3,1,0,69,85,67699,52118,68,25,73482,51222
14,2,2,1,0,3,1,0,58,58,67701,52119,60,41,73485,51222
15,2,1,1,2,1,2,1,179,180,67702,52120,196,16,73486,51223
16,2,3,1,0,3,1,0,48,42,67705,52121,64,34,73489,51223
17,2,1,0,0,3,1,0,57,41,67706,52121,72,0,73492,51223
18,2,2,1,0,3,1,0,267,255,67708,52122,268,66,73495,51223
19,2,0,1,1,0,0,3,0,1,67708,52123,0,45,73495,51226
20,2,1,2,1,0,0,3,1,2,67709,52125,0,62,73495,51229
21,2,3,2,0,3,1,0,74,85,67712,52127,72,47,73498,51229
22,3,1,2,1,0,0,3,57,51,67713,52129,66,65,73498,51232
23,3,2,0,0,3,1,0,181,180,67715,52129,199,48,73501,51232
24,3,2,0,0,3,1,0,39,50,67717,52129,44,0,73504,51232
25,3,3,1,0,3,1,0,132,127,67720,52130,132,42,73507,51232
26,3,0,3,1,0,0,3,152,152,67720,52133,167,242,73507,51235
27,3,1,1,2,1,2,1,35,29,67721,52134,37,38,73508,51236
28,3,1,1,2,1,2,1,67,45,67722,52135,80,42,73509,51237
29,3,1,2,1,0,0,3,2,2,67723,52137,3,69,73509,51240
30,3,1,1,2,1,2,1,2,3,67724,52138,1,47,73510,51241
31,3,3,1,0,3,1,0,25,27,67727,52139,23,49,73513,51241
32,3,1,4,1,0,0,3,52,83,67728,52143,55,41,73513,51244
33,4,0,0,2,1,2,1,69,85,67728,52143,69,48,73514,51245
34,4,2,0,0,3,1,0,55,47,67730,52143,69,16,73517,51245
35,4,1,0,0,3,1,0,59,58,67731,52143,63,1,73520,51245
36,4,1,0,0,3,1,0,56,52,67732,52143,63,66,73523,51245
37,4,2,3,1,0,0,3,50,45,67734,52146,64,130,73523,51248
38,4,4,2,0,3,1,0,78,87,67738,52148,75,97,73526,51248
39,4,1,1,2,1,2,1,61,47,67739,52149,67,26,73527,51249
40,4,2,2,2,1,2,1,59,43,67741,52151,73,46,73528,51250
41,4,2,1,0,3,1,0,269,256,67743,52152,271,0,73531,51250
42,4,0,0,2,1,2,1,0,1,67743,52152,1,35,73532,51251
43,4,2,2,2,1,2,1,64,29,67745,52154,84,46,73533,51252
44,5,0,2,1,0,0,3,152,154,67745,52156,167,3,73533,51255
45,5,1,1,2,1,2,1,182,181,67746,52157,200,42,73534,51256
46,5,1,0,0,3,1,0,53,83,67747,52157,58,42,73537,51256
47,5,0,0,2,1,2,1,132,127,67747,52157,133,47,73538,51257
48,5,1,2,1,0,0,3,36,31,67748,52159,37,68,73538,51260
49,5,2,2,2,1,2,1,52,47,67750,52161,65,50,73539,51261
50,5,1,0,0,3,1,0,58,51,67751,52161,69,69,73542,51261
51,5,3,2,0,3,1,0,70,47,67754,52163,83,48,73545,51261
52,5,3,1,0,3,1,0,5,3,67757,52164,6,47,73548,51261
53,5,0,2,1,0,0,3,25,29,67757,52166,23,245,73548,51264
54,5,1,1,2,1,2,1,3,4,67758,52167,2,43,73549,51265
55,6,1,0,0,3,1,0,62,47,67759,52167,70,16,73552,51265
56,6,1,0,0,3,1,0,56,47,67760,52167,72,35,73555,51265
57,6,2,1,0,3,1,0,41,51,67762,52168,47,0,73558,51265
58,6,2,1,0,3,1,0,71,86,67764,52169,72,46,73561,51265
59,6,2,2,2,1,2,1,58,54,67766,52171,64,27,73562,51266
60,6,2,2,2,1,2,1,80,89,67768,52173,76,43,73563,51267
61,6,2,0,0,3,1,0,72,47,67770,52173,86,97,73566,51267
62,6,0,1,1,0,0,3,59,44,67770,52174,73,4,73566,51270
63,6,0,0,2,1,2,1,269,256,67770,52174,272,39,73567,51271
64,6,1,0,0,3,1,0,1,1,67771,52174,4,66,73570,51271
65,6,0,3,1,0,0,3,64,32,67771,52177,84,133,73570,51274
66,7,1,2,1,0,0,3,133,129,67772,52179,133,72,73570,51277
67,7,1,1,2,1,2,1,153,155,67773,52180,168,51,73571,51278
68,7,1,0,0,3,1,0,183,181,67774,52180,203,47,73574,51278
69,7,1,0,0,3,1,0,37,31,67775,52180,40,48,73577,51278
70,7,2,1,0,3,1,0,54,48,67777,52181,68,43,73580,51278
71,7,1,2,1,0,0,3,63,49,67778,52183,70,6,73580,51281
72,7,1,0,0,3,1,0,270,256,67779,52183,275,47,73583,51281
73,7,1,0,0,3,1,0,26,29,67780,52183,26,48,73586,51281
74,7,1,1,2,1,2,1,4,5,67781,52184,3,47,73587,51282
75,7,3,0,0,3,1,0,62,58,67784,52184,66,0,73590,51282
76,7,2,0,0,3,1,0,55,83,67786,52184,61,68,73593,51282
77,8,2,1,0,3,1,0,74,48,67788,52185,89,133,73596,51282
78,8,2,0,0,3,1,0,58,47,67790,52185,75,66,73599,51282
79,8,1,0,0,3,1,0,42,51,67791,52185,50,39,73602,51282
80,8,2,0,0,3,1,0,73,86,67793,52185,75,4,73605,51282
81,8,1,2,1,0,0,3,59,56,67794,52187,64,248,73605,51285
82,8,4,0,0,3,1,0,62,51,67798,52187,72,35,73608,51285
83,8,1,4,1,0,0,3,6,7,67799,52191,6,30,73608,51288
84,8,1,0,0,3,1,0,60,44,67800,52191,76,42,73611,51288
85,8,3,1,0,3,1,0,4,2,67803,52192,7,43,73614,51288
86,8,2,2,2,1,2,1,66,34,67805,52194,85,98,73615,51289
87,8,1,5,1,0,0,3,81,94,67806,52199,76,19,73615,51292
88,9,2,1,0,3,1,0,39,32,67808,52200,43,47,73618,51292
89,9,4,2,0,3,1,0,67,51,67812,52202,73,51,73621,51292
90,9,0,2,1,0,0,3,54,50,67812,52204,68,51,73621,51295
91,9,0,0,2,1,2,1,55,83,67812,52204,62,67,73622,51296
92,9,0,3,1,0,0,3,62,61,67812,52207,66,50,73622,51299
93,9,0,3,1,0,0,3,153,158,67812,52210,168,50,73622,51302
94,9,2,0,0,3,1,0,185,181,67814,52210,206,43,73625,51302
95,9,4,0,0,3,1,0,274,256,67818,52210,278,68,73628,51302
96,9,1,1,2,1,2,1,27,30,67819,52211,27,7,73629,51303
97,9,1,1,2,1,2,1,5,6,67820,52212,4,1,73630,51304
98,9,1,3,1,0,0,3,61,47,67821,52215,76,75,73630,51307
99,10,2,1,0,3,1,0,135,130,67823,52216,136,42,73633,51307
100,10,2,4,1,0,0,3,60,51,67825,52220,75,33,73633,51310
101,10,1,1,2,1,2,1,56,84,67826,52221,63,49,73634,51311
102,10,1,0,0,3,1,0,63,61,67827,52221,69,248,73637,51311
103,10,0,2,1,0,0,3,81,96,67827,52223,76,136,73637,51314
104,10,0,0,2,1,2,1,62,51,67827,52223,73,44,73638,51315
105,10,1,2,1,0,0,3,7,9,67828,52225,6,54,73638,51318
106,10,0,0,2,1,2,1,4,2,67828,52225,8,40,73639,51319
107,10,0,0,2,1,2,1,66,34,67828,52225,86,20,73640,51320
108,10,0,3,1,0,0,3,5,9,67828,52228,4,101,73640,51323
109,10,1,1,2,1,2,1,43,52,67829,52229,51,52,73641,51324
110,11,1,0,0,3,1,0,275,256,67830,52229,281,33,73644,51324
111,11,1,0,0,3,1,0,82,96,67831,52229,79,35,73647,51324
112,11,1,1,2,1,2,1,74,87,67832,52230,76,2,73648,51325
113,11,4,2,0,3,1,0,157,160,67836,52232,171,50,73651,51325
114,11,1,1,2,1,2,1,60,57,67837,52233,65,8,73652,51326
115,11,2,0,0,3,1,0,187,181,67839,52233,209,4,73655,51326
116,11,0,0,2,1,2,1,54,50,67839,52233,69,68,73656,51327
117,11,1,1,2,1,2,1,68,52,67840,52234,74,69,73657,51328
118,11,1,1,2,1,2,1,75,49,67841,52235,90,48,73658,51329
119,11,2,0,0,3,1,0,63,47,67843,52235,79,50,73661,51329
120,11,0,3,1,0,0,3,27,33,67843,52238,27,46,73661,51332
121,12,1,3,1,0,0,3,5,5,67844,52241,8,251,73661,51335
122,12,2,0,0,3,1,0,62,51,67846,52241,78,42,73664,51335
123,12,2,3,1,0,0,3,45,55,67848,52244,51,104,73664,51338
124,12,3,2,0,3,1,0,59,86,67851,52246,66,44,73667,51338
125,12,1,1,2,1,2,1,64,62,67852,52247,70,53,73668,51339
126,12,3,3,2,1,2,1,138,133,67855,52250,137,137,73669,51340
127,12,1,0,0,3,1,0,40,32,67856,52250,46,49,73672,51340
128,12,0,0,2,1,2,1,62,51,67856,52250,74,55,73673,51341
129,12,1,0,0,3,1,0,8,9,67857,52250,9,20,73676,51341
130,12,1,1,2,1,2,1,67,35,67858,52251,87,41,73677,51342
131,12,1,1,2,1,2,1,6,10,67859,52252,5,76,73678,51343
132,13,1,0,0,3,1,0,75,87,67860,52252,79,8,73681,51343
133,13,2,1,0,3,1,0,159,161,67862,52253,174,2,73684,51343
134,13,2,1,0,3,1,0,62,58,67864,52254,68,50,73687,51343
135,13,0,1,1,0,0,3,54,51,67864,52255,69,7,73687,51346
136,13,2,1,0,3,1,0,84,97,67866,52256,82,48,73690,51346
137,13,0,1,1,0,0,3,68,53,67866,52257,74,49,73690,51349
138,13,1,1,2,1,2,1,76,50,67867,52258,91,36,73691,51350
139,13,1,1,2,1,2,1,64,48,67868,52259,80,70,73692,51351
140,13,2,1,0,3,1,0,29,34,67870,52260,30,68,73695,51351
141,13,1,0,0,3,1,0,63,51,67871,52260,77,33,73698,51351
142,13,1,0,0,3,1,0,188,181,67872,52260,212,251,73701,51351
143,14,1,1,2,1,2,1,63,59,67873,52261,69,21,73702,51352
144,14,1,4,1,0,0,3,63,55,67874,52265,78,79,73702,51355
145,14,1,3,1,0,0,3,60,89,67875,52268,66,56,73702,51358
146,14,2,2,2,1,2,1,66,64,67877,52270,71,42,73703,51359
147,14,3,2,0,3,1,0,141,135,67880,52272,140,104,73706,51359
148,14,2,1,0,3,1,0,42,33,67882,52273,49,7,73709,51359
149,14,1,2,1,0,0,3,9,11,67883,52275,9,53,73709,51362
150,14,2,0,0,3,1,0,277,256,67885,52275,284,42,73712,51362
151,14,0,2,1,0,0,3,5,7,67885,52277,8,140,73712,51365
152,14,3,0,0,3,1,0,70,35,67888,52277,90,55,73715,51365
153,14,0,1,1,0,0,3,45,56,67888,52278,51,52,73715,51368
154,15,1,1,2,1,2,1,189,182,67889,52279,213,37,73716,51369
155,15,3,2,0,3,1,0,162,163,67892,52281,177,44,73719,51369
156,15,2,1,0,3,1,0,56,52,67894,52282,72,42,73722,51369
157,15,2,0,0,3,1,0,86,97,67896,52282,85,70,73725,51369
158,15,1,1,2,1,2,1,64,52,67897,52283,78,51,73726,51370
159,15,3,1,0,3,1,0,79,51,67900,52284,94,49,73729,51370
160,15,0,2,1,0,0,3,9,13,67900,52286,9,71,73729,51373
161,15,1,1,2,1,2,1,65,49,67901,52287,81,9,73730,51374
162,15,2,3,1,0,0,3,31,37,67903,52290,30,36,73730,51377
163,15,0,3,1,0,0,3,6,13,67903,52293,5,51,73730,51380
164,15,1,1,2,1,2,1,76,88,67904,52294,80,252,73731,51381
165,16,0,1,1,0,0,3,68,54,67904,52295,74,82,73731,51384
166,16,0,0,2,1,2,1,63,55,67904,52295,79,43,73732,51385
167,16,2,1,0,3,1,0,68,65,67906,52296,74,140,73735,51385
168,16,0,1,1,0,0,3,141,136,67906,52297,140,58,73735,51388
169,16,2,2,2,1,2,1,65,61,67908,52299,70,57,73736,51389
170,16,1,2,1,0,0,3,43,35,67909,52301,49,107,73736,51392
171,16,3,1,0,3,1,0,280,257,67912,52302,287,52,73739,51392
172,16,2,2,2,1,2,1,7,9,67914,52304,9,8,73740,51393
173,16,2,0,0,3,1,0,72,35,67916,52304,93,2,73743,51393
174,16,1,1,2,1,2,1,61,90,67917,52305,67,22,73744,51394
175,16,2,0,0,3,1,0,47,56,67919,52305,54,53,73747,51394
176,17,3,3,2,1,2,1,50,59,67922,52308,55,253,73748,51395
177,17,2,0,0,3,1,0,78,88,67924,52308,83,140,73751,51395
178,17,2,2,2,1,2,1,164,165,67926,52310,178,23,73752,51396
179,17,1,1,2,1,2,1,44,36,67927,52311,50,50,73753,51397
180,17,4,0,0,3,1,0,90,97,67931,52311,88,44,73756,51397
181,17,1,0,0,3,1,0,65,52,67932,52311,81,42,73759,51397
182,17,1,1,2,1,2,1,80,52,67933,52312,95,52,73760,51398
183,17,1,0,0,3,1,0,73,35,67934,52312,96,9,73763,51398
184,17,3,3,2,1,2,1,9,16,67937,52315,6,38,73764,51399
185,17,2,1,0,3,1,0,11,14,67939,52316,12,43,73767,51399
186,17,1,1,2,1,2,1,66,50,67940,52317,82,72,73768,51400
187,18,2,0,0,3,1,0,282,257,67942,52317,290,53,73771,51400
188,18,2,2,2,1,2,1,80,90,67944,52319,84,53,73772,51401
189,18,0,0,2,1,2,1,141,136,67944,52319,141,9,73773,51402
190,18,3,0,0,3,1,0,68,61,67947,52319,73,2,73776,51402
191,18,3,1,0,3,1,0,192,183,67950,52320,216,52,73779,51402
192,18,3,3,2,1,2,1,59,55,67953,52323,73,83,73780,51403
193,18,3,1,0,3,1,0,71,55,67956,52324,77,58,73783,51403
194,18,3,2,0,3,1,0,34,39,67959,52326,33,51,73786,51403
195,18,3,2,0,3,1,0,10,11,67962,52328,12,36,73789,51403
196,18,0,1,1,0,0,3,68,66,67962,52329,74,73,73789,51406
197,18,1,3,1,0,0,3,62,93,67963,52332,67,110,73789,51409
198,19,2,1,0,3,1,0,92,98,67965,52333,91,9,73792,51409
199,19,1,3,1,0,0,3,51,62,67966,52336,55,45,73792,51412
200,19,2,0,0,3,1,0,166,165,67968,52336,181,43,73795,51412
201,19,2,2,2,1,2,1,46,38,67970,52338,51,39,73796,51413
202,19,3,0,0,3,1,0,68,52,67973,52338,84,72,73799,51413
203,19,1,3,1,0,0,3,81,55,67974,52341,95,256,73799,51416
204,19,0,0,2,1,2,1,11,14,67974,52341,13,141,73800,51417
205,19,1,1,2,1,2,1,10,17,67975,52342,7,24,73801,51418
206,19,0,1,1,0,0,3,66,51,67975,52343,82,53,73801,51421
207,19,2,0,0,3,1,0,65,55,67977,52343,82,57,73804,51421
208,19,4,0,0,3,1,0,77,35,67981,52343,99,44,73807,51421
209,20,1,1,2,1,2,1,63,94,67982,52344,68,52,73808,51422
210,20,0,0,2,1,2,1,80,90,67982,52344,85,84,73809,51423
211,20,0,0,2,1,2,1,68,66,67982,52344,75,111,73810,51424
212,20,1,0,0,3,1,0,142,136,67983,52344,144,73,73813,51424
213,20,0,1,1,0,0,3,68,62,67983,52345,73,56,73813,51427
214,20,1,0,0,3,1,0,193,183,67984,52345,219,36,73816,51427
215,20,3,3,2,1,2,1,62,58,67987,52348,74,54,73817,51428
216,20,2,0,0,3,1,0,284,257,67989,52348,293,9,73820,51428
217,20,2,3,1,0,0,3,36,42,67991,52351,33,61,73820,51431
218,20,1,2,1,0,0,3,11,13,67992,52353,12,55,73820,51434
219,20,2,0,0,3,1,0,73,55,67994,52353,80,2,73823,51434
220,21,4,1,0,3,1,0,69,56,67998,52354,85,53,73826,51434
221,21,1,0,0,3,1,0,52,62,67999,52354,58,44,73829,51434
222,21,1,1,2,1,2,1,167,166,68000,52355,182,142,73830,51435
223,21,3,1,0,3,1,0,49,39,68003,52356,54,72,73833,51435
224,21,3,2,0,3,1,0,95,100,68006,52358,94,256,73836,51435
225,21,1,0,0,3,1,0,69,52,68007,52358,87,24,73839,51435
226,21,0,0,2,1,2,1,81,55,68007,52358,96,10,73840,51436
227,21,1,3,1,0,0,3,12,17,68008,52361,13,42,73840,51439
228,21,1,0,0,3,1,0,67,51,68009,52361,85,43,73843,51439
229,21,1,0,0,3,1,0,11,17,68010,52361,10,45,73846,51439
230,21,3,2,0,3,1,0,80,37,68013,52363,102,57,73849,51439
231,22,0,3,1,0,0,3,67,54,68013,52366,85,114,73849,51442
232,22,1,1,2,1,2,1,69,67,68014,52367,76,53,73850,51443
233,22,5,0,0,3,1,0,289,257,68019,52367,296,42,73853,51443
234,22,5,0,0,3,1,0,85,90,68024,52367,88,72,73856,51443
235,22,2,0,0,3,1,0,75,55,68026,52367,83,44,73859,51443
236,22,2,2,2,1,2,1,97,102,68028,52369,95,37,73860,51444
237,22,2,1,0,3,1,0,13,18,68030,52370,13,61,73863,51444
238,22,4,2,0,3,1,0,15,15,68034,52372,15,2,73866,51444
239,22,2,3,1,0,0,3,64,61,68036,52375,74,27,73866,51447
240,22,1,1,2,1,2,1,70,57,68037,52376,86,74,73867,51448
241,22,3,1,0,3,1,0,196,184,68040,52377,222,54,73870,51448
242,23,2,1,0,3,1,0,144,137,68042,52378,147,256,73873,51448
243,23,0,1,1,0,0,3,52,63,68042,52379,58,58,73873,51451
244,23,3,1,0,3,1,0,71,63,68045,52380,76,53,73876,51451
245,23,0,1,1,0,0,3,36,43,68045,52381,33,145,73876,51454
246,23,3,1,0,3,1,0,66,95,68048,52382,71,43,73879,51454
247,23,0,0,2,1,2,1,81,55,68048,52382,97,85,73880,51455
248,23,0,2,1,0,0,3,167,168,68048,52384,182,48,73880,51458
249,23,0,0,2,1,2,1,12,17,68048,52384,14,57,73881,51459
250,23,1,2,1,0,0,3,70,54,68049,52386,87,13,73881,51462
251,23,1,2,1,0,0,3,81,39,68050,52388,102,12,73881,51465
252,23,0,0,2,1,2,1,49,39,68050,52388,55,58,73882,51466
253,24,1,1,2,1,2,1,68,55,68051,52389,86,146,73883,51467
254,24,0,0,2,1,2,1,15,15,68051,52389,16,54,73884,51468
255,24,0,1,1,0,0,3,75,56,68051,52390,83,45,73884,51471
256,24,2,2,2,1,2,1,71,69,68053,52392,77,73,73885,51472
257,24,1,1,2,1,2,1,290,258,68054,52393,297,115,73886,51473
258,24,1,2,1,0,0,3,65,63,68055,52395,74,40,73886,51476
259,24,2,0,0,3,1,0,83,39,68057,52395,105,54,73889,51476
260,24,1,1,2,1,2,1,72,64,68058,52396,77,62,73890,51477
261,24,2,0,0,3,1,0,99,102,68060,52396,98,2,73893,51477
262,24,0,0,2,1,2,1,85,90,68060,52396,89,28,73894,51478
263,24,1,1,2,1,2,1,71,58,68061,52397,87,13,73895,51479
264,25,1,0,0,3,1,0,67,95,68062,52397,74,13,73898,51479
265,25,4,3,0,3,1,0,40,46,68066,52400,36,58,73901,51479
266,25,0,0,2,1,2,1,81,55,68066,52400,98,59,73902,51480
267,25,3,2,0,3,1,0,16,20,68069,52402,16,53,73905,51480
268,25,1,0,0,3,1,0,145,137,68070,52402,150,44,73908,51480
269,25,0,1,1,0,0,3,196,185,68070,52403,222,46,73908,51483
270,25,2,4,1,0,0,3,51,43,68072,52407,55,51,73908,51486
271,25,1,1,2,1,2,1,71,55,68073,52408,88,58,73909,51487
272,25,1,3,1,0,0,3,13,20,68074,52411,14,259,73909,51490
273,25,0,1,1,0,0,3,52,64,68074,52412,58,77,73909,51493
274,25,2,1,0,3,1,0,169,169,68076,52413,185,85,73912,51493
275,26,1,1,2,1,2,1,72,70,68077,52414,78,46,73913,51494
276,26,0,0,2,1,2,1,52,64,68077,52414,59,74,73914,51495
277,26,0,0,2,1,2,1,15,15,68077,52414,17,116,73915,51496
278,26,1,1,2,1,2,1,84,40,68078,52415,106,41,73916,51497
279,26,0,1,1,0,0,3,85,91,68078,52416,89,49,73916,51500
280,26,2,1,0,3,1,0,70,56,68080,52417,89,62,73919,51500
281,26,0,0,2,1,2,1,71,58,68080,52417,88,3,73920,51501
282,26,3,2,0,3,1,0,293,260,68083,52419,300,28,73923,51501
283,26,2,2,2,1,2,1,74,66,68085,52421,78,14,73924,51502
284,26,1,2,1,0,0,3,100,104,68086,52423,98,57,73924,51505
285,26,1,0,0,3,1,0,76,56,68087,52423,86,146,73927,51505
286,27,2,1,0,3,1,0,53,44,68089,52424,58,44,73930,51505
287,27,0,6,1,0,0,3,40,52,68089,52430,36,54,73930,51508
288,27,2,1,0,3,1,0,15,21,68091,52431,17,54,73933,51508
289,27,0,2,1,0,0,3,72,72,68091,52433,78,88,73933,51511
290,27,1,1,2,1,2,1,170,170,68092,52434,186,63,73934,51512
291,27,3,1,0,3,1,0,19,21,68095,52435,19,58,73937,51512
292,27,0,1,1,0,0,3,65,64,68095,52436,74,262,73937,51515
293,27,0,1,1,0,0,3,145,138,68095,52437,150,16,73937,51518
294,27,2,0,0,3,1,0,198,185,68097,52437,225,77,73940,51518
295,27,1,2,1,0,0,3,68,97,68098,52439,74,61,73940,51521
296,27,1,2,1,0,0,3,72,57,68099,52441,88,62,73940,51524
297,28,0,0,2,1,2,1,15,21,68099,52441,18,54,73941,51525
298,28,1,2,1,0,0,3,101,106,68100,52443,98,77,73941,51528
299,28,0,3,1,0,0,3,85,94,68100,52446,89,119,73941,51531
300,28,1,0,0,3,1,0,82,55,68101,52446,101,41,73944,51531
301,28,1,2,1,0,0,3,75,68,68102,52448,78,52,73944,51534
302,28,1,1,2,1,2,1,16,16,68103,52449,18,55,73945,51535
303,28,2,4,1,0,0,3,73,62,68105,52453,88,265,73945,51538
304,28,1,1,2,1,2,1,71,57,68106,52454,90,29,73946,51539
305,28,2,2,2,1,2,1,74,59,68108,52456,89,15,73947,51540
306,28,3,2,0,3,1,0,87,42,68111,52458,109,46,73950,51540
307,28,0,2,1,0,0,3,52,66,68111,52460,59,149,73950,51543
308,29,0,2,1,0,0,3,19,23,68111,52462,19,65,73950,51546
309,29,0,2,1,0,0,3,293,262,68111,52464,300,47,73950,51549
310,29,1,2,1,0,0,3,41,54,68112,52466,36,91,73950,51552
311,29,1,0,0,3,1,0,69,97,68113,52466,77,57,73953,51552
312,29,1,1,2,1,2,1,54,45,68114,52467,59,4,73954,51553
313,29,1,1,2,1,2,1,77,57,68115,52468,87,59,73955,51554
314,29,1,0,0,3,1,0,73,72,68116,52468,81,16,73958,51554
315,29,3,1,0,3,1,0,173,171,68119,52469,189,77,73961,51554
316,29,0,1,1,0,0,3,65,65,68119,52470,74,57,73961,51557
317,29,0,2,1,0,0,3,198,187,68119,52472,225,66,73961,51560
318,29,1,0,0,3,1,0,146,138,68120,52472,153,61,73964,51560
319,30,3,3,2,1,2,1,77,62,68123,52475,90,55,73965,51561
320,30,1,2,1,0,0,3,74,64,68124,52477,88,122,73965,51564
321,30,0,2,1,0,0,3,75,70,68124,52479,78,152,73965,51567
322,30,2,0,0,3,1,0,54,66,68126,52479,62,41,73968,51567
323,30,0,1,1,0,0,3,82,56,68126,52480,101,55,73968,51570
324,30,1,1,2,1,2,1,86,95,68127,52481,90,56,73969,51571
325,30,3,4,1,0,0,3,90,46,68130,52485,109,268,73969,51574
326,30,0,0,2,1,2,1,16,16,68130,52485,19,30,73970,51575
327,30,1,2,1,0,0,3,16,23,68131,52487,18,18,73970,51578
328,30,3,3,2,1,2,1,104,109,68134,52490,99,60,73971,51579
329,30,1,0,0,3,1,0,147,138,68135,52490,156,46,73974,51579
330,31,1,2,1,0,0,3,72,59,68136,52492,90,49,73974,51582
331,31,1,1,2,1,2,1,199,188,68137,52493,226,92,73975,51583
332,31,1,1,2,1,2,1,55,46,68138,52494,60,62,73976,51584
333,31,1,1,2,1,2,1,87,96,68139,52495,91,58,73977,51585
334,31,1,0,0,3,1,0,294,262,68140,52495,303,55,73980,51585
335,31,5,1,0,3,1,0,82,58,68145,52496,90,77,73983,51585
336,31,2,0,0,3,1,0,77,70,68147,52496,81,57,73986,51585
337,31,0,1,1,0,0,3,82,57,68147,52497,101,7,73986,51588
338,31,0,1,1,0,0,3,65,66,68147,52498,74,19,73986,51591
339,31,0,0,2,1,2,1,41,54,68147,52498,37,78,73987,51592
340,31,2,2,2,1,2,1,175,173,68149,52500,190,19,73988,51593
341,32,2,3,1,0,0,3,18,26,68151,52503,18,68,73988,51596
342,32,2,3,1,0,0,3,79,65,68153,52506,90,125,73988,51599
343,32,0,0,2,1,2,1,16,16,68153,52506,20,48,73989,51600
344,32,1,2,1,0,0,3,20,25,68154,52508,19,155,73989,51603
345,32,1,0,0,3,1,0,148,138,68155,52508,159,55,73992,51603
346,32,0,0,2,1,2,1,69,97,68155,52508,78,93,73993,51604
347,32,3,0,0,3,1,0,57,66,68158,52508,65,66,73996,51604
348,32,0,3,1,0,0,3,74,67,68158,52511,88,63,73996,51607
349,32,1,1,2,1,2,1,56,47,68159,52512,61,269,73997,51608
350,32,0,0,2,1,2,1,73,72,68159,52512,82,31,73998,51609
351,32,0,2,1,0,0,3,90,48,68159,52514,109,59,73998,51612
352,33,1,2,1,0,0,3,78,72,68160,52516,81,52,73998,51615
353,33,0,1,1,0,0,3,82,58,68160,52517,101,60,73998,51618
354,33,1,3,1,0,0,3,42,57,68161,52520,37,10,73998,51621
355,33,1,0,0,3,1,0,83,58,68162,52520,93,62,74001,51621
356,33,2,2,2,1,2,1,89,98,68164,52522,92,56,74002,51622
357,33,3,2,0,3,1,0,202,190,68167,52524,229,77,74005,51622
358,33,2,1,0,3,1,0,74,60,68169,52525,93,41,74008,51622
359,33,0,0,2,1,2,1,294,262,68169,52525,304,20,74009,51623
360,33,1,1,2,1,2,1,66,67,68170,52526,75,79,74010,51624
361,33,2,0,0,3,1,0,106,109,68172,52526,102,19,74013,51624
362,33,0,1,1,0,0,3,175,174,68172,52527,190,61,74013,51627
363,34,2,0,0,3,1,0,71,97,68174,52527,81,66,74016,51627
364,34,1,0,0,3,1,0,17,16,68175,52527,23,68,74019,51627
365,34,0,1,1,0,0,3,18,27,68175,52528,18,128,74019,51630
366,34,3,1,0,3,1,0,77,68,68178,52529,91,48,74022,51630
367,34,1,1,2,1,2,1,295,263,68179,52530,305,156,74023,51631
368,34,2,0,0,3,1,0,22,25,68181,52530,22,55,74026,51631
369,34,1,1,2,1,2,1,58,67,68182,52531,66,94,74027,51632
370,34,1,0,0,3,1,0,57,47,68183,52531,64,60,74030,51632
371,34,2,6,1,0,0,3,75,78,68185,52537,82,62,74030,51635
372,34,3,0,0,3,1,0,93,48,68188,52537,112,63,74033,51635
373,34,0,2,1,0,0,3,148,140,68188,52539,159,34,74033,51638
374,35,1,0,0,3,1,0,75,60,68189,52539,96,61,74036,51638
375,35,3,0,0,3,1,0,109,109,68192,52539,105,62,74039,51638
376,35,2,1,0,3,1,0,91,99,68194,52540,95,52,74042,51638
377,35,1,2,1,0,0,3,67,69,68195,52542,75,59,74042,51641
378,35,0,0,2,1,2,1,175,174,68195,52542,191,78,74043,51642
379,35,2,1,0,3,1,0,44,58,68197,52543,40,48,74046,51642
380,35,1,1,2,1,2,1,23,26,68198,52544,23,42,74047,51643
381,35,1,0,0,3,1,0,80,65,68199,52544,93,10,74050,51643
382,35,3,2,0,3,1,0,86,60,68202,52546,96,269,74053,51643
383,35,2,1,0,3,1,0,204,191,68204,52547,232,20,74056,51643
384,35,1,1,2,1,2,1,83,59,68205,52548,102,80,74057,51644
385,36,0,1,1,0,0,3,78,73,68205,52549,81,131,74057,51647
386,36,0,0,2,1,2,1,71,97,68205,52549,82,157,74058,51648
387,36,1,1,2,1,2,1,296,264,68206,52550,306,69,74059,51649
388,36,3,1,0,3,1,0,89,61,68209,52551,99,55,74062,51649
389,36,1,3,1,0,0,3,94,51,68210,52554,112,97,74062,51652
390,36,2,3,1,0,0,3,79,71,68212,52557,91,63,74062,51655
391,36,3,3,2,1,2,1,78,81,68215,52560,83,67,74063,51656
392,36,2,1,0,3,1,0,150,141,68217,52561,162,10,74066,51656
393,36,1,0,0,3,1,0,18,16,68218,52561,26,63,74069,51656
394,36,2,1,0,3,1,0,59,48,68220,52562,67,34,74072,51656
395,36,4,3,0,3,1,0,62,70,68224,52565,69,19,74075,51656
396,37,1,0,0,3,1,0,68,69,68225,52565,78,62,74078,51656
397,37,0,0,2,1,2,1,80,65,68225,52565,94,62,74079,51657
398,37,1,0,0,3,1,0,45,58,68226,52565,43,52,74082,51657
399,37,0,0,2,1,2,1,204,191,68226,52565,233,60,74083,51658
400,37,2,1,0,3,1,0,85,60,68228,52566,105,78,74086,51658
401,37,3,1,0,3,1,0,94,100,68231,52567,98,48,74089,51658
402,37,5,0,0,3,1,0,180,174,68236,52567,194,42,74092,51658
403,37,0,2,1,0,0,3,75,62,68236,52569,96,272,74092,51661
404,37,1,1,2,1,2,1,24,27,68237,52570,24,21,74093,51662
405,37,2,1,0,3,1,0,20,28,68239,52571,21,80,74096,51662
406,37,1,3,1,0,0,3,110,112,68240,52574,105,65,74096,51665
407,38,2,1,0,3,1,0,298,265,68242,52575,309,62,74099,51665
408,38,3,0,0,3,1,0,48,58,68245,52575,46,131,74102,51665
409,38,1,0,0,3,1,0,79,81,68246,52575,86,42,74105,51665
410,38,0,3,1,0,0,3,78,76,68246,52578,81,100,74105,51668
411,38,0,1,1,0,0,3,89,62,68246,52579,99,66,74105,51671
412,38,3,1,0,3,1,0,71,70,68249,52580,81,10,74108,51671
413,38,2,2,2,1,2,1,152,143,68251,52582,163,64,74109,51672
414,38,0,1,1,0,0,3,18,17,68251,52583,26,83,74109,51675
415,38,1,1,2,1,2,1,72,98,68252,52584,83,20,74110,51676
416,38,0,1,1,0,0,3,79,72,68252,52585,91,70,74110,51679
417,38,4,2,0,3,1,0,208,193,68256,52587,236,69,74113,51679
418,39,2,1,0,3,1,0,82,66,68258,52588,97,272,74116,51679
419,39,0,1,1,0,0,3,75,63,68258,52589,96,72,74116,51682
420,39,2,0,0,3,1,0,96,51,68260,52589,115,60,74119,51682
421,39,1,1,2,1,2,1,25,28,68261,52590,25,79,74120,51683
422,39,0,0,2,1,2,1,20,28,68261,52590,22,49,74121,51684
423,39,0,5,1,0,0,3,79,77,68261,52595,91,160,74121,51687
424,39,2,0,0,3,1,0,112,112,68263,52595,108,55,74124,51687
425,39,3,3,2,1,2,1,88,63,68266,52598,106,66,74125,51688
426,39,2,1,0,3,1,0,64,71,68268,52599,72,34,74128,51688
427,39,1,1,2,1,2,1,60,49,68269,52600,68,22,74129,51689
428,39,1,0,0,3,1,0,181,174,68270,52600,197,52,74132,51689
429,40,3,1,0,3,1,0,211,194,68273,52601,239,10,74135,51689
430,40,3,2,0,3,1,0,97,102,68276,52603,101,62,74138,51689
431,40,0,1,1,0,0,3,89,63,68276,52604,99,65,74138,51692
432,40,1,5,1,0,0,3,72,75,68277,52609,81,134,74138,51695
433,40,3,1,0,3,1,0,75,99,68280,52610,86,42,74141,51695
434,40,1,1,2,1,2,1,19,18,68281,52611,27,101,74142,51696
435,40,2,1,0,3,1,0,154,144,68283,52612,166,66,74145,51696
436,40,1,2,1,0,0,3,80,83,68284,52614,86,67,74145,51699
437,40,2,2,2,1,2,1,80,78,68286,52616,82,84,74146,51700
438,40,1,1,2,1,2,1,49,59,68287,52617,47,21,74147,51701
439,40,1,1,2,1,2,1,299,266,68288,52618,310,71,74148,51702
440,41,3,0,0,3,1,0,115,112,68291,52618,111,72,74151,51702
441,41,2,1,0,3,1,0,66,72,68293,52619,75,52,74154,51702
442,41,1,0,0,3,1,0,182,174,68294,52619,200,60,74157,51702
443,41,1,0,0,3,1,0,76,63,68295,52619,99,49,74160,51702
444,41,0,3,1,0,0,3,60,52,68295,52622,68,163,74160,51705
445,41,0,1,1,0,0,3,82,67,68295,52623,97,58,74160,51708
446,41,1,2,1,0,0,3,21,30,68296,52625,22,69,74160,51711
447,41,2,2,2,1,2,1,27,30,68298,52627,26,273,74161,51712
448,41,1,1,2,1,2,1,89,64,68299,52628,107,35,74162,51713
449,41,1,1,2,1,2,1,80,78,68300,52629,92,23,74163,51714
450,41,1,1,2,1,2,1,97,52,68301,52630,116,80,74164,51715
451,42,4,3,0,3,1,0,84,81,68305,52633,85,65,74167,51715
452,42,1,1,2,1,2,1,50,60,68306,52634,48,67,74168,51716
453,42,2,1,0,3,1,0,21,19,68308,52635,30,71,74171,51716
454,42,1,1,2,1,2,1,76,100,68309,52636,87,11,74172,51717
455,42,1,0,0,3,1,0,81,83,68310,52636,89,62,74175,51717
456,42,0,0,2,1,2,1,211,194,68310,52636,240,135,74176,51718
457,42,1,0,0,3,1,0,300,266,68311,52636,313,101,74179,51718
458,42,0,0,2,1,2,1,72,75,68311,52636,82,68,74180,51719
459,42,2,0,0,3,1,0,99,102,68313,52636,104,84,74183,51719
460,42,1,1,2,1,2,1,90,64,68314,52637,100,22,74184,51720
461,42,3,3,2,1,2,1,157,147,68317,52640,167,43,74185,51721
0,1,0,0,2,1,2,1,76,63,68317,52640,100,66,74186,51722
1,1,1,1,2,1,2,1,83,68,68318,52641,98,88,74187,51723
2,1,3,1,0,3,1,0,185,175,68321,52642,203,0,74190,51723
3,1,2,2,2,1,2,1,101,104,68323,52644,105,23,74191,51724
4,1,0,2,1,0,0,3,89,66,68323,52646,107,3,74191,51727
5,1,3,0,0,3,1,0,106,121,68326,52646,109,43,74194,51727
6,1,1,0,0,3,1,0,22,19,68327,52646,33,15,74197,51727
7,1,0,0,2,1,2,1,50,60,68327,52646,49,61,74198,51728
8,1,2,1,0,3,1,0,2,1,68329,52647,3,69,74201,51728
9,1,5,2,0,3,1,0,94,53,68334,52649,105,80,74204,51728
10,1,1,0,0,3,1,0,77,100,68335,52649,90,84,74207,51728
11,2,2,1,0,3,1,0,92,65,68337,52650,103,57,74210,51728
12,2,1,1,2,1,2,1,1,1,68338,52651,1,1,74211,51729
13,2,1,2,1,0,0,3,163,171,68339,52653,158,138,74211,51732
14,2,1,1,2,1,2,1,28,31,68340,52654,27,69,74212,51733
15,2,1,2,1,0,0,3,61,54,68341,52656,68,38,74212,51736
16,2,1,1,2,1,2,1,98,53,68342,52657,117,68,74213,51737
17,2,1,2,1,0,0,3,158,149,68343,52659,167,55,74213,51740
18,2,0,0,2,1,2,1,66,72,68343,52659,76,73,74214,51741
19,2,2,2,2,1,2,1,83,85,68345,52661,90,24,74215,51742
20,2,2,2,2,1,2,1,2,2,68347,52663,1,71,74216,51743
21,2,1,1,2,1,2,1,24,27,68348,52664,24,72,74217,51744
22,3,0,2,1,0,0,3,50,62,68348,52666,49,18,74217,51747
23,3,1,1,2,1,2,1,102,105,68349,52667,106,70,74218,51748
24,3,0,3,1,0,0,3,1,4,68349,52670,1,87,74218,51751
25,3,1,1,2,1,2,1,186,176,68350,52671,204,4,74219,51752
26,3,0,1,1,0,0,3,77,101,68350,52672,90,26,74219,51755
27,3,2,0,0,3,1,0,85,68,68352,52672,101,61,74222,51755
28,3,3,2,0,3,1,0,97,55,68355,52674,108,66,74225,51755
29,3,3,1,0,3,1,0,79,64,68358,52675,103,43,74228,51755
30,3,2,2,2,1,2,1,108,123,68360,52677,110,81,74229,51756
31,3,1,0,0,3,1,0,3,1,68361,52677,6,24,74232,51756
32,3,0,3,1,0,0,3,89,69,68361,52680,107,91,74232,51759
33,4,2,1,0,3,1,0,165,172,68363,52681,161,55,74235,51759
34,4,4,0,0,3,1,0,6,2,68367,52681,4,69,74238,51759
35,4,3,2,0,3,1,0,101,55,68370,52683,120,71,74241,51759
36,4,1,0,0,3,1,0,29,31,68371,52683,30,1,74244,51759
37,4,1,0,0,3,1,0,93,65,68372,52683,106,72,74247,51759
38,4,1,0,0,3,1,0,67,72,68373,52683,79,68,74250,51759
39,4,0,2,1,0,0,3,24,29,68373,52685,24,141,74250,51762
40,4,2,2,2,1,2,1,63,56,68375,52687,69,58,74251,51763
41,4,0,0,2,1,2,1,83,85,68375,52687,91,1,74252,51764
42,4,1,0,0,3,1,0,159,149,68376,52687,170,38,74255,51764
43,4,1,2,1,0,0,3,23,21,68377,52689,33,76,74255,51767
44,5,0,0,2,1,2,1,1,4,68377,52689,2,27,74256,51768
45,5,1,0,0,3,1,0,51,62,68378,52689,52,91,74259,51768
46,5,3,1,0,3,1,0,88,69,68381,52690,104,4,74262,51768
47,5,0,1,1,0,0,3,108,124,68381,52691,110,69,74262,51771
48,5,1,1,2,1,2,1,80,65,68382,52692,104,71,74263,51772
49,5,1,1,2,1,2,1,98,56,68383,52693,109,25,74264,51773
50,5,0,2,1,0,0,3,83,87,68383,52695,91,46,74264,51776
51,5,3,1,0,3,1,0,189,177,68386,52696,207,72,74267,51776
52,5,1,1,2,1,2,1,4,2,68387,52697,7,88,74268,51777
53,5,1,2,1,0,0,3,103,107,68388,52699,106,84,74268,51780
54,5,4,1,0,3,1,0,81,102,68392,52700,93,18,74271,51780
55,6,1,1,2,1,2,1,109,125,68393,52701,111,2,74272,51781
56,6,1,2,1,0,0,3,24,23,68394,52703,33,41,74272,51784
57,6,0,0,2,1,2,1,89,69,68394,52703,108,2,74273,51785
58,6,1,0,0,3,1,0,102,55,68395,52703,123,69,74276,51785
59,6,0,1,1,0,0,3,6,3,68395,52704,4,58,74276,51788
60,6,3,1,0,3,1,0,162,150,68398,52705,173,68,74279,51788
61,6,2,2,2,1,2,1,95,67,68400,52707,107,62,74280,51789
62,6,2,1,0,3,1,0,69,73,68402,52708,82,91,74283,51789
63,6,0,0,2,1,2,1,24,29,68402,52708,25,77,74284,51790
64,6,0,1,1,0,0,3,63,57,68402,52709,69,30,74284,51793
65,6,0,0,2,1,2,1,189,177,68402,52709,208,59,74285,51794
66,7,2,1,0,3,1,0,100,57,68404,52710,112,4,74288,51794
67,7,0,0,2,1,2,1,51,62,68404,52710,53,72,74289,51795
68,7,1,0,0,3,1,0,30,31,68405,52710,33,69,74292,51795
69,7,0,1,1,0,0,3,80,66,68405,52711,104,21,74292,51798
70,7,2,1,0,3,1,0,104,56,68407,52712,126,25,74295,51798
71,7,1,0,0,3,1,0,84,87,68408,52712,94,84,74298,51798
72,7,3,0,0,3,1,0,168,172,68411,52712,164,46,74301,51798
73,7,2,0,0,3,1,0,3,4,68413,52712,5,77,74304,51798
74,7,3,1,0,3,1,0,91,70,68416,52713,107,72,74307,51798
75,7,1,0,0,3,1,0,5,2,68417,52713,10,141,74310,51798
76,7,1,1,2,1,2,1,82,103,68418,52714,94,72,74311,51799
77,8,3,2,0,3,1,0,92,71,68421,52716,111,88,74314,51799
78,8,1,1,2,1,2,1,110,126,68422,52717,112,42,74315,51800
79,8,1,1,2,1,2,1,25,24,68423,52718,34,47,74316,51801
80,8,1,1,2,1,2,1,7,4,68424,52719,5,3,74317,51802
81,8,0,3,1,0,0,3,95,70,68424,52722,107,33,74317,51805
82,8,1,0,0,3,1,0,6,2,68425,52722,13,69,74320,51805
83,8,1,1,2,1,2,1,104,108,68426,52723,107,92,74321,51806
84,8,0,1,1,0,0,3,24,30,68426,52724,25,65,74321,51809
85,8,1,1,2,1,2,1,83,104,68427,52725,95,60,74322,51810
86,8,2,1,0,3,1,0,191,178,68429,52726,211,68,74325,51810
87,8,2,0,0,3,1,0,164,150,68431,52726,176,69,74328,51810
88,9,2,2,2,1,2,1,53,64,68433,52728,54,78,74329,51811
89,9,2,1,0,3,1,0,82,67,68435,52729,107,141,74332,51811
90,9,1,0,0,3,1,0,85,87,68436,52729,97,72,74335,51811
91,9,0,0,2,1,2,1,104,56,68436,52729,127,5,74336,51812
92,9,1,1,2,1,2,1,31,32,68437,52730,34,26,74337,51813
93,9,0,0,2,1,2,1,3,4,68437,52730,6,69,74338,51814
94,9,3,0,0,3,1,0,103,57,68440,52730,115,2,74341,51814
95,9,0,2,1,0,0,3,63,59,68440,52732,69,61,74341,51817
96,9,1,2,1,0,0,3,70,75,68441,52734,82,87,74341,51820
97,9,1,0,0,3,1,0,169,172,68442,52734,167,72,74344,51820
98,9,1,0,0,3,1,0,25,30,68443,52734,28,72,74347,51820
99,10,2,1,0,3,1,0,85,105,68445,52735,98,69,74350,51820
100,10,0,1,1,0,0,3,110,127,68445,52736,112,6,74350,51823
101,10,5,0,0,3,1,0,30,24,68450,52736,37,72,74353,51823
102,10,2,1,0,3,1,0,94,72,68452,52737,114,47,74356,51823
103,10,1,1,2,1,2,1,8,5,68453,52738,6,43,74357,51824
104,10,4,1,0,3,1,0,108,109,68457,52739,110,65,74360,51824
105,10,4,1,0,3,1,0,10,3,68461,52740,16,21,74363,51824
106,10,1,2,1,0,0,3,165,152,68462,52742,176,36,74363,51827
107,10,2,0,0,3,1,0,193,178,68464,52742,214,88,74366,51827
108,10,3,0,0,3,1,0,94,70,68467,52742,110,69,74369,51827
109,10,2,3,1,0,0,3,105,60,68469,52745,115,95,74369,51830
110,11,2,3,1,0,0,3,84,70,68471,52748,107,75,74369,51833
111,11,2,1,0,3,1,0,55,65,68473,52749,57,69,74372,51833
112,11,2,3,1,0,0,3,32,27,68475,52752,37,90,74372,51836
113,11,1,0,0,3,1,0,32,32,68476,52752,37,72,74375,51836
114,11,0,0,2,1,2,1,169,172,68476,52752,168,89,74376,51837
115,11,2,2,2,1,2,1,110,111,68478,52754,111,61,74377,51838
116,11,1,1,2,1,2,1,71,76,68479,52755,83,6,74378,51839
117,11,1,1,2,1,2,1,26,31,68480,52756,29,7,74379,51840
118,11,0,2,1,0,0,3,63,61,68480,52758,69,144,74379,51843
119,11,1,1,2,1,2,1,96,71,68481,52759,108,62,74380,51844
120,11,1,2,1,0,0,3,86,89,68482,52761,97,5,74380,51847
121,12,2,2,2,1,2,1,106,58,68484,52763,128,48,74381,51848
122,12,3,3,2,1,2,1,113,130,68487,52766,113,79,74382,51849
123,12,0,1,1,0,0,3,8,6,68487,52767,6,24,74382,51852
124,12,1,0,0,3,1,0,95,72,68488,52767,117,43,74385,51852
125,12,2,2,2,1,2,1,167,154,68490,52769,177,73,74386,51853
126,12,1,1,2,1,2,1,86,106,68491,52770,99,27,74387,51854
127,12,1,0,0,3,1,0,4,4,68492,52770,9,69,74390,51854
128,12,1,0,0,3,1,0,95,70,68493,52770,113,36,74393,51854
129,12,1,1,2,1,2,1,194,179,68494,52771,215,70,74394,51855
130,12,1,1,2,1,2,1,106,61,68495,52772,116,66,74395,51856
131,12,0,2,1,0,0,3,10,5,68495,52774,16,98,74395,51859
132,13,2,1,0,3,1,0,57,66,68497,52775,60,62,74398,51859
133,13,3,0,0,3,1,0,172,172,68500,52775,171,6,74401,51859
134,13,2,1,0,3,1,0,86,71,68502,52776,110,72,74404,51859
135,13,2,2,2,1,2,1,98,73,68504,52778,109,8,74405,51860
136,13,1,1,2,1,2,1,33,33,68505,52779,38,62,74406,51861
137,13,1,1,2,1,2,1,64,62,68506,52780,70,70,74407,51862
138,13,0,2,1,0,0,3,110,113,68506,52782,111,8,74407,51865
139,13,2,1,0,3,1,0,73,77,68508,52783,86,89,74410,51865
140,13,1,2,1,0,0,3,27,33,68509,52785,29,93,74410,51868
141,13,0,1,1,0,0,3,86,90,68509,52786,97,78,74410,51871
142,13,1,0,0,3,1,0,33,27,68510,52786,40,144,74413,51871
143,14,0,0,2,1,2,1,95,72,68510,52786,118,80,74414,51872
144,14,0,2,1,0,0,3,86,73,68510,52788,110,101,74414,51875
145,14,2,3,1,0,0,3,97,73,68512,52791,113,27,74414,51878
146,14,2,1,0,3,1,0,115,131,68514,52792,116,27,74417,51878
147,14,2,1,0,3,1,0,10,7,68516,52793,9,73,74420,51878
148,14,2,0,0,3,1,0,108,61,68518,52793,119,43,74423,51878
149,14,2,0,0,3,1,0,108,58,68520,52793,131,93,74426,51878
150,14,2,2,2,1,2,1,88,108,68522,52795,100,67,74427,51879
151,14,3,0,0,3,1,0,197,179,68525,52795,218,36,74430,51879
152,14,1,0,0,3,1,0,5,4,68526,52795,12,70,74433,51879
153,14,2,1,0,3,1,0,12,6,68528,52796,19,48,74436,51879
154,15,0,0,2,1,2,1,98,73,68528,52796,110,79,74437,51880
155,15,1,1,2,1,2,1,34,28,68529,52797,41,71,74438,51881
156,15,2,0,0,3,1,0,35,33,68531,52797,41,89,74441,51881
157,15,1,3,1,0,0,3,58,69,68532,52800,60,147,74441,51884
158,15,2,3,1,0,0,3,66,65,68534,52803,70,9,74441,51887
159,15,3,2,0,3,1,0,170,156,68537,52805,180,8,74444,51887
160,15,0,0,2,1,2,1,110,113,68537,52805,112,63,74445,51888
161,15,2,2,2,1,2,1,75,79,68539,52807,87,73,74446,51889
162,15,0,0,2,1,2,1,86,90,68539,52807,98,70,74447,51890
163,15,1,2,1,0,0,3,173,174,68540,52809,171,11,74447,51893
164,15,0,1,1,0,0,3,27,34,68540,52810,29,65,74447,51896
165,16,2,2,2,1,2,1,199,181,68542,52812,219,81,74448,51897
166,16,4,2,0,3,1,0,119,133,68546,52814,119,27,74451,51897
167,16,2,1,0,3,1,0,175,175,68548,52815,174,73,74454,51897
168,16,1,0,0,3,1,0,11,7,68549,52815,12,36,74457,51897
169,16,2,1,0,3,1,0,110,59,68551,52816,134,67,74460,51897
170,16,1,2,1,0,0,3,87,75,68552,52818,110,46,74460,51900
171,16,0,0,2,1,2,1,95,72,68552,52818,119,94,74461,51901
172,16,1,1,2,1,2,1,98,74,68553,52819,114,66,74462,51902
173,16,0,0,2,1,2,1,12,6,68553,52819,20,64,74463,51903
174,16,1,0,0,3,1,0,6,4,68554,52819,15,48,74466,51903
175,16,2,1,0,3,1,0,77,80,68556,52820,90,27,74469,51903
176,17,0,1,1,0,0,3,88,109,68556,52821,100,76,74469,51906
177,17,1,3,1,0,0,3,109,64,68557,52824,119,82,74469,51909
178,17,1,1,2,1,2,1,36,34,68558,52825,42,102,74470,51910
179,17,1,0,0,3,1,0,99,73,68559,52825,113,71,74473,51910
180,17,1,0,0,3,1,0,35,28,68560,52825,44,11,74476,51910
181,17,1,1,2,1,2,1,67,66,68561,52826,71,71,74477,51911
182,17,2,1,0,3,1,0,112,114,68563,52827,115,70,74480,51911
183,17,1,0,0,3,1,0,28,34,68564,52827,32,89,74483,51911
184,17,2,2,2,1,2,1,88,92,68566,52829,99,10,74484,51912
185,17,1,1,2,1,2,1,171,157,68567,52830,181,148,74485,51913
186,17,0,0,2,1,2,1,58,69,68567,52830,61,9,74486,51914
187,18,0,2,1,0,0,3,87,77,68567,52832,110,69,74486,51917
188,18,3,1,0,3,1,0,178,176,68570,52833,177,67,74489,51917
189,18,4,0,0,3,1,0,114,59,68574,52833,137,46,74492,51917
190,18,1,1,2,1,2,1,96,73,68575,52834,120,28,74493,51918
191,18,1,1,2,1,2,1,12,8,68576,52835,13,10,74494,51919
192,18,0,1,1,0,0,3,98,75,68576,52836,114,84,74494,51922
193,18,0,0,2,1,2,1,199,181,68576,52836,220,65,74495,51923
194,18,2,2,2,1,2,1,79,82,68578,52838,91,28,74496,51924
195,18,1,2,1,0,0,3,68,68,68579,52840,71,76,74496,51927
196,18,2,3,1,0,0,3,8,7,68581,52843,15,97,74496,51930
197,18,0,1,1,0,0,3,36,35,68581,52844,42,85,74496,51933
198,19,0,2,1,0,0,3,35,30,68581,52846,44,13,74496,51936
199,19,1,0,0,3,1,0,120,133,68582,52846,122,76,74499,51936
200,19,0,1,1,0,0,3,99,74,68582,52847,113,151,74499,51939
201,19,2,0,0,3,1,0,60,69,68584,52847,64,36,74502,51939
202,19,1,1,2,1,2,1,172,158,68585,52848,182,49,74503,51940
203,19,1,0,0,3,1,0,110,64,68586,52848,122,11,74506,51940
204,19,1,1,2,1,2,1,89,93,68587,52849,100,72,74507,51941
205,19,4,2,0,3,1,0,116,116,68591,52851,118,89,74510,51941
206,19,1,0,0,3,1,0,29,34,68592,52851,35,102,74513,51941
207,19,3,1,0,3,1,0,91,110,68595,52852,103,70,74516,51941
208,19,2,1,0,3,1,0,14,7,68597,52853,23,71,74519,51941
209,20,1,1,2,1,2,1,88,78,68598,52854,111,11,74520,51942
210,20,1,0,0,3,1,0,179,176,68599,52854,180,28,74523,51942
211,20,1,3,1,0,0,3,37,38,68600,52857,42,31,74523,51945
212,20,1,0,0,3,1,0,13,8,68601,52857,16,97,74526,51945
213,20,2,2,2,1,2,1,98,75,68603,52859,121,70,74527,51946
214,20,0,1,1,0,0,3,98,76,68603,52860,114,88,74527,51949
215,20,0,1,1,0,0,3,199,182,68603,52861,220,70,74527,51952
216,20,1,2,1,0,0,3,80,84,68604,52863,91,49,74527,51955
217,20,1,2,1,0,0,3,69,70,68605,52865,71,87,74527,51958
218,20,0,0,2,1,2,1,8,7,68605,52865,16,66,74528,51959
219,20,1,1,2,1,2,1,115,60,68606,52866,138,77,74529,51960
220,21,1,1,2,1,2,1,111,65,68607,52867,123,90,74530,51961
221,21,1,2,1,0,0,3,121,135,68608,52869,122,154,74530,51964
222,21,0,1,1,0,0,3,99,75,68608,52870,113,75,74530,51967
223,21,1,4,1,0,0,3,61,73,68609,52874,64,14,74530,51970
224,21,1,2,1,0,0,3,173,160,68610,52876,182,105,74530,51973
225,21,2,1,0,3,1,0,37,31,68612,52877,47,70,74533,51973
226,21,1,2,1,0,0,3,90,95,68613,52879,100,39,74533,51976
227,21,3,3,2,1,2,1,119,119,68616,52882,119,14,74534,51977
228,21,2,1,0,3,1,0,16,8,68618,52883,26,76,74537,51977
229,21,1,0,0,3,1,0,30,34,68619,52883,38,49,74540,51977
230,21,1,1,2,1,2,1,92,111,68620,52884,104,72,74541,51978
231,22,2,1,0,3,1,0,15,9,68622,52885,19,76,74544,51978
232,22,0,0,2,1,2,1,179,176,68622,52885,181,73,74545,51979
233,22,1,0,0,3,1,0,38,38,68623,52885,45,87,74548,51979
234,22,2,1,0,3,1,0,101,76,68625,52886,116,11,74551,51979
235,22,1,3,1,0,0,3,116,63,68626,52889,138,69,74551,51982
236,22,2,1,0,3,1,0,10,8,68628,52890,19,154,74554,51982
237,22,0,1,1,0,0,3,80,85,68628,52891,91,73,74554,51985
238,22,1,2,1,0,0,3,91,97,68629,52893,100,52,74554,51988
239,22,1,2,1,0,0,3,31,36,68630,52895,38,31,74554,51991
240,22,2,1,0,3,1,0,71,71,68632,52896,74,88,74557,51991
241,22,0,0,2,1,2,1,173,160,68632,52896,183,71,74558,51992
242,23,1,1,2,1,2,1,17,9,68633,52897,27,15,74559,51993
243,23,0,1,1,0,0,3,121,136,68633,52898,122,17,74559,51996
244,23,1,0,0,3,1,0,89,78,68634,52898,114,39,74562,51996
245,23,1,1,2,1,2,1,62,74,68635,52899,65,50,74563,51997
246,23,1,4,1,0,0,3,99,79,68636,52903,121,34,74563,52000
247,23,1,0,0,3,1,0,112,65,68637,52903,126,77,74566,52000
248,23,2,1,0,3,1,0,39,32,68639,52904,50,70,74569,52000
249,23,4,1,0,3,1,0,102,77,68643,52905,117,90,74572,52000
250,23,2,1,0,3,1,0,121,120,68645,52906,122,75,74575,52000
251,23,1,0,0,3,1,0,93,111,68646,52906,107,97,74578,52000
252,23,1,1,2,1,2,1,200,183,68647,52907,221,106,74579,52001
253,24,1,1,2,1,2,1,39,39,68648,52908,46,70,74580,52002
254,24,1,0,0,3,1,0,180,176,68649,52908,184,76,74583,52002
255,24,1,1,2,1,2,1,40,33,68650,52909,51,12,74584,52003
256,24,0,0,2,1,2,1,116,63,68650,52909,139,16,74585,52004
257,24,0,0,2,1,2,1,15,9,68650,52909,20,155,74586,52005
258,24,1,1,2,1,2,1,72,72,68651,52910,75,74,74587,52006
259,24,1,1,2,1,2,1,32,37,68652,52911,39,53,74588,52007
260,24,2,1,0,3,1,0,82,86,68654,52912,94,71,74591,52007
261,24,0,1,1,0,0,3,91,98,68654,52913,100,76,74591,52010
262,24,3,0,0,3,1,0,176,160,68657,52913,186,88,74594,52010
263,24,1,2,1,0,0,3,102,78,68658,52915,116,90,74594,52013
264,25,1,0,0,3,1,0,100,79,68659,52915,124,77,74597,52013
265,25,1,0,0,3,1,0,113,65,68660,52915,129,50,74600,52013
266,25,3,1,0,3,1,0,65,75,68663,52916,68,97,74603,52013
267,25,1,1,2,1,2,1,90,79,68664,52917,115,18,74604,52014
268,25,1,0,0,3,1,0,11,8,68665,52917,22,70,74607,52014
269,25,1,1,2,1,2,1,122,121,68666,52918,123,32,74608,52015
270,25,1,3,1,0,0,3,18,12,68667,52921,27,42,74608,52018
271,25,0,0,2,1,2,1,93,111,68667,52921,108,107,74609,52019
272,25,1,1,2,1,2,1,201,184,68668,52922,222,35,74610,52020
273,25,1,2,1,0,0,3,122,138,68669,52924,122,93,74610,52023
274,25,4,0,0,3,1,0,106,77,68673,52924,120,75,74613,52023
275,26,1,0,0,3,1,0,177,160,68674,52924,189,90,74616,52023
276,26,2,2,2,1,2,1,42,35,68676,52926,52,72,74617,52024
277,26,1,1,2,1,2,1,117,64,68677,52927,140,13,74618,52025
278,26,0,1,1,0,0,3,100,80,68677,52928,124,158,74618,52028
279,26,2,0,0,3,1,0,17,9,68679,52928,23,76,74621,52028
280,26,0,0,2,1,2,1,39,39,68679,52928,47,17,74622,52029
281,26,1,0,0,3,1,0,103,78,68680,52928,119,74,74625,52029
282,26,1,2,1,0,0,3,33,39,68681,52930,39,73,74625,52032
283,26,1,0,0,3,1,0,83,86,68682,52930,97,88,74628,52032
284,26,1,1,2,1,2,1,73,73,68683,52931,76,71,74629,52033
285,26,1,1,2,1,2,1,181,177,68684,52932,185,54,74630,52034
286,27,3,0,0,3,1,0,14,8,68687,52932,25,76,74633,52034
287,27,2,1,0,3,1,0,183,178,68689,52933,188,75,74636,52034
288,27,3,4,1,0,0,3,93,83,68692,52937,115,96,74636,52037
289,27,2,2,2,1,2,1,67,77,68694,52939,69,33,74637,52038
290,27,2,0,0,3,1,0,108,77,68696,52939,123,97,74640,52038
291,27,1,1,2,1,2,1,114,66,68697,52940,130,159,74641,52039
292,27,1,0,0,3,1,0,40,39,68698,52940,50,50,74644,52039
293,27,0,2,1,0,0,3,122,123,68698,52942,123,38,74644,52042
294,27,2,2,2,1,2,1,95,113,68700,52944,109,19,74645,52043
295,27,2,2,2,1,2,1,93,100,68702,52946,101,78,74646,52044
296,27,1,1,2,1,2,1,19,13,68703,52947,28,89,74647,52045
297,28,0,1,1,0,0,3,201,185,68703,52948,222,16,74647,52048
298,28,2,2,2,1,2,1,102,82,68705,52950,125,77,74648,52049
299,28,2,0,0,3,1,0,105,78,68707,52950,122,54,74651,52049
300,28,2,0,0,3,1,0,44,35,68709,52950,55,96,74654,52049
301,28,0,2,1,0,0,3,17,11,68709,52952,23,75,74654,52052
302,28,2,0,0,3,1,0,124,138,68711,52952,125,73,74657,52052
303,28,0,2,1,0,0,3,122,125,68711,52954,123,20,74657,52055
304,28,1,0,0,3,1,0,84,86,68712,52954,100,42,74660,52055
305,28,0,3,1,0,0,3,33,42,68712,52957,39,77,74660,52058
306,28,2,0,0,3,1,0,179,160,68714,52957,192,71,74663,52058
307,28,0,3,1,0,0,3,73,76,68714,52960,76,110,74663,52061
308,29,0,1,1,0,0,3,67,78,68714,52961,69,92,74663,52064
309,29,1,4,1,0,0,3,94,87,68715,52965,115,100,74663,52067
310,29,0,3,1,0,0,3,117,67,68715,52968,140,79,74663,52070
311,29,2,1,0,3,1,0,42,40,68717,52969,53,78,74666,52070
312,29,2,0,0,3,1,0,185,178,68719,52969,191,90,74669,52070
313,29,0,0,2,1,2,1,108,77,68719,52969,124,160,74670,52071
314,29,1,0,0,3,1,0,94,100,68720,52969,104,38,74673,52071
315,29,1,0,0,3,1,0,85,86,68721,52969,103,16,74676,52071
316,29,2,3,1,0,0,3,75,79,68723,52972,76,36,74676,52074
317,29,0,1,1,0,0,3,14,9,68723,52973,25,22,74676,52077
318,29,1,0,0,3,1,0,115,66,68724,52973,133,73,74679,52077
319,30,1,1,2,1,2,1,18,12,68725,52974,24,97,74680,52078
320,30,0,1,1,0,0,3,19,14,68725,52975,28,78,74680,52081
321,30,1,0,0,3,1,0,106,78,68726,52975,125,38,74683,52081
322,30,0,4,1,0,0,3,102,86,68726,52979,125,74,74683,52084
323,30,1,1,2,1,2,1,45,36,68727,52980,56,43,74684,52085
324,30,4,0,0,3,1,0,112,77,68731,52980,127,20,74687,52085
325,30,1,2,1,0,0,3,125,140,68732,52982,125,113,74687,52088
326,30,4,0,0,3,1,0,205,185,68736,52982,225,77,74690,52088
327,30,0,2,1,0,0,3,122,127,68736,52984,123,57,74690,52091
328,30,1,0,0,3,1,0,96,113,68737,52984,112,50,74693,52091
329,30,0,0,2,1,2,1,179,160,68737,52984,193,76,74694,52092
330,31,2,2,2,1,2,1,96,89,68739,52986,116,78,74695,52093
331,31,1,1,2,1,2,1,186,179,68740,52987,192,79,74696,52094
332,31,1,0,0,3,1,0,118,67,68741,52987,143,160,74699,52094
333,31,0,1,1,0,0,3,42,41,68741,52988,53,103,74699,52097
334,31,0,1,1,0,0,3,67,79,68741,52989,69,25,74699,52100
335,31,1,1,2,1,2,1,107,79,68742,52990,126,37,74700,52101
336,31,0,2,1,0,0,3,14,11,68742,52992,25,95,74700,52104
337,31,1,1,2,1,2,1,34,43,68743,52993,40,17,74701,52105
338,31,0,0,2,1,2,1,85,86,68743,52993,104,74,74702,52106
339,31,0,1,1,0,0,3,94,101,68743,52994,104,93,74702,52109
340,31,1,1,2,1,2,1,76,80,68744,52995,77,80,74703,52110
341,32,2,1,0,3,1,0,117,67,68746,52996,136,93,74706,52110
342,32,2,2,2,1,2,1,127,142,68748,52998,126,78,74707,52111
343,32,3,4,1,0,0,3,21,16,68751,53002,24,79,74707,52114
344,32,1,2,1,0,0,3,119,69,68752,53004,143,116,74707,52117
345,32,5,1,0,3,1,0,107,87,68757,53005,128,43,74710,52117
346,32,0,0,2,1,2,1,112,77,68757,53005,128,58,74711,52118
347,32,1,0,0,3,1,0,20,14,68758,53005,31,74,74714,52118
348,32,2,1,0,3,1,0,207,186,68760,53006,228,50,74717,52118
349,32,1,0,0,3,1,0,15,11,68761,53006,28,38,74720,52118
350,32,2,0,0,3,1,0,98,113,68763,53006,115,78,74723,52118
351,32,1,1,2,1,2,1,180,161,68764,53007,194,38,74724,52119
352,33,2,0,0,3,1,0,188,179,68766,53007,195,17,74727,52119
353,33,0,1,1,0,0,3,96,90,68766,53008,116,23,74727,52122
354,33,2,2,2,1,2,1,69,81,68768,53010,70,81,74728,52123
355,33,1,3,1,0,0,3,43,44,68769,53013,53,81,74728,52126
356,33,0,2,1,0,0,3,45,38,68769,53015,56,77,74728,52129
357,33,1,1,2,1,2,1,108,80,68770,53016,127,104,74729,52130
358,33,3,2,0,3,1,0,37,45,68773,53018,43,25,74732,52130
359,33,3,0,0,3,1,0,125,127,68776,53018,126,95,74735,52130
360,33,1,0,0,3,1,0,95,101,68777,53018,107,79,74738,52130
361,33,2,4,1,0,0,3,78,84,68779,53022,77,100,74738,52133
362,33,3,0,0,3,1,0,88,86,68782,53022,107,160,74741,52133
363,34,0,2,1,0,0,3,98,115,68782,53024,115,61,74741,52136
364,34,1,1,2,1,2,1,128,143,68783,53025,127,75,74742,52137
365,34,0,1,1,0,0,3,21,17,68783,53026,24,119,74742,52140
366,34,4,2,0,3,1,0,116,79,68787,53028,131,50,74745,52140
367,34,1,0,0,3,1,0,118,67,68788,53028,139,43,74748,52140
368,34,0,1,1,0,0,3,119,70,68788,53029,143,82,74748,52143
369,34,4,1,0,3,1,0,19,12,68792,53030,31,78,74751,52143
370,34,0,1,1,0,0,3,20,15,68792,53031,31,96,74751,52146
371,34,0,0,2,1,2,1,180,161,68792,53031,195,39,74752,52147
372,34,1,0,0,3,1,0,208,186,68793,53031,231,38,74755,52147
373,34,2,2,2,1,2,1,109,89,68795,53033,129,79,74756,52148
374,35,3,2,0,3,1,0,183,163,68798,53035,198,100,74759,52148
375,35,3,1,0,3,1,0,111,81,68801,53036,130,25,74762,52148
376,35,1,0,0,3,1,0,189,179,68802,53036,198,79,74765,52148
377,35,1,0,0,3,1,0,46,38,68803,53036,59,95,74768,52148
378,35,2,2,2,1,2,1,80,86,68805,53038,78,18,74769,52149
379,35,1,0,0,3,1,0,70,81,68806,53038,73,79,74772,52149
380,35,2,1,0,3,1,0,45,45,68808,53039,56,160,74775,52149
381,35,1,3,1,0,0,3,126,130,68809,53042,126,84,74775,52152
382,35,0,1,1,0,0,3,88,87,68809,53043,107,26,74775,52155
383,35,2,2,2,1,2,1,39,47,68811,53045,44,82,74776,52156
384,35,1,0,0,3,1,0,96,101,68812,53045,110,77,74779,52156
385,36,0,0,2,1,2,1,128,143,68812,53045,128,79,74780,52157
386,36,3,3,2,1,2,1,119,82,68815,53048,132,39,74781,52158
387,36,0,1,1,0,0,3,96,91,68815,53049,116,78,74781,52161
388,36,3,0,0,3,1,0,24,17,68818,53049,27,50,74784,52161
389,36,0,1,1,0,0,3,119,71,68818,53050,143,46,74784,52164
390,36,0,0,2,1,2,1,118,67,68818,53050,140,40,74785,52165
391,36,1,2,1,0,0,3,110,91,68819,53052,129,85,74785,52168
392,36,0,3,1,0,0,3,98,118,68819,53055,115,99,74785,52171
393,36,2,0,0,3,1,0,22,15,68821,53055,34,104,74788,52171
394,36,2,0,0,3,1,0,210,186,68823,53055,234,61,74791,52171
395,36,1,3,1,0,0,3,20,15,68824,53058,31,122,74791,52174
396,37,2,1,0,3,1,0,72,82,68826,53059,76,79,74794,52174
397,37,1,3,1,0,0,3,119,70,68827,53062,140,85,74794,52177
398,37,0,1,1,0,0,3,111,82,68827,53063,130,125,74794,52180
399,37,1,3,1,0,0,3,47,41,68828,53066,59,88,74794,52183
400,37,1,1,2,1,2,1,81,87,68829,53067,79,27,74795,52184
401,37,2,1,0,3,1,0,185,164,68831,53068,201,84,74798,52184
402,37,2,0,0,3,1,0,41,47,68833,53068,47,95,74801,52184
403,37,1,3,1,0,0,3,127,133,68834,53071,126,163,74801,52187
404,37,2,0,0,3,1,0,100,118,68836,53071,118,18,74804,52187
405,37,5,1,0,3,1,0,101,102,68841,53072,113,100,74807,52187
406,37,2,2,2,1,2,1,47,47,68843,53074,57,26,74808,52188
407,38,0,1,1,0,0,3,110,92,68843,53075,129,80,74808,52191
408,38,3,1,0,3,1,0,213,187,68846,53076,237,104,74811,52191
409,38,1,1,2,1,2,1,190,180,68847,53077,199,47,74812,52192
410,38,1,0,0,3,1,0,129,143,68848,53077,131,79,74815,52192
411,38,1,2,1,0,0,3,25,19,68849,53079,27,81,74815,52195
412,38,1,1,2,1,2,1,97,92,68850,53080,117,100,74816,52196
413,38,0,2,1,0,0,3,119,73,68850,53082,143,43,74816,52199
414,38,3,1,0,3,1,0,122,83,68853,53083,135,79,74819,52199
415,38,3,0,0,3,1,0,91,87,68856,53083,110,50,74822,52199
416,38,2,0,0,3,1,0,24,15,68858,53083,37,61,74825,52199
417,38,2,0,0,3,1,0,22,15,68860,53083,34,39,74828,52199
418,39,2,2,2,1,2,1,131,145,68862,53085,132,48,74829,52200
419,39,2,0,0,3,1,0,113,82,68864,53085,133,50,74832,52200
420,39,2,1,0,3,1,0,74,83,68866,53086,79,100,74835,52200
421,39,2,1,0,3,1,0,49,42,68868,53087,62,84,74838,52200
422,39,2,1,0,3,1,0,121,71,68870,53088,143,79,74841,52200
423,39,0,1,1,0,0,3,185,165,68870,53089,201,30,74841,52203
424,39,0,2,1,0,0,3,101,104,68870,53091,113,128,74841,52206
425,39,0,1,1,0,0,3,127,134,68870,53092,126,88,74841,52209
426,39,3,3,2,1,2,1,27,18,68873,53095,38,27,74842,52210
427,39,1,2,1,0,0,3,42,49,68874,53097,47,91,74842,52213
428,39,1,0,0,3,1,0,101,118,68875,53097,121,163,74845,52213
429,40,2,1,0,3,1,0,27,20,68877,53098,30,39,74848,52213
430,40,1,2,1,0,0,3,98,94,68878,53100,117,83,74848,52216
431,40,1,2,1,0,0,3,120,75,68879,53102,143,103,74848,52219
432,40,2,2,2,1,2,1,49,49,68881,53104,58,62,74849,52220
433,40,1,2,1,0,0,3,191,182,68882,53106,199,46,74849,52223
434,40,2,2,2,1,2,1,83,89,68884,53108,80,105,74850,52224
435,40,2,1,0,3,1,0,112,93,68886,53109,132,95,74853,52224
436,40,3,1,0,3,1,0,216,188,68889,53110,240,79,74856,52224
437,40,1,0,0,3,1,0,123,83,68890,53110,138,18,74859,52224
438,40,1,0,0,3,1,0,92,87,68891,53110,113,81,74862,52224
439,40,0,3,1,0,0,3,22,18,68891,53113,34,82,74862,52227
440,41,0,0,2,1,2,1,113,82,68891,53113,134,101,74863,52228
441,41,2,2,2,1,2,1,133,147,68893,53115,133,89,74864,52229
442,41,2,0,0,3,1,0,76,83,68895,53115,82,91,74867,52229
443,41,2,1,0,3,1,0,187,166,68897,53116,204,27,74870,52229
444,41,1,2,1,0,0,3,50,44,68898,53118,62,131,74870,52232
445,41,2,0,0,3,1,0,123,71,68900,53118,146,84,74873,52232
446,41,2,2,2,1,2,1,103,106,68902,53120,114,164,74874,52233
447,41,4,1,0,3,1,0,131,135,68906,53121,129,50,74877,52233
448,41,3,0,0,3,1,0,30,18,68909,53121,41,79,74880,52233
449,41,1,3,1,0,0,3,102,121,68910,53124,121,33,74880,52236
450,41,2,2,2,1,2,1,44,51,68912,53126,48,49,74881,52237
451,42,1,2,1,0,0,3,99,96,68913,53128,117,42,74881,52240
452,42,0,1,1,0,0,3,27,21,68913,53129,30,106,74881,52243
453,42,2,0,0,3,1,0,122,75,68915,53129,146,82,74884,52243
454,42,0,0,2,1,2,1,191,182,68915,53129,200,106,74885,52244
455,42,0,0,2,1,2,1,49,49,68915,53129,59,82,74886,52245
456,42,0,2,1,0,0,3,83,91,68915,53131,80,49,74886,52248
457,42,4,1,0,3,1,0,96,88,68919,53132,116,79,74889,52248
458,42,2,0,0,3,1,0,218,188,68921,53132,243,95,74892,52248
459,42,0,0,2,1,2,1,22,18,68921,53132,35,63,74893,52249
460,42,0,0,2,1,2,1,123,83,68921,53132,139,84,74894,52250
461,42,2,1,0,3,1,0,114,94,68923,53133,135,18,74897,52250
0,1,2,1,0,3,1,0,2,1,68925,53134,3,173,74900,52250
1,1,1,0,0,3,1,0,31,18,68926,53134,44,11,74903,52250
2,1,3,3,2,1,2,1,110,77,68929,53137,137,50,74904,52251
3,1,0,2,1,0,0,3,187,168,68929,53139,204,45,74904,52254
4,1,0,2,1,0,0,3,0,2,68929,53141,0,94,74904,52257
5,1,1,0,0,3,1,0,56,86,68930,53141,60,106,74907,52257
6,1,1,1,2,1,2,1,116,113,68931,53142,112,50,74908,52258
7,1,0,0,2,1,2,1,133,147,68931,53142,134,28,74909,52259
8,1,2,1,0,3,1,0,124,76,68933,53143,149,63,74912,52259
9,1,1,1,2,1,2,1,124,84,68934,53144,140,83,74913,52260
10,1,0,0,2,1,2,1,72,75,68934,53144,83,34,74914,52261
11,2,1,0,0,3,1,0,23,18,68935,53144,38,106,74917,52261
12,2,0,1,1,0,0,3,131,136,68935,53145,129,104,74917,52264
13,2,1,1,2,1,2,1,232,241,68936,53146,243,1,74918,52265
14,2,4,2,0,3,1,0,48,53,68940,53148,51,101,74921,52265
15,2,3,1,0,3,1,0,106,107,68943,53149,117,18,74924,52265
16,2,2,0,0,3,1,0,51,49,68945,53149,62,89,74927,52265
17,2,2,1,0,3,1,0,78,84,68947,53150,85,37,74930,52265
18,2,1,1,2,1,2,1,51,45,68948,53151,63,96,74931,52266
19,2,2,1,0,3,1,0,29,22,68950,53152,33,58,74934,52266
20,2,3,2,0,3,1,0,24,32,68953,53154,25,46,74937,52266
21,2,0,2,1,0,0,3,96,90,68953,53156,116,3,74937,52269
22,3,2,3,1,0,0,3,135,150,68955,53159,134,176,74937,52272
23,3,0,0,2,1,2,1,31,18,68955,53159,45,64,74938,52273
24,3,1,1,2,1,2,1,188,169,68956,53160,205,51,74939,52274
25,3,0,1,1,0,0,3,0,3,68956,53161,0,109,74939,52277
26,3,1,1,2,1,2,1,57,87,68957,53162,61,95,74940,52278
27,3,1,0,0,3,1,0,125,84,68958,53162,143,11,74943,52278
28,3,1,0,0,3,1,0,3,1,68959,53162,6,46,74946,52278
29,3,2,1,0,3,1,0,31,23,68961,53163,36,83,74949,52278
30,3,1,1,2,1,2,1,125,77,68962,53164,150,51,74950,52279
31,3,0,1,1,0,0,3,72,76,68962,53165,83,48,74950,52282
32,3,1,1,2,1,2,1,117,114,68963,53166,113,35,74951,52283
33,4,2,2,2,1,2,1,50,55,68965,53168,52,29,74952,52284
34,4,1,0,0,3,1,0,79,84,68966,53168,88,1,74955,52284
35,4,2,0,0,3,1,0,98,90,68968,53168,119,104,74958,52284
36,4,0,2,1,0,0,3,232,243,68968,53170,243,109,74958,52287
37,4,0,0,2,1,2,1,131,136,68968,53170,130,49,74959,52288
38,4,0,0,2,1,2,1,110,77,68968,53170,138,90,74960,52289
39,4,3,2,0,3,1,0,109,109,68971,53172,120,96,74963,52289
40,4,1,5,1,0,0,3,52,54,68972,53177,62,40,74963,52292
41,4,1,2,1,0,0,3,24,20,68973,53179,38,21,74963,52295
42,4,2,2,2,1,2,1,5,3,68975,53181,7,59,74964,52296
43,4,4,0,0,3,1,0,28,32,68979,53181,28,101,74967,52296
44,5,1,2,1,0,0,3,80,86,68980,53183,88,54,74967,52299
45,5,1,1,2,1,2,1,132,137,68981,53184,131,52,74968,52300
46,5,1,2,1,0,0,3,110,111,68982,53186,120,14,74968,52303
47,5,1,1,2,1,2,1,189,170,68983,53187,206,47,74969,52304
48,5,0,0,2,1,2,1,57,87,68983,53187,62,22,74970,52305
49,5,1,0,0,3,1,0,118,114,68984,53187,116,101,74973,52305
50,5,0,0,2,1,2,1,125,84,68984,53187,144,4,74974,52306
51,5,1,1,2,1,2,1,136,151,68985,53188,135,36,74975,52307
52,5,0,1,1,0,0,3,51,46,68985,53189,63,179,74975,52310
53,5,2,2,2,1,2,1,33,25,68987,53191,37,2,74976,52311
54,5,1,0,0,3,1,0,73,76,68988,53191,86,95,74979,52311
55,6,2,1,0,3,1,0,33,19,68990,53192,48,104,74982,52311
56,6,1,0,0,3,1,0,233,243,68991,53192,246,83,74985,52311
57,6,0,0,2,1,2,1,189,170,68991,53192,207,60,74986,52312
58,6,2,0,0,3,1,0,2,3,68993,53192,3,54,74989,52312
59,6,1,1,2,1,2,1,25,21,68994,53193,39,50,74990,52313
60,6,2,0,0,3,1,0,127,84,68996,53193,147,64,74993,52313
61,6,1,0,0,3,1,0,6,3,68997,53193,10,109,74996,52313
62,6,1,1,2,1,2,1,29,33,68998,53194,29,41,74997,52314
63,6,5,2,0,3,1,0,130,79,69003,53196,153,29,75000,52314
64,6,2,1,0,3,1,0,112,78,69005,53197,141,96,75003,52314
65,6,1,1,2,1,2,1,53,55,69006,53198,63,96,75004,52315
66,7,1,0,0,3,1,0,119,114,69007,53198,119,109,75007,52315
67,7,1,1,2,1,2,1,99,91,69008,53199,120,91,75008,52316
68,7,1,1,2,1,2,1,133,138,69009,53200,132,102,75009,52317
69,7,1,0,0,3,1,0,51,55,69010,53200,55,14,75012,52317
70,7,2,3,1,0,0,3,112,114,69012,53203,120,55,75012,52320
71,7,1,0,0,3,1,0,58,87,69013,53203,65,47,75015,52320
72,7,4,0,0,3,1,0,140,151,69017,53203,138,2,75018,52320
73,7,2,0,0,3,1,0,82,86,69019,53203,91,4,75021,52320
74,7,1,0,0,3,1,0,34,25,69020,53203,40,36,75024,52320
75,7,0,0,2,1,2,1,73,76,69020,53203,87,180,75025,52321
76,7,2,2,2,1,2,1,53,48,69022,53205,64,23,75026,52322
77,8,1,0,0,3,1,0,30,33,69023,53205,32,64,75029,52322
78,8,1,1,2,1,2,1,128,85,69024,53206,148,110,75030,52323
79,8,2,3,1,0,0,3,114,81,69026,53209,141,99,75030,52326
80,8,1,0,0,3,1,0,34,19,69027,53209,51,54,75033,52326
81,8,1,4,1,0,0,3,190,174,69028,53213,207,99,75033,52329
82,8,4,0,0,3,1,0,57,55,69032,53213,66,60,75036,52329
83,8,1,2,1,0,0,3,26,23,69033,53215,39,183,75036,52332
84,8,6,0,0,3,1,0,125,114,69039,53215,122,29,75039,52332
85,8,0,1,1,0,0,3,6,4,69039,53216,10,44,75039,52335
86,8,2,2,2,1,2,1,132,81,69041,53218,154,84,75040,52336
87,8,2,1,0,3,1,0,4,4,69043,53219,6,50,75043,52336
88,9,2,1,0,3,1,0,75,77,69045,53220,90,99,75046,52336
89,9,3,0,0,3,1,0,236,243,69048,53220,249,102,75049,52336
90,9,2,1,0,3,1,0,135,139,69050,53221,135,14,75052,52336
91,9,2,1,0,3,1,0,53,56,69052,53222,58,36,75055,52336
92,9,2,0,0,3,1,0,60,87,69054,53222,68,91,75058,52336
93,9,1,1,2,1,2,1,58,56,69055,53223,67,5,75059,52337
94,9,3,0,0,3,1,0,85,86,69058,53223,94,47,75062,52337
95,9,0,4,1,0,0,3,53,52,69058,53227,64,107,75062,52340
96,9,3,1,0,3,1,0,37,26,69061,53228,43,109,75065,52340
97,9,4,2,0,3,1,0,103,93,69065,53230,123,23,75068,52340
98,9,0,1,1,0,0,3,112,115,69065,53231,120,5,75068,52343
99,10,1,2,1,0,0,3,54,54,69066,53233,64,32,75068,52346
100,10,0,0,2,1,2,1,128,85,69066,53233,149,184,75069,52347
101,10,1,1,2,1,2,1,35,20,69067,53234,52,56,75070,52348
102,10,3,1,0,3,1,0,117,82,69070,53235,144,60,75073,52348
103,10,2,2,2,1,2,1,192,176,69072,53237,208,85,75074,52349
104,10,1,0,0,3,1,0,5,4,69073,53237,9,44,75077,52349
105,10,1,1,2,1,2,1,27,24,69074,53238,40,111,75078,52350
106,10,0,1,1,0,0,3,125,115,69074,53239,122,67,75078,52353
107,10,0,5,1,0,0,3,140,156,69074,53244,138,57,75078,52356
108,10,0,0,2,1,2,1,30,33,69074,53244,33,6,75079,52357
109,10,2,1,0,3,1,0,134,82,69076,53245,157,99,75082,52357
110,11,2,1,0,3,1,0,238,244,69078,53246,252,32,75085,52357
111,11,0,2,1,0,0,3,75,79,69078,53248,90,94,75085,52360
112,11,1,1,2,1,2,1,104,94,69079,53249,124,100,75086,52361
113,11,2,1,0,3,1,0,137,140,69081,53250,138,109,75089,52361
114,11,3,1,0,3,1,0,56,57,69084,53251,61,50,75092,52361
115,11,5,1,0,3,1,0,122,83,69089,53252,147,5,75095,52361
116,11,1,1,2,1,2,1,113,116,69090,53253,121,108,75096,52362
117,11,1,1,2,1,2,1,61,88,69091,53254,69,103,75097,52363
118,11,2,0,0,3,1,0,60,56,69093,53254,70,14,75100,52363
119,11,0,0,2,1,2,1,6,4,69093,53254,11,24,75101,52364
120,11,1,1,2,1,2,1,86,87,69094,53255,95,37,75102,52365
121,12,1,0,0,3,1,0,36,20,69095,53255,55,47,75105,52365
122,12,1,0,0,3,1,0,57,57,69096,53255,64,60,75108,52365
123,12,2,1,0,3,1,0,194,177,69098,53256,211,6,75111,52365
124,12,0,0,2,1,2,1,5,4,69098,53256,10,57,75112,52366
125,12,3,2,0,3,1,0,128,117,69101,53258,125,184,75115,52366
126,12,1,2,1,0,0,3,141,158,69102,53260,138,70,75115,52369
127,12,3,0,0,3,1,0,33,33,69105,53260,36,99,75118,52369
128,12,1,1,2,1,2,1,55,55,69106,53261,65,86,75119,52370
129,12,3,2,0,3,1,0,40,28,69109,53263,46,111,75122,52370
130,12,1,4,1,0,0,3,28,28,69110,53267,40,47,75122,52373
131,12,2,1,0,3,1,0,136,83,69112,53268,160,94,75125,52373
132,13,2,1,0,3,1,0,88,88,69114,53269,98,109,75128,52373
133,13,0,0,2,1,2,1,238,244,69114,53269,253,58,75129,52374
134,13,1,3,1,0,0,3,138,143,69115,53272,138,103,75129,52377
135,13,2,1,0,3,1,0,124,84,69117,53273,150,103,75132,52377
136,13,1,1,2,1,2,1,114,117,69118,53274,122,38,75133,52378
137,13,4,1,0,3,1,0,65,89,69122,53275,72,32,75136,52378
138,13,1,0,0,3,1,0,61,56,69123,53275,73,108,75139,52378
139,13,1,2,1,0,0,3,129,87,69124,53277,149,27,75139,52381
140,13,2,1,0,3,1,0,8,5,69126,53278,14,5,75142,52381
141,13,2,1,0,3,1,0,77,80,69128,53279,93,14,75145,52381
142,13,0,1,1,0,0,3,104,95,69128,53280,124,53,75145,52384
143,14,5,2,0,3,1,0,62,59,69133,53282,67,86,75148,52384
144,14,1,2,1,0,0,3,239,246,69134,53284,253,114,75148,52387
145,14,2,2,2,1,2,1,42,30,69136,53286,47,48,75149,52388
146,14,3,0,0,3,1,0,197,177,69139,53286,214,99,75152,52388
147,14,1,0,0,3,1,0,29,28,69140,53286,43,57,75155,52388
148,14,3,1,0,3,1,0,131,118,69143,53287,128,14,75158,52388
149,14,3,0,0,3,1,0,144,158,69146,53287,141,47,75161,52388
150,14,0,0,2,1,2,1,55,55,69146,53287,66,71,75162,52389
151,14,1,1,2,1,2,1,137,84,69147,53288,161,7,75163,52390
152,14,0,1,1,0,0,3,36,21,69147,53289,55,63,75163,52393
153,14,1,1,2,1,2,1,6,5,69148,53290,11,95,75164,52394
154,15,5,1,0,3,1,0,70,90,69153,53291,75,108,75167,52394
155,15,0,0,2,1,2,1,36,21,69153,53291,56,104,75168,52395
156,15,2,1,0,3,1,0,106,96,69155,53292,127,32,75171,52395
157,15,3,3,2,1,2,1,141,146,69158,53295,139,59,75172,52396
158,15,1,1,2,1,2,1,62,57,69159,53296,74,110,75173,52397
159,15,2,0,0,3,1,0,131,87,69161,53296,152,103,75176,52397
160,15,2,2,2,1,2,1,10,7,69163,53298,15,54,75177,52398
161,15,2,0,0,3,1,0,35,33,69165,53298,39,5,75180,52398
162,15,1,1,2,1,2,1,89,89,69166,53299,99,185,75181,52399
163,15,1,1,2,1,2,1,78,81,69167,53300,94,87,75182,52400
164,15,1,0,0,3,1,0,125,84,69168,53300,153,38,75185,52400
165,16,1,1,2,1,2,1,145,159,69169,53301,142,58,75186,52401
166,16,0,0,2,1,2,1,62,59,69169,53301,68,48,75187,52402
167,16,1,1,2,1,2,1,115,118,69170,53302,123,115,75188,52403
168,16,1,4,1,0,0,3,198,181,69171,53306,214,98,75188,52406
169,16,0,0,2,1,2,1,6,5,69171,53306,12,28,75189,52407
170,16,1,1,2,1,2,1,30,29,69172,53307,44,15,75190,52408
171,16,0,0,2,1,2,1,131,118,69172,53307,129,8,75191,52409
172,16,1,0,0,3,1,0,56,55,69173,53307,69,48,75194,52409
173,16,3,2,0,3,1,0,45,32,69176,53309,50,71,75197,52409
174,16,2,3,1,0,0,3,139,87,69178,53312,161,66,75197,52412
175,16,2,0,0,3,1,0,241,246,69180,53312,256,99,75200,52412
176,17,0,1,1,0,0,3,70,91,69180,53313,75,57,75200,52415
177,17,1,2,1,0,0,3,37,23,69181,53315,56,113,75200,52418
178,17,0,1,1,0,0,3,106,97,69181,53316,127,62,75200,52421
179,17,2,2,2,1,2,1,127,86,69183,53318,154,186,75201,52422
180,17,2,2,2,1,2,1,64,59,69185,53320,75,33,75202,52423
181,17,0,0,2,1,2,1,10,7,69185,53320,16,39,75203,52424
182,17,0,4,1,0,0,3,35,37,69185,53324,39,106,75203,52427
183,17,0,0,2,1,2,1,89,89,69185,53324,100,88,75204,52428
184,17,2,2,2,1,2,1,141,89,69187,53326,162,6,75205,52429
185,17,0,0,2,1,2,1,131,87,69187,53326,153,109,75206,52430
186,17,2,0,0,3,1,0,80,81,69189,53326,97,115,75209,52430
187,18,2,2,2,1,2,1,47,34,69191,53328,51,9,75210,52431
188,18,2,2,2,1,2,1,243,248,69193,53330,257,49,75211,52432
189,18,0,1,1,0,0,3,141,147,69193,53331,139,74,75211,52435
190,18,1,0,0,3,1,0,63,59,69194,53331,71,98,75214,52435
191,18,0,1,1,0,0,3,115,119,69194,53332,123,102,75214,52438
192,18,0,1,1,0,0,3,198,182,69194,53333,214,18,75214,52441
193,18,2,1,0,3,1,0,8,6,69196,53334,15,66,75217,52441
194,18,4,2,0,3,1,0,135,120,69200,53336,132,48,75220,52441
195,18,0,0,2,1,2,1,145,159,69200,53336,143,29,75221,52442
196,18,0,1,1,0,0,3,56,56,69200,53337,69,61,75221,52445
197,18,1,0,0,3,1,0,31,29,69201,53337,47,104,75224,52445
198,19,1,1,2,1,2,1,65,60,69202,53338,76,63,75225,52446
199,19,1,0,0,3,1,0,38,23,69203,53338,59,186,75228,52446
200,19,1,0,0,3,1,0,107,97,69204,53338,130,39,75231,52446
201,19,2,2,2,1,2,1,129,88,69206,53340,155,116,75232,52447
202,19,1,1,2,1,2,1,9,7,69207,53341,16,110,75233,52448
203,19,1,1,2,1,2,1,71,92,69208,53342,76,89,75234,52449
204,19,2,1,0,3,1,0,133,88,69210,53343,156,33,75237,52449
205,19,2,2,2,1,2,1,12,9,69212,53345,17,107,75238,52450
206,19,2,1,0,3,1,0,37,38,69214,53346,42,57,75241,52450
207,19,1,0,0,3,1,0,142,89,69215,53346,165,113,75244,52450
208,19,1,0,0,3,1,0,81,81,69216,53346,100,74,75247,52450
209,20,2,0,0,3,1,0,200,182,69218,53346,217,49,75250,52450
210,20,3,0,0,3,1,0,246,248,69221,53346,260,18,75253,52450
211,20,2,1,0,3,1,0,143,148,69223,53347,142,102,75256,52450
212,20,4,0,0,3,1,0,67,59,69227,53347,74,9,75259,52450
213,20,3,2,0,3,1,0,118,121,69230,53349,126,48,75262,52450
214,20,1,1,2,1,2,1,32,30,69231,53350,48,7,75263,52451
215,20,2,0,0,3,1,0,147,159,69233,53350,146,104,75266,52451
216,20,3,3,2,1,2,1,92,92,69236,53353,101,62,75267,52452
217,20,1,0,0,3,1,0,57,56,69237,53353,72,98,75270,52452
218,20,4,1,0,3,1,0,51,35,69241,53354,54,29,75273,52452
219,20,0,0,2,1,2,1,81,81,69241,53354,101,111,75274,52453
220,21,0,3,1,0,0,3,107,100,69241,53357,130,77,75274,52456
221,21,2,0,0,3,1,0,40,23,69243,53357,62,116,75277,52456
222,21,0,2,1,0,0,3,129,90,69243,53359,155,66,75277,52459
223,21,1,1,2,1,2,1,10,8,69244,53360,17,114,75278,52460
224,21,1,0,0,3,1,0,72,92,69245,53360,79,66,75281,52460
225,21,1,2,1,0,0,3,66,62,69246,53362,76,189,75281,52463
226,21,0,0,2,1,2,1,133,88,69246,53362,157,40,75282,52464
227,21,3,1,0,3,1,0,15,10,69249,53363,20,89,75285,52464
228,21,1,0,0,3,1,0,38,38,69250,53363,45,33,75288,52464
229,21,2,0,0,3,1,0,144,89,69252,53363,168,57,75291,52464
230,21,1,2,1,0,0,3,136,122,69253,53365,132,110,75291,52467
231,22,0,0,2,1,2,1,107,100,69253,53365,131,8,75292,52468
232,22,3,1,0,3,1,0,146,149,69256,53366,145,49,75295,52468
233,22,1,1,2,1,2,1,119,122,69257,53367,127,99,75296,52469
234,22,3,0,0,3,1,0,69,62,69260,53367,79,48,75299,52469
235,22,0,0,2,1,2,1,32,30,69260,53367,49,67,75300,52470
236,22,1,1,2,1,2,1,39,39,69261,53368,46,30,75301,52471
237,22,1,1,2,1,2,1,93,93,69262,53369,102,105,75302,52472
238,22,2,1,0,3,1,0,59,57,69264,53370,75,114,75305,52472
239,22,2,4,1,0,0,3,53,39,69266,53374,54,113,75305,52475
240,22,1,2,1,0,0,3,68,61,69267,53376,74,114,75305,52478
241,22,2,1,0,3,1,0,248,249,69269,53377,263,9,75308,52478
242,23,4,0,0,3,1,0,133,90,69273,53377,158,18,75311,52478
243,23,1,2,1,0,0,3,41,25,69274,53379,62,92,75311,52481
244,23,2,1,0,3,1,0,202,183,69276,53380,220,40,75314,52481
245,23,1,2,1,0,0,3,11,10,69277,53382,17,192,75314,52484
246,23,1,1,2,1,2,1,73,93,69278,53383,80,78,75315,52485
247,23,4,2,0,3,1,0,140,124,69282,53385,135,116,75318,52485
248,23,1,1,2,1,2,1,16,11,69283,53386,21,103,75319,52486
249,23,1,2,1,0,0,3,148,161,69284,53388,146,60,75319,52489
250,23,0,1,1,0,0,3,144,90,69284,53389,168,69,75319,52492
251,23,3,0,0,3,1,0,84,81,69287,53389,104,33,75322,52492
252,23,1,1,2,1,2,1,134,89,69288,53390,158,63,75323,52493
253,24,4,0,0,3,1,0,111,100,69292,53390,134,49,75326,52493
254,24,0,0,2,1,2,1,248,249,69292,53390,264,114,75327,52494
255,24,3,0,0,3,1,0,149,149,69295,53390,148,8,75330,52494
256,24,2,1,0,3,1,0,70,62,69297,53391,77,114,75333,52494
257,24,2,0,0,3,1,0,135,90,69299,53391,161,9,75336,52494
258,24,1,0,0,3,1,0,120,122,69300,53391,130,33,75339,52494
259,24,1,2,1,0,0,3,70,64,69301,53393,79,108,75339,52497
260,24,3,2,0,3,1,0,35,32,69304,53395,52,114,75342,52497
261,24,1,1,2,1,2,1,40,40,69305,53396,47,100,75343,52498
262,24,0,2,1,0,0,3,59,59,69305,53398,75,70,75343,52501
263,24,0,1,1,0,0,3,93,94,69305,53399,102,33,75343,52504
264,25,0,0,2,1,2,1,53,39,69305,53399,55,70,75344,52505
265,25,1,0,0,3,1,0,42,25,69306,53399,65,40,75347,52505
266,25,0,2,1,0,0,3,202,185,69306,53401,220,195,75347,52508
267,25,2,0,0,3,1,0,13,10,69308,53401,20,78,75350,52508
268,25,2,1,0,3,1,0,75,94,69310,53402,83,63,75353,52508
269,25,5,2,0,3,1,0,145,126,69315,53404,138,103,75356,52508
270,25,1,1,2,1,2,1,149,162,69316,53405,147,93,75357,52509
271,25,1,1,2,1,2,1,145,91,69317,53406,169,19,75358,52510
272,25,3,1,0,3,1,0,87,82,69320,53407,107,9,75361,52510
273,25,2,1,0,3,1,0,61,60,69322,53408,78,116,75364,52510
274,25,0,0,2,1,2,1,134,89,69322,53408,159,49,75365,52511
275,26,2,0,0,3,1,0,18,11,69324,53408,24,100,75368,52511
276,26,3,0,0,3,1,0,45,25,69327,53408,68,49,75371,52511
277,26,0,1,1,0,0,3,111,101,69327,53409,134,73,75371,52514
278,26,0,0,2,1,2,1,248,249,69327,53409,265,61,75372,52515
279,26,0,0,2,1,2,1,70,62,69327,53409,78,79,75373,52516
280,26,1,1,2,1,2,1,14,11,69328,53410,21,34,75374,52517
281,26,2,0,0,3,1,0,72,64,69330,53410,82,116,75377,52517
282,26,2,0,0,3,1,0,37,32,69332,53410,55,114,75380,52517
283,26,0,1,1,0,0,3,40,41,69332,53411,47,96,75380,52520
284,26,0,1,1,0,0,3,145,92,69332,53412,169,117,75380,52523
285,26,1,1,2,1,2,1,136,91,69333,53413,162,115,75381,52524
286,27,1,2,1,0,0,3,150,151,69334,53415,148,12,75381,52527
287,27,0,0,2,1,2,1,70,62,69334,53415,79,9,75382,52528
288,27,0,1,1,0,0,3,120,123,69334,53416,130,198,75382,52531
289,27,3,2,0,3,1,0,78,96,69337,53418,86,19,75385,52531
290,27,3,2,0,3,1,0,96,96,69340,53420,105,100,75388,52531
291,27,0,2,1,0,0,3,61,62,69340,53422,78,43,75388,52534
292,27,0,0,2,1,2,1,53,39,69340,53422,56,109,75389,52535
293,27,1,0,0,3,1,0,88,82,69341,53422,110,115,75392,52535
294,27,2,0,0,3,1,0,113,101,69343,53422,137,63,75395,52535
295,27,0,1,1,0,0,3,145,127,69343,53423,138,36,75395,52538
296,27,1,0,0,3,1,0,150,162,69344,53423,150,49,75398,52538
297,28,1,0,0,3,1,0,38,32,69345,53423,58,34,75401,52538
298,28,0,2,1,0,0,3,248,251,69345,53425,265,76,75401,52541
299,28,1,1,2,1,2,1,46,26,69346,53426,69,62,75402,52542
300,28,1,2,1,0,0,3,137,93,69347,53428,162,52,75402,52545
301,28,1,0,0,3,1,0,203,185,69348,53428,223,117,75405,52545
302,28,2,5,1,0,0,3,16,16,69350,53433,21,117,75405,52548
303,28,2,2,2,1,2,1,74,66,69352,53435,83,97,75406,52549
304,28,0,1,1,0,0,3,134,90,69352,53436,159,106,75406,52552
305,28,2,1,0,3,1,0,20,12,69354,53437,27,79,75409,52552
306,28,0,0,2,1,2,1,40,41,69354,53437,48,71,75410,52553
307,28,1,2,1,0,0,3,146,94,69355,53439,169,119,75410,52556
308,29,2,2,2,1,2,1,90,84,69357,53441,111,64,75411,52557
309,29,1,1,2,1,2,1,114,102,69358,53442,138,50,75412,52558
310,29,0,0,2,1,2,1,248,251,69358,53442,266,44,75413,52559
311,29,0,1,1,0,0,3,150,152,69358,53443,148,103,75413,52562
312,29,2,0,0,3,1,0,72,62,69360,53443,82,36,75416,52562
313,29,3,0,0,3,1,0,123,123,69363,53443,133,109,75419,52562
314,29,2,1,0,3,1,0,80,97,69365,53444,89,12,75422,52562
315,29,2,1,0,3,1,0,152,163,69367,53445,153,115,75425,52562
316,29,5,2,0,3,1,0,101,98,69372,53447,108,19,75428,52562
317,29,0,1,1,0,0,3,61,63,69372,53448,78,12,75428,52565
318,29,0,0,2,1,2,1,53,39,69372,53448,57,118,75429,52566
319,30,2,2,2,1,2,1,139,95,69374,53450,163,80,75430,52567
320,30,1,0,0,3,1,0,204,185,69375,53450,226,34,75433,52567
321,30,0,1,1,0,0,3,38,33,69375,53451,58,74,75433,52570
322,30,3,1,0,3,1,0,148,128,69378,53452,141,62,75436,52570
323,30,1,0,0,3,1,0,135,90,69379,53452,162,52,75439,52570
324,30,0,0,2,1,2,1,20,12,69379,53452,28,65,75440,52571
325,30,2,2,2,1,2,1,154,165,69381,53454,154,77,75441,52572
326,30,0,0,2,1,2,1,40,41,69381,53454,49,120,75442,52573
327,30,1,3,1,0,0,3,147,97,69382,53457,169,201,75442,52576
328,30,2,0,0,3,1,0,48,26,69384,53457,72,106,75445,52576
329,30,2,1,0,3,1,0,18,17,69386,53458,24,97,75448,52576
330,31,3,0,0,3,1,0,104,98,69389,53458,111,118,75451,52576
331,31,3,0,0,3,1,0,117,102,69392,53458,141,109,75454,52576
332,31,1,2,1,0,0,3,151,154,69393,53460,148,47,75454,52579
333,31,1,2,1,0,0,3,73,64,69394,53462,82,120,75454,52582
334,31,0,0,2,1,2,1,123,123,69394,53462,134,116,75455,52583
335,31,3,3,2,1,2,1,83,100,69397,53465,90,13,75456,52584
336,31,1,0,0,3,1,0,75,66,69398,53465,86,36,75459,52584
337,31,3,2,0,3,1,0,23,14,69401,53467,31,19,75462,52584
338,31,4,2,0,3,1,0,57,41,69405,53469,60,62,75465,52584
339,31,0,0,2,1,2,1,248,251,69405,53469,267,104,75466,52585
340,31,0,0,2,1,2,1,90,84,69405,53469,112,51,75467,52586
341,32,0,0,2,1,2,1,154,165,69405,53469,155,107,75468,52587
342,32,1,2,1,0,0,3,49,28,69406,53471,72,15,75468,52590
343,32,2,1,0,3,1,0,206,186,69408,53472,229,120,75471,52590
344,32,2,0,0,3,1,0,20,17,69410,53472,27,51,75474,52590
345,32,1,2,1,0,0,3,39,35,69411,53474,58,83,75474,52593
346,32,0,1,1,0,0,3,148,129,69411,53475,141,100,75474,52596
347,32,1,2,1,0,0,3,136,92,69412,53477,162,80,75474,52599
348,32,2,1,0,3,1,0,42,42,69414,53478,52,65,75477,52599
349,32,0,1,1,0,0,3,61,64,69414,53479,78,77,75477,52602
350,32,0,0,2,1,2,1,57,41,69414,53479,61,202,75478,52603
351,32,1,4,1,0,0,3,148,101,69415,53483,169,55,75478,52606
352,33,2,0,0,3,1,0,250,251,69417,53483,270,118,75481,52606
353,33,2,2,2,1,2,1,106,100,69419,53485,112,121,75482,52607
354,33,1,2,1,0,0,3,91,86,69420,53487,112,80,75482,52610
355,33,0,0,2,1,2,1,23,14,69420,53487,32,117,75483,52611
356,33,1,0,0,3,1,0,118,102,69421,53487,144,19,75486,52611
357,33,1,0,0,3,1,0,140,95,69422,53487,166,36,75489,52611
358,33,0,0,2,1,2,1,123,123,69422,53487,135,63,75490,52612
359,33,1,0,0,3,1,0,76,66,69423,53487,89,13,75493,52612
360,33,1,1,2,1,2,1,137,93,69424,53488,163,110,75494,52613
361,33,1,1,2,1,2,1,152,155,69425,53489,149,35,75495,52614
362,33,1,0,0,3,1,0,84,100,69426,53489,93,47,75498,52614
363,34,3,0,0,3,1,0,76,64,69429,53489,85,202,75501,52614
364,34,1,0,0,3,1,0,50,28,69430,53489,75,104,75504,52614
365,34,2,0,0,3,1,0,208,186,69432,53489,232,83,75507,52614
366,34,0,2,1,0,0,3,20,19,69432,53491,27,18,75507,52617
367,34,3,2,0,3,1,0,42,37,69435,53493,61,100,75510,52617
368,34,1,0,0,3,1,0,149,129,69436,53493,144,65,75513,52617
369,34,2,3,1,0,0,3,156,168,69438,53496,155,123,75513,52620
370,34,1,1,2,1,2,1,43,43,69439,53497,53,81,75514,52621
371,34,2,0,0,3,1,0,63,64,69441,53497,81,107,75517,52621
372,34,3,1,0,3,1,0,60,42,69444,53498,64,55,75520,52621
373,34,0,3,1,0,0,3,148,104,69444,53501,169,54,75520,52624
374,35,1,0,0,3,1,0,92,86,69445,53501,115,36,75523,52624
375,35,1,1,2,1,2,1,119,103,69446,53502,145,118,75524,52625
376,35,1,1,2,1,2,1,153,156,69447,53503,150,203,75525,52626
377,35,4,1,0,3,1,0,144,96,69451,53504,169,35,75528,52626
378,35,0,1,1,0,0,3,123,124,69451,53505,135,83,75528,52629
379,35,2,1,0,3,1,0,86,101,69453,53506,96,121,75531,52629
380,35,1,1,2,1,2,1,77,67,69454,53507,90,48,75532,52630
381,35,2,0,0,3,1,0,139,93,69456,53507,166,13,75535,52630
382,35,3,3,2,1,2,1,46,46,69459,53510,54,119,75536,52631
383,35,0,1,1,0,0,3,106,101,69459,53511,112,66,75536,52634
384,35,2,0,0,3,1,0,25,14,69461,53511,35,110,75539,52634
385,36,0,1,1,0,0,3,123,125,69461,53512,135,84,75539,52637
386,36,0,0,2,1,2,1,250,251,69461,53512,271,84,75540,52638
387,36,3,0,0,3,1,0,79,64,69464,53512,88,123,75543,52638
388,36,1,1,2,1,2,1,209,187,69465,53513,233,66,75544,52639
389,36,1,0,0,3,1,0,157,168,69466,53513,158,104,75547,52639
390,36,0,0,2,1,2,1,63,64,69466,53513,82,19,75548,52640
391,36,1,1,2,1,2,1,61,43,69467,53514,65,108,75549,52641
392,36,1,2,1,0,0,3,43,39,69468,53516,61,57,75549,52644
393,36,0,0,2,1,2,1,149,129,69468,53516,145,56,75550,52645
394,36,1,1,2,1,2,1,149,105,69469,53517,170,37,75551,52646
395,36,0,0,2,1,2,1,20,19,69469,53517,28,20,75552,52647
396,37,2,0,0,3,1,0,146,96,69471,53517,172,66,75555,52647
397,37,1,1,2,1,2,1,120,104,69472,53518,146,204,75556,52648
398,37,1,1,2,1,2,1,51,29,69473,53519,76,14,75557,52649
399,37,0,0,2,1,2,1,153,156,69473,53519,151,101,75558,52650
400,37,1,0,0,3,1,0,87,101,69474,53519,99,83,75561,52650
401,37,0,1,1,0,0,3,77,68,69474,53520,90,124,75561,52653
402,37,3,0,0,3,1,0,142,93,69477,53520,169,118,75564,52653
403,37,1,1,2,1,2,1,26,15,69478,53521,36,120,75565,52654
404,37,1,1,2,1,2,1,47,47,69479,53522,55,49,75566,52655
405,37,3,0,0,3,1,0,109,101,69482,53522,115,35,75569,52655
406,37,1,0,0,3,1,0,93,86,69483,53522,118,110,75572,52655
407,38,2,0,0,3,1,0,252,251,69485,53522,274,57,75575,52655
408,38,3,0,0,3,1,0,156,156,69488,53522,154,84,75578,52655
409,38,0,0,2,1,2,1,79,64,69488,53522,89,109,75579,52656
410,38,1,3,1,0,0,3,124,128,69489,53525,135,87,75579,52659
411,38,2,0,0,3,1,0,211,187,69491,53525,236,37,75582,52659
412,38,0,1,1,0,0,3,20,20,69491,53526,28,113,75582,52662
413,38,0,0,2,1,2,1,43,39,69491,53526,62,20,75583,52663
414,38,1,1,2,1,2,1,150,130,69492,53527,146,105,75584,52664
415,38,1,0,0,3,1,0,158,168,69493,53527,161,20,75587,52664
416,38,0,1,1,0,0,3,63,65,69493,53528,82,59,75587,52667
417,38,1,0,0,3,1,0,62,43,69494,53528,68,66,75590,52667
418,39,1,0,0,3,1,0,121,104,69495,53528,149,101,75593,52667
419,39,1,1,2,1,2,1,147,97,69496,53529,173,121,75594,52668
420,39,2,1,0,3,1,0,89,102,69498,53530,102,204,75597,52668
421,39,1,1,2,1,2,1,78,69,69499,53531,91,67,75598,52669
422,39,1,0,0,3,1,0,27,15,69500,53531,39,35,75601,52669
423,39,3,2,0,3,1,0,50,49,69503,53533,58,118,75604,52669
424,39,4,1,0,3,1,0,113,102,69507,53534,118,123,75607,52669
425,39,1,2,1,0,0,3,150,107,69508,53536,170,52,75607,52672
426,39,0,0,2,1,2,1,93,86,69508,53536,119,15,75608,52673
427,39,3,2,0,3,1,0,54,31,69511,53538,79,124,75611,52673
428,39,1,2,1,0,0,3,143,95,69512,53540,169,86,75611,52676
429,40,2,1,0,3,1,0,152,131,69514,53541,149,15,75614,52676
430,40,1,1,2,1,2,1,253,252,69515,53542,275,38,75615,52677
431,40,4,2,0,3,1,0,160,158,69519,53544,157,57,75618,52677
432,40,0,0,2,1,2,1,79,64,69519,53544,90,67,75619,52678
433,40,1,1,2,1,2,1,125,129,69520,53545,136,60,75620,52679
434,40,2,0,0,3,1,0,45,39,69522,53545,65,109,75623,52679
435,40,2,2,2,1,2,1,160,170,69524,53547,162,21,75624,52680
436,40,0,0,2,1,2,1,113,102,69524,53547,119,85,75625,52681
437,40,0,1,1,0,0,3,63,66,69524,53548,82,23,75625,52684
438,40,3,0,0,3,1,0,65,43,69527,53548,71,105,75628,52684
439,40,1,0,0,3,1,0,212,187,69528,53548,239,113,75631,52684
440,41,2,0,0,3,1,0,29,15,69530,53548,42,86,75634,52684
441,41,1,1,2,1,2,1,55,32,69531,53549,80,36,75635,52685
442,41,2,3,1,0,0,3,149,100,69533,53552,173,104,75635,52688
443,41,2,0,0,3,1,0,22,20,69535,53552,31,52,75638,52688
444,41,3,1,0,3,1,0,92,103,69538,53553,105,118,75641,52688
445,41,0,2,1,0,0,3,78,71,69538,53555,91,90,75641,52691
446,41,1,1,2,1,2,1,153,132,69539,53556,150,86,75642,52692
447,41,1,2,1,0,0,3,144,97,69540,53558,169,70,75642,52695
448,41,1,1,2,1,2,1,51,50,69541,53559,59,205,75643,52696
449,41,2,1,0,3,1,0,152,108,69543,53560,173,124,75646,52696
450,41,3,2,0,3,1,0,124,106,69546,53562,152,123,75649,52696
451,42,1,0,0,3,1,0,254,252,69547,53562,278,67,75652,52696
452,42,3,2,0,3,1,0,163,160,69550,53564,160,38,75655,52696
453,42,0,0,2,1,2,1,79,64,69550,53564,91,58,75656,52697
454,42,0,2,1,0,0,3,125,131,69550,53566,136,24,75656,52700
455,42,0,0,2,1,2,1,212,187,69550,53566,240,16,75657,52701
456,42,1,1,2,1,2,1,46,40,69551,53567,66,106,75658,52702
457,42,3,0,0,3,1,0,163,170,69554,53567,165,121,75661,52702
458,42,1,0,0,3,1,0,114,102,69555,53567,122,109,75664,52702
459,42,2,0,0,3,1,0,65,66,69557,53567,85,113,75667,52702
460,42,2,1,0,3,1,0,67,44,69559,53568,74,23,75670,52702
461,42,2,1,0,3,1,0,95,87,69561,53569,122,60,75673,52702
0,1,2,0,0,3,1,0,104,121,69563,53569,124,123,75676,52702
1,1,4,0,0,3,1,0,157,132,69567,53569,153,124,75679,52702
2,1,0,1,1,0,0,3,144,98,69567,53570,169,89,75679,52705
3,1,1,1,2,1,2,1,114,83,69568,53571,135,53,75680,52706
4,1,2,0,0,3,1,0,31,15,69570,53571,45,0,75683,52706
5,1,2,1,0,3,1,0,53,51,69572,53572,62,67,75686,52706
6,1,3,1,0,3,1,0,3,1,69575,53573,3,38,75689,52706
7,1,3,0,0,3,1,0,70,44,69578,53573,77,70,75692,52706
8,1,4,3,0,3,1,0,128,109,69582,53576,155,90,75695,52706
9,1,4,0,0,3,1,0,252,264,69586,53576,255,118,75698,52706
10,1,1,0,0,3,1,0,81,78,69587,53576,95,16,75701,52706
11,2,2,1,0,3,1,0,165,171,69589,53577,168,24,75704,52706
12,2,2,0,0,3,1,0,57,32,69591,53577,83,106,75707,52706
13,2,2,2,2,1,2,1,165,162,69593,53579,161,1,75708,52707
14,2,1,2,1,0,0,3,1,2,69594,53581,0,124,75708,52710
15,2,2,1,0,3,1,0,214,188,69596,53582,243,79,75711,52710
16,2,1,1,2,1,2,1,66,67,69597,53583,86,151,75712,52711
17,2,0,0,2,1,2,1,95,87,69597,53583,123,110,75713,52712
18,2,2,0,0,3,1,0,80,71,69599,53583,94,62,75716,52712
19,2,2,1,0,3,1,0,24,21,69601,53584,34,84,75719,52712
20,2,1,1,2,1,2,1,115,103,69602,53585,123,24,75720,52713
21,2,1,1,2,1,2,1,47,41,69603,53586,67,37,75721,52714
22,3,1,0,0,3,1,0,145,98,69604,53586,172,70,75724,52714
23,3,3,1,0,3,1,0,160,133,69607,53587,156,123,75727,52714
24,3,0,0,2,1,2,1,128,109,69607,53587,156,125,75728,52715
25,3,2,1,0,3,1,0,254,265,69609,53588,258,38,75731,52715
26,3,0,0,2,1,2,1,31,15,69609,53588,46,119,75732,52716
27,3,1,1,2,1,2,1,54,52,69610,53589,63,54,75733,52717
28,3,0,2,1,0,0,3,3,3,69610,53591,3,93,75733,52720
29,3,1,1,2,1,2,1,71,45,69611,53592,78,68,75734,52721
30,3,3,3,2,1,2,1,98,90,69614,53595,124,1,75735,52722
31,3,1,3,1,0,0,3,82,81,69615,53598,95,87,75735,52725
32,3,1,0,0,3,1,0,115,83,69616,53598,138,16,75738,52725
33,4,2,3,1,0,0,3,68,70,69618,53601,86,127,75738,52728
34,4,0,0,2,1,2,1,57,32,69618,53601,84,80,75739,52729
35,4,2,0,0,3,1,0,167,162,69620,53601,164,24,75742,52729
36,4,2,0,0,3,1,0,106,121,69622,53601,127,106,75745,52729
37,4,0,0,2,1,2,1,1,2,69622,53601,1,38,75746,52730
38,4,4,1,0,3,1,0,218,189,69626,53602,246,110,75749,52730
39,4,1,1,2,1,2,1,166,172,69627,53603,169,2,75750,52731
40,4,1,0,0,3,1,0,116,103,69628,53603,126,24,75753,52731
41,4,0,0,2,1,2,1,80,71,69628,53603,95,90,75754,52732
42,4,1,3,1,0,0,3,25,24,69629,53606,34,154,75754,52735
43,4,1,0,0,3,1,0,48,41,69630,53606,70,62,75757,52735
44,5,3,2,0,3,1,0,257,267,69633,53608,261,54,75760,52735
45,5,1,2,1,0,0,3,161,135,69634,53610,156,96,75760,52738
46,5,1,0,0,3,1,0,146,98,69635,53610,175,68,75763,52738
47,5,0,0,2,1,2,1,31,15,69635,53610,47,88,75764,52739
48,5,0,2,1,0,0,3,54,54,69635,53612,63,122,75764,52742
49,5,2,1,0,3,1,0,5,4,69637,53613,6,70,75767,52742
50,5,2,2,2,1,2,1,100,92,69639,53615,125,126,75768,52743
51,5,0,0,2,1,2,1,82,81,69639,53615,96,124,75769,52744
52,5,4,2,0,3,1,0,75,47,69643,53617,81,16,75772,52744
53,5,2,1,0,3,1,0,130,110,69645,53618,159,38,75775,52744
54,5,0,2,1,0,0,3,115,85,69645,53620,138,4,75775,52747
55,6,4,0,0,3,1,0,222,189,69649,53620,249,2,75778,52747
56,6,1,4,1,0,0,3,58,36,69650,53624,84,93,75778,52750
57,6,2,2,2,1,2,1,169,164,69652,53626,165,107,75779,52751
58,6,1,0,0,3,1,0,107,121,69653,53626,130,127,75782,52751
59,6,1,2,1,0,0,3,49,43,69654,53628,70,113,75782,52754
60,6,1,0,0,3,1,0,167,172,69655,53628,172,154,75785,52754
61,6,2,0,0,3,1,0,70,70,69657,53628,89,80,75788,52754
62,6,0,0,2,1,2,1,80,71,69657,53628,96,97,75789,52755
63,6,1,0,0,3,1,0,26,24,69658,53628,37,24,75792,52755
64,6,0,4,1,0,0,3,1,6,69658,53632,1,65,75792,52758
65,6,0,0,2,1,2,1,75,47,69658,53632,82,25,75793,52759
66,7,0,0,2,1,2,1,100,92,69658,53632,126,123,75794,52760
67,7,0,1,1,0,0,3,54,55,69658,53633,63,83,75794,52763
68,7,3,1,0,3,1,0,260,268,69661,53634,264,88,75797,52763
69,7,1,0,0,3,1,0,131,110,69662,53634,162,68,75800,52763
70,7,1,3,1,0,0,3,2,9,69663,53637,1,127,75800,52766
71,7,1,1,2,1,2,1,162,136,69664,53638,157,39,75801,52767
72,7,0,2,1,0,0,3,146,100,69664,53640,175,57,75801,52770
73,7,0,1,1,0,0,3,5,5,69664,53641,6,41,75801,52773
74,7,1,0,0,3,1,0,117,103,69665,53641,129,70,75804,52773
75,7,0,0,2,1,2,1,31,15,69665,53641,48,17,75805,52774
76,7,3,1,0,3,1,0,85,82,69668,53642,99,126,75808,52774
77,8,3,3,2,1,2,1,61,39,69671,53645,85,128,75809,52775
78,8,3,0,0,3,1,0,225,189,69674,53645,252,127,75812,52775
79,8,1,0,0,3,1,0,116,85,69675,53645,141,154,75815,52775
80,8,2,1,0,3,1,0,56,56,69677,53646,66,93,75818,52775
81,8,3,0,0,3,1,0,73,70,69680,53646,92,113,75821,52775
82,8,0,3,1,0,0,3,75,50,69680,53649,82,129,75821,52778
83,8,1,0,0,3,1,0,81,71,69681,53649,99,4,75824,52778
84,8,2,1,0,3,1,0,148,101,69683,53650,178,65,75827,52778
85,8,1,0,0,3,1,0,27,24,69684,53650,40,2,75830,52778
86,8,2,1,0,3,1,0,51,44,69686,53651,73,25,75833,52778
87,8,5,1,0,3,1,0,112,122,69691,53652,133,97,75836,52778
88,9,1,0,0,3,1,0,168,172,69692,53652,175,24,75839,52778
89,9,0,2,1,0,0,3,100,94,69692,53654,126,86,75839,52781
90,9,2,1,0,3,1,0,171,165,69694,53655,168,68,75842,52781
91,9,4,1,0,3,1,0,264,269,69698,53656,267,41,75845,52781
92,9,1,1,2,1,2,1,3,10,69699,53657,2,58,75846,52782
93,9,2,0,0,3,1,0,164,136,69701,53657,160,107,75849,52782
94,9,1,1,2,1,2,1,6,6,69702,53658,7,89,75850,52783
95,9,1,1,2,1,2,1,118,104,69703,53659,130,40,75851,52784
96,9,0,1,1,0,0,3,73,71,69703,53660,92,28,75851,52787
97,9,0,0,2,1,2,1,131,110,69703,53660,163,18,75852,52788
98,9,0,1,1,0,0,3,85,83,69703,53661,99,126,75852,52791
99,10,3,1,0,3,1,0,115,123,69706,53662,136,4,75855,52791
100,10,1,1,2,1,2,1,226,190,69707,53663,253,129,75856,52792
101,10,1,2,1,0,0,3,52,46,69708,53665,73,73,75856,52795
102,10,1,1,2,1,2,1,149,102,69709,53666,179,98,75857,52796
103,10,0,0,2,1,2,1,31,15,69709,53666,49,155,75858,52797
104,10,0,1,1,0,0,3,56,57,69709,53667,66,116,75858,52800
105,10,1,2,1,0,0,3,76,52,69710,53669,82,96,75858,52803
106,10,2,2,2,1,2,1,83,73,69712,53671,100,3,75859,52804
107,10,3,0,0,3,1,0,64,39,69715,53671,88,65,75862,52804
108,10,0,0,2,1,2,1,27,24,69715,53671,41,128,75863,52805
109,10,1,0,0,3,1,0,117,85,69716,53671,144,129,75866,52805
110,11,1,1,2,1,2,1,132,111,69717,53672,164,87,75867,52806
111,11,1,0,0,3,1,0,172,165,69718,53672,171,58,75870,52806
112,11,2,0,0,3,1,0,117,123,69720,53672,139,68,75873,52806
113,11,1,1,2,1,2,1,4,11,69721,53673,3,108,75874,52807
114,11,2,0,0,3,1,0,166,136,69723,53673,163,41,75877,52807
115,11,4,1,0,3,1,0,172,173,69727,53674,178,126,75880,52807
116,11,1,1,2,1,2,1,7,7,69728,53675,8,29,75881,52808
117,11,0,3,1,0,0,3,73,74,69728,53678,92,43,75881,52811
118,11,0,1,1,0,0,3,85,84,69728,53679,99,27,75881,52814
119,11,0,0,2,1,2,1,118,104,69728,53679,131,19,75882,52815
120,11,2,0,0,3,1,0,266,269,69730,53679,270,96,75885,52815
121,12,2,1,0,3,1,0,134,112,69732,53680,167,3,75888,52815
122,12,2,1,0,3,1,0,268,270,69734,53681,273,108,75891,52815
123,12,1,0,0,3,1,0,53,46,69735,53681,76,89,75894,52815
124,12,4,0,0,3,1,0,121,85,69739,53681,147,129,75897,52815
125,12,1,2,1,0,0,3,173,175,69740,53683,178,76,75897,52818
126,12,1,0,0,3,1,0,57,57,69741,53683,69,128,75900,52818
127,12,5,1,0,3,1,0,81,53,69746,53684,85,98,75903,52818
128,12,2,2,2,1,2,1,29,26,69748,53686,42,5,75904,52819
129,12,3,0,0,3,1,0,103,94,69751,53686,129,65,75907,52819
130,12,2,0,0,3,1,0,33,15,69753,53686,52,68,75910,52819
131,12,3,1,0,3,1,0,229,191,69756,53687,256,43,75913,52819
132,13,2,2,2,1,2,1,168,138,69758,53689,164,97,75914,52820
133,13,1,0,0,3,1,0,150,102,69759,53689,182,27,75917,52820
134,13,0,3,1,0,0,3,118,107,69759,53692,131,158,75917,52823
135,13,3,1,0,3,1,0,67,40,69762,53693,91,58,75920,52823
136,13,3,0,0,3,1,0,175,165,69765,53693,174,41,75923,52823
137,13,0,2,1,0,0,3,4,13,69765,53695,3,132,75923,52826
138,13,1,0,0,3,1,0,8,7,69766,53695,11,87,75926,52826
139,13,1,1,2,1,2,1,84,74,69767,53696,101,127,75927,52827
140,13,1,0,0,3,1,0,86,84,69768,53696,102,29,75930,52827
141,13,1,2,1,0,0,3,74,76,69769,53698,92,22,75930,52830
142,13,0,2,1,0,0,3,117,125,69769,53700,139,119,75930,52833
143,14,3,2,0,3,1,0,176,177,69772,53702,181,43,75933,52833
144,14,3,0,0,3,1,0,232,191,69775,53702,259,76,75936,52833
145,14,2,2,2,1,2,1,55,48,69777,53704,77,4,75937,52834
146,14,1,0,0,3,1,0,122,85,69778,53704,150,98,75940,52834
147,14,4,0,0,3,1,0,37,15,69782,53704,55,129,75943,52834
148,14,2,0,0,3,1,0,59,57,69784,53704,72,5,75946,52834
149,14,2,1,0,3,1,0,83,54,69786,53705,88,108,75949,52834
150,14,1,1,2,1,2,1,104,95,69787,53706,130,90,75950,52835
151,14,1,1,2,1,2,1,30,27,69788,53707,43,69,75951,52836
152,14,1,0,0,3,1,0,135,112,69789,53707,170,128,75954,52836
153,14,3,0,0,3,1,0,271,270,69792,53707,276,65,75957,52836
154,15,0,1,1,0,0,3,118,108,69792,53708,131,130,75957,52839
155,15,1,0,0,3,1,0,118,125,69793,53708,142,132,75960,52839
156,15,1,2,1,0,0,3,9,9,69794,53710,11,30,75960,52842
157,15,1,2,1,0,0,3,68,42,69795,53712,91,32,75960,52845
158,15,4,0,0,3,1,0,179,165,69799,53712,177,158,75963,52845
159,15,1,1,2,1,2,1,5,14,69800,53713,4,120,75964,52846
160,15,0,1,1,0,0,3,168,139,69800,53714,164,90,75964,52849
161,15,2,0,0,3,1,0,76,76,69802,53714,95,97,75967,52849
162,15,2,1,0,3,1,0,86,75,69804,53715,104,58,75970,52849
163,15,0,1,1,0,0,3,150,103,69804,53716,182,25,75970,52852
164,15,0,0,2,1,2,1,86,84,69804,53716,103,42,75971,52853
165,16,0,0,2,1,2,1,30,27,69804,53716,44,130,75972,52854
166,16,1,0,0,3,1,0,38,15,69805,53716,58,108,75975,52854
167,16,2,0,0,3,1,0,234,191,69807,53716,262,90,75978,52854
168,16,3,1,0,3,1,0,58,49,69810,53717,80,128,75981,52854
169,16,4,1,0,3,1,0,126,86,69814,53718,153,69,75984,52854
170,16,2,2,2,1,2,1,178,179,69816,53720,182,99,75985,52855
171,16,1,2,1,0,0,3,60,59,69817,53722,72,79,75985,52858
172,16,2,1,0,3,1,0,85,55,69819,53723,91,43,75988,52858
173,16,3,0,0,3,1,0,138,112,69822,53723,173,65,75991,52858
174,16,0,0,2,1,2,1,104,95,69822,53723,131,5,75992,52859
175,16,1,1,2,1,2,1,272,271,69823,53724,277,6,75993,52860
176,17,1,0,0,3,1,0,69,42,69824,53724,94,30,75996,52860
177,17,0,0,2,1,2,1,118,125,69824,53724,143,43,75997,52861
178,17,2,1,0,3,1,0,152,104,69826,53725,185,120,76000,52861
179,17,1,4,1,0,0,3,39,19,69827,53729,58,93,76000,52864
180,17,1,0,0,3,1,0,31,27,69828,53729,47,58,76003,52864
181,17,1,0,0,3,1,0,87,84,69829,53729,106,79,76006,52864
182,17,2,0,0,3,1,0,181,165,69831,53729,180,132,76009,52864
183,17,0,1,1,0,0,3,5,15,69831,53730,4,133,76009,52867
184,17,0,0,2,1,2,1,168,139,69831,53730,165,6,76010,52868
185,17,1,0,0,3,1,0,119,108,69832,53730,134,97,76013,52868
186,17,1,3,1,0,0,3,87,78,69833,53733,104,161,76013,52871
187,18,3,2,0,3,1,0,72,44,69836,53735,97,69,76016,52871
188,18,1,1,2,1,2,1,169,140,69837,53736,166,162,76017,52872
189,18,2,0,0,3,1,0,62,59,69839,53736,75,90,76020,52872
190,18,2,1,0,3,1,0,121,109,69841,53737,137,58,76023,52872
191,18,4,0,0,3,1,0,80,76,69845,53737,98,6,76026,52872
192,18,1,2,1,0,0,3,105,97,69846,53739,131,133,76026,52875
193,18,2,0,0,3,1,0,11,9,69848,53739,14,65,76029,52875
194,18,2,0,0,3,1,0,180,179,69850,53739,185,25,76032,52875
195,18,1,0,0,3,1,0,139,112,69851,53739,176,32,76035,52875
196,18,1,0,0,3,1,0,235,191,69852,53739,265,108,76038,52875
197,18,4,1,0,3,1,0,130,87,69856,53740,156,43,76041,52875
198,19,2,0,0,3,1,0,154,104,69858,53740,188,6,76044,52875
199,19,4,1,0,3,1,0,43,20,69862,53741,61,128,76047,52875
200,19,1,1,2,1,2,1,182,166,69863,53742,181,100,76048,52876
201,19,4,0,0,3,1,0,122,125,69867,53742,146,79,76051,52876
202,19,0,1,1,0,0,3,5,16,69867,53743,4,46,76051,52879
203,19,2,2,2,1,2,1,60,51,69869,53745,81,134,76052,52880
204,19,1,1,2,1,2,1,86,56,69870,53746,92,31,76053,52881
205,19,1,2,1,0,0,3,88,80,69871,53748,104,135,76053,52884
206,19,4,1,0,3,1,0,35,28,69875,53749,50,97,76056,52884
207,19,1,3,1,0,0,3,88,87,69876,53752,106,96,76056,52887
208,19,2,1,0,3,1,0,274,272,69878,53753,280,120,76059,52887
209,20,2,0,0,3,1,0,74,44,69880,53753,100,25,76062,52887
210,20,1,2,1,0,0,3,140,114,69881,53755,176,136,76062,52890
211,20,0,0,2,1,2,1,235,191,69881,53755,266,44,76063,52891
212,20,0,0,2,1,2,1,130,87,69881,53755,157,91,76064,52892
213,20,1,0,0,3,1,0,181,179,69882,53755,188,108,76067,52892
214,20,0,1,1,0,0,3,62,60,69882,53756,75,35,76067,52895
215,20,1,1,2,1,2,1,122,110,69883,53757,138,7,76068,52896
216,20,1,1,2,1,2,1,81,77,69884,53758,99,70,76069,52897
217,20,1,1,2,1,2,1,106,98,69885,53759,132,59,76070,52898
218,20,1,3,1,0,0,3,170,143,69886,53762,166,68,76070,52901
219,20,0,2,1,0,0,3,11,11,69886,53764,14,165,76070,52904
220,21,0,1,1,0,0,3,60,52,69886,53765,81,138,76070,52907
221,21,0,0,2,1,2,1,182,166,69886,53765,182,80,76071,52908
222,21,3,0,0,3,1,0,277,272,69889,53765,283,31,76074,52908
223,21,1,2,1,0,0,3,123,127,69890,53767,146,49,76074,52911
224,21,2,1,0,3,1,0,7,17,69892,53768,7,6,76077,52911
225,21,3,0,0,3,1,0,157,104,69895,53768,191,96,76080,52911
226,21,1,0,0,3,1,0,87,56,69896,53768,95,120,76083,52911
227,21,2,1,0,3,1,0,90,81,69898,53769,107,128,76086,52911
228,21,1,2,1,0,0,3,36,30,69899,53771,50,137,76086,52914
229,21,3,0,0,3,1,0,91,87,69902,53771,109,100,76089,52914
230,21,0,1,1,0,0,3,43,21,69902,53772,61,100,76089,52917
231,22,0,0,2,1,2,1,122,110,69902,53772,139,121,76090,52918
232,22,1,0,0,3,1,0,75,44,69903,53772,103,6,76093,52918
233,22,1,0,0,3,1,0,8,17,69904,53772,10,35,76096,52918
234,22,1,0,0,3,1,0,91,81,69905,53772,110,31,76099,52918
235,22,1,0,0,3,1,0,61,52,69906,53772,84,96,76102,52918
236,22,2,1,0,3,1,0,183,180,69908,53773,191,128,76105,52918
237,22,1,0,0,3,1,0,82,77,69909,53773,102,44,76108,52918
238,22,2,1,0,3,1,0,108,99,69911,53774,135,108,76111,52918
239,22,2,1,0,3,1,0,184,167,69913,53775,185,91,76114,52918
240,22,3,1,0,3,1,0,238,192,69916,53776,269,165,76117,52918
241,22,4,0,0,3,1,0,40,30,69920,53776,53,68,76120,52918
242,23,3,0,0,3,1,0,14,11,69923,53776,17,136,76123,52918
243,23,2,1,0,3,1,0,142,115,69925,53777,179,100,76126,52918
244,23,1,0,0,3,1,0,278,272,69926,53777,286,80,76129,52918
245,23,1,1,2,1,2,1,158,105,69927,53778,192,50,76130,52919
246,23,0,1,1,0,0,3,130,88,69927,53779,157,140,76130,52922
247,23,0,1,1,0,0,3,62,61,69927,53780,75,103,76130,52925
248,23,1,2,1,0,0,3,88,58,69928,53782,95,62,76130,52928
249,23,1,0,0,3,1,0,92,87,69929,53782,112,70,76133,52928
250,23,2,0,0,3,1,0,125,127,69931,53782,149,25,76136,52928
251,23,0,4,1,0,0,3,43,25,69931,53786,61,141,76136,52931
252,23,1,1,2,1,2,1,171,144,69932,53787,167,8,76137,52932
253,24,1,2,1,0,0,3,76,46,69933,53789,103,168,76137,52935
254,24,1,3,1,0,0,3,185,170,69934,53792,185,131,76137,52938
255,24,1,1,2,1,2,1,9,18,69935,53793,11,101,76138,52939
256,24,1,2,1,0,0,3,239,194,69936,53795,269,38,76138,52942
257,24,0,3,1,0,0,3,91,84,69936,53798,110,47,76138,52945
258,24,1,0,0,3,1,0,62,52,69937,53798,87,31,76141,52945
259,24,3,1,0,3,1,0,186,181,69940,53799,194,121,76144,52945
260,24,2,1,0,3,1,0,84,78,69942,53800,105,108,76147,52945
261,24,3,0,0,3,1,0,128,127,69945,53800,152,68,76150,52945
262,24,1,0,0,3,1,0,41,30,69946,53800,56,96,76153,52945
263,24,3,1,0,3,1,0,125,111,69949,53801,142,6,76156,52945
264,25,2,3,1,0,0,3,144,118,69951,53804,179,143,76156,52948
265,25,1,0,0,3,1,0,172,144,69952,53804,170,80,76159,52948
266,25,4,1,0,3,1,0,134,89,69956,53805,160,50,76162,52948
267,25,0,0,2,1,2,1,43,25,69956,53805,62,104,76163,52949
268,25,2,1,0,3,1,0,64,62,69958,53806,78,136,76166,52949
269,25,2,2,2,1,2,1,16,13,69960,53808,18,142,76167,52950
270,25,0,2,1,0,0,3,108,101,69960,53810,135,73,76167,52953
271,25,1,0,0,3,1,0,279,272,69961,53810,289,25,76170,52953
272,25,0,0,2,1,2,1,92,87,69961,53810,113,63,76171,52954
273,25,0,0,2,1,2,1,158,105,69961,53810,193,92,76172,52955
274,25,2,2,2,1,2,1,90,60,69963,53812,96,9,76173,52956
275,26,1,1,2,1,2,1,187,182,69964,53813,195,102,76174,52957
276,26,1,1,2,1,2,1,77,47,69965,53814,104,122,76175,52958
277,26,2,1,0,3,1,0,130,128,69967,53815,155,38,76178,52958
278,26,1,1,2,1,2,1,10,19,69968,53816,12,97,76179,52959
279,26,1,1,2,1,2,1,240,195,69969,53817,270,32,76180,52960
280,26,2,1,0,3,1,0,93,85,69971,53818,113,108,76183,52960
281,26,1,3,1,0,0,3,63,55,69972,53821,87,171,76183,52963
282,26,4,0,0,3,1,0,88,78,69976,53821,108,6,76186,52963
283,26,4,0,0,3,1,0,45,30,69980,53821,59,47,76189,52963
284,26,3,0,0,3,1,0,128,111,69983,53821,145,131,76192,52963
285,26,2,2,2,1,2,1,187,172,69985,53823,186,69,76193,52964
286,27,0,0,2,1,2,1,144,118,69985,53823,180,64,76194,52965
287,27,2,1,0,3,1,0,281,273,69987,53824,292,142,76197,52965
288,27,1,1,2,1,2,1,173,145,69988,53825,171,93,76198,52966
289,27,1,0,0,3,1,0,159,105,69989,53825,196,136,76201,52966
290,27,1,2,1,0,0,3,135,91,69990,53827,160,83,76201,52969
291,27,2,0,0,3,1,0,130,111,69992,53827,148,73,76204,52969
292,27,0,0,2,1,2,1,108,101,69992,53827,136,51,76205,52970
293,27,2,3,1,0,0,3,66,65,69994,53830,78,28,76205,52973
294,27,1,0,0,3,1,0,93,87,69995,53830,116,9,76208,52973
295,27,1,1,2,1,2,1,17,14,69996,53831,19,144,76209,52974
296,27,0,2,1,0,0,3,43,27,69996,53833,62,50,76209,52977
297,28,1,1,2,1,2,1,136,92,69997,53834,161,33,76210,52978
298,28,2,0,0,3,1,0,132,128,69999,53834,158,171,76213,52978
299,28,2,1,0,3,1,0,79,48,70001,53835,107,131,76216,52978
300,28,2,1,0,3,1,0,189,173,70003,53836,189,9,76219,52978
301,28,2,0,0,3,1,0,242,195,70005,53836,273,102,76222,52978
302,28,1,0,0,3,1,0,94,85,70006,53836,116,122,76225,52978
303,28,0,1,1,0,0,3,63,56,70006,53837,87,111,76225,52981
304,28,1,2,1,0,0,3,89,80,70007,53839,108,107,76225,52984
305,28,1,1,2,1,2,1,91,61,70008,53840,97,7,76226,52985
306,28,2,1,0,3,1,0,47,31,70010,53841,62,38,76229,52985
307,28,2,2,2,1,2,1,189,184,70012,53843,196,70,76230,52986
308,29,0,1,1,0,0,3,281,274,70012,53844,292,100,76230,52989
309,29,4,0,0,3,1,0,148,118,70016,53844,183,83,76233,52989
310,29,1,0,0,3,1,0,190,173,70017,53844,192,51,76236,52989
311,29,1,1,2,1,2,1,11,20,70018,53845,13,74,76237,52990
312,29,0,0,2,1,2,1,173,145,70018,53845,172,145,76238,52991
313,29,2,0,0,3,1,0,45,27,70020,53845,65,64,76241,52991
314,29,1,2,1,0,0,3,190,186,70021,53847,196,53,76241,52994
315,29,1,1,2,1,2,1,131,112,70022,53848,149,94,76242,52995
316,29,1,1,2,1,2,1,109,102,70023,53849,137,34,76243,52996
317,29,2,2,2,1,2,1,19,16,70025,53851,20,29,76244,52997
318,29,2,1,0,3,1,0,95,88,70027,53852,119,111,76247,52997
319,30,0,1,1,0,0,3,79,49,70027,53853,107,110,76247,53000
320,30,1,0,0,3,1,0,95,85,70028,53853,119,136,76250,53000
321,30,1,1,2,1,2,1,64,57,70029,53854,88,10,76251,53001
322,30,4,0,0,3,1,0,140,92,70033,53854,164,102,76254,53001
323,30,1,0,0,3,1,0,46,27,70034,53854,68,83,76257,53001
324,30,2,2,2,1,2,1,93,63,70036,53856,98,172,76258,53002
325,30,2,0,0,3,1,0,49,31,70038,53856,65,122,76261,53002
326,30,2,0,0,3,1,0,244,195,70040,53856,276,70,76264,53002
327,30,5,2,0,3,1,0,71,67,70045,53858,81,142,76267,53002
328,30,1,0,0,3,1,0,160,105,70046,53858,199,131,76270,53002
329,30,1,2,1,0,0,3,133,130,70047,53860,158,10,76270,53005
330,31,3,0,0,3,1,0,193,173,70050,53860,195,145,76273,53005
331,31,6,2,0,3,1,0,154,120,70056,53862,186,34,76276,53005
332,31,1,3,1,0,0,3,12,23,70057,53865,13,97,76276,53008
333,31,1,2,1,0,0,3,191,188,70058,53867,196,103,76276,53011
334,31,1,3,1,0,0,3,20,19,70059,53870,20,77,76276,53014
335,31,2,0,0,3,1,0,133,112,70061,53870,152,111,76279,53014
336,31,0,0,2,1,2,1,89,80,70061,53870,109,65,76280,53015
337,31,0,0,2,1,2,1,173,145,70061,53870,173,30,76281,53016
338,31,3,4,1,0,0,3,98,92,70064,53874,119,54,76281,53019
339,31,1,2,1,0,0,3,110,104,70065,53876,137,56,76281,53022
340,31,0,2,1,0,0,3,281,276,70065,53878,292,41,76281,53025
341,32,2,2,2,1,2,1,51,33,70067,53880,66,111,76282,53026
342,32,2,0,0,3,1,0,97,85,70069,53880,122,97,76285,53026
343,32,2,2,2,1,2,1,66,59,70071,53882,89,137,76286,53027
344,32,1,2,1,0,0,3,161,107,70072,53884,199,13,76286,53030
345,32,1,2,1,0,0,3,141,94,70073,53886,164,125,76286,53033
346,32,1,1,2,1,2,1,47,28,70074,53887,69,11,76287,53034
347,32,1,0,0,3,1,0,94,63,70075,53887,101,131,76290,53034
348,32,0,2,1,0,0,3,110,106,70075,53889,137,175,76290,53037
349,32,1,1,2,1,2,1,72,68,70076,53890,82,71,76291,53038
350,32,4,2,0,3,1,0,248,197,70080,53892,279,142,76294,53038
351,32,0,2,1,0,0,3,79,51,70080,53894,107,86,76294,53041
352,33,0,0,2,1,2,1,79,51,70080,53894,108,146,76295,53042
353,33,3,0,0,3,1,0,136,130,70083,53894,161,65,76298,53042
354,33,0,1,1,0,0,3,97,86,70083,53895,122,44,76298,53045
355,33,0,1,1,0,0,3,173,146,70083,53896,173,37,76298,53048
356,33,1,2,1,0,0,3,162,109,70084,53898,199,178,76298,53051
357,33,1,2,1,0,0,3,134,114,70085,53900,152,59,76298,53054
358,33,1,0,0,3,1,0,90,80,70086,53900,112,142,76301,53054
359,33,1,1,2,1,2,1,13,24,70087,53901,14,31,76302,53055
360,33,1,2,1,0,0,3,99,94,70088,53903,119,105,76302,53058
361,33,0,0,2,1,2,1,193,173,70088,53903,196,104,76303,53059
362,33,3,4,1,0,0,3,23,23,70091,53907,20,128,76303,53062
363,34,1,0,0,3,1,0,249,197,70092,53907,282,77,76306,53062
364,34,1,2,1,0,0,3,282,278,70093,53909,292,114,76306,53065
365,34,3,0,0,3,1,0,69,59,70096,53909,92,54,76309,53065
366,34,2,1,0,3,1,0,193,189,70098,53910,199,13,76312,53065
367,34,1,1,2,1,2,1,73,69,70099,53911,83,112,76313,53066
368,34,3,0,0,3,1,0,97,63,70102,53911,104,137,76316,53066
369,34,2,0,0,3,1,0,112,106,70104,53911,140,131,76319,53066
370,34,2,2,2,1,2,1,53,35,70106,53913,67,87,76320,53067
371,34,0,2,1,0,0,3,47,30,70106,53915,69,74,76320,53070
372,34,1,1,2,1,2,1,142,95,70107,53916,165,12,76321,53071
373,34,0,0,2,1,2,1,154,120,70107,53916,187,98,76322,53072
374,35,1,3,1,0,0,3,80,54,70108,53919,108,145,76322,53075
375,35,1,1,2,1,2,1,137,131,70109,53920,162,106,76323,53076
376,35,1,2,1,0,0,3,174,148,70110,53922,173,131,76323,53079
377,35,1,4,1,0,0,3,163,113,70111,53926,199,62,76323,53082
378,35,3,2,0,3,1,0,26,25,70114,53928,23,65,76326,53082
379,35,1,0,0,3,1,0,135,114,70115,53928,155,104,76329,53082
380,35,1,2,1,0,0,3,91,82,70116,53930,112,149,76329,53085
381,35,1,2,1,0,0,3,98,88,70117,53932,122,34,76329,53088
382,35,2,1,0,3,1,0,101,95,70119,53933,122,178,76332,53088
383,35,1,1,2,1,2,1,14,25,70120,53934,15,38,76333,53089
384,35,2,2,2,1,2,1,195,175,70122,53936,197,45,76334,53090
385,36,0,0,2,1,2,1,249,197,70122,53936,283,115,76335,53091
386,36,1,0,0,3,1,0,194,189,70123,53936,202,98,76338,53091
387,36,3,0,0,3,1,0,157,120,70126,53936,190,13,76341,53091
388,36,6,0,0,3,1,0,288,278,70132,53936,295,137,76344,53091
389,36,2,2,2,1,2,1,71,61,70134,53938,93,78,76345,53092
390,36,2,1,0,3,1,0,144,96,70136,53939,168,131,76348,53092
391,36,2,0,0,3,1,0,49,30,70138,53939,72,54,76351,53092
392,36,1,1,2,1,2,1,74,70,70139,53940,84,13,76352,53093
393,36,2,1,0,3,1,0,114,107,70141,53941,143,87,76355,53093
394,36,1,0,0,3,1,0,54,35,70142,53941,70,112,76358,53093
395,36,4,3,0,3,1,0,101,66,70146,53944,107,74,76361,53093
396,37,2,1,0,3,1,0,139,132,70148,53945,165,149,76364,53093
397,37,1,3,1,0,0,3,81,57,70149,53948,108,65,76364,53096
398,37,1,1,2,1,2,1,15,26,70150,53949,16,179,76365,53097
399,37,2,1,0,3,1,0,100,89,70152,53950,125,104,76368,53097
400,37,1,0,0,3,1,0,175,148,70153,53950,176,65,76371,53097
401,37,3,0,0,3,1,0,166,113,70156,53950,202,45,76374,53097
402,37,0,0,2,1,2,1,26,25,70156,53950,24,107,76375,53098
403,37,0,1,1,0,0,3,135,115,70156,53951,155,148,76375,53101
404,37,2,2,2,1,2,1,93,84,70158,53953,113,39,76376,53102
405,37,2,0,0,3,1,0,197,175,70160,53953,200,34,76379,53102
406,37,0,1,1,0,0,3,101,96,70160,53954,122,134,76379,53105
407,38,1,1,2,1,2,1,158,121,70161,53955,191,113,76380,53106
408,38,1,1,2,1,2,1,289,279,70162,53956,296,79,76381,53107
409,38,2,0,0,3,1,0,251,197,70164,53956,286,13,76384,53107
410,38,2,1,0,3,1,0,196,190,70166,53957,205,137,76387,53107
411,38,1,1,2,1,2,1,75,71,70167,53958,85,55,76388,53108
412,38,2,1,0,3,1,0,103,67,70169,53959,110,98,76391,53108
413,38,1,3,1,0,0,3,94,87,70170,53962,113,77,76391,53111
414,38,0,3,1,0,0,3,114,110,70170,53965,143,118,76391,53114
415,38,3,1,0,3,1,0,29,26,70173,53966,27,131,76394,53114
416,38,0,1,1,0,0,3,71,62,70173,53967,93,37,76394,53117
417,38,2,2,2,1,2,1,146,98,70175,53969,169,46,76395,53118
418,39,1,1,2,1,2,1,167,114,70176,53970,203,150,76396,53119
419,39,0,1,1,0,0,3,197,176,70176,53971,200,110,76396,53122
420,39,2,2,2,1,2,1,291,281,70178,53973,297,132,76397,53123
421,39,1,2,1,0,0,3,101,91,70179,53975,125,58,76397,53126
422,39,0,0,2,1,2,1,71,62,70179,53975,94,119,76398,53127
423,39,0,0,2,1,2,1,49,30,70179,53975,73,135,76399,53128
424,39,0,0,2,1,2,1,103,67,70179,53975,111,105,76400,53129
425,39,0,0,2,1,2,1,54,35,70179,53975,71,149,76401,53130
426,39,2,2,2,1,2,1,103,98,70181,53977,123,14,76402,53131
427,39,1,2,1,0,0,3,16,28,70182,53979,16,90,76402,53134
428,39,2,1,0,3,1,0,141,133,70184,53980,168,39,76405,53134
429,40,0,3,1,0,0,3,158,124,70184,53983,191,182,76405,53137
430,40,1,1,2,1,2,1,82,58,70185,53984,109,14,76406,53138
431,40,1,1,2,1,2,1,252,198,70186,53985,287,66,76407,53139
432,40,1,1,2,1,2,1,176,149,70187,53986,177,47,76408,53140
433,40,1,1,2,1,2,1,76,72,70188,53987,86,66,76409,53141
434,40,0,0,2,1,2,1,29,26,70188,53987,28,114,76410,53142
435,40,1,1,2,1,2,1,95,88,70189,53988,114,99,76411,53143
436,40,2,1,0,3,1,0,116,111,70191,53989,146,37,76414,53143
437,40,2,0,0,3,1,0,148,98,70193,53989,172,77,76417,53143
438,40,4,0,0,3,1,0,200,190,70197,53989,208,79,76420,53143
439,40,2,1,0,3,1,0,137,116,70199,53990,158,137,76423,53143
440,41,1,2,1,0,0,3,50,32,70200,53992,73,42,76423,53146
441,41,2,3,1,0,0,3,199,179,70202,53995,200,138,76423,53149
442,41,3,0,0,3,1,0,294,281,70205,53995,300,14,76426,53149
443,41,1,0,0,3,1,0,142,133,70206,53995,171,105,76429,53149
444,41,1,1,2,1,2,1,102,92,70207,53996,126,91,76430,53150
445,41,2,1,0,3,1,0,73,63,70209,53997,97,110,76433,53150
446,41,2,5,1,0,0,3,169,119,70211,54002,203,152,76433,53153
447,41,3,0,0,3,1,0,106,67,70214,54002,114,150,76436,53153
448,41,4,0,0,3,1,0,58,35,70218,54002,74,58,76439,53153
449,41,1,3,1,0,0,3,104,101,70219,54005,123,135,76439,53156
450,41,4,0,0,3,1,0,20,28,70223,54005,19,119,76442,53156
451,42,1,2,1,0,0,3,83,60,70224,54007,109,102,76442,53159
452,42,1,2,1,0,0,3,159,126,70225,54009,191,69,76442,53162
453,42,2,2,2,1,2,1,178,151,70227,54011,178,80,76443,53163
454,42,4,0,0,3,1,0,152,98,70231,54011,175,114,76446,53163
455,42,1,1,2,1,2,1,201,191,70232,54012,209,67,76447,53164
456,42,1,2,1,0,0,3,77,74,70233,54014,86,185,76447,53167
457,42,1,0,0,3,1,0,30,26,70234,54014,31,14,76450,53167
458,42,3,2,0,3,1,0,98,90,70237,54016,117,137,76453,53167
459,42,0,0,2,1,2,1,116,111,70237,54016,147,48,76454,53168
460,42,1,0,0,3,1,0,253,198,70238,54016,290,37,76457,53168
461,42,0,0,2,1,2,1,137,116,70238,54016,159,78,76458,53169
0,1,1,1,2,1,2,1,138,117,70239,54017,160,15,76459,53170
1,1,1,1,2,1,2,1,84,61,70240,54018,110,138,76460,53171
2,1,1,2,1,0,0,3,160,128,70241,54020,191,107,76460,53174
3,1,2,0,0,3,1,0,40,71,70243,54020,32,45,76463,53174
4,1,2,0,0,3,1,0,94,103,70245,54020,108,37,76466,53174
5,1,4,1,0,3,1,0,215,195,70249,54021,243,67,76469,53174
6,1,1,1,2,1,2,1,78,75,70250,54022,87,79,76470,53175
7,1,0,2,1,0,0,3,116,113,70250,54024,147,89,76470,53178
8,1,2,2,2,1,2,1,154,100,70252,54026,176,70,76471,53179
9,1,1,1,2,1,2,1,143,134,70253,54027,172,49,76472,53180
10,1,1,0,0,3,1,0,99,90,70254,54027,120,0,76475,53180
11,2,2,0,0,3,1,0,201,179,70256,54027,203,60,76478,53180
12,2,2,0,0,3,1,0,127,131,70258,54027,139,91,76481,53180
13,2,0,1,1,0,0,3,50,33,70258,54028,73,141,76481,53183
14,2,2,0,0,3,1,0,60,35,70260,54028,77,58,76484,53183
15,2,1,1,2,1,2,1,80,65,70261,54029,92,23,76485,53184
16,2,0,0,2,1,2,1,73,63,70261,54029,98,120,76486,53185
17,2,1,0,0,3,1,0,1,0,70262,54029,3,105,76489,53185
18,2,1,1,2,1,2,1,31,27,70263,54030,32,164,76490,53186
19,2,3,0,0,3,1,0,61,95,70266,54030,58,110,76493,53186
20,2,1,1,2,1,2,1,107,68,70267,54031,115,43,76494,53187
21,2,0,0,2,1,2,1,104,101,70267,54031,124,103,76495,53188
22,3,1,0,0,3,1,0,144,134,70268,54031,175,89,76498,53188
23,3,1,1,2,1,2,1,105,102,70269,54032,125,46,76499,53189
24,3,0,0,2,1,2,1,84,61,70269,54032,111,71,76500,53190
25,3,2,0,0,3,1,0,42,71,70271,54032,35,164,76503,53190
26,3,1,1,2,1,2,1,202,180,70272,54033,204,50,76504,53191
27,3,2,1,0,3,1,0,96,104,70274,54034,111,67,76507,53191
28,3,1,0,0,3,1,0,155,100,70275,54034,179,15,76510,53191
29,3,1,5,1,0,0,3,79,80,70276,54039,87,110,76510,53194
30,3,0,0,2,1,2,1,116,113,70276,54039,148,142,76511,53195
31,3,1,1,2,1,2,1,100,91,70277,54040,121,121,76512,53196
32,3,0,0,2,1,2,1,60,35,70277,54040,78,1,76513,53197
33,4,2,1,0,3,1,0,162,129,70279,54041,194,103,76516,53197
34,4,0,0,2,1,2,1,80,65,70279,54041,93,61,76517,53198
35,4,2,3,1,0,0,3,33,30,70281,54044,32,113,76517,53201
36,4,3,1,0,3,1,0,130,132,70284,54045,142,105,76520,53201
37,4,3,1,0,3,1,0,218,196,70287,54046,246,58,76523,53201
38,4,1,1,2,1,2,1,74,64,70288,54047,99,24,76524,53202
39,4,1,1,2,1,2,1,51,34,70289,54048,74,92,76525,53203
40,4,1,0,0,3,1,0,2,0,70290,54048,6,138,76528,53203
41,4,2,2,2,1,2,1,63,97,70292,54050,59,38,76529,53204
42,4,2,1,0,3,1,0,140,118,70294,54051,163,43,76532,53204
43,4,1,1,2,1,2,1,108,69,70295,54052,116,80,76533,53205
44,5,0,0,2,1,2,1,144,134,70295,54052,176,16,76534,53206
45,5,2,0,0,3,1,0,107,102,70297,54052,128,113,76537,53206
46,5,0,1,1,0,0,3,84,62,70297,54053,111,113,76537,53209
47,5,1,1,2,1,2,1,43,72,70298,54054,36,44,76538,53210
48,5,2,2,2,1,2,1,204,182,70300,54056,205,90,76539,53211
49,5,0,0,2,1,2,1,96,104,70300,54056,112,2,76540,53212
50,5,2,2,2,1,2,1,157,102,70302,54058,180,68,76541,53213
51,5,1,3,1,0,0,3,64,100,70303,54061,59,167,76541,53216
52,5,0,0,2,1,2,1,100,91,70303,54061,122,143,76542,53217
53,5,0,0,2,1,2,1,108,69,70303,54061,117,122,76543,53218
54,5,2,1,0,3,1,0,62,36,70305,54062,81,50,76546,53218
55,6,0,4,1,0,0,3,162,133,70305,54066,194,27,76546,53221
56,6,2,1,0,3,1,0,82,66,70307,54067,96,38,76549,53221
57,6,0,3,1,0,0,3,130,135,70307,54070,142,141,76549,53224
58,6,1,1,2,1,2,1,75,65,70308,54071,100,93,76550,53225
59,6,2,1,0,3,1,0,4,1,70310,54072,9,80,76553,53225
60,6,1,0,0,3,1,0,80,80,70311,54072,90,103,76556,53225
61,6,2,0,0,3,1,0,35,30,70313,54072,35,71,76559,53225
62,6,1,0,0,3,1,0,141,118,70314,54072,166,105,76562,53225
63,6,0,0,2,1,2,1,116,113,70314,54072,149,59,76563,53226
64,6,2,0,0,3,1,0,220,196,70316,54072,249,61,76566,53226
65,6,1,0,0,3,1,0,52,34,70317,54072,77,46,76569,53226
66,7,1,1,2,1,2,1,205,183,70318,54073,206,144,76570,53227
67,7,3,2,0,3,1,0,87,64,70321,54075,114,44,76573,53227
68,7,1,0,0,3,1,0,44,72,70322,54075,39,105,76576,53227
69,7,1,2,1,0,0,3,97,106,70323,54077,112,53,76576,53230
70,7,3,2,0,3,1,0,67,102,70326,54079,62,16,76579,53230
71,7,0,3,1,0,0,3,100,94,70326,54082,122,170,76579,53233
72,7,0,2,1,0,0,3,108,71,70326,54084,117,116,76579,53236
73,7,4,1,0,3,1,0,66,37,70330,54085,84,113,76582,53236
74,7,2,2,2,1,2,1,146,136,70332,54087,177,69,76583,53237
75,7,0,2,1,0,0,3,107,104,70332,54089,128,125,76583,53240
76,7,1,1,2,1,2,1,83,67,70333,54090,97,3,76584,53241
77,8,1,0,0,3,1,0,158,102,70334,54090,183,80,76587,53241
78,8,2,3,1,0,0,3,132,138,70336,54093,142,64,76587,53244
79,8,2,2,2,1,2,1,222,198,70338,54095,250,142,76588,53245
80,8,1,1,2,1,2,1,163,134,70339,54096,195,39,76589,53246
81,8,2,0,0,3,1,0,77,65,70341,54096,103,71,76592,53246
82,8,3,0,0,3,1,0,55,34,70344,54096,80,59,76595,53246
83,8,0,1,1,0,0,3,4,2,70344,54097,9,49,76595,53249
84,8,1,0,0,3,1,0,81,80,70345,54097,93,93,76598,53249
85,8,0,1,1,0,0,3,141,119,70345,54098,166,93,76598,53252
86,8,0,0,2,1,2,1,116,113,70345,54098,150,104,76599,53253
87,8,2,1,0,3,1,0,37,31,70347,54099,38,27,76602,53253
88,9,1,1,2,1,2,1,147,137,70348,54100,178,50,76603,53254
89,9,1,4,1,0,0,3,108,108,70349,54104,128,173,76603,53257
90,9,1,0,0,3,1,0,88,64,70350,54104,117,125,76606,53257
91,9,1,1,2,1,2,1,206,184,70351,54105,207,17,76607,53258
92,9,2,0,0,3,1,0,85,67,70353,54105,100,69,76610,53258
93,9,2,0,0,3,1,0,57,34,70355,54105,83,116,76613,53258
94,9,0,1,1,0,0,3,4,3,70355,54106,9,116,76613,53261
95,9,3,2,0,3,1,0,69,39,70358,54108,87,27,76616,53261
96,9,3,1,0,3,1,0,100,107,70361,54109,115,144,76619,53261
97,9,2,1,0,3,1,0,83,81,70363,54110,96,105,76622,53261
98,9,2,2,2,1,2,1,110,73,70365,54112,118,94,76623,53262
99,10,0,1,1,0,0,3,132,139,70365,54113,142,83,76623,53265
100,10,2,0,0,3,1,0,143,119,70367,54113,169,142,76626,53265
101,10,3,0,0,3,1,0,166,134,70370,54113,198,71,76629,53265
102,10,0,0,2,1,2,1,44,72,70370,54113,40,54,76630,53266
103,10,3,0,0,3,1,0,225,198,70373,54113,253,44,76633,53266
104,10,1,1,2,1,2,1,78,66,70374,54114,104,4,76634,53267
105,10,1,0,0,3,1,0,159,102,70375,54114,186,59,76637,53267
106,10,1,1,2,1,2,1,38,32,70376,54115,39,40,76638,53268
107,10,3,1,0,3,1,0,70,103,70379,54116,65,93,76641,53268
108,10,1,1,2,1,2,1,101,95,70380,54117,123,105,76642,53269
109,10,1,1,2,1,2,1,117,114,70381,54118,151,65,76643,53270
110,11,1,1,2,1,2,1,144,120,70382,54119,170,117,76644,53271
111,11,0,0,2,1,2,1,108,108,70382,54119,129,18,76645,53272
112,11,1,0,0,3,1,0,89,64,70383,54119,120,94,76648,53272
113,11,2,1,0,3,1,0,208,185,70385,54120,210,116,76651,53272
114,11,0,1,1,0,0,3,147,138,70385,54121,178,43,76651,53275
115,11,2,1,0,3,1,0,102,108,70387,54122,118,50,76654,53275
116,11,1,0,0,3,1,0,160,102,70388,54122,189,144,76657,53275
117,11,0,2,1,0,0,3,57,36,70388,54124,83,96,76657,53278
118,11,0,0,2,1,2,1,4,3,70388,54124,10,174,76658,53279
119,11,1,1,2,1,2,1,84,82,70389,54125,97,70,76659,53280
120,11,1,0,0,3,1,0,111,73,70390,54125,121,27,76662,53280
121,12,2,0,0,3,1,0,168,134,70392,54125,201,44,76665,53280
122,12,1,0,0,3,1,0,45,72,70393,54125,43,125,76668,53280
123,12,0,2,1,0,0,3,85,69,70393,54127,100,86,76668,53283
124,12,2,1,0,3,1,0,134,140,70395,54128,145,70,76671,53283
125,12,2,1,0,3,1,0,104,109,70397,54129,121,105,76674,53283
126,12,0,0,2,1,2,1,38,32,70397,54129,40,5,76675,53284
127,12,4,3,0,3,1,0,105,98,70401,54132,126,105,76678,53284
128,12,4,0,0,3,1,0,73,39,70405,54132,90,142,76681,53284
129,12,2,0,0,3,1,0,227,198,70407,54132,256,71,76684,53284
130,12,1,4,1,0,0,3,118,118,70408,54136,151,57,76684,53287
131,12,3,0,0,3,1,0,73,103,70411,54136,68,59,76687,53287
132,13,3,2,0,3,1,0,211,187,70414,54138,213,105,76690,53287
133,13,2,0,0,3,1,0,136,140,70416,54138,148,18,76693,53287
134,13,2,1,0,3,1,0,80,67,70418,54139,107,144,76696,53287
135,13,0,1,1,0,0,3,160,103,70418,54140,189,53,76696,53290
136,13,0,1,1,0,0,3,4,4,70418,54141,10,60,76696,53293
137,13,0,0,2,1,2,1,84,82,70418,54141,98,97,76697,53294
138,13,1,4,1,0,0,3,145,124,70419,54145,170,177,76697,53297
139,13,0,1,1,0,0,3,111,74,70419,54146,121,119,76697,53300
140,13,0,1,1,0,0,3,89,65,70419,54147,120,68,76697,53303
141,13,0,1,1,0,0,3,105,99,70419,54148,126,30,76697,53306
142,13,2,1,0,3,1,0,110,109,70421,54149,132,43,76700,53306
143,14,3,2,0,3,1,0,76,105,70424,54151,71,142,76703,53306
144,14,0,1,1,0,0,3,118,119,70424,54152,151,73,76703,53309
145,14,2,0,0,3,1,0,149,138,70426,54152,181,5,76706,53309
146,14,1,0,0,3,1,0,46,72,70427,54152,46,117,76709,53309
147,14,1,1,2,1,2,1,86,70,70428,54153,101,60,76710,53310
148,14,3,1,0,3,1,0,107,110,70431,54154,124,86,76713,53310
149,14,0,4,1,0,0,3,227,202,70431,54158,256,108,76713,53313
150,14,1,1,2,1,2,1,58,37,70432,54159,84,72,76714,53314
151,14,4,2,0,3,1,0,42,34,70436,54161,43,94,76717,53314
152,14,0,0,2,1,2,1,73,39,70436,54161,91,45,76718,53315
153,14,1,1,2,1,2,1,169,135,70437,54162,202,126,76719,53316
154,15,5,1,0,3,1,0,141,141,70442,54163,151,177,76722,53316
155,15,1,0,0,3,1,0,90,65,70443,54163,123,5,76725,53316
156,15,2,0,0,3,1,0,171,135,70445,54163,205,97,76728,53316
157,15,4,0,0,3,1,0,50,72,70449,54163,49,142,76731,53316
158,15,1,1,2,1,2,1,81,68,70450,54164,108,19,76732,53317
159,15,1,1,2,1,2,1,85,83,70451,54165,99,120,76733,53318
160,15,1,0,0,3,1,0,146,124,70452,54165,173,105,76736,53318
161,15,3,0,0,3,1,0,108,99,70455,54165,129,43,76739,53318
162,15,2,2,2,1,2,1,112,111,70457,54167,133,61,76740,53319
163,15,1,2,1,0,0,3,161,105,70458,54169,189,71,76740,53322
164,15,1,1,2,1,2,1,112,75,70459,54170,122,54,76741,53323
165,16,1,1,2,1,2,1,74,40,70460,54171,92,127,76742,53324
166,16,1,0,0,3,1,0,212,187,70461,54171,216,86,76745,53324
167,16,2,0,0,3,1,0,88,70,70463,54171,104,117,76748,53324
168,16,3,0,0,3,1,0,152,138,70466,54171,184,60,76751,53324
169,16,1,1,2,1,2,1,108,111,70467,54172,125,95,76752,53325
170,16,0,0,2,1,2,1,58,37,70467,54172,85,109,76753,53326
171,16,1,0,0,3,1,0,5,4,70468,54172,13,72,76756,53326
172,16,0,0,2,1,2,1,76,105,70468,54172,72,74,76757,53327
173,16,0,0,2,1,2,1,118,119,70468,54172,152,31,76758,53328
174,16,1,0,0,3,1,0,228,202,70469,54172,259,144,76761,53328
175,16,1,1,2,1,2,1,43,35,70470,54173,44,46,76762,53329
176,17,0,1,1,0,0,3,112,76,70470,54174,122,100,76762,53332
177,17,1,2,1,0,0,3,91,67,70471,54176,123,89,76762,53335
178,17,2,0,0,3,1,0,173,135,70473,54176,208,19,76765,53335
179,17,1,2,1,0,0,3,142,143,70474,54178,151,57,76765,53338
180,17,1,1,2,1,2,1,82,69,70475,54179,109,44,76766,53339
181,17,2,1,0,3,1,0,163,106,70477,54180,192,120,76769,53339
182,17,0,0,2,1,2,1,85,83,70477,54180,100,6,76770,53340
183,17,0,0,2,1,2,1,146,124,70477,54180,174,72,76771,53341
184,17,1,0,0,3,1,0,109,99,70478,54180,132,142,76774,53341
185,17,2,2,2,1,2,1,230,204,70480,54182,260,62,76775,53342
186,17,2,1,0,3,1,0,52,73,70482,54183,52,105,76778,53342
187,18,0,0,2,1,2,1,5,4,70482,54183,14,145,76779,53343
188,18,2,2,2,1,2,1,114,113,70484,54185,134,75,76780,53344
189,18,1,1,2,1,2,1,92,68,70485,54186,124,32,76781,53345
190,18,1,1,2,1,2,1,89,71,70486,54187,105,96,76782,53346
191,18,3,0,0,3,1,0,155,138,70489,54187,187,117,76785,53346
192,18,1,3,1,0,0,3,109,114,70490,54190,125,22,76785,53349
193,18,1,0,0,3,1,0,59,37,70491,54190,88,46,76788,53349
194,18,2,1,0,3,1,0,78,106,70493,54191,75,127,76791,53349
195,18,2,2,2,1,2,1,76,42,70495,54193,93,73,76792,53350
196,18,1,0,0,3,1,0,119,119,70496,54193,155,177,76795,53350
197,18,0,0,2,1,2,1,212,187,70496,54193,217,110,76796,53351
198,19,1,4,1,0,0,3,113,80,70497,54197,122,75,76796,53354
199,19,2,1,0,3,1,0,175,136,70499,54198,211,60,76799,53354
200,19,1,0,0,3,1,0,143,143,70500,54198,154,6,76802,53354
201,19,1,1,2,1,2,1,83,70,70501,54199,110,143,76803,53355
202,19,3,1,0,3,1,0,166,107,70504,54200,195,105,76806,53355
203,19,3,1,0,3,1,0,88,84,70507,54201,103,57,76809,53355
204,19,1,2,1,0,0,3,44,37,70508,54203,44,103,76809,53358
205,19,2,1,0,3,1,0,148,125,70510,54204,177,62,76812,53358
206,19,1,2,1,0,0,3,110,101,70511,54206,132,123,76812,53361
207,19,0,0,2,1,2,1,52,73,70511,54206,53,90,76813,53362
208,19,1,0,0,3,1,0,231,204,70512,54206,263,44,76816,53362
209,20,0,0,2,1,2,1,5,4,70512,54206,15,128,76817,53363
210,20,1,1,2,1,2,1,115,114,70513,54207,135,146,76818,53364
211,20,3,2,0,3,1,0,95,70,70516,54209,127,22,76821,53364
212,20,2,1,0,3,1,0,214,188,70518,54210,220,46,76824,53364
213,20,1,1,2,1,2,1,90,72,70519,54211,106,178,76825,53365
214,20,3,1,0,3,1,0,158,139,70522,54212,190,73,76828,53365
215,20,3,2,0,3,1,0,112,116,70525,54214,128,32,76831,53365
216,20,1,1,2,1,2,1,60,38,70526,54215,89,76,76832,53366
217,20,4,0,0,3,1,0,82,106,70530,54215,78,96,76835,53366
218,20,4,1,0,3,1,0,80,43,70534,54216,96,110,76838,53366
219,20,2,0,0,3,1,0,121,119,70536,54216,158,117,76841,53366
220,21,0,0,2,1,2,1,148,125,70536,54216,178,124,76842,53367
221,21,1,1,2,1,2,1,176,137,70537,54217,212,58,76843,53368
222,21,2,1,0,3,1,0,46,38,70539,54218,47,62,76846,53368
223,21,2,1,0,3,1,0,168,108,70541,54219,198,103,76849,53368
224,21,1,0,0,3,1,0,53,73,70542,54219,56,6,76852,53368
225,21,2,1,0,3,1,0,145,144,70544,54220,157,44,76855,53368
226,21,3,0,0,3,1,0,234,204,70547,54220,266,105,76858,53368
227,21,0,0,2,1,2,1,83,70,70547,54220,111,61,76859,53369
228,21,2,0,0,3,1,0,90,84,70549,54220,106,75,76862,53369
229,21,0,1,1,0,0,3,110,102,70549,54221,132,93,76862,53372
230,21,0,0,2,1,2,1,113,80,70549,54221,123,144,76863,53373
231,22,0,2,1,0,0,3,214,190,70549,54223,220,64,76863,53376
232,22,2,0,0,3,1,0,147,144,70551,54223,160,146,76866,53376
233,22,2,0,0,3,1,0,84,106,70553,54223,81,32,76869,53376
234,22,2,1,0,3,1,0,82,44,70555,54224,99,75,76872,53376
235,22,2,0,0,3,1,0,85,70,70557,54224,114,178,76875,53376
236,22,2,1,0,3,1,0,115,81,70559,54225,126,110,76878,53376
237,22,1,0,0,3,1,0,6,4,70560,54225,18,96,76881,53376
238,22,0,0,2,1,2,1,90,72,70560,54225,107,125,76882,53377
239,22,1,0,0,3,1,0,47,38,70561,54225,50,128,76885,53377
240,22,3,3,2,1,2,1,63,41,70564,54228,90,106,76886,53378
241,22,3,1,0,3,1,0,118,115,70567,54229,138,46,76889,53378
242,23,1,0,0,3,1,0,113,116,70568,54229,131,144,76892,53378
243,23,2,2,2,1,2,1,160,141,70570,54231,191,94,76893,53379
244,23,3,0,0,3,1,0,56,73,70573,54231,59,103,76896,53379
245,23,1,0,0,3,1,0,111,102,70574,54231,135,117,76899,53379
246,23,0,0,2,1,2,1,176,137,70574,54231,213,63,76900,53380
247,23,1,1,2,1,2,1,169,109,70575,54232,199,7,76901,53381
248,23,1,1,2,1,2,1,122,120,70576,54233,159,59,76902,53382
249,23,1,3,1,0,0,3,91,87,70577,54236,106,76,76902,53385
250,23,2,2,2,1,2,1,97,72,70579,54238,128,45,76903,53386
251,23,2,0,0,3,1,0,236,204,70581,54238,269,22,76906,53386
252,23,3,2,0,3,1,0,151,127,70584,54240,181,76,76909,53386
253,24,2,2,2,1,2,1,238,206,70586,54242,270,33,76910,53387
254,24,1,1,2,1,2,1,85,107,70587,54243,82,95,76911,53388
255,24,3,2,0,3,1,0,66,43,70590,54245,93,144,76914,53388
256,24,0,1,1,0,0,3,85,71,70590,54246,114,78,76914,53391
257,24,0,0,2,1,2,1,47,38,70590,54246,51,111,76915,53392
258,24,0,0,2,1,2,1,147,144,70590,54246,161,47,76916,53393
259,24,2,0,0,3,1,0,153,127,70592,54246,184,96,76919,53393
260,24,1,1,2,1,2,1,7,5,70593,54247,19,46,76920,53394
261,24,2,1,0,3,1,0,178,138,70595,54248,216,125,76923,53394
262,24,1,2,1,0,0,3,91,74,70596,54250,107,109,76923,53397
263,24,0,0,2,1,2,1,115,81,70596,54250,127,65,76924,53398
264,25,0,1,1,0,0,3,122,121,70596,54251,159,25,76924,53401
265,25,1,1,2,1,2,1,161,142,70597,54252,192,147,76925,53402
266,25,1,0,0,3,1,0,114,116,70598,54252,134,103,76928,53402
267,25,1,1,2,1,2,1,170,110,70599,54253,200,118,76929,53403
268,25,2,0,0,3,1,0,99,72,70601,54253,131,178,76932,53403
269,25,2,1,0,3,1,0,58,74,70603,54254,62,76,76935,53403
270,25,1,1,2,1,2,1,215,191,70604,54255,221,8,76936,53404
271,25,0,2,1,0,0,3,91,89,70604,54257,106,131,76936,53407
272,25,2,2,2,1,2,1,120,117,70606,54259,139,77,76937,53408
273,25,0,3,1,0,0,3,82,47,70606,54262,99,62,76937,53411
274,25,0,1,1,0,0,3,111,103,70606,54263,135,66,76937,53414
275,26,0,1,1,0,0,3,85,72,70606,54264,114,114,76937,53417
276,26,1,1,2,1,2,1,123,122,70607,54265,160,96,76938,53418
277,26,1,3,1,0,0,3,148,147,70608,54268,161,68,76938,53421
278,26,0,1,1,0,0,3,91,90,70608,54269,106,36,76938,53424
279,26,2,1,0,3,1,0,93,75,70610,54270,110,144,76941,53424
280,26,1,1,2,1,2,1,48,39,70611,54271,52,110,76942,53425
281,26,3,1,0,3,1,0,181,139,70614,54272,219,96,76945,53425
282,26,2,2,2,1,2,1,155,129,70616,54274,185,78,76946,53426
283,26,0,0,2,1,2,1,66,43,70616,54274,94,47,76947,53427
284,26,0,0,2,1,2,1,7,5,70616,54274,20,79,76948,53428
285,26,0,0,2,1,2,1,238,206,70616,54274,271,63,76949,53429
286,27,4,1,0,3,1,0,219,192,70620,54275,224,118,76952,53429
287,27,3,4,1,0,0,3,61,78,70623,54279,62,150,76952,53432
288,27,2,0,0,3,1,0,84,47,70625,54279,102,103,76955,53432
289,27,1,0,0,3,1,0,115,116,70626,54279,137,178,76958,53432
290,27,0,1,1,0,0,3,111,104,70626,54280,135,79,76958,53435
291,27,2,0,0,3,1,0,87,107,70628,54280,85,66,76961,53435
292,27,2,4,1,0,0,3,122,121,70630,54284,139,11,76961,53438
293,27,1,2,1,0,0,3,162,144,70631,54286,192,50,76961,53441
294,27,1,0,0,3,1,0,116,81,70632,54286,130,25,76964,53441
295,27,2,1,0,3,1,0,172,111,70634,54287,203,131,76967,53441
296,27,3,1,0,3,1,0,102,73,70637,54288,134,125,76970,53441
297,28,2,0,0,3,1,0,183,139,70639,54288,222,144,76973,53441
298,28,2,1,0,3,1,0,157,130,70641,54289,188,96,76976,53441
299,28,1,1,2,1,2,1,92,91,70642,54290,107,69,76977,53442
300,28,1,0,0,3,1,0,173,111,70643,54290,206,36,76980,53442
301,28,0,0,2,1,2,1,7,5,70643,54290,21,104,76981,53443
302,28,1,1,2,1,2,1,86,73,70644,54291,115,111,76982,53444
303,28,1,1,2,1,2,1,67,44,70645,54292,95,80,76983,53445
304,28,1,2,1,0,0,3,49,41,70646,54294,52,66,76983,53448
305,28,2,0,0,3,1,0,240,206,70648,54294,274,96,76986,53448
306,28,3,2,0,3,1,0,151,149,70651,54296,164,78,76989,53448
307,28,2,2,2,1,2,1,125,124,70653,54298,161,48,76990,53449
308,29,2,0,0,3,1,0,86,47,70655,54298,105,150,76993,53449
309,29,1,1,2,1,2,1,117,82,70656,54299,131,80,76994,53450
310,29,1,2,1,0,0,3,123,123,70657,54301,139,117,76994,53453
311,29,0,5,1,0,0,3,102,78,70657,54306,134,69,76994,53456
312,29,1,1,2,1,2,1,88,108,70658,54307,86,12,76995,53457
313,29,1,2,1,0,0,3,112,106,70659,54309,135,53,76995,53460
314,29,1,0,0,3,1,0,94,75,70660,54309,113,131,76998,53460
315,29,1,1,2,1,2,1,163,145,70661,54310,193,126,76999,53461
316,29,0,1,1,0,0,3,219,193,70661,54311,224,181,76999,53464
317,29,1,1,2,1,2,1,62,79,70662,54312,63,26,77000,53465
318,29,1,1,2,1,2,1,116,117,70663,54313,138,119,77001,53466
319,30,2,1,0,3,1,0,159,131,70665,54314,191,69,77004,53466
320,30,2,0,0,3,1,0,51,41,70667,54314,55,144,77007,53466
321,30,2,0,0,3,1,0,90,108,70669,54314,89,111,77010,53466
322,30,1,0,0,3,1,0,184,139,70670,54314,225,80,77013,53466
323,30,1,1,2,1,2,1,152,150,70671,54315,165,70,77014,53467
324,30,0,0,2,1,2,1,62,79,70671,54315,64,49,77015,53468
325,30,0,1,1,0,0,3,86,74,70671,54316,115,107,77015,53471
326,30,0,0,2,1,2,1,173,111,70671,54316,207,54,77016,53472
327,30,2,1,0,3,1,0,114,107,70673,54317,138,78,77019,53472
328,30,2,1,0,3,1,0,127,125,70675,54318,164,12,77022,53472
329,30,0,0,2,1,2,1,240,206,70675,54318,275,97,77023,53473
330,31,3,1,0,3,1,0,70,45,70678,54319,98,36,77026,53473
331,31,4,0,0,3,1,0,121,82,70682,54319,134,150,77029,53473
332,31,2,1,0,3,1,0,125,124,70684,54320,142,119,77032,53473
333,31,1,1,2,1,2,1,93,92,70685,54321,108,182,77033,53474
334,31,1,1,2,1,2,1,8,6,70686,54322,22,81,77034,53475
335,31,1,1,2,1,2,1,103,79,70687,54323,135,118,77035,53476
336,31,1,4,1,0,0,3,95,79,70688,54327,113,69,77035,53479
337,31,1,1,2,1,2,1,220,194,70689,54328,225,132,77036,53480
338,31,3,1,0,3,1,0,119,118,70692,54329,141,126,77039,53480
339,31,1,0,0,3,1,0,164,145,70693,54329,196,96,77042,53480
340,31,0,1,1,0,0,3,86,48,70693,54330,105,29,77042,53483
341,32,1,0,0,3,1,0,153,150,70694,54330,168,132,77045,53483
342,32,1,3,1,0,0,3,63,82,70695,54333,64,81,77045,53486
343,32,1,1,2,1,2,1,241,207,70696,54334,276,13,77046,53487
344,32,2,0,0,3,1,0,53,41,70698,54334,58,97,77049,53487
345,32,4,1,0,3,1,0,118,108,70702,54335,141,69,77052,53487
346,32,1,1,2,1,2,1,128,126,70703,54336,165,145,77053,53488
347,32,2,1,0,3,1,0,88,49,70705,54337,108,111,77056,53488
348,32,0,2,1,0,0,3,90,110,70705,54339,89,83,77056,53491
349,32,0,0,2,1,2,1,95,79,70705,54339,114,71,77057,53492
350,32,0,0,2,1,2,1,86,74,70705,54339,116,55,77058,53493
351,32,0,0,2,1,2,1,184,139,70705,54339,226,119,77059,53494
352,33,1,0,0,3,1,0,104,79,70706,54339,138,69,77062,53494
353,33,1,1,2,1,2,1,165,146,70707,54340,197,84,77063,53495
354,33,1,0,0,3,1,0,94,92,70708,54340,111,150,77066,53495
355,33,1,3,1,0,0,3,160,134,70709,54343,191,39,77066,53498
356,33,1,2,1,0,0,3,126,126,70710,54345,142,110,77066,53501
357,33,0,2,1,0,0,3,86,76,70710,54347,116,122,77066,53504
358,33,0,2,1,0,0,3,121,84,70710,54349,134,185,77066,53507
359,33,0,1,1,0,0,3,8,7,70710,54350,22,32,77066,53510
360,33,1,2,1,0,0,3,174,113,70711,54352,207,99,77066,53513
361,33,2,2,2,1,2,1,222,196,70713,54354,226,50,77067,53514
362,33,1,0,0,3,1,0,71,45,70714,54354,101,126,77070,53514
363,34,1,1,2,1,2,1,120,119,70715,54355,142,70,77071,53515
364,34,2,1,0,3,1,0,90,50,70717,54356,111,97,77074,53515
365,34,1,1,2,1,2,1,166,147,70718,54357,198,146,77075,53516
366,34,0,0,2,1,2,1,53,41,70718,54357,59,123,77076,53517
367,34,2,0,0,3,1,0,186,139,70720,54357,229,81,77079,53517
368,34,2,0,0,3,1,0,92,110,70722,54357,92,119,77082,53517
369,34,2,2,2,1,2,1,73,47,70724,54359,102,14,77083,53518
370,34,0,0,2,1,2,1,95,79,70724,54359,115,56,77084,53519
371,34,0,1,1,0,0,3,241,208,70724,54360,276,135,77084,53522
372,34,2,1,0,3,1,0,65,83,70726,54361,67,99,77087,53522
373,34,0,1,1,0,0,3,128,127,70726,54362,165,84,77087,53525
374,35,1,0,0,3,1,0,161,134,70727,54362,194,150,77090,53525
375,35,1,0,0,3,1,0,154,150,70728,54362,171,39,77093,53525
376,35,1,0,0,3,1,0,105,79,70729,54362,141,110,77096,53525
377,35,0,1,1,0,0,3,8,8,70729,54363,22,114,77096,53528
378,35,1,1,2,1,2,1,127,127,70730,54364,143,85,77097,53529
379,35,3,0,0,3,1,0,124,84,70733,54364,137,71,77100,53529
380,35,1,0,0,3,1,0,119,108,70734,54364,144,32,77103,53529
381,35,1,0,0,3,1,0,95,92,70735,54364,114,50,77106,53529
382,35,0,1,1,0,0,3,86,77,70735,54365,116,129,77106,53532
383,35,1,3,1,0,0,3,223,199,70736,54368,226,72,77106,53535
384,35,2,2,2,1,2,1,176,115,70738,54370,208,186,77107,53536
385,36,2,1,0,3,1,0,94,111,70740,54371,95,84,77110,53536
386,36,0,0,2,1,2,1,73,47,70740,54371,103,98,77111,53537
387,36,2,0,0,3,1,0,97,79,70742,54371,118,150,77114,53537
388,36,1,0,0,3,1,0,224,199,70743,54371,229,39,77117,53537
389,36,2,0,0,3,1,0,243,208,70745,54371,279,123,77120,53537
390,36,2,1,0,3,1,0,55,42,70747,54372,62,81,77123,53537
391,36,2,3,1,0,0,3,122,122,70749,54375,142,122,77123,53540
392,36,0,1,1,0,0,3,128,128,70749,54376,165,59,77123,53543
393,36,1,1,2,1,2,1,91,51,70750,54377,112,100,77124,53544
394,36,0,1,1,0,0,3,8,9,70750,54378,22,73,77124,53547
395,36,1,0,0,3,1,0,167,147,70751,54378,201,135,77127,53547
396,37,0,1,1,0,0,3,176,116,70751,54379,208,74,77127,53550
397,37,0,0,2,1,2,1,65,83,70751,54379,68,130,77128,53551
398,37,0,0,2,1,2,1,127,127,70751,54379,144,147,77129,53552
399,37,4,1,0,3,1,0,158,151,70755,54380,174,110,77132,53552
400,37,1,1,2,1,2,1,106,80,70756,54381,142,115,77133,53553
401,37,2,0,0,3,1,0,121,108,70758,54381,147,85,77136,53553
402,37,0,2,1,0,0,3,186,141,70758,54383,229,189,77136,53556
403,37,1,0,0,3,1,0,125,84,70759,54383,140,14,77139,53556
404,37,0,0,2,1,2,1,95,92,70759,54383,115,33,77140,53557
405,37,1,2,1,0,0,3,87,79,70760,54385,116,75,77140,53560
406,37,2,0,0,3,1,0,163,134,70762,54385,197,50,77143,53560
407,38,3,1,0,3,1,0,131,129,70765,54386,168,122,77146,53560
408,38,0,0,2,1,2,1,55,42,70765,54386,63,151,77147,53561
409,38,2,0,0,3,1,0,129,127,70767,54386,147,73,77150,53561
410,38,2,1,0,3,1,0,96,112,70769,54387,98,123,77153,53561
411,38,0,1,1,0,0,3,91,52,70769,54388,112,84,77153,53564
412,38,1,1,2,1,2,1,9,10,70770,54389,23,60,77154,53565
413,38,2,0,0,3,1,0,124,122,70772,54389,145,135,77157,53565
414,38,2,1,0,3,1,0,226,200,70774,54390,232,100,77160,53565
415,38,4,1,0,3,1,0,171,148,70778,54391,204,39,77163,53565
416,38,1,1,2,1,2,1,74,48,70779,54392,104,190,77164,53566
417,38,2,1,0,3,1,0,99,80,70781,54393,121,84,77167,53566
418,39,0,0,2,1,2,1,87,79,70781,54393,117,99,77168,53567
419,39,0,0,2,1,2,1,121,108,70781,54393,148,111,77169,53568
420,39,2,3,1,0,0,3,160,154,70783,54396,174,118,77169,53571
421,39,0,1,1,0,0,3,95,93,70783,54397,115,77,77169,53574
422,39,0,0,2,1,2,1,186,141,70783,54397,230,15,77170,53575
423,39,0,0,2,1,2,1,163,134,70783,54397,198,76,77171,53576
424,39,2,0,0,3,1,0,127,84,70785,54397,143,50,77174,53576
425,39,2,3,1,0,0,3,178,119,70787,54400,208,150,77174,53579
426,39,2,1,0,3,1,0,67,84,70789,54401,71,73,77177,53579
427,39,3,2,0,3,1,0,246,210,70792,54403,282,130,77180,53579
428,39,1,3,1,0,0,3,56,45,70793,54406,63,88,77180,53582
429,40,0,0,2,1,2,1,74,48,70793,54406,105,136,77181,53583
430,40,1,1,2,1,2,1,107,81,70794,54407,143,152,77182,53584
431,40,1,1,2,1,2,1,130,128,70795,54408,148,40,77183,53585
432,40,1,2,1,0,0,3,92,54,70796,54410,112,193,77183,53588
433,40,1,1,2,1,2,1,227,201,70797,54411,233,85,77184,53589
434,40,0,1,1,0,0,3,171,149,70797,54412,204,125,77184,53592
435,40,2,0,0,3,1,0,101,80,70799,54412,124,33,77187,53592
436,40,0,1,1,0,0,3,131,130,70799,54413,168,103,77187,53595
437,40,1,0,0,3,1,0,125,122,70800,54413,148,84,77190,53595
438,40,0,0,2,1,2,1,96,112,70800,54413,99,61,77191,53596
439,40,1,4,1,0,0,3,10,14,70801,54417,23,126,77191,53599
440,41,2,0,0,3,1,0,58,45,70803,54417,66,73,77194,53599
441,41,2,2,2,1,2,1,97,95,70805,54419,116,151,77195,53600
442,41,1,1,2,1,2,1,247,211,70806,54420,283,112,77196,53601
443,41,2,1,0,3,1,0,69,85,70808,54421,74,88,77199,53601
444,41,2,2,2,1,2,1,89,81,70810,54423,118,78,77200,53602
445,41,0,0,2,1,2,1,163,134,70810,54423,199,16,77201,53603
446,41,2,1,0,3,1,0,123,109,70812,54424,151,76,77204,53603
447,41,2,0,0,3,1,0,180,119,70814,54424,211,50,77207,53603
448,41,2,0,0,3,1,0,162,154,70816,54424,177,130,77210,53603
449,41,1,2,1,0,0,3,128,86,70817,54426,143,121,77210,53606
450,41,0,1,1,0,0,3,186,142,70817,54427,230,102,77210,53609
451,42,2,1,0,3,1,0,98,113,70819,54428,102,152,77213,53609
452,42,0,3,1,0,0,3,10,17,70819,54431,23,43,77213,53612
453,42,4,1,0,3,1,0,96,55,70823,54432,115,126,77216,53612
454,42,0,0,2,1,2,1,171,149,70823,54432,205,194,77217,53613
455,42,2,1,0,3,1,0,109,82,70825,54433,146,85,77220,53613
456,42,2,0,0,3,1,0,103,80,70827,54433,127,125,77223,53613
457,42,2,1,0,3,1,0,127,123,70829,54434,151,61,77226,53613
458,42,3,2,0,3,1,0,77,50,70832,54436,108,33,77229,53613
459,42,0,1,1,0,0,3,131,131,70832,54437,168,139,77229,53616
460,42,1,2,1,0,0,3,131,130,70833,54439,148,106,77229,53619
461,42,2,1,0,3,1,0,229,202,70835,54440,236,84,77232,53619
0,1,1,0,0,3,1,0,184,175,70836,54440,208,0,77235,53619
1,1,2,1,0,3,1,0,111,83,70838,54441,149,151,77238,53619
2,1,1,0,0,3,1,0,104,80,70839,54441,130,125,77241,53619
3,1,3,2,0,3,1,0,165,156,70842,54443,180,102,77244,53619
4,1,2,0,0,3,1,0,193,182,70844,54443,203,139,77247,53619
5,1,0,2,1,0,0,3,97,97,70844,54445,116,91,77247,53622
6,1,1,1,2,1,2,1,124,110,70845,54446,152,165,77248,53623
7,1,1,5,1,0,0,3,97,60,70846,54451,115,81,77248,53626
8,1,0,0,2,1,2,1,0,0,70846,54451,1,34,77249,53627
9,1,5,1,0,3,1,0,206,192,70851,54452,212,0,77252,53627
10,1,3,0,0,3,1,0,189,142,70854,54452,233,121,77255,53627
11,2,0,0,2,1,2,1,229,202,70854,54452,237,132,77256,53628
12,2,3,2,0,3,1,0,221,190,70857,54454,246,152,77259,53628
13,2,1,0,0,3,1,0,132,130,70858,54454,151,61,77262,53628
14,2,0,0,2,1,2,1,171,149,70858,54454,206,1,77263,53629
15,2,3,1,0,3,1,0,3,1,70861,54455,3,73,77266,53629
16,2,1,1,2,1,2,1,1,1,70862,54456,1,51,77267,53630
17,2,2,1,0,3,1,0,129,124,70864,54457,154,126,77270,53630
18,2,0,1,1,0,0,3,180,120,70864,54458,211,143,77270,53633
19,2,4,2,0,3,1,0,81,52,70868,54460,111,152,77273,53633
20,2,0,1,1,0,0,3,163,135,70868,54461,199,115,77273,53636
21,2,3,3,2,1,2,1,61,48,70871,54464,67,107,77274,53637
22,3,3,3,2,1,2,1,209,195,70874,54467,213,92,77275,53638
23,3,1,2,1,0,0,3,133,132,70875,54469,151,128,77275,53641
24,3,5,1,0,3,1,0,116,84,70880,54470,152,0,77278,53641
25,3,0,2,1,0,0,3,189,144,70880,54472,233,4,77278,53644
26,3,1,0,0,3,1,0,105,80,70881,54472,133,34,77281,53644
27,3,3,3,2,1,2,1,196,185,70884,54475,204,166,77282,53645
28,3,1,4,1,0,0,3,98,101,70885,54479,116,3,77282,53648
29,3,2,1,0,3,1,0,165,136,70887,54480,202,51,77285,53648
30,3,1,0,0,3,1,0,125,110,70888,54480,155,121,77288,53648
31,3,0,1,1,0,0,3,184,176,70888,54481,208,154,77288,53651
32,3,1,1,2,1,2,1,166,157,70889,54482,181,82,77289,53652
33,4,0,0,2,1,2,1,0,0,70889,54482,2,140,77290,53653
34,4,3,1,0,3,1,0,174,150,70892,54483,209,73,77293,53653
35,4,0,0,2,1,2,1,229,202,70892,54483,238,62,77294,53654
36,4,1,1,2,1,2,1,4,2,70893,54484,4,116,77295,53655
37,4,3,0,0,3,1,0,224,190,70896,54484,249,102,77298,53655
38,4,1,1,2,1,2,1,2,2,70897,54485,2,133,77299,53656
39,4,3,2,0,3,1,0,132,126,70900,54487,157,152,77302,53656
40,4,1,0,0,3,1,0,181,120,70901,54487,214,126,77305,53656
41,4,3,0,0,3,1,0,84,52,70904,54487,114,143,77308,53656
42,4,2,2,2,1,2,1,63,50,70906,54489,68,153,77309,53657
43,4,3,1,0,3,1,0,100,61,70909,54490,118,107,77312,53657
44,5,1,1,2,1,2,1,117,85,70910,54491,153,5,77313,53658
45,5,0,1,1,0,0,3,133,133,70910,54492,151,95,77313,53661
46,5,1,0,0,3,1,0,190,144,70911,54492,236,3,77316,53661
47,5,1,3,1,0,0,3,106,83,70912,54495,133,3,77316,53664
48,5,4,0,0,3,1,0,170,157,70916,54495,184,121,77319,53664
49,5,1,0,0,3,1,0,197,185,70917,54495,207,82,77322,53664
50,5,1,2,1,0,0,3,185,178,70918,54497,208,169,77322,53667
51,5,2,2,2,1,2,1,211,197,70920,54499,214,52,77323,53668
52,5,1,1,2,1,2,1,99,102,70921,54500,117,35,77324,53669
53,5,1,0,0,3,1,0,166,136,70922,54500,205,128,77327,53669
54,5,1,1,2,1,2,1,126,111,70923,54501,156,155,77328,53670
55,6,3,0,0,3,1,0,193,144,70926,54501,239,107,77331,53670
56,6,2,2,2,1,2,1,231,204,70928,54503,239,4,77332,53671
57,6,0,0,2,1,2,1,4,2,70928,54503,5,154,77333,53672
58,6,0,1,1,0,0,3,224,191,70928,54504,249,129,77333,53675
59,6,1,2,1,0,0,3,182,122,70929,54506,214,76,77333,53678
60,6,1,0,0,3,1,0,85,52,70930,54506,117,95,77336,53678
61,6,2,0,0,3,1,0,65,50,70932,54506,71,140,77339,53678
62,6,0,0,2,1,2,1,100,61,70932,54506,119,117,77340,53679
63,6,0,1,1,0,0,3,0,1,70932,54507,2,146,77340,53682
64,6,0,2,1,0,0,3,174,152,70932,54509,209,105,77340,53685
65,6,2,1,0,3,1,0,199,186,70934,54510,210,62,77343,53685
66,7,2,2,2,1,2,1,187,180,70936,54512,209,36,77344,53686
67,7,0,0,2,1,2,1,133,133,70936,54512,152,134,77345,53687
68,7,3,2,0,3,1,0,120,87,70939,54514,156,169,77348,53687
69,7,2,1,0,3,1,0,233,205,70941,54515,242,82,77351,53687
70,7,0,1,1,0,0,3,106,84,70941,54516,133,157,77351,53690
71,7,0,1,1,0,0,3,170,158,70941,54517,184,55,77351,53693
72,7,5,2,0,3,1,0,104,104,70946,54519,120,121,77354,53693
73,7,1,0,0,3,1,0,167,136,70947,54519,208,152,77357,53693
74,7,2,3,1,0,0,3,128,114,70949,54522,156,8,77357,53696
75,7,2,2,2,1,2,1,4,4,70951,54524,3,129,77358,53697
76,7,0,0,2,1,2,1,132,126,70951,54524,158,4,77359,53698
77,8,0,0,2,1,2,1,65,50,70951,54524,72,106,77360,53699
78,8,1,0,0,3,1,0,175,152,70952,54524,212,140,77363,53699
79,8,1,2,1,0,0,3,212,199,70953,54526,214,132,77363,53702
80,8,2,1,0,3,1,0,195,145,70955,54527,242,76,77366,53702
81,8,3,3,2,1,2,1,7,5,70958,54530,6,108,77367,53703
82,8,3,1,0,3,1,0,227,192,70961,54531,252,4,77370,53703
83,8,1,1,2,1,2,1,200,187,70962,54532,211,147,77371,53704
84,8,1,5,1,0,0,3,86,57,70963,54537,117,65,77371,53707
85,8,3,0,0,3,1,0,103,61,70966,54537,122,155,77374,53707
86,8,2,0,0,3,1,0,2,1,70968,54537,5,117,77377,53707
87,8,2,1,0,3,1,0,184,123,70970,54538,217,95,77380,53707
88,9,2,1,0,3,1,0,6,5,70972,54539,6,82,77383,53707
89,9,3,3,2,1,2,1,136,136,70975,54542,153,9,77384,53708
90,9,0,1,1,0,0,3,233,206,70975,54543,242,132,77384,53711
91,9,2,1,0,3,1,0,108,85,70977,54544,136,121,77387,53711
92,9,1,2,1,0,0,3,171,160,70978,54546,184,7,77387,53714
93,9,0,0,2,1,2,1,132,126,70978,54546,159,135,77388,53715
94,9,0,1,1,0,0,3,187,181,70978,54547,209,160,77388,53718
95,9,2,2,2,1,2,1,106,106,70980,54549,121,153,77389,53719
96,9,4,2,0,3,1,0,132,116,70984,54551,159,140,77392,53719
97,9,2,3,1,0,0,3,122,90,70986,54554,156,39,77392,53722
98,9,2,3,1,0,0,3,105,64,70988,54557,122,172,77392,53725
99,10,2,0,0,3,1,0,9,5,70990,54557,9,155,77395,53725
100,10,4,2,0,3,1,0,199,147,70994,54559,245,132,77398,53725
101,10,3,3,2,1,2,1,178,155,70997,54562,213,5,77399,53726
102,10,0,2,1,0,0,3,200,189,70997,54564,211,135,77399,53729
103,10,3,1,0,3,1,0,190,182,71000,54565,212,55,77402,53729
104,10,2,1,0,3,1,0,214,200,71002,54566,217,76,77405,53729
105,10,0,0,2,1,2,1,106,106,71002,54566,122,118,77406,53730
106,10,1,1,2,1,2,1,66,51,71003,54567,73,96,77407,53731
107,10,4,2,0,3,1,0,171,138,71007,54569,211,82,77410,53731
108,10,1,1,2,1,2,1,133,117,71008,54570,160,107,77411,53732
109,10,1,0,0,3,1,0,3,1,71009,54570,8,172,77414,53732
110,11,2,1,0,3,1,0,235,207,71011,54571,245,153,77417,53732
111,11,3,1,0,3,1,0,139,137,71014,54572,156,140,77420,53732
112,11,1,0,0,3,1,0,123,90,71015,54572,159,65,77423,53732
113,11,1,3,1,0,0,3,109,88,71016,54575,136,138,77423,53735
114,11,2,1,0,3,1,0,173,161,71018,54576,187,9,77426,53735
115,11,3,1,0,3,1,0,230,193,71021,54577,255,160,77429,53735
116,11,0,3,1,0,0,3,6,8,71021,54580,6,150,77429,53738
117,11,4,2,0,3,1,0,136,128,71025,54582,162,108,77432,53738
118,11,2,3,1,0,0,3,186,126,71027,54585,217,42,77432,53741
119,11,0,3,1,0,0,3,86,60,71027,54588,117,124,77432,53744
120,11,1,1,2,1,2,1,106,65,71028,54589,123,8,77433,53745
121,12,3,0,0,3,1,0,202,147,71031,54589,248,107,77436,53745
122,12,2,2,2,1,2,1,180,157,71033,54591,214,136,77437,53746
123,12,3,3,2,1,2,1,12,8,71036,54594,10,83,77438,53747
124,12,2,0,0,3,1,0,202,189,71038,54594,214,55,77441,53747
125,12,0,3,1,0,0,3,214,203,71038,54597,217,158,77441,53750
126,12,2,1,0,3,1,0,68,52,71040,54598,76,172,77444,53750
127,12,0,0,2,1,2,1,171,138,71040,54598,212,133,77445,53751
128,12,1,1,2,1,2,1,4,2,71041,54599,9,97,77446,53752
129,12,2,0,0,3,1,0,192,182,71043,54599,215,76,77449,53752
130,12,1,4,1,0,0,3,107,110,71044,54603,122,8,77449,53755
131,12,0,0,2,1,2,1,133,117,71044,54603,161,119,77450,53756
132,13,2,2,2,1,2,1,216,205,71046,54605,218,139,77451,53757
133,13,1,2,1,0,0,3,236,209,71047,54607,245,12,77451,53760
134,13,4,2,0,3,1,0,113,90,71051,54609,139,107,77454,53760
135,13,1,1,2,1,2,1,174,162,71052,54610,188,109,77455,53761
136,13,2,3,1,0,0,3,8,11,71054,54613,6,11,77455,53764
137,13,2,1,0,3,1,0,138,129,71056,54614,165,150,77458,53764
138,13,0,1,1,0,0,3,186,127,71056,54615,217,68,77458,53767
139,13,2,2,2,1,2,1,70,54,71058,54617,77,154,77459,53768
140,13,2,2,2,1,2,1,108,67,71060,54619,124,125,77460,53769
141,13,1,1,2,1,2,1,231,194,71061,54620,256,141,77461,53770
142,13,1,1,2,1,2,1,87,61,71062,54621,118,77,77462,53771
143,14,2,1,0,3,1,0,109,111,71064,54622,125,172,77465,53771
144,14,0,0,2,1,2,1,123,90,71064,54622,160,56,77466,53772
145,14,1,1,2,1,2,1,172,139,71065,54623,213,98,77467,53773
146,14,1,0,0,3,1,0,5,2,71066,54623,12,83,77470,53773
147,14,0,2,1,0,0,3,139,139,71066,54625,156,11,77470,53776
148,14,1,1,2,1,2,1,114,91,71067,54626,140,159,77471,53777
149,14,3,3,2,1,2,1,183,160,71070,54629,215,43,77472,53778
150,14,1,2,1,0,0,3,175,164,71071,54631,188,153,77472,53781
151,14,1,2,1,0,0,3,13,10,71072,54633,10,142,77472,53784
152,14,1,1,2,1,2,1,134,118,71073,54634,162,137,77473,53785
153,14,1,0,0,3,1,0,203,147,71074,54634,251,160,77476,53785
154,15,1,1,2,1,2,1,139,130,71075,54635,166,78,77477,53786
155,15,1,1,2,1,2,1,237,210,71076,54636,246,142,77478,53787
156,15,5,3,0,3,1,0,236,197,71081,54639,259,125,77481,53787
157,15,1,1,2,1,2,1,9,12,71082,54640,7,110,77482,53788
158,15,1,2,1,0,0,3,187,129,71083,54642,217,157,77482,53791
159,15,4,0,0,3,1,0,196,182,71087,54642,218,107,77485,53791
160,15,5,0,0,3,1,0,92,61,71092,54642,121,119,77488,53791
161,15,3,1,0,3,1,0,219,206,71095,54643,221,68,77491,53791
162,15,0,0,2,1,2,1,108,67,71095,54643,125,13,77492,53792
163,15,1,1,2,1,2,1,71,55,71096,54644,78,12,77493,53793
164,15,0,3,1,0,0,3,202,192,71096,54647,214,136,77493,53796
165,16,3,3,2,1,2,1,239,200,71099,54650,260,99,77494,53797
166,16,0,0,2,1,2,1,139,139,71099,54650,157,13,77495,53798
167,16,1,3,1,0,0,3,124,93,71100,54653,160,145,77495,53801
168,16,2,1,0,3,1,0,116,92,71102,54654,143,153,77498,53801
169,16,2,1,0,3,1,0,177,165,71104,54655,191,43,77501,53801
170,16,1,1,2,1,2,1,110,112,71105,54656,126,57,77502,53802
171,16,4,0,0,3,1,0,176,139,71109,54656,216,160,77505,53802
172,16,1,3,1,0,0,3,6,5,71110,54659,12,140,77505,53805
173,16,1,0,0,3,1,0,204,147,71111,54659,254,11,77508,53805
174,16,1,1,2,1,2,1,135,119,71112,54660,163,84,77509,53806
175,16,1,0,0,3,1,0,184,160,71113,54660,218,159,77512,53806
176,17,2,0,0,3,1,0,239,210,71115,54660,249,43,77515,53806
177,17,1,0,0,3,1,0,14,10,71116,54660,13,142,77518,53806
178,17,1,3,1,0,0,3,10,15,71117,54663,7,139,77518,53809
179,17,3,3,2,1,2,1,142,133,71120,54666,167,126,77519,53810
180,17,1,1,2,1,2,1,188,130,71121,54667,218,173,77520,53811
181,17,3,0,0,3,1,0,199,182,71124,54667,221,68,77523,53811
182,17,3,3,2,1,2,1,222,209,71127,54670,222,111,77524,53812
183,17,0,0,2,1,2,1,202,192,71127,54670,215,14,77525,53813
184,17,1,1,2,1,2,1,125,94,71128,54671,161,120,77526,53814
185,17,3,1,0,3,1,0,111,68,71131,54672,128,157,77529,53814
186,17,1,0,0,3,1,0,93,61,71132,54672,124,107,77532,53814
187,18,1,1,2,1,2,1,189,131,71133,54673,219,14,77533,53815
188,18,1,1,2,1,2,1,136,120,71134,54674,164,154,77534,53816
189,18,4,2,0,3,1,0,188,162,71138,54676,221,160,77537,53816
190,18,1,0,0,3,1,0,177,139,71139,54676,219,11,77540,53816
191,18,1,1,2,1,2,1,72,56,71140,54677,79,85,77541,53817
192,18,1,1,2,1,2,1,140,140,71141,54678,158,58,77542,53818
193,18,2,2,2,1,2,1,179,167,71143,54680,192,79,77543,53819
194,18,1,0,0,3,1,0,240,200,71144,54680,263,120,77546,53819
195,18,2,0,0,3,1,0,144,133,71146,54680,170,159,77549,53819
196,18,1,1,2,1,2,1,7,6,71147,54681,13,69,77550,53820
197,18,0,3,1,0,0,3,204,150,71147,54684,254,148,77550,53823
198,19,2,2,2,1,2,1,12,17,71149,54686,8,15,77551,53824
199,19,1,1,2,1,2,1,126,95,71150,54687,162,108,77552,53825
200,19,1,1,2,1,2,1,117,93,71151,54688,144,100,77553,53826
201,19,1,1,2,1,2,1,15,11,71152,54689,14,174,77554,53827
202,19,1,0,0,3,1,0,203,192,71153,54689,218,111,77557,53827
203,19,0,0,2,1,2,1,199,182,71153,54689,222,127,77558,53828
204,19,1,3,1,0,0,3,94,64,71154,54692,124,160,77558,53831
205,19,0,2,1,0,0,3,110,114,71154,54694,126,145,77558,53834
206,19,0,2,1,0,0,3,111,70,71154,54696,128,46,77558,53837
207,19,1,1,2,1,2,1,240,211,71155,54697,250,140,77559,53838
208,19,1,0,0,3,1,0,223,209,71156,54697,225,140,77562,53838
209,20,1,1,2,1,2,1,8,7,71157,54698,14,15,77563,53839
210,20,1,1,2,1,2,1,141,141,71158,54699,159,161,77564,53840
211,20,0,0,2,1,2,1,204,150,71158,54699,255,155,77565,53841
212,20,1,1,2,1,2,1,189,163,71159,54700,222,149,77566,53842
213,20,0,1,1,0,0,3,179,168,71159,54701,192,123,77566,53845
214,20,1,1,2,1,2,1,241,201,71160,54702,264,160,77567,53846
215,20,4,3,0,3,1,0,148,136,71164,54705,173,58,77570,53846
216,20,1,1,2,1,2,1,190,132,71165,54706,220,86,77571,53847
217,20,0,3,1,0,0,3,72,59,71165,54709,79,14,77571,53850
218,20,1,0,0,3,1,0,178,139,71166,54709,222,79,77574,53850
219,20,4,3,0,3,1,0,140,123,71170,54712,167,69,77577,53850
220,21,0,0,2,1,2,1,199,182,71170,54712,223,146,77578,53851
221,21,2,1,0,3,1,0,128,96,71172,54713,165,111,77581,53851
222,21,0,1,1,0,0,3,240,212,71172,54714,250,111,77581,53854
223,21,0,0,2,1,2,1,117,93,71172,54714,145,161,77582,53855
224,21,1,0,0,3,1,0,16,11,71173,54714,17,127,77585,53855
225,21,1,2,1,0,0,3,13,19,71174,54716,8,103,77585,53858
226,21,3,0,0,3,1,0,206,192,71177,54716,221,46,77588,53858
227,21,2,4,1,0,0,3,96,68,71179,54720,124,177,77588,53861
228,21,1,0,0,3,1,0,224,209,71180,54720,228,15,77591,53861
229,21,1,2,1,0,0,3,111,116,71181,54722,126,143,77591,53864
230,21,2,1,0,3,1,0,113,71,71183,54723,131,140,77594,53864
231,22,1,0,0,3,1,0,191,132,71184,54723,223,123,77597,53864
232,22,1,2,1,0,0,3,142,143,71185,54725,159,146,77597,53867
233,22,1,0,0,3,1,0,17,11,71186,54725,20,155,77600,53867
234,22,0,1,1,0,0,3,13,20,71186,54726,8,164,77600,53870
235,22,4,0,0,3,1,0,152,136,71190,54726,176,69,77603,53870
236,22,2,1,0,3,1,0,243,202,71192,54727,267,111,77606,53870
237,22,2,0,0,3,1,0,98,68,71194,54727,127,58,77609,53870
238,22,3,2,0,3,1,0,75,61,71197,54729,82,15,77612,53870
239,22,0,0,2,1,2,1,178,139,71197,54729,223,150,77613,53871
240,22,1,1,2,1,2,1,190,164,71198,54730,223,162,77614,53872
241,22,2,3,1,0,0,3,242,215,71200,54733,250,82,77614,53875
242,23,0,2,1,0,0,3,224,211,71200,54735,228,89,77614,53878
243,23,2,0,0,3,1,0,113,116,71202,54735,129,111,77617,53878
244,23,2,0,0,3,1,0,208,192,71204,54735,224,160,77620,53878
245,23,1,0,0,3,1,0,9,7,71205,54735,17,127,77623,53878
246,23,0,0,2,1,2,1,128,96,71205,54735,166,16,77624,53879
247,23,0,4,1,0,0,3,204,154,71205,54739,255,180,77624,53882
248,23,1,2,1,0,0,3,114,73,71206,54741,131,17,77624,53885
249,23,3,0,0,3,1,0,202,182,71209,54741,226,140,77627,53885
250,23,2,1,0,3,1,0,119,94,71211,54742,148,146,77630,53885
251,23,1,2,1,0,0,3,180,170,71212,54744,192,106,77630,53888
252,23,2,2,2,1,2,1,142,125,71214,54746,168,47,77631,53889
253,24,4,0,0,3,1,0,247,202,71218,54746,270,150,77634,53889
254,24,1,2,1,0,0,3,192,134,71219,54748,223,114,77634,53892
255,24,2,1,0,3,1,0,15,21,71221,54749,11,82,77637,53892
256,24,3,1,0,3,1,0,12,8,71224,54750,20,162,77640,53892
257,24,1,2,1,0,0,3,76,63,71225,54752,82,126,77640,53895
258,24,1,3,1,0,0,3,99,71,71226,54755,127,149,77640,53898
259,24,2,1,0,3,1,0,244,216,71228,54756,253,155,77643,53898
260,24,3,0,0,3,1,0,155,136,71231,54756,179,164,77646,53898
261,24,2,3,1,0,0,3,19,14,71233,54759,20,72,77646,53901
262,24,4,3,0,3,1,0,194,167,71237,54762,226,111,77649,53901
263,24,0,1,1,0,0,3,114,74,71237,54763,131,149,77649,53904
264,25,0,0,2,1,2,1,113,116,71237,54763,130,161,77650,53905
265,25,1,1,2,1,2,1,129,97,71238,54764,167,128,77651,53906
266,25,1,1,2,1,2,1,120,95,71239,54765,149,17,77652,53907
267,25,1,2,1,0,0,3,143,145,71240,54767,159,183,77652,53910
268,25,1,0,0,3,1,0,205,154,71241,54767,258,106,77655,53910
269,25,1,0,0,3,1,0,225,211,71242,54767,231,47,77658,53910
270,25,0,1,1,0,0,3,142,126,71242,54768,168,61,77658,53913
271,25,1,1,2,1,2,1,179,140,71243,54769,224,16,77659,53914
272,25,1,1,2,1,2,1,203,183,71244,54770,227,90,77660,53915
273,25,1,3,1,0,0,3,181,173,71245,54773,192,143,77660,53918
274,25,1,2,1,0,0,3,209,194,71246,54775,224,20,77660,53921
275,26,0,1,1,0,0,3,19,15,71246,54776,20,165,77660,53924
276,26,3,1,0,3,1,0,15,9,71249,54777,23,82,77663,53924
277,26,3,0,0,3,1,0,18,21,71252,54777,14,126,77666,53924
278,26,0,1,1,0,0,3,194,168,71252,54778,226,152,77666,53927
279,26,1,0,0,3,1,0,100,71,71253,54778,130,150,77669,53927
280,26,4,0,0,3,1,0,251,202,71257,54778,273,155,77672,53927
281,26,0,0,2,1,2,1,114,74,71257,54778,132,165,77673,53928
282,26,0,0,2,1,2,1,76,63,71257,54778,83,73,77674,53929
283,26,1,1,2,1,2,1,193,135,71258,54779,224,150,77675,53930
284,26,2,0,0,3,1,0,157,136,71260,54779,182,114,77678,53930
285,26,3,1,0,3,1,0,247,217,71263,54780,256,111,77681,53930
286,27,3,0,0,3,1,0,182,140,71266,54780,227,47,77684,53930
287,27,1,1,2,1,2,1,204,184,71267,54781,228,17,77685,53931
288,27,1,2,1,0,0,3,143,128,71268,54783,168,168,77685,53934
289,27,1,2,1,0,0,3,19,23,71269,54785,14,164,77685,53937
290,27,2,1,0,3,1,0,145,146,71271,54786,162,128,77688,53937
291,27,0,0,2,1,2,1,225,211,71271,54786,232,18,77689,53938
292,27,1,1,2,1,2,1,182,174,71272,54787,193,184,77690,53939
293,27,2,1,0,3,1,0,131,98,71274,54788,170,143,77693,53939
294,27,0,0,2,1,2,1,113,116,71274,54788,131,151,77694,53940
295,27,1,3,1,0,0,3,158,139,71275,54791,182,93,77694,53943
296,27,0,0,2,1,2,1,120,95,71275,54791,150,62,77695,53944
297,28,0,1,1,0,0,3,76,64,71275,54792,83,158,77695,53947
298,28,4,1,0,3,1,0,213,195,71279,54793,227,114,77698,53947
299,28,1,1,2,1,2,1,252,203,71280,54794,274,83,77699,53948
300,28,0,1,1,0,0,3,114,75,71280,54795,132,155,77699,53951
301,28,0,1,1,0,0,3,193,136,71280,54796,224,23,77699,53954
302,28,2,2,2,1,2,1,21,17,71282,54798,21,107,77700,53955
303,28,2,0,0,3,1,0,17,9,71284,54798,26,111,77703,53955
304,28,2,0,0,3,1,0,102,71,71286,54798,133,164,77706,53955
305,28,2,2,2,1,2,1,196,170,71288,54800,227,74,77707,53956
306,28,0,1,1,0,0,3,225,212,71288,54801,232,129,77707,53959
307,28,1,1,2,1,2,1,206,155,71289,54802,259,151,77708,53960
308,29,1,2,1,0,0,3,183,142,71290,54804,227,131,77708,53963
309,29,2,1,0,3,1,0,145,129,71292,54805,171,18,77711,53963
310,29,1,0,0,3,1,0,159,139,71293,54805,185,143,77714,53963
311,29,2,0,0,3,1,0,184,174,71295,54805,196,165,77717,53963
312,29,1,3,1,0,0,3,146,149,71296,54808,162,50,77717,53966
313,29,0,3,1,0,0,3,19,26,71296,54811,14,187,77717,53969
314,29,1,2,1,0,0,3,132,100,71297,54813,170,171,77717,53972
315,29,0,0,2,1,2,1,120,95,71297,54813,151,18,77718,53973
316,29,3,2,0,3,1,0,207,186,71300,54815,231,151,77721,53973
317,29,0,2,1,0,0,3,113,118,71300,54817,131,96,77721,53976
318,29,0,0,2,1,2,1,247,217,71300,54817,257,63,77722,53977
319,30,1,0,0,3,1,0,18,9,71301,54817,29,114,77725,53977
320,30,0,0,2,1,2,1,196,170,71301,54817,228,130,77726,53978
321,30,1,1,2,1,2,1,22,18,71302,54818,22,156,77727,53979
322,30,2,0,0,3,1,0,104,71,71304,54818,136,23,77730,53979
323,30,1,4,1,0,0,3,226,216,71305,54822,232,161,77730,53982
324,30,2,2,2,1,2,1,208,157,71307,54824,260,75,77731,53983
325,30,1,1,2,1,2,1,184,143,71308,54825,228,112,77732,53984
326,30,1,0,0,3,1,0,214,195,71309,54825,230,107,77735,53984
327,30,2,0,0,3,1,0,78,64,71311,54825,86,83,77738,53984
328,30,2,1,0,3,1,0,254,204,71313,54826,277,63,77741,53984
329,30,2,1,0,3,1,0,195,137,71315,54827,227,164,77744,53984
330,31,2,1,0,3,1,0,21,27,71317,54828,17,131,77747,53984
331,31,0,0,2,1,2,1,184,174,71317,54828,197,172,77748,53985
332,31,1,1,2,1,2,1,248,218,71318,54829,258,19,77749,53986
333,31,2,2,2,1,2,1,197,139,71320,54831,228,152,77750,53987
334,31,2,0,0,3,1,0,116,75,71322,54831,135,161,77753,53987
335,31,0,0,2,1,2,1,159,139,71322,54831,186,51,77754,53988
336,31,3,0,0,3,1,0,107,71,71325,54831,139,151,77757,53988
337,31,2,1,0,3,1,0,148,150,71327,54832,165,112,77760,53988
338,31,3,2,0,3,1,0,257,206,71330,54834,280,18,77763,53988
339,31,2,2,2,1,2,1,134,102,71332,54836,171,166,77764,53989
340,31,2,0,0,3,1,0,122,95,71334,54836,154,75,77767,53989
341,32,1,1,2,1,2,1,185,144,71335,54837,229,115,77768,53990
342,32,3,0,0,3,1,0,211,157,71338,54837,263,164,77771,53990
343,32,3,1,0,3,1,0,210,187,71341,54838,234,23,77774,53990
344,32,0,0,2,1,2,1,113,118,71341,54838,132,84,77775,53991
345,32,4,0,0,3,1,0,218,195,71345,54838,233,130,77778,53991
346,32,0,1,1,0,0,3,226,217,71345,54839,232,190,77778,53994
347,32,0,0,2,1,2,1,145,129,71345,54839,172,108,77779,53995
348,32,1,0,0,3,1,0,79,64,71346,54839,89,143,77782,53995
349,32,0,1,1,0,0,3,22,19,71346,54840,22,66,77782,53998
350,32,2,1,0,3,1,0,20,10,71348,54841,32,156,77785,53998
351,32,1,1,2,1,2,1,197,171,71349,54842,229,97,77786,53999
352,33,1,0,0,3,1,0,149,150,71350,54842,168,172,77789,53999
353,33,1,2,1,0,0,3,117,77,71351,54844,135,155,77789,54002
354,33,1,2,1,0,0,3,135,104,71352,54846,171,164,77789,54005
355,33,2,1,0,3,1,0,250,219,71354,54847,261,166,77792,54005
356,33,2,1,0,3,1,0,23,28,71356,54848,20,75,77795,54005
357,33,2,0,0,3,1,0,259,206,71358,54848,283,51,77798,54005
358,33,1,2,1,0,0,3,185,176,71359,54850,197,154,77798,54008
359,33,2,1,0,3,1,0,124,96,71361,54851,157,112,77801,54008
360,33,2,1,0,3,1,0,161,140,71363,54852,189,18,77804,54008
361,33,1,0,0,3,1,0,198,139,71364,54852,231,131,77807,54008
362,33,1,0,0,3,1,0,108,71,71365,54852,142,19,77810,54008
363,34,2,0,0,3,1,0,151,150,71367,54852,171,130,77813,54008
364,34,5,1,0,3,1,0,150,130,71372,54853,175,156,77816,54008
365,34,1,1,2,1,2,1,186,145,71373,54854,230,191,77817,54009
366,34,0,4,1,0,0,3,22,23,71373,54858,22,26,77817,54012
367,34,2,0,0,3,1,0,212,187,71375,54858,237,108,77820,54012
368,34,1,1,2,1,2,1,219,196,71376,54859,234,167,77821,54013
369,34,1,1,2,1,2,1,212,158,71377,54860,264,52,77822,54014
370,34,1,2,1,0,0,3,21,12,71378,54862,32,167,77822,54017
371,34,0,0,2,1,2,1,113,118,71378,54862,133,144,77823,54018
372,34,3,0,0,3,1,0,200,171,71381,54862,232,66,77826,54018
373,34,2,0,0,3,1,0,137,104,71383,54862,174,97,77829,54018
374,35,3,0,0,3,1,0,26,28,71386,54862,23,115,77832,54018
375,35,0,0,2,1,2,1,212,187,71386,54862,238,157,77833,54019
376,35,1,1,2,1,2,1,118,78,71387,54863,136,85,77834,54020
377,35,2,2,2,1,2,1,228,219,71389,54865,233,173,77835,54021
378,35,1,1,2,1,2,1,251,220,71390,54866,262,131,77836,54022
379,35,1,1,2,1,2,1,80,65,71391,54867,90,132,77837,54023
380,35,1,1,2,1,2,1,220,197,71392,54868,235,20,77838,54024
381,35,3,2,0,3,1,0,262,208,71395,54870,286,75,77841,54024
382,35,1,1,2,1,2,1,162,141,71396,54871,190,155,77842,54025
383,35,0,3,1,0,0,3,198,142,71396,54874,231,115,77842,54028
384,35,1,1,2,1,2,1,109,72,71397,54875,143,19,77843,54029
385,36,0,1,1,0,0,3,151,151,71397,54876,171,167,77843,54032
386,36,0,1,1,0,0,3,186,146,71397,54877,230,170,77843,54035
387,36,2,3,1,0,0,3,202,174,71399,54880,232,194,77843,54038
388,36,2,2,2,1,2,1,152,132,71401,54882,176,27,77844,54039
389,36,0,2,1,0,0,3,137,106,71401,54884,174,111,77844,54042
390,36,1,1,2,1,2,1,213,159,71402,54885,265,145,77845,54043
391,36,0,0,2,1,2,1,185,176,71402,54885,198,156,77846,54044
392,36,1,2,1,0,0,3,125,98,71403,54887,157,100,77846,54047
393,36,3,1,0,3,1,0,116,119,71406,54888,136,167,77849,54047
394,36,1,1,2,1,2,1,23,24,71407,54889,23,53,77850,54048
395,36,2,0,0,3,1,0,23,12,71409,54889,35,66,77853,54048
396,37,1,2,1,0,0,3,24,26,71410,54891,23,118,77853,54051
397,37,3,0,0,3,1,0,223,197,71413,54891,238,85,77856,54051
398,37,1,1,2,1,2,1,27,29,71414,54892,24,174,77857,54052
399,37,2,1,0,3,1,0,214,188,71416,54893,241,131,77860,54052
400,37,0,0,2,1,2,1,251,220,71416,54893,263,133,77861,54053
401,37,1,3,1,0,0,3,81,68,71417,54896,90,160,77861,54056
402,37,3,2,0,3,1,0,121,80,71420,54898,139,75,77864,54056
403,37,1,3,1,0,0,3,199,145,71421,54901,231,22,77864,54059
404,37,2,3,1,0,0,3,111,75,71423,54904,143,118,77864,54062
405,37,3,2,0,3,1,0,231,221,71426,54906,236,155,77867,54062
406,37,2,4,1,0,0,3,164,145,71428,54910,190,197,77867,54065
407,38,3,0,0,3,1,0,26,12,71431,54910,38,156,77870,54065
408,38,1,0,0,3,1,0,214,159,71432,54910,268,66,77873,54065
409,38,0,0,2,1,2,1,125,98,71432,54910,158,86,77874,54066
410,38,4,2,0,3,1,0,85,70,71436,54912,93,170,77877,54066
411,38,1,0,0,3,1,0,187,146,71437,54912,233,20,77880,54066
412,38,3,1,0,3,1,0,188,177,71440,54913,201,27,77883,54066
413,38,1,0,0,3,1,0,203,174,71441,54913,235,111,77886,54066
414,38,1,1,2,1,2,1,263,209,71442,54914,287,146,77887,54067
415,38,1,0,0,3,1,0,117,119,71443,54914,139,167,77890,54067
416,38,2,2,2,1,2,1,153,153,71445,54916,172,101,77891,54068
417,38,0,3,1,0,0,3,152,135,71445,54919,176,170,77891,54071
418,39,1,1,2,1,2,1,224,198,71446,54920,239,175,77892,54072
419,39,0,2,1,0,0,3,137,108,71446,54922,174,163,77892,54075
420,39,1,1,2,1,2,1,122,81,71447,54923,140,119,77893,54076
421,39,0,0,2,1,2,1,231,221,71447,54923,237,134,77894,54077
422,39,0,0,2,1,2,1,125,98,71447,54923,159,198,77895,54078
423,39,1,2,1,0,0,3,252,222,71448,54925,263,114,77895,54081
424,39,1,1,2,1,2,1,25,27,71449,54926,24,147,77896,54082
425,39,2,1,0,3,1,0,29,30,71451,54927,27,155,77899,54082
426,39,2,0,0,3,1,0,216,188,71453,54927,244,118,77902,54082
427,39,0,2,1,0,0,3,117,121,71453,54929,139,25,77902,54085
428,39,1,1,2,1,2,1,112,76,71454,54930,144,54,77903,54086
429,40,1,1,2,1,2,1,154,154,71455,54931,173,87,77904,54087
430,40,2,2,2,1,2,1,190,179,71457,54933,202,171,77905,54088
431,40,1,0,0,3,1,0,165,145,71458,54933,193,131,77908,54088
432,40,2,1,0,3,1,0,28,13,71460,54934,41,27,77911,54088
433,40,2,3,1,0,0,3,154,138,71462,54937,176,159,77911,54091
434,40,3,1,0,3,1,0,217,160,71465,54938,271,101,77914,54091
435,40,1,1,2,1,2,1,200,146,71466,54939,232,171,77915,54092
436,40,5,1,0,3,1,0,192,147,71471,54940,236,75,77918,54092
437,40,1,0,0,3,1,0,86,70,71472,54940,96,66,77921,54092
438,40,2,1,0,3,1,0,205,175,71474,54941,238,167,77924,54092
439,40,1,1,2,1,2,1,264,210,71475,54942,288,21,77925,54093
440,41,1,0,0,3,1,0,138,108,71476,54942,177,155,77928,54093
441,41,0,1,1,0,0,3,231,222,71476,54943,237,122,77928,54096
442,41,1,0,0,3,1,0,217,188,71477,54943,247,175,77931,54096
443,41,0,0,2,1,2,1,224,198,71477,54943,240,135,77932,54097
444,41,1,1,2,1,2,1,126,99,71478,54944,160,164,77933,54098
445,41,0,2,1,0,0,3,252,224,71478,54946,263,201,77933,54101
446,41,0,1,1,0,0,3,122,82,71478,54947,140,117,77933,54104
447,41,1,1,2,1,2,1,113,77,71479,54948,145,148,77934,54105
448,41,1,0,0,3,1,0,30,30,71480,54948,30,54,77937,54105
449,41,2,1,0,3,1,0,119,122,71482,54949,142,118,77940,54105
450,41,5,1,0,3,1,0,30,28,71487,54950,27,25,77943,54105
451,42,1,2,1,0,0,3,155,140,71488,54952,176,90,77943,54108
452,42,0,0,2,1,2,1,154,154,71488,54952,174,172,77944,54109
453,42,2,0,0,3,1,0,219,160,71490,54952,274,131,77947,54109
454,42,1,0,0,3,1,0,206,175,71491,54952,241,21,77950,54109
455,42,2,2,2,1,2,1,167,147,71493,54954,194,28,77951,54110
456,42,0,2,1,0,0,3,86,72,71493,54956,96,162,77951,54113
457,42,0,2,1,0,0,3,192,149,71493,54958,236,170,77951,54116
458,42,2,1,0,3,1,0,266,211,71495,54959,291,101,77954,54116
459,42,0,0,2,1,2,1,28,13,71495,54959,42,172,77955,54117
460,42,2,0,0,3,1,0,192,179,71497,54959,205,75,77958,54117
461,42,0,1,1,0,0,3,200,147,71497,54960,232,69,77958,54120
0,1,1,1,2,1,2,1,253,225,71498,54961,264,102,77959,54121
1,1,1,1,2,1,2,1,31,29,71499,54962,28,173,77960,54122
2,1,0,0,2,1,2,1,86,72,71499,54962,97,163,77961,54123
3,1,1,0,0,3,1,0,29,13,71500,54962,45,155,77964,54123
4,1,1,1,2,1,2,1,248,212,71501,54963,284,85,77965,54124
5,1,1,1,2,1,2,1,155,155,71502,54964,175,1,77966,54125
6,1,3,0,0,3,1,0,195,179,71505,54964,208,150,77969,54125
7,1,4,2,0,3,1,0,34,32,71509,54966,33,131,77972,54125
8,1,3,3,2,1,2,1,72,88,71512,54969,75,55,77973,54126
9,2,2,2,2,1,2,1,226,200,71514,54971,241,22,77974,54127
10,2,0,1,1,0,0,3,126,100,71514,54972,160,167,77974,54130
11,2,0,3,1,0,0,3,0,3,71514,54975,0,197,77974,54133
12,2,1,0,0,3,1,0,115,94,71515,54975,138,25,77977,54133
13,2,3,2,0,3,1,0,195,151,71518,54977,239,172,77980,54133
14,2,2,1,0,3,1,0,233,223,71520,54978,240,135,77983,54133
15,2,4,1,0,3,1,0,257,199,71524,54979,293,28,77986,54133
16,2,2,2,2,1,2,1,82,101,71526,54981,59,55,77987,54134
17,2,2,0,0,3,1,0,115,77,71528,54981,148,122,77990,54134
18,3,2,3,1,0,0,3,31,16,71530,54984,45,46,77990,54137
19,3,1,0,0,3,1,0,156,155,71531,54984,178,55,77993,54137
20,3,1,1,2,1,2,1,254,226,71532,54985,265,174,77994,54138
21,3,2,0,0,3,1,0,197,179,71534,54985,211,1,77997,54138
22,3,2,0,0,3,1,0,33,29,71536,54985,31,155,78000,54138
23,3,4,1,0,3,1,0,252,213,71540,54986,287,131,78003,54138
24,3,3,0,0,3,1,0,89,72,71543,54986,100,85,78006,54138
25,3,1,2,1,0,0,3,35,34,71544,54988,33,166,78006,54141
26,3,0,1,1,0,0,3,178,152,71544,54989,178,153,78006,54144
27,4,4,0,0,3,1,0,76,88,71548,54989,78,55,78009,54144
28,4,1,1,2,1,2,1,127,101,71549,54990,161,173,78010,54145
29,4,1,2,1,0,0,3,258,201,71550,54992,293,200,78010,54148
30,4,2,1,0,3,1,0,84,102,71552,54993,62,25,78013,54148
31,4,4,1,0,3,1,0,230,201,71556,54994,244,102,78016,54148
32,4,1,0,0,3,1,0,234,223,71557,54994,243,28,78019,54148
33,4,1,0,0,3,1,0,196,151,71558,54994,242,167,78022,54148
34,4,1,1,2,1,2,1,1,4,71559,54995,1,136,78023,54149
35,4,1,1,2,1,2,1,116,95,71560,54996,139,23,78024,54150
36,5,2,1,0,3,1,0,256,227,71562,54997,268,166,78027,54150
37,5,0,1,1,0,0,3,197,180,71562,54998,211,49,78027,54153
38,5,2,1,0,3,1,0,254,214,71564,54999,290,155,78030,54153
39,5,0,3,1,0,0,3,178,155,71564,55002,178,58,78030,54156
40,5,0,1,1,0,0,3,115,78,71564,55003,148,134,78030,54159
41,5,2,1,0,3,1,0,236,224,71566,55004,246,153,78033,54159
42,5,1,1,2,1,2,1,90,73,71567,55005,101,123,78034,54160
43,5,2,0,0,3,1,0,35,29,71569,55005,34,1,78037,54160
44,5,2,1,0,3,1,0,37,35,71571,55006,36,85,78040,54160
45,6,2,2,2,1,2,1,260,203,71573,55008,294,174,78041,54161
46,6,1,1,2,1,2,1,85,103,71574,55009,63,168,78042,54162
47,6,1,0,0,3,1,0,91,73,71575,55009,104,200,78045,54162
48,6,2,1,0,3,1,0,198,152,71577,55010,245,134,78048,54162
49,6,1,1,2,1,2,1,32,17,71578,55011,46,137,78049,54163
50,6,0,0,2,1,2,1,156,155,71578,55011,179,24,78050,54164
51,6,1,1,2,1,2,1,2,5,71579,55012,2,103,78051,54165
52,6,1,3,1,0,0,3,77,91,71580,55015,78,31,78051,54168
53,6,2,2,2,1,2,1,118,97,71582,55017,140,175,78052,54169
54,7,0,2,1,0,0,3,254,216,71582,55019,290,61,78052,54172
55,7,1,1,2,1,2,1,128,102,71583,55020,162,2,78053,54173
56,7,0,0,2,1,2,1,35,29,71583,55020,35,56,78054,54174
57,7,3,2,0,3,1,0,40,37,71586,55022,39,123,78057,54174
58,7,2,1,0,3,1,0,238,225,71588,55023,249,49,78060,54174
59,7,1,0,0,3,1,0,116,78,71589,55023,151,25,78063,54174
60,7,4,1,0,3,1,0,260,228,71593,55024,271,85,78066,54174
61,7,1,3,1,0,0,3,179,158,71594,55027,178,158,78066,54177
62,7,1,0,0,3,1,0,231,201,71595,55027,247,153,78069,54177
63,8,1,3,1,0,0,3,199,155,71596,55030,245,178,78069,54180
64,8,1,0,0,3,1,0,157,155,71597,55030,182,134,78072,54180
65,8,2,2,2,1,2,1,199,182,71599,55032,212,175,78073,54181
66,8,2,0,0,3,1,0,4,5,71601,55032,5,31,78076,54181
67,8,2,1,0,3,1,0,262,204,71603,55033,297,85,78079,54181
68,8,2,1,0,3,1,0,93,74,71605,55034,107,103,78082,54181
69,8,1,1,2,1,2,1,33,18,71606,55035,47,201,78083,54182
70,8,1,2,1,0,0,3,86,105,71607,55037,63,169,78083,54185
71,8,1,0,0,3,1,0,78,91,71608,55037,81,137,78086,54185
72,9,1,1,2,1,2,1,232,202,71609,55038,248,26,78087,54186
73,9,2,1,0,3,1,0,80,92,71611,55039,84,24,78090,54186
74,9,1,0,0,3,1,0,261,228,71612,55039,274,2,78093,54186
75,9,2,2,2,1,2,1,42,39,71614,55041,40,62,78094,54187
76,9,1,0,0,3,1,0,180,158,71615,55041,181,123,78097,54187
77,9,0,0,2,1,2,1,118,97,71615,55041,141,159,78098,54188
78,9,0,1,1,0,0,3,238,226,71615,55042,249,171,78098,54191
79,9,2,1,0,3,1,0,256,217,71617,55043,293,103,78101,54191
80,9,1,1,2,1,2,1,263,205,71618,55044,298,57,78102,54192
81,10,1,0,0,3,1,0,158,155,71619,55044,185,201,78105,54192
82,10,0,3,1,0,0,3,128,105,71619,55047,162,172,78105,54195
83,10,1,1,2,1,2,1,200,183,71620,55048,213,32,78106,54196
84,10,1,1,2,1,2,1,5,6,71621,55049,6,179,78107,54197
85,10,0,1,1,0,0,3,35,30,71621,55050,35,29,78107,54200
86,10,3,2,0,3,1,0,119,80,71624,55052,154,85,78110,54200
87,10,3,1,0,3,1,0,96,75,71627,55053,110,137,78113,54200
88,10,1,0,0,3,1,0,87,105,71628,55053,66,153,78116,54200
89,10,3,1,0,3,1,0,202,156,71631,55054,248,49,78119,54200
90,11,1,1,2,1,2,1,257,218,71632,55055,294,25,78120,54201
91,11,2,2,2,1,2,1,44,41,71634,55057,41,176,78121,54202
92,11,0,0,2,1,2,1,118,97,71634,55057,142,172,78122,54203
93,11,2,1,0,3,1,0,234,203,71636,55058,251,2,78125,54203
94,11,1,2,1,0,0,3,81,94,71637,55060,84,126,78125,54206
95,11,1,1,2,1,2,1,264,206,71638,55061,299,135,78126,54207
96,11,1,0,0,3,1,0,34,18,71639,55061,50,57,78129,54207
97,11,2,3,1,0,0,3,182,161,71641,55064,181,106,78129,54210
98,11,4,2,0,3,1,0,242,228,71645,55066,252,62,78132,54210
99,12,2,1,0,3,1,0,121,81,71647,55067,157,153,78135,54210
100,12,2,3,1,0,0,3,160,158,71649,55070,185,88,78135,54213
101,12,2,2,2,1,2,1,130,107,71651,55072,163,50,78136,54214
102,12,1,0,0,3,1,0,36,30,71652,55072,38,137,78139,54214
103,12,1,0,0,3,1,0,97,75,71653,55072,113,159,78142,54214
104,12,2,3,1,0,0,3,7,9,71655,55075,6,65,78142,54217
105,12,4,2,0,3,1,0,265,230,71659,55077,277,201,78145,54217
106,12,3,2,0,3,1,0,203,185,71662,55079,216,29,78148,54217
107,12,3,0,0,3,1,0,237,203,71665,55079,254,179,78151,54217
108,13,1,1,2,1,2,1,258,219,71666,55080,295,173,78152,54218
109,13,0,0,2,1,2,1,182,161,71666,55080,182,173,78153,54219
110,13,0,1,1,0,0,3,118,98,71666,55081,142,138,78153,54222
111,13,2,1,0,3,1,0,36,19,71668,55082,53,176,78156,54222
112,13,2,1,0,3,1,0,83,95,71670,55083,87,106,78159,54222
113,13,1,1,2,1,2,1,243,229,71671,55084,253,127,78160,54223
114,13,0,0,2,1,2,1,202,156,71671,55084,249,33,78161,54224
115,13,2,0,0,3,1,0,89,105,71673,55084,69,25,78164,54224
116,13,0,1,1,0,0,3,264,207,71673,55085,299,5,78164,54227
117,14,0,0,2,1,2,1,237,203,71673,55085,255,51,78165,54228
118,14,3,1,0,3,1,0,206,186,71676,55086,219,57,78168,54228
119,14,2,1,0,3,1,0,9,10,71678,55087,9,88,78171,54228
120,14,1,0,0,3,1,0,37,30,71679,55087,41,153,78174,54228
121,14,3,1,0,3,1,0,163,159,71682,55088,188,159,78177,54228
122,14,2,0,0,3,1,0,267,230,71684,55088,280,137,78180,54228
123,14,0,1,1,0,0,3,130,108,71684,55089,163,68,78180,54231
124,14,2,1,0,3,1,0,123,82,71686,55090,160,179,78183,54231
125,14,1,1,2,1,2,1,45,42,71687,55091,42,30,78184,54232
126,15,2,0,0,3,1,0,245,229,71689,55091,256,138,78187,54232
127,15,1,3,1,0,0,3,119,101,71690,55094,142,176,78187,54235
128,15,0,0,2,1,2,1,89,105,71690,55094,70,107,78188,54236
129,15,4,0,0,3,1,0,206,156,71694,55094,252,5,78191,54236
130,15,1,0,0,3,1,0,37,19,71695,55094,56,127,78194,54236
131,15,0,0,2,1,2,1,37,30,71695,55094,42,174,78195,54237
132,15,3,1,0,3,1,0,185,162,71698,55095,185,33,78198,54237
133,15,0,1,1,0,0,3,83,96,71698,55096,87,204,78198,54240
134,15,1,3,1,0,0,3,98,78,71699,55099,113,179,78198,54243
135,16,3,1,0,3,1,0,48,43,71702,55100,45,25,78201,54243
136,16,1,1,2,1,2,1,164,160,71703,55101,189,175,78202,54244
137,16,1,1,2,1,2,1,238,204,71704,55102,256,138,78203,54245
138,16,1,1,2,1,2,1,124,83,71705,55103,161,160,78204,54246
139,16,3,2,0,3,1,0,133,110,71708,55105,166,57,78207,54246
140,16,1,1,2,1,2,1,265,208,71709,55106,300,31,78208,54247
141,16,0,0,2,1,2,1,9,10,71709,55106,10,52,78209,54248
142,16,2,1,0,3,1,0,269,231,71711,55107,283,68,78212,54248
143,16,3,1,0,3,1,0,261,220,71714,55108,298,179,78215,54248
144,17,1,1,2,1,2,1,165,161,71715,55109,190,180,78216,54249
145,17,1,2,1,0,0,3,38,32,71716,55111,42,141,78216,54252
146,17,0,0,2,1,2,1,185,162,71716,55111,186,205,78217,54253
147,17,1,0,0,3,1,0,99,78,71717,55111,116,33,78220,54253
148,17,2,2,2,1,2,1,208,188,71719,55113,220,108,78221,54254
149,17,3,2,0,3,1,0,92,107,71722,55115,73,88,78224,54254
150,17,0,1,1,0,0,3,37,20,71722,55116,56,8,78224,54257
151,17,1,1,2,1,2,1,207,157,71723,55117,253,177,78225,54258
152,17,3,0,0,3,1,0,86,96,71726,55117,90,153,78228,54258
153,18,3,2,0,3,1,0,272,233,71729,55119,286,25,78231,54258
154,18,1,4,1,0,0,3,134,114,71730,55123,166,141,78231,54261
155,18,1,0,0,3,1,0,246,229,71731,55123,259,31,78234,54261
156,18,0,0,2,1,2,1,9,10,71731,55123,11,58,78235,54262
157,18,0,3,1,0,0,3,265,211,71731,55126,300,163,78235,54265
158,18,4,0,0,3,1,0,265,220,71735,55126,301,175,78238,54265
159,18,0,1,1,0,0,3,119,102,71735,55127,142,55,78238,54268
160,18,3,0,0,3,1,0,241,204,71738,55127,259,127,78241,54268
161,18,3,0,0,3,1,0,127,83,71741,55127,164,33,78244,54268
162,19,2,2,2,1,2,1,50,45,71743,55129,46,206,78245,54269
163,19,3,2,0,3,1,0,168,163,71746,55131,193,153,78248,54269
164,19,0,1,1,0,0,3,208,189,71746,55132,220,180,78248,54272
165,19,4,0,0,3,1,0,42,32,71750,55132,45,108,78251,54272
166,19,2,4,1,0,0,3,101,82,71752,55136,116,182,78251,54275
167,19,1,1,2,1,2,1,38,21,71753,55137,57,142,78252,54276
168,19,1,1,2,1,2,1,87,97,71754,55138,91,181,78253,54277
169,19,1,1,2,1,2,1,186,163,71755,55139,187,89,78254,54278
170,19,1,1,2,1,2,1,208,158,71756,55140,254,69,78255,54279
171,20,1,2,1,0,0,3,242,206,71757,55142,259,61,78255,54282
172,20,1,1,2,1,2,1,93,108,71758,55143,74,56,78256,54283
173,20,0,0,2,1,2,1,265,211,71758,55143,301,176,78257,54284
174,20,0,2,1,0,0,3,134,116,71758,55145,166,36,78257,54287
175,20,0,2,1,0,0,3,127,85,71758,55147,164,184,78257,54290
176,20,0,0,2,1,2,1,9,10,71758,55147,12,128,78258,54291
177,20,3,0,0,3,1,0,122,102,71761,55147,145,206,78261,54291
178,20,0,0,2,1,2,1,246,229,71761,55147,260,26,78262,54292
179,20,1,1,2,1,2,1,209,159,71762,55148,255,32,78263,54293
180,21,0,2,1,0,0,3,50,47,71762,55150,46,156,78263,54296
181,21,3,1,0,3,1,0,211,190,71765,55151,223,142,78266,54296
182,21,2,0,0,3,1,0,44,32,71767,55151,48,180,78269,54296
183,21,0,3,1,0,0,3,168,166,71767,55154,193,111,78269,54299
184,21,1,2,1,0,0,3,102,84,71768,55156,116,72,78269,54302
185,21,2,1,0,3,1,0,40,22,71770,55157,60,89,78272,54302
186,21,0,0,2,1,2,1,186,163,71770,55157,188,183,78273,54303
187,21,4,4,2,1,2,1,276,237,71774,55161,287,164,78274,54304
188,21,2,2,2,1,2,1,267,222,71776,55163,302,9,78275,54305
189,22,2,0,0,3,1,0,11,10,71778,55163,15,176,78278,54305
190,22,1,1,2,1,2,1,135,117,71779,55164,167,207,78279,54306
191,22,0,0,2,1,2,1,122,102,71779,55164,146,62,78280,54307
192,22,2,0,0,3,1,0,211,159,71781,55164,258,26,78283,54307
193,22,1,1,2,1,2,1,266,212,71782,55165,302,142,78284,54308
194,22,3,0,0,3,1,0,90,97,71785,55165,94,32,78287,54308
195,22,1,5,1,0,0,3,247,234,71786,55170,260,187,78287,54311
196,22,0,0,2,1,2,1,242,206,71786,55170,260,37,78288,54312
197,22,7,0,0,3,1,0,100,108,71793,55170,77,128,78291,54312
198,23,0,1,1,0,0,3,102,85,71793,55171,116,59,78291,54315
199,23,0,0,2,1,2,1,44,32,71793,55171,49,90,78292,54316
200,23,1,2,1,0,0,3,128,87,71794,55173,164,183,78292,54319
201,23,0,1,1,0,0,3,211,191,71794,55174,223,167,78292,54322
202,23,3,1,0,3,1,0,279,238,71797,55175,290,142,78295,54322
203,23,2,0,0,3,1,0,188,163,71799,55175,191,9,78298,54322
204,23,1,1,2,1,2,1,51,48,71800,55176,47,184,78299,54323
205,23,1,1,2,1,2,1,268,223,71801,55177,303,157,78300,54324
206,23,1,1,2,1,2,1,41,23,71802,55178,61,73,78301,54325
207,24,1,1,2,1,2,1,243,207,71803,55179,261,188,78302,54326
208,24,1,0,0,3,1,0,91,97,71804,55179,97,176,78305,54326
209,24,1,1,2,1,2,1,123,103,71805,55180,147,38,78306,54327
210,24,0,1,1,0,0,3,135,118,71805,55181,167,114,78306,54330
211,24,2,4,1,0,0,3,170,170,71807,55185,193,65,78306,54333
212,24,2,0,0,3,1,0,13,10,71809,55185,18,26,78309,54333
213,24,3,2,0,3,1,0,103,110,71812,55187,80,142,78312,54333
214,24,1,2,1,0,0,3,212,161,71813,55189,258,210,78312,54336
215,24,0,2,1,0,0,3,266,214,71813,55191,302,187,78312,54339
216,25,1,0,0,3,1,0,269,223,71814,55191,306,65,78315,54339
217,25,0,1,1,0,0,3,44,33,71814,55192,49,131,78315,54342
218,25,0,1,1,0,0,3,128,88,71814,55193,164,12,78315,54345
219,25,2,0,0,3,1,0,281,238,71816,55193,293,157,78318,54345
220,25,4,1,0,3,1,0,215,192,71820,55194,226,73,78321,54345
221,25,2,0,0,3,1,0,249,234,71822,55194,263,90,78324,54345
222,25,3,2,0,3,1,0,138,120,71825,55196,170,167,78327,54345
223,25,1,1,2,1,2,1,52,49,71826,55197,48,60,78328,54346
224,25,1,0,0,3,1,0,189,163,71827,55197,194,32,78331,54346
225,26,2,1,0,3,1,0,93,98,71829,55198,100,187,78334,54346
226,26,1,1,2,1,2,1,124,104,71830,55199,148,189,78335,54347
227,26,1,0,0,3,1,0,14,10,71831,55199,21,142,78338,54347
228,26,2,0,0,3,1,0,104,85,71833,55199,119,26,78341,54347
229,26,2,2,2,1,2,1,172,172,71835,55201,194,39,78342,54348
230,26,2,1,0,3,1,0,105,111,71837,55202,83,210,78345,54348
231,26,3,0,0,3,1,0,269,214,71840,55202,305,183,78348,54348
232,26,2,3,1,0,0,3,43,26,71842,55205,61,117,78348,54351
233,26,3,0,0,3,1,0,215,161,71845,55205,261,142,78351,54351
234,27,1,0,0,3,1,0,53,49,71846,55205,51,12,78354,54351
235,27,1,1,2,1,2,1,139,121,71847,55206,171,132,78355,54352
236,27,0,1,1,0,0,3,281,239,71847,55207,293,179,78355,54355
237,27,0,0,2,1,2,1,124,104,71847,55207,149,158,78356,54356
238,27,2,1,0,3,1,0,245,208,71849,55208,264,73,78359,54356
239,27,3,1,0,3,1,0,131,89,71852,55209,167,65,78362,54356
240,27,2,0,0,3,1,0,251,234,71854,55209,266,167,78365,54356
241,27,1,0,0,3,1,0,270,223,71855,55209,309,32,78368,54356
242,27,2,0,0,3,1,0,191,163,71857,55209,197,60,78371,54356
243,28,1,2,1,0,0,3,132,91,71858,55211,167,213,78371,54359
244,28,2,3,1,0,0,3,16,13,71860,55214,21,192,78371,54362
245,28,1,0,0,3,1,0,106,111,71861,55214,86,39,78374,54362
246,28,4,1,0,3,1,0,219,193,71865,55215,229,187,78377,54362
247,28,0,2,1,0,0,3,215,163,71865,55217,261,93,78377,54365
248,28,1,0,0,3,1,0,45,33,71866,55217,52,60,78380,54365
249,28,1,1,2,1,2,1,173,173,71867,55218,195,143,78381,54366
250,28,0,2,1,0,0,3,104,87,71867,55220,119,161,78381,54369
251,28,1,1,2,1,2,1,44,27,71868,55221,62,184,78382,54370
252,29,1,1,2,1,2,1,252,235,71869,55222,267,13,78383,54371
253,29,1,1,2,1,2,1,54,50,71870,55223,52,180,78384,54372
254,29,0,1,1,0,0,3,124,105,71870,55224,149,120,78384,54375
255,29,1,0,0,3,1,0,192,163,71871,55224,200,65,78387,54375
256,29,2,3,1,0,0,3,95,101,71873,55227,100,170,78387,54378
257,29,1,1,2,1,2,1,271,224,71874,55228,310,133,78388,54379
258,29,4,1,0,3,1,0,249,209,71878,55229,267,142,78391,54379
259,29,1,1,2,1,2,1,45,28,71879,55230,63,27,78392,54380
260,29,2,2,2,1,2,1,271,216,71881,55232,306,74,78393,54381
261,30,1,1,2,1,2,1,46,34,71882,55233,53,214,78394,54382
262,30,2,2,2,1,2,1,175,175,71884,55235,196,61,78395,54383
263,30,1,2,1,0,0,3,140,123,71885,55237,171,164,78395,54386
264,30,3,1,0,3,1,0,135,92,71888,55238,170,143,78398,54386
265,30,1,1,2,1,2,1,220,194,71889,55239,230,94,78399,54387
266,30,1,1,2,1,2,1,17,14,71890,55240,22,185,78400,54388
267,30,1,1,2,1,2,1,105,88,71891,55241,120,33,78401,54389
268,30,2,1,0,3,1,0,283,240,71893,55242,296,39,78404,54389
269,30,2,0,0,3,1,0,108,111,71895,55242,89,187,78407,54389
270,31,1,2,1,0,0,3,125,107,71896,55244,149,136,78407,54392
271,31,2,2,2,1,2,1,273,226,71898,55246,311,193,78408,54393
272,31,3,1,0,3,1,0,98,102,71901,55247,103,142,78411,54393
273,31,1,1,2,1,2,1,46,29,71902,55248,64,181,78412,54394
274,31,1,3,1,0,0,3,193,166,71903,55251,200,30,78412,54397
275,31,2,0,0,3,1,0,273,216,71905,55251,309,120,78415,54397
276,31,2,1,0,3,1,0,217,164,71907,55252,264,65,78418,54397
277,31,3,1,0,3,1,0,111,112,71910,55253,92,13,78421,54397
278,31,3,2,0,3,1,0,255,237,71913,55255,270,185,78424,54397
279,32,2,0,0,3,1,0,285,240,71915,55255,299,33,78427,54397
280,32,4,0,0,3,1,0,224,194,71919,55255,233,143,78430,54397
281,32,2,1,0,3,1,0,142,124,71921,55256,174,94,78433,54397
282,32,1,0,0,3,1,0,55,50,71922,55256,55,170,78436,54397
283,32,2,4,1,0,0,3,137,96,71924,55260,170,64,78436,54400
284,32,2,0,0,3,1,0,48,34,71926,55260,56,74,78439,54400
285,32,2,1,0,3,1,0,177,176,71928,55261,199,187,78442,54400
286,32,1,0,0,3,1,0,18,14,71929,55261,25,164,78445,54400
287,32,1,0,0,3,1,0,250,209,71930,55261,270,214,78448,54400
288,33,1,1,2,1,2,1,256,238,71931,55262,271,121,78449,54401
289,33,4,1,0,3,1,0,115,113,71935,55263,95,142,78452,54401
290,33,4,2,0,3,1,0,109,90,71939,55265,123,181,78455,54401
291,33,0,0,2,1,2,1,273,216,71939,55265,310,31,78456,54402
292,33,1,0,0,3,1,0,47,29,71940,55265,67,39,78459,54402
293,33,3,2,0,3,1,0,220,166,71943,55267,267,136,78462,54402
294,33,0,0,2,1,2,1,125,107,71943,55267,150,14,78463,54403
295,33,1,2,1,0,0,3,99,104,71944,55269,103,188,78463,54406
296,33,0,1,1,0,0,3,193,167,71944,55270,200,196,78463,54409
297,34,0,3,1,0,0,3,273,229,71944,55273,311,67,78463,54412
298,34,3,0,0,3,1,0,288,240,71947,55273,302,65,78466,54412
299,34,1,3,1,0,0,3,225,197,71948,55276,233,34,78466,54415
300,34,1,2,1,0,0,3,138,98,71949,55278,170,77,78466,54418
301,34,2,2,2,1,2,1,57,52,71951,55280,56,144,78467,54419
302,34,1,1,2,1,2,1,251,210,71952,55281,271,95,78468,54420
303,34,0,0,2,1,2,1,142,124,71952,55281,175,188,78469,54421
304,34,1,0,0,3,1,0,19,14,71953,55281,28,170,78472,54421
305,34,1,0,0,3,1,0,178,176,71954,55281,202,33,78475,54421
306,35,4,2,0,3,1,0,103,106,71958,55283,106,14,78478,54421
307,35,2,5,1,0,0,3,111,95,71960,55288,123,145,78478,54424
308,35,1,4,1,0,0,3,48,33,71961,55292,67,167,78478,54427
309,35,1,1,2,1,2,1,257,239,71962,55293,272,215,78479,54428
310,35,2,2,2,1,2,1,195,169,71964,55295,201,189,78480,54429
311,35,1,1,2,1,2,1,221,167,71965,55296,268,122,78481,54430
312,35,2,2,2,1,2,1,227,199,71967,55298,234,137,78482,54431
313,35,1,0,0,3,1,0,49,34,71968,55298,59,39,78485,54431
314,35,1,0,0,3,1,0,116,113,71969,55298,98,196,78488,54431
315,36,2,2,2,1,2,1,253,212,71971,55300,272,171,78489,54432
316,36,1,0,0,3,1,0,274,216,71972,55300,313,67,78492,54432
317,36,0,0,2,1,2,1,138,98,71972,55300,171,182,78493,54433
318,36,1,2,1,0,0,3,143,126,71973,55302,175,37,78493,54436
319,36,2,1,0,3,1,0,127,108,71975,55303,153,77,78496,54436
320,36,2,3,1,0,0,3,275,232,71977,55306,311,147,78496,54439
321,36,3,1,0,3,1,0,60,53,71980,55307,59,65,78499,54439
322,36,1,1,2,1,2,1,20,15,71981,55308,29,34,78500,54440
323,36,1,0,0,3,1,0,289,240,71982,55308,305,137,78503,54440
324,37,0,0,2,1,2,1,49,34,71982,55308,60,197,78504,54441
325,37,2,0,0,3,1,0,223,167,71984,55308,271,167,78507,54441
326,37,1,2,1,0,0,3,179,178,71985,55310,202,192,78507,54444
327,37,2,2,2,1,2,1,50,35,71987,55312,68,189,78508,54445
328,37,3,0,0,3,1,0,230,199,71990,55312,237,215,78511,54445
329,37,1,0,0,3,1,0,196,169,71991,55312,204,145,78514,54445
330,37,3,3,2,1,2,1,106,109,71994,55315,107,96,78515,54446
331,37,1,2,1,0,0,3,112,97,71995,55317,123,17,78515,54449
332,37,1,0,0,3,1,0,61,53,71996,55317,62,122,78518,54449
333,38,3,0,0,3,1,0,277,216,71999,55317,316,137,78521,54449
334,38,2,3,1,0,0,3,291,243,72001,55320,305,70,78521,54452
335,38,2,2,2,1,2,1,255,214,72003,55322,273,183,78522,54453
336,38,3,1,0,3,1,0,141,99,72006,55323,174,37,78525,54453
337,38,2,1,0,3,1,0,277,233,72008,55324,314,39,78528,54453
338,38,1,1,2,1,2,1,128,109,72009,55325,154,148,78529,54454
339,38,2,0,0,3,1,0,259,239,72011,55325,275,65,78532,54454
340,38,2,1,0,3,1,0,118,114,72013,55326,101,171,78535,54454
341,38,2,3,1,0,0,3,145,129,72015,55329,175,37,78535,54457
0,1,0,0,2,1,2,1,10,17,72015,55329,24,71,78536,54458
1,1,0,0,2,1,2,1,277,216,72015,55329,317,18,78537,54459
2,1,3,1,0,3,1,0,115,98,72018,55330,126,189,78540,54459
3,1,3,1,0,3,1,0,182,179,72021,55331,205,84,78543,54459
4,1,0,3,1,0,0,3,230,202,72021,55334,237,174,78543,54462
5,1,1,2,1,0,0,3,51,37,72022,55336,68,40,78543,54465
6,1,1,0,0,3,1,0,123,82,72023,55336,143,148,78546,54465
7,1,2,1,0,3,1,0,268,212,72025,55337,294,50,78549,54465
8,1,2,1,0,3,1,0,143,100,72027,55338,177,160,78552,54465
9,1,3,0,0,3,1,0,3,0,72030,55338,3,117,78555,54465
10,2,1,1,2,1,2,1,171,195,72031,55339,213,202,78556,54466
11,2,4,1,0,3,1,0,110,110,72035,55340,110,183,78559,54466
12,2,1,2,1,0,0,3,224,169,72036,55342,271,170,78559,54469
13,2,0,1,1,0,0,3,20,16,72036,55343,29,68,78559,54472
14,2,0,1,1,0,0,3,49,35,72036,55344,60,72,78559,54475
15,2,0,1,1,0,0,3,196,170,72036,55345,204,125,78559,54478
16,2,0,1,1,0,0,3,128,87,72036,55346,143,40,78559,54481
17,2,0,2,1,0,0,3,83,93,72036,55348,80,19,78559,54484
18,2,4,2,0,3,1,0,263,241,72040,55350,278,0,78562,54484
19,2,2,1,0,3,1,0,169,148,72042,55351,197,137,78565,54484
20,3,1,0,0,3,1,0,4,0,72043,55351,6,174,78568,54484
21,3,2,0,0,3,1,0,184,179,72045,55351,208,148,78571,54484
22,3,2,0,0,3,1,0,232,202,72047,55351,240,84,78574,54484
23,3,0,0,2,1,2,1,143,100,72047,55351,178,51,78575,54485
24,3,1,0,0,3,1,0,124,82,72048,55351,146,117,78578,54485
25,3,0,2,1,0,0,3,51,39,72048,55353,68,163,78578,54488
26,3,1,2,1,0,0,3,21,18,72049,55355,29,192,78578,54491
27,3,0,0,2,1,2,1,277,216,72049,55355,318,203,78579,54492
28,3,4,1,0,3,1,0,14,18,72053,55356,27,40,78582,54492
29,3,0,2,1,0,0,3,115,100,72053,55358,126,74,78582,54495
30,4,1,1,2,1,2,1,170,149,72054,55359,198,41,78583,54496
31,4,1,0,0,3,1,0,111,110,72055,55359,113,18,78586,54496
32,4,2,1,0,3,1,0,51,36,72057,55360,63,170,78589,54496
33,4,1,0,0,3,1,0,269,212,72058,55360,297,183,78592,54496
34,4,1,5,1,0,0,3,84,98,72059,55365,80,140,78592,54499
35,4,2,1,0,3,1,0,198,171,72061,55366,207,0,78595,54499
36,4,1,1,2,1,2,1,264,242,72062,55367,279,73,78596,54500
37,4,2,2,2,1,2,1,226,171,72064,55369,272,126,78597,54501
38,4,2,2,2,1,2,1,173,197,72066,55371,214,20,78598,54502
39,4,0,1,1,0,0,3,128,88,72066,55372,143,71,78598,54505
40,5,3,0,0,3,1,0,187,179,72069,55372,211,174,78601,54505
41,5,2,1,0,3,1,0,234,203,72071,55373,243,192,78604,54505
42,5,1,1,2,1,2,1,22,19,72072,55374,30,149,78605,54506
43,5,2,0,0,3,1,0,279,216,72074,55374,321,51,78608,54506
44,5,3,1,0,3,1,0,146,101,72077,55375,181,117,78611,54506
45,5,2,3,1,0,0,3,16,21,72079,55378,27,206,78611,54509
46,5,1,1,2,1,2,1,5,1,72080,55379,7,75,78612,54510
47,5,0,2,1,0,0,3,124,84,72080,55381,146,44,78612,54513
48,5,0,0,2,1,2,1,128,88,72080,55381,144,41,78613,54514
49,5,1,1,2,1,2,1,116,101,72081,55382,127,164,78614,54515
50,6,0,3,1,0,0,3,264,245,72081,55385,279,173,78614,54518
51,6,1,1,2,1,2,1,171,150,72082,55386,199,19,78615,54519
52,6,0,1,1,0,0,3,84,99,72082,55387,80,186,78615,54522
53,6,1,1,2,1,2,1,52,40,72083,55388,69,21,78616,54523
54,6,3,0,0,3,1,0,272,212,72086,55388,300,126,78619,54523
55,6,1,1,2,1,2,1,112,111,72087,55389,114,74,78620,54524
56,6,1,1,2,1,2,1,174,198,72088,55390,215,1,78621,54525
57,6,2,4,1,0,0,3,228,175,72090,55394,272,87,78621,54528
58,6,2,3,1,0,0,3,200,174,72092,55397,207,74,78621,54531
59,6,1,0,0,3,1,0,52,36,72093,55397,66,140,78624,54531
60,7,1,0,0,3,1,0,147,101,72094,55397,184,21,78627,54531
61,7,1,1,2,1,2,1,23,20,72095,55398,31,45,78628,54532
62,7,3,1,0,3,1,0,282,217,72098,55399,324,74,78631,54532
63,7,3,4,1,0,0,3,203,178,72101,55403,207,167,78631,54535
64,7,2,0,0,3,1,0,7,1,72103,55403,10,206,78634,54535
65,7,0,1,1,0,0,3,228,176,72103,55404,272,78,78634,54538
66,7,1,2,1,0,0,3,129,90,72104,55406,144,54,78634,54541
67,7,0,2,1,0,0,3,52,38,72104,55408,66,189,78634,54544
68,7,1,1,2,1,2,1,117,102,72105,55409,128,118,78635,54545
69,7,0,2,1,0,0,3,187,181,72105,55411,211,195,78635,54548
70,8,1,3,1,0,0,3,235,206,72106,55414,243,22,78635,54551
71,8,4,2,0,3,1,0,88,101,72110,55416,83,1,78638,54551
72,8,1,2,1,0,0,3,265,247,72111,55418,279,177,78638,54554
73,8,1,0,0,3,1,0,53,40,72112,55418,72,74,78641,54554
74,8,1,1,2,1,2,1,125,85,72113,55419,147,88,78642,54555
75,8,1,0,0,3,1,0,113,111,72114,55419,117,126,78645,54555
76,8,2,0,0,3,1,0,176,198,72116,55419,218,140,78648,54555
77,8,1,1,2,1,2,1,17,22,72117,55420,28,174,78649,54556
78,8,1,1,2,1,2,1,273,213,72118,55421,301,42,78650,54557
79,8,1,0,0,3,1,0,172,150,72119,55421,202,149,78653,54557
80,9,2,1,0,3,1,0,189,182,72121,55422,214,74,78656,54557
81,9,1,1,2,1,2,1,24,21,72122,55423,32,168,78657,54558
82,9,3,2,0,3,1,0,285,219,72125,55425,327,45,78660,54558
83,9,4,0,0,3,1,0,269,247,72129,55425,282,78,78663,54558
84,9,0,0,2,1,2,1,7,1,72129,55425,11,190,78664,54559
85,9,1,1,2,1,2,1,118,103,72130,55426,129,127,78665,54560
86,9,2,0,0,3,1,0,230,176,72132,55426,275,54,78668,54560
87,9,2,2,2,1,2,1,131,92,72134,55428,145,207,78669,54561
88,9,1,0,0,3,1,0,204,178,72135,55428,210,21,78672,54561
89,9,1,1,2,1,2,1,53,39,72136,55429,67,119,78673,54562
90,10,2,1,0,3,1,0,178,199,72138,55430,221,174,78676,54562
91,10,1,0,0,3,1,0,236,206,72139,55430,246,149,78679,54562
92,10,1,1,2,1,2,1,274,214,72140,55431,302,178,78680,54563
93,10,2,1,0,3,1,0,90,102,72142,55432,86,195,78683,54563
94,10,1,1,2,1,2,1,148,102,72143,55433,185,141,78684,54564
95,10,2,1,0,3,1,0,19,23,72145,55434,31,74,78687,54564
96,10,1,2,1,0,0,3,54,42,72146,55436,72,4,78687,54567
97,10,1,0,0,3,1,0,126,85,72147,55436,150,22,78690,54567
98,10,2,0,0,3,1,0,115,111,72149,55436,120,42,78693,54567
99,10,3,0,0,3,1,0,175,150,72152,55436,205,88,78696,54567
100,11,0,0,2,1,2,1,230,176,72152,55436,276,169,78697,54568
101,11,1,1,2,1,2,1,190,183,72153,55437,215,46,78698,54569
102,11,2,3,1,0,0,3,287,222,72155,55440,327,130,78698,54572
103,11,2,1,0,3,1,0,206,179,72157,55441,213,54,78701,54572
104,11,3,0,0,3,1,0,272,247,72160,55441,285,21,78704,54572
105,11,2,1,0,3,1,0,120,104,72162,55442,132,74,78707,54572
106,11,0,0,2,1,2,1,236,206,72162,55442,247,120,78708,54573
107,11,2,1,0,3,1,0,9,2,72164,55443,14,88,78711,54573
108,11,2,0,0,3,1,0,117,111,72166,55443,123,207,78714,54573
109,11,2,0,0,3,1,0,26,21,72168,55443,35,42,78717,54573
110,12,3,1,0,3,1,0,290,223,72171,55444,330,141,78720,54573
111,12,1,1,2,1,2,1,91,103,72172,55445,87,79,78721,54574
112,12,0,2,1,0,0,3,148,104,72172,55447,185,193,78721,54577
113,12,3,2,0,3,1,0,22,25,72175,55449,34,178,78724,54577
114,12,1,0,0,3,1,0,55,42,72176,55449,75,149,78727,54577
115,12,1,1,2,1,2,1,127,86,72177,55450,151,5,78728,54578
116,12,1,2,1,0,0,3,275,216,72178,55452,302,198,78728,54581
117,12,1,0,0,3,1,0,54,39,72179,55452,70,74,78731,54581
118,12,2,2,2,1,2,1,133,94,72181,55454,146,23,78732,54582
119,12,2,0,0,3,1,0,177,150,72183,55454,208,169,78735,54582
120,13,1,1,2,1,2,1,273,248,72184,55455,286,43,78736,54583
121,13,2,0,0,3,1,0,119,111,72186,55455,126,174,78739,54583
122,13,2,0,0,3,1,0,93,103,72188,55455,90,74,78742,54583
123,13,1,2,1,0,0,3,207,181,72189,55457,213,91,78742,54586
124,13,3,0,0,3,1,0,12,2,72192,55457,17,130,78745,54586
125,13,1,1,2,1,2,1,276,217,72193,55458,303,47,78746,54587
126,13,3,2,0,3,1,0,193,185,72196,55460,218,23,78749,54587
127,13,1,1,2,1,2,1,237,207,72197,55461,248,22,78750,54588
128,13,2,0,0,3,1,0,232,176,72199,55461,279,120,78753,54588
129,13,2,1,0,3,1,0,180,200,72201,55462,224,74,78756,54588
130,14,1,1,2,1,2,1,27,22,72202,55463,36,179,78757,54589
131,14,0,0,2,1,2,1,54,39,72202,55463,71,150,78758,54590
132,14,1,1,2,1,2,1,291,224,72203,55464,331,194,78759,54591
133,14,4,0,0,3,1,0,181,150,72207,55464,211,207,78762,54591
134,14,0,2,1,0,0,3,55,44,72207,55466,75,82,78762,54594
135,14,1,1,2,1,2,1,121,105,72208,55467,133,142,78763,54595
136,14,1,0,0,3,1,0,134,94,72209,55467,149,169,78766,54595
137,14,2,0,0,3,1,0,129,86,72211,55467,154,54,78769,54595
138,14,3,1,0,3,1,0,151,105,72214,55468,188,198,78772,54595
139,14,2,0,0,3,1,0,24,25,72216,55468,37,5,78775,54595
140,15,5,0,0,3,1,0,124,111,72221,55468,129,91,78778,54595
141,15,4,3,0,3,1,0,241,210,72225,55471,251,74,78781,54595
142,15,2,1,0,3,1,0,278,218,72227,55472,306,142,78784,54595
143,15,2,2,2,1,2,1,275,250,72229,55474,287,48,78785,54596
144,15,2,0,0,3,1,0,234,176,72231,55474,282,150,78788,54596
145,15,1,0,0,3,1,0,181,200,72232,55474,227,43,78791,54596
146,15,0,2,1,0,0,3,93,105,72232,55476,90,123,78791,54599
147,15,0,2,1,0,0,3,24,27,72232,55478,37,77,78791,54602
148,15,1,0,0,3,1,0,13,2,72233,55478,20,174,78794,54602
149,15,2,2,2,1,2,1,153,107,72235,55480,189,24,78795,54603
150,16,2,3,1,0,0,3,183,203,72237,55483,227,57,78795,54606
151,16,1,0,0,3,1,0,194,185,72238,55483,221,194,78798,54606
152,16,2,0,0,3,1,0,183,150,72240,55483,214,198,78801,54606
153,16,0,0,2,1,2,1,55,44,72240,55483,76,180,78802,54607
154,16,2,0,0,3,1,0,131,86,72242,55483,157,207,78805,54607
155,16,0,2,1,0,0,3,207,183,72242,55485,213,85,78805,54610
156,16,1,2,1,0,0,3,28,24,72243,55487,36,8,78805,54613
157,16,2,1,0,3,1,0,56,40,72245,55488,74,130,78808,54613
158,16,3,2,0,3,1,0,124,107,72248,55490,136,174,78811,54613
159,16,1,3,1,0,0,3,135,97,72249,55493,149,25,78811,54616
160,17,3,2,0,3,1,0,237,178,72252,55495,285,43,78814,54616
161,17,1,1,2,1,2,1,242,211,72253,55496,252,170,78815,54617
162,17,2,1,0,3,1,0,293,225,72255,55497,334,150,78818,54617
163,17,1,1,2,1,2,1,279,219,72256,55498,307,75,78819,54618
164,17,2,0,0,3,1,0,95,105,72258,55498,93,48,78822,54618
165,17,2,0,0,3,1,0,155,107,72260,55498,192,77,78825,54618
166,17,1,0,0,3,1,0,125,111,72261,55498,132,123,78828,54618
167,17,1,1,2,1,2,1,276,251,72262,55499,288,92,78829,54619
168,17,1,3,1,0,0,3,25,30,72263,55502,37,27,78829,54622
169,17,2,1,0,3,1,0,15,3,72265,55503,23,142,78832,54622
170,18,1,0,0,3,1,0,29,24,72266,55503,39,207,78835,54622
171,18,1,2,1,0,0,3,184,205,72267,55505,227,88,78835,54625
172,18,1,1,2,1,2,1,57,41,72268,55506,75,58,78836,54626
173,18,1,2,1,0,0,3,184,152,72269,55508,214,177,78836,54629
174,18,0,2,1,0,0,3,207,185,72269,55510,213,201,78836,54632
175,18,4,0,0,3,1,0,128,107,72273,55510,139,8,78839,54632
176,18,2,2,2,1,2,1,137,99,72275,55512,150,131,78840,54633
177,18,1,2,1,0,0,3,56,46,72276,55514,76,197,78840,54636
178,18,1,0,0,3,1,0,195,185,72277,55514,224,25,78843,54636
179,18,0,0,2,1,2,1,131,86,72277,55514,158,181,78844,54637
180,19,0,0,2,1,2,1,276,251,72277,55514,289,171,78845,54638
181,19,1,3,1,0,0,3,243,214,72278,55517,252,80,78845,54641
182,19,3,0,0,3,1,0,296,225,72281,55517,337,92,78848,54641
183,19,1,0,0,3,1,0,96,105,72282,55517,96,27,78851,54641
184,19,0,1,1,0,0,3,155,108,72282,55518,192,51,78851,54644
185,19,0,0,2,1,2,1,25,30,72282,55518,38,124,78852,54645
186,19,1,0,0,3,1,0,16,3,72283,55518,26,43,78855,54645
187,19,2,1,0,3,1,0,239,179,72285,55519,288,75,78858,54645
188,19,4,0,0,3,1,0,129,111,72289,55519,135,142,78861,54645
189,19,1,1,2,1,2,1,280,220,72290,55520,308,151,78862,54646
190,20,2,2,2,1,2,1,186,154,72292,55522,215,9,78863,54647
191,20,3,1,0,3,1,0,140,100,72295,55523,153,142,78866,54647
192,20,1,0,0,3,1,0,97,105,72296,55523,99,207,78869,54647
193,20,0,0,2,1,2,1,57,41,72296,55523,76,52,78870,54648
194,20,4,4,2,1,2,1,211,189,72300,55527,214,81,78871,54649
195,20,2,0,0,3,1,0,186,205,72302,55527,230,131,78874,54649
196,20,1,1,2,1,2,1,240,180,72303,55528,289,198,78875,54650
197,20,1,2,1,0,0,3,277,253,72304,55530,289,78,78875,54653
198,20,1,1,2,1,2,1,130,112,72305,55531,136,26,78876,54654
199,20,0,1,1,0,0,3,29,25,72305,55532,39,180,78876,54657
200,21,1,1,2,1,2,1,281,221,72306,55533,309,172,78877,54658
201,21,1,2,1,0,0,3,244,216,72307,55535,252,91,78877,54661
202,21,1,1,2,1,2,1,132,87,72308,55536,159,44,78878,54662
203,21,1,1,2,1,2,1,26,31,72309,55537,39,59,78879,54663
204,21,0,2,1,0,0,3,16,5,72309,55539,26,204,78879,54666
205,21,2,1,0,3,1,0,130,108,72311,55540,142,27,78882,54666
206,21,1,2,1,0,0,3,297,227,72312,55542,337,184,78882,54669
207,21,1,1,2,1,2,1,57,47,72313,55543,77,93,78883,54670
208,21,0,1,1,0,0,3,195,186,72313,55544,224,127,78883,54673
209,21,1,0,0,3,1,0,156,108,72314,55544,195,151,78886,54673
210,22,3,4,1,0,0,3,60,45,72317,55548,76,29,78886,54676
211,22,0,3,1,0,0,3,211,192,72317,55551,214,145,78886,54679
212,22,0,3,1,0,0,3,140,103,72317,55554,153,201,78886,54682
213,22,1,0,0,3,1,0,241,180,72318,55554,292,9,78889,54682
214,22,1,0,0,3,1,0,187,154,72319,55554,218,81,78892,54682
215,22,3,1,0,3,1,0,284,222,72322,55555,312,180,78895,54682
216,22,1,2,1,0,0,3,98,107,72323,55557,99,134,78895,54685
217,22,0,1,1,0,0,3,186,206,72323,55558,230,55,78895,54688
218,22,1,1,2,1,2,1,131,113,72324,55559,137,79,78896,54689
219,22,2,1,0,3,1,0,279,254,72326,55560,292,27,78899,54689
220,23,2,2,2,1,2,1,197,188,72328,55562,225,60,78900,54690
221,23,1,0,0,3,1,0,298,227,72329,55562,340,44,78903,54690
222,23,1,2,1,0,0,3,245,218,72330,55564,252,210,78903,54693
223,23,0,1,1,0,0,3,57,48,72330,55565,77,130,78903,54696
224,23,2,2,2,1,2,1,18,7,72332,55567,27,152,78904,54697
225,23,0,3,1,0,0,3,156,111,72332,55570,195,187,78904,54700
226,23,1,1,2,1,2,1,27,32,72333,55571,40,173,78905,54701
227,23,2,0,0,3,1,0,134,87,72335,55571,162,204,78908,54701
228,23,0,1,1,0,0,3,29,26,72335,55572,39,94,78908,54704
229,23,1,0,0,3,1,0,131,108,72336,55572,145,93,78911,54704
230,24,1,2,1,0,0,3,280,256,72337,55574,292,204,78911,54707
231,24,0,3,1,0,0,3,211,195,72337,55577,214,30,78911,54710
232,24,3,2,0,3,1,0,101,109,72340,55579,102,180,78914,54710
233,24,2,1,0,3,1,0,133,114,72342,55580,140,9,78917,54710
234,24,2,2,2,1,2,1,59,50,72344,55582,78,82,78918,54711
235,24,3,1,0,3,1,0,244,181,72347,55583,295,145,78921,54711
236,24,1,0,0,3,1,0,188,154,72348,55583,221,134,78924,54711
237,24,5,0,0,3,1,0,65,45,72353,55583,79,93,78927,54711
238,24,2,1,0,3,1,0,286,223,72355,55584,315,29,78930,54711
239,24,2,0,0,3,1,0,188,206,72357,55584,233,79,78933,54711
240,25,0,2,1,0,0,3,29,28,72357,55586,39,133,78933,54714
241,25,0,4,1,0,0,3,134,91,72357,55590,162,97,78933,54717
242,25,3,0,0,3,1,0,248,218,72360,55590,255,60,78936,54717
243,25,1,1,2,1,2,1,141,104,72361,55591,154,188,78937,54718
244,25,1,2,1,0,0,3,28,34,72362,55593,40,58,78937,54721
245,25,0,1,1,0,0,3,18,8,72362,55594,27,176,78937,54724
246,25,1,0,0,3,1,0,132,108,72363,55594,148,152,78940,54724
247,25,4,1,0,3,1,0,302,228,72367,55595,343,204,78943,54724
248,25,0,1,1,0,0,3,156,112,72367,55596,195,213,78943,54727
249,25,1,3,1,0,0,3,198,191,72368,55599,225,47,78943,54730
250,26,1,2,1,0,0,3,135,93,72369,55601,162,183,78943,54733
251,26,1,1,2,1,2,1,60,51,72370,55602,79,31,78944,54734
252,26,0,0,2,1,2,1,248,218,72370,55602,256,48,78945,54735
253,26,1,0,0,3,1,0,29,34,72371,55602,43,134,78948,54735
254,26,0,1,1,0,0,3,286,224,72371,55603,315,12,78948,54738
255,26,3,1,0,3,1,0,136,115,72374,55604,143,188,78951,54738
256,26,2,2,2,1,2,1,103,111,72376,55606,103,94,78952,54739
257,26,0,1,1,0,0,3,188,207,72376,55607,233,155,78952,54742
258,26,1,0,0,3,1,0,189,154,72377,55607,224,79,78955,54742
259,26,2,1,0,3,1,0,282,257,72379,55608,295,145,78958,54742
260,27,1,2,1,0,0,3,157,114,72380,55610,195,100,78958,54745
261,27,1,2,1,0,0,3,30,30,72381,55612,39,207,78958,54748
262,27,2,3,1,0,0,3,67,48,72383,55615,79,216,78958,54751
263,27,2,2,2,1,2,1,213,197,72385,55617,215,134,78959,54752
264,27,2,1,0,3,1,0,20,9,72387,55618,30,60,78962,54752
265,27,1,0,0,3,1,0,303,228,72388,55618,346,29,78965,54752
266,27,2,0,0,3,1,0,134,108,72390,55618,151,58,78968,54752
267,27,4,1,0,3,1,0,145,105,72394,55619,157,82,78971,54752
268,27,1,1,2,1,2,1,199,192,72395,55620,226,177,78972,54753
269,27,2,0,0,3,1,0,246,181,72397,55620,298,204,78975,54753
270,28,0,2,1,0,0,3,248,220,72397,55622,256,15,78975,54756
271,28,0,2,1,0,0,3,189,156,72397,55624,224,51,78975,54759
272,28,1,3,1,0,0,3,61,54,72398,55627,79,186,78975,54762
273,28,1,0,0,3,1,0,158,114,72399,55627,198,79,78978,54762
274,28,1,1,2,1,2,1,287,225,72400,55628,316,95,78979,54763
275,28,1,0,0,3,1,0,30,34,72401,55628,46,155,78982,54763
276,28,3,0,0,3,1,0,138,93,72404,55628,165,145,78985,54763
277,28,3,1,0,3,1,0,106,112,72407,55629,106,188,78988,54763
278,28,4,0,0,3,1,0,140,115,72411,55629,146,204,78991,54763
279,28,2,0,0,3,1,0,190,207,72413,55629,236,31,78994,54763
280,29,1,0,0,3,1,0,247,181,72414,55629,301,216,78997,54763
281,29,1,1,2,1,2,1,304,229,72415,55630,347,178,78998,54764
282,29,0,2,1,0,0,3,213,199,72415,55632,215,210,78998,54767
283,29,0,0,2,1,2,1,145,105,72415,55632,158,135,78999,54768
284,29,3,1,0,3,1,0,285,258,72418,55633,298,60,79002,54768
285,29,1,1,2,1,2,1,135,109,72419,55634,152,30,79003,54769
286,29,2,1,0,3,1,0,32,31,72421,55635,42,82,79006,54769
287,29,0,0,2,1,2,1,20,9,72421,55635,31,59,79007,54770
288,29,0,1,1,0,0,3,67,49,72421,55636,79,103,79007,54773
289,29,0,1,1,0,0,3,199,193,72421,55637,226,137,79007,54776
290,30,3,0,0,3,1,0,148,105,72424,55637,161,15,79010,54776
291,30,2,1,0,3,1,0,63,55,72426,55638,82,145,79013,54776
292,30,0,0,2,1,2,1,287,225,72426,55638,317,104,79014,54777
293,30,0,2,1,0,0,3,189,158,72426,55640,224,213,79014,54780
294,30,0,2,1,0,0,3,67,51,72426,55642,79,34,79014,54783
295,30,0,0,2,1,2,1,158,114,72426,55642,199,187,79015,54784
296,30,2,3,1,0,0,3,108,115,72428,55645,106,158,79015,54787
297,30,2,1,0,3,1,0,32,35,72430,55646,49,204,79018,54787
298,30,1,0,0,3,1,0,139,93,72431,55646,168,79,79021,54787
299,30,1,3,1,0,0,3,191,210,72432,55649,236,191,79021,54790
300,31,3,3,2,1,2,1,138,112,72435,55652,153,52,79022,54791
301,31,1,1,2,1,2,1,200,194,72436,55653,227,188,79023,54792
302,31,1,1,2,1,2,1,286,259,72437,55654,299,217,79024,54793
303,31,2,0,0,3,1,0,193,210,72439,55654,239,135,79027,54793
304,31,1,0,0,3,1,0,141,115,72440,55654,149,60,79030,54793
305,31,2,0,0,3,1,0,250,220,72442,55654,259,137,79033,54793
306,31,1,2,1,0,0,3,248,183,72443,55656,301,33,79033,54796
307,31,2,2,2,1,2,1,34,33,72445,55658,43,96,79034,54797
308,31,0,2,1,0,0,3,213,201,72445,55660,215,62,79034,54800
309,31,2,0,0,3,1,0,22,9,72447,55660,34,82,79037,54800
310,32,2,0,0,3,1,0,34,35,72449,55660,52,213,79040,54800
311,32,0,1,1,0,0,3,34,34,72449,55661,43,148,79040,54803
312,32,3,0,0,3,1,0,307,229,72452,55661,350,104,79043,54803
313,32,1,1,2,1,2,1,140,94,72453,55662,169,179,79044,54804
314,32,0,2,1,0,0,3,63,57,72453,55664,82,220,79044,54807
315,32,2,1,0,3,1,0,140,113,72455,55665,156,60,79047,54807
316,32,2,1,0,3,1,0,150,106,72457,55666,164,158,79050,54807
317,32,1,0,0,3,1,0,68,51,72458,55666,82,204,79053,54807
318,32,1,2,1,0,0,3,159,116,72459,55668,199,18,79053,54810
319,32,2,1,0,3,1,0,191,159,72461,55669,227,191,79056,54810
320,33,1,1,2,1,2,1,109,116,72462,55670,107,83,79057,54811
321,33,5,1,0,3,1,0,253,184,72467,55671,304,34,79060,54811
322,33,1,2,1,0,0,3,214,203,72468,55673,215,55,79060,54814
323,33,1,3,1,0,0,3,251,223,72469,55676,259,191,79060,54817
324,33,2,0,0,3,1,0,289,225,72471,55676,320,135,79063,54817
325,33,2,2,2,1,2,1,288,261,72473,55678,300,138,79064,54818
326,33,1,0,0,3,1,0,23,9,72474,55678,37,33,79067,54818
327,33,3,2,0,3,1,0,203,196,72477,55680,230,79,79070,54818
328,33,1,1,2,1,2,1,194,211,72478,55681,240,97,79071,54819
329,33,1,1,2,1,2,1,142,116,72479,55682,150,63,79072,54820
330,34,2,1,0,3,1,0,36,35,72481,55683,46,138,79075,54820
331,34,2,0,0,3,1,0,152,106,72483,55683,167,104,79078,54820
332,34,1,0,0,3,1,0,69,51,72484,55683,85,179,79081,54820
333,34,4,1,0,3,1,0,144,114,72488,55684,159,213,79084,54820
334,34,1,0,0,3,1,0,204,196,72489,55684,233,220,79087,54820
335,34,2,2,2,1,2,1,193,161,72491,55686,228,61,79088,54821
336,34,1,1,2,1,2,1,64,58,72492,55687,83,205,79089,54822
337,34,1,1,2,1,2,1,141,95,72493,55688,170,34,79090,54823
338,34,1,0,0,3,1,0,308,229,72494,55688,353,18,79093,54823
339,34,0,1,1,0,0,3,214,204,72494,55689,215,194,79093,54826
340,35,1,1,2,1,2,1,289,262,72495,55690,301,136,79094,54827
341,35,1,2,1,0,0,3,252,225,72496,55692,259,151,79094,54830
342,35,3,2,0,3,1,0,112,118,72499,55694,110,179,79097,54830
343,35,1,2,1,0,0,3,24,11,72500,55696,37,37,79097,54833
344,35,0,0,2,1,2,1,159,116,72500,55696,200,56,79098,54834
345,35,3,1,0,3,1,0,145,117,72503,55697,153,158,79101,54834
346,35,1,1,2,1,2,1,309,230,72504,55698,354,80,79102,54835
347,35,3,2,0,3,1,0,37,37,72507,55700,55,97,79105,54835
348,35,0,1,1,0,0,3,253,185,72507,55701,304,66,79105,54838
349,35,2,4,1,0,0,3,291,229,72509,55705,320,86,79105,54841
350,36,1,5,1,0,0,3,215,209,72510,55710,215,194,79105,54844
351,36,2,3,1,0,0,3,195,164,72512,55713,228,107,79105,54847
352,36,4,1,0,3,1,0,198,212,72516,55714,243,213,79108,54847
353,36,2,4,1,0,0,3,146,118,72518,55718,159,223,79108,54850
354,36,1,0,0,3,1,0,65,58,72519,55718,86,61,79111,54850
355,36,0,2,1,0,0,3,141,97,72519,55720,170,141,79111,54853
356,36,1,0,0,3,1,0,153,106,72520,55720,170,205,79114,54853
357,36,2,1,0,3,1,0,38,36,72522,55721,49,34,79117,54853
358,36,2,2,2,1,2,1,206,198,72524,55723,234,19,79118,54854
359,36,0,0,2,1,2,1,69,51,72524,55723,86,195,79119,54855
360,37,1,0,0,3,1,0,38,37,72525,55723,58,151,79122,54855
361,37,0,1,1,0,0,3,145,118,72525,55724,153,182,79122,54858
362,37,1,5,1,0,0,3,292,234,72526,55729,320,40,79122,54861
363,37,1,2,1,0,0,3,113,120,72527,55731,110,59,79122,54864
364,37,1,0,0,3,1,0,310,230,72528,55731,357,136,79125,54864
365,37,1,0,0,3,1,0,290,262,72529,55731,304,158,79128,54864
366,37,1,1,2,1,2,1,25,12,72530,55732,38,81,79129,54865
367,37,1,2,1,0,0,3,160,118,72531,55734,200,100,79129,54868
368,37,1,0,0,3,1,0,253,225,72532,55734,262,66,79132,54868
369,37,0,0,2,1,2,1,253,185,72532,55734,305,87,79133,54869
370,38,2,4,1,0,0,3,208,202,72534,55738,234,110,79133,54872
371,38,2,3,1,0,0,3,143,100,72536,55741,170,216,79133,54875
372,38,2,0,0,3,1,0,155,106,72538,55741,173,194,79136,54875
373,38,0,2,1,0,0,3,215,211,72538,55743,215,226,79136,54878
374,38,3,1,0,3,1,0,41,37,72541,55744,52,61,79139,54878
375,38,3,1,0,3,1,0,68,59,72544,55745,89,141,79142,54878
376,38,1,0,0,3,1,0,199,212,72545,55745,246,205,79145,54878
377,38,1,1,2,1,2,1,196,165,72546,55746,229,35,79146,54879
378,38,2,2,2,1,2,1,71,53,72548,55748,87,20,79147,54880
379,38,1,2,1,0,0,3,147,120,72549,55750,159,198,79147,54883
0,1,0,0,2,1,2,1,0,0,72549,55750,1,77,79148,54884
1,1,1,1,2,1,2,1,292,244,72550,55751,306,152,79149,54885
2,1,0,0,2,1,2,1,41,37,72550,55751,53,88,79150,54886
3,1,0,2,1,0,0,3,196,167,72550,55753,229,229,79150,54889
4,1,0,0,2,1,2,1,118,114,72550,55753,102,21,79151,54890
5,1,0,0,2,1,2,1,290,262,72550,55753,305,183,79152,54891
6,1,1,1,2,1,2,1,148,121,72551,55754,160,80,79153,54892
7,1,1,0,0,3,1,0,69,59,72552,55754,92,130,79156,54892
8,1,0,2,1,0,0,3,71,55,72552,55756,87,219,79156,54895
9,1,2,2,2,1,2,1,2,2,72554,55758,1,36,79157,54896
10,2,1,2,1,0,0,3,200,214,72555,55760,246,84,79157,54899
11,2,0,2,1,0,0,3,208,204,72555,55762,234,80,79157,54902
12,2,0,0,2,1,2,1,292,234,72555,55762,321,1,79158,54903
13,2,3,1,0,3,1,0,102,97,72558,55763,120,205,79161,54903
14,2,1,1,2,1,2,1,99,114,72559,55764,103,41,79162,54904
15,2,0,2,1,0,0,3,69,61,72559,55766,92,139,79162,54907
16,2,0,2,1,0,0,3,143,102,72559,55768,170,3,79162,54910
17,2,1,1,2,1,2,1,132,132,72560,55769,169,22,79163,54911
18,2,1,1,2,1,2,1,39,38,72561,55770,59,60,79164,54912
19,2,3,0,0,3,1,0,256,225,72564,55770,265,197,79167,54912
20,3,3,0,0,3,1,0,295,244,72567,55770,309,80,79170,54912
21,3,1,1,2,1,2,1,42,38,72568,55771,54,220,79171,54913
22,3,0,0,2,1,2,1,71,55,72568,55771,88,67,79172,54914
23,3,3,3,2,1,2,1,28,15,72571,55774,39,78,79173,54915
24,3,0,1,1,0,0,3,2,3,72571,55775,1,186,79173,54918
25,3,4,1,0,3,1,0,152,122,72575,55776,163,36,79176,54918
26,3,1,1,2,1,2,1,144,103,72576,55777,171,81,79177,54919
27,3,1,2,1,0,0,3,291,264,72577,55779,305,232,79177,54922
28,3,1,0,0,3,1,0,197,167,72578,55779,232,152,79180,54922
29,3,1,1,2,1,2,1,1,1,72579,55780,2,131,79181,54923
30,4,2,1,0,3,1,0,210,205,72581,55781,237,3,79184,54923
31,4,1,0,0,3,1,0,201,214,72582,55781,249,197,79187,54923
32,4,2,0,0,3,1,0,258,225,72584,55781,268,22,79190,54923
33,4,2,1,0,3,1,0,294,235,72586,55782,324,78,79193,54923
34,4,0,0,2,1,2,1,197,167,72586,55782,233,89,79194,54924
35,4,1,1,2,1,2,1,133,133,72587,55783,170,85,79195,54925
36,4,1,1,2,1,2,1,40,39,72588,55784,60,2,79196,54926
37,4,0,0,2,1,2,1,102,97,72588,55784,121,42,79197,54927
38,4,4,0,0,3,1,0,73,61,72592,55784,95,205,79200,54927
39,4,2,2,2,1,2,1,120,116,72594,55786,103,61,79201,54928
40,5,3,1,0,3,1,0,297,236,72597,55787,327,36,79204,54928
41,5,1,2,1,0,0,3,2,3,72598,55789,2,189,79204,54931
42,5,2,2,2,1,2,1,30,17,72600,55791,40,82,79205,54932
43,5,1,0,0,3,1,0,153,122,72601,55791,166,152,79208,54932
44,5,3,2,0,3,1,0,102,116,72604,55793,106,131,79211,54932
45,5,0,2,1,0,0,3,291,266,72604,55795,305,142,79211,54935
46,5,1,1,2,1,2,1,43,39,72605,55796,55,81,79212,54936
47,5,0,2,1,0,0,3,144,105,72605,55798,171,70,79212,54939
48,5,2,2,2,1,2,1,73,57,72607,55800,89,198,79213,54940
49,5,0,2,1,0,0,3,2,5,72607,55802,1,223,79213,54943
50,6,1,2,1,0,0,3,259,227,72608,55804,268,5,79213,54946
51,6,0,1,1,0,0,3,210,206,72608,55805,237,25,79213,54949
52,6,2,2,2,1,2,1,297,246,72610,55807,310,90,79214,54950
53,6,2,0,0,3,1,0,203,214,72612,55807,252,42,79217,54950
54,6,4,4,2,1,2,1,137,137,72616,55811,171,37,79218,54951
55,6,3,0,0,3,1,0,156,122,72619,55811,169,3,79221,54951
56,6,2,0,0,3,1,0,75,61,72621,55811,98,232,79224,54951
57,6,0,1,1,0,0,3,102,98,72621,55812,121,81,79224,54954
58,6,1,0,0,3,1,0,198,167,72622,55812,236,61,79227,54954
59,6,3,1,0,3,1,0,123,117,72625,55813,106,205,79230,54954
60,7,2,0,0,3,1,0,104,116,72627,55813,109,85,79233,54954
61,7,1,2,1,0,0,3,44,41,72628,55815,55,201,79233,54957
62,7,2,0,0,3,1,0,4,3,72630,55815,5,142,79236,54957
63,7,1,1,2,1,2,1,31,18,72631,55816,41,190,79237,54958
64,7,3,0,0,3,1,0,300,236,72634,55816,330,82,79240,54958
65,7,0,1,1,0,0,3,73,58,72634,55817,89,134,79240,54961
66,7,3,1,0,3,1,0,294,267,72637,55818,308,223,79243,54961
67,7,2,1,0,3,1,0,4,6,72639,55819,4,70,79246,54961
68,7,1,5,1,0,0,3,145,110,72640,55824,171,84,79246,54964
69,7,2,1,0,3,1,0,42,40,72642,55825,63,152,79249,54964
70,8,0,2,1,0,0,3,198,169,72642,55827,236,45,79249,54967
71,8,2,2,2,1,2,1,299,248,72644,55829,311,71,79250,54968
72,8,2,2,2,1,2,1,261,229,72646,55831,269,233,79251,54969
73,8,7,1,0,3,1,0,130,118,72653,55832,109,3,79254,54969
74,8,1,1,2,1,2,1,32,19,72654,55833,42,6,79255,54970
75,8,2,0,0,3,1,0,106,116,72656,55833,112,205,79258,54970
76,8,1,1,2,1,2,1,211,207,72657,55834,238,91,79259,54971
77,8,1,2,1,0,0,3,103,100,72658,55836,121,40,79259,54974
78,8,2,1,0,3,1,0,158,123,72660,55837,172,61,79262,54974
79,8,1,1,2,1,2,1,138,138,72661,55838,172,191,79263,54975
80,9,1,2,1,0,0,3,204,216,72662,55840,252,87,79263,54978
81,9,1,2,1,0,0,3,300,250,72663,55842,311,145,79263,54981
82,9,2,2,2,1,2,1,302,238,72665,55844,331,135,79264,54982
83,9,0,2,1,0,0,3,294,269,72665,55846,308,28,79264,54985
84,9,1,4,1,0,0,3,43,44,72666,55850,63,226,79264,54988
85,9,2,1,0,3,1,0,77,62,72668,55851,101,152,79267,54988
86,9,1,0,0,3,1,0,5,3,72669,55851,8,82,79270,54988
87,9,1,1,2,1,2,1,5,7,72670,55852,5,62,79271,54989
88,9,0,1,1,0,0,3,44,42,72670,55853,55,88,79271,54992
89,9,0,1,1,0,0,3,145,111,72670,55854,171,84,79271,54995
90,10,0,2,1,0,0,3,211,209,72670,55856,238,208,79271,54998
91,10,2,1,0,3,1,0,75,59,72672,55857,92,91,79274,54998
92,10,3,2,0,3,1,0,201,171,72675,55859,239,191,79277,54998
93,10,2,2,2,1,2,1,132,120,72677,55861,110,72,79278,54999
94,10,1,0,0,3,1,0,159,123,72678,55861,175,226,79281,54999
95,10,4,0,0,3,1,0,110,116,72682,55861,115,40,79284,54999
96,10,2,1,0,3,1,0,105,101,72684,55862,124,201,79287,54999
97,10,3,0,0,3,1,0,8,7,72687,55862,8,6,79290,54999
98,10,1,1,2,1,2,1,139,139,72688,55863,173,46,79291,55000
99,10,0,0,2,1,2,1,32,19,72688,55863,43,234,79292,55001
100,11,0,2,1,0,0,3,77,64,72688,55865,101,9,79292,55004
101,11,3,0,0,3,1,0,207,216,72691,55865,255,82,79295,55004
102,11,3,1,0,3,1,0,303,251,72694,55866,314,88,79298,55004
103,11,0,1,1,0,0,3,44,43,72694,55867,55,6,79298,55007
104,11,3,3,2,1,2,1,78,62,72697,55870,93,153,79299,55008
105,11,2,2,2,1,2,1,134,122,72699,55872,111,146,79300,55009
106,11,1,0,0,3,1,0,44,44,72700,55872,66,28,79303,55009
107,11,2,5,1,0,0,3,147,116,72702,55877,171,237,79303,55012
108,11,2,3,1,0,0,3,296,272,72704,55880,308,138,79303,55015
109,11,2,0,0,3,1,0,263,229,72706,55880,272,84,79306,55015
110,12,1,2,1,0,0,3,106,103,72707,55882,124,75,79306,55018
111,12,1,2,1,0,0,3,9,9,72708,55884,8,149,79306,55021
112,12,0,3,1,0,0,3,211,212,72708,55887,238,49,79306,55024
113,12,3,0,0,3,1,0,266,229,72711,55887,275,138,79309,55024
114,12,1,0,0,3,1,0,303,238,72712,55887,334,62,79312,55024
115,12,5,0,0,3,1,0,10,3,72717,55887,11,91,79315,55024
116,12,0,0,2,1,2,1,44,44,72717,55887,67,209,79316,55025
117,12,1,1,2,1,2,1,33,20,72718,55888,44,202,79317,55026
118,12,1,1,2,1,2,1,160,124,72719,55889,176,88,79318,55027
119,12,0,0,2,1,2,1,110,116,72719,55889,116,192,79319,55028
120,13,0,1,1,0,0,3,147,117,72719,55890,171,31,79319,55031
121,13,0,0,2,1,2,1,201,171,72719,55890,240,89,79320,55032
122,13,3,1,0,3,1,0,306,252,72722,55891,317,6,79323,55032
123,13,1,1,2,1,2,1,208,217,72723,55892,256,238,79324,55033
124,13,1,0,0,3,1,0,79,62,72724,55892,96,49,79327,55033
125,13,2,1,0,3,1,0,141,140,72726,55893,176,153,79330,55033
126,13,0,3,1,0,0,3,134,125,72726,55896,111,43,79330,55036
127,13,3,2,0,3,1,0,299,274,72729,55898,311,9,79333,55036
128,13,0,0,2,1,2,1,77,64,72729,55898,102,85,79334,55037
129,13,1,3,1,0,0,3,107,106,72730,55901,124,229,79334,55040
130,14,2,1,0,3,1,0,162,125,72732,55902,179,91,79337,55040
131,14,1,0,0,3,1,0,267,229,72733,55902,278,149,79340,55040
132,14,0,0,2,1,2,1,44,43,72733,55902,56,76,79341,55041
133,14,1,1,2,1,2,1,142,141,72734,55903,177,83,79342,55042
134,14,2,0,0,3,1,0,12,3,72736,55903,14,153,79345,55042
135,14,1,1,2,1,2,1,300,275,72737,55904,312,203,79346,55043
136,14,2,2,2,1,2,1,46,46,72739,55906,68,193,79347,55044
137,14,1,2,1,0,0,3,34,22,72740,55908,44,65,79347,55047
138,14,1,0,0,3,1,0,111,116,72741,55908,119,88,79350,55047
139,14,0,0,2,1,2,1,303,238,72741,55908,335,7,79351,55048
140,15,0,1,1,0,0,3,9,10,72741,55909,8,86,79351,55051
141,15,2,0,0,3,1,0,213,212,72743,55909,241,85,79354,55051
142,15,1,1,2,1,2,1,45,44,72744,55910,57,44,79355,55052
143,15,1,1,2,1,2,1,202,172,72745,55911,241,32,79356,55053
144,15,2,1,0,3,1,0,136,126,72747,55912,114,138,79359,55053
145,15,1,2,1,0,0,3,78,66,72748,55914,102,92,79359,55056
146,15,3,0,0,3,1,0,150,117,72751,55914,174,209,79362,55056
147,15,1,3,1,0,0,3,307,255,72752,55917,317,241,79362,55059
148,15,0,2,1,0,0,3,79,64,72752,55919,96,12,79362,55062
149,15,2,1,0,3,1,0,210,218,72754,55920,259,229,79365,55062
150,16,0,0,2,1,2,1,300,275,72754,55920,313,50,79366,55063
151,16,2,2,2,1,2,1,269,231,72756,55922,279,89,79367,55064
152,16,3,0,0,3,1,0,37,22,72759,55922,47,7,79370,55064
153,16,1,0,0,3,1,0,108,106,72760,55922,127,65,79373,55064
154,16,3,0,0,3,1,0,15,3,72763,55922,17,92,79376,55064
155,16,2,3,1,0,0,3,113,119,72765,55925,119,206,79376,55067
156,16,1,1,2,1,2,1,304,239,72766,55926,336,154,79377,55068
157,16,0,1,1,0,0,3,142,142,72766,55927,177,94,79377,55071
158,16,1,1,2,1,2,1,211,219,72767,55928,260,77,79378,55072
159,16,0,0,2,1,2,1,46,46,72767,55928,69,150,79379,55073
160,17,1,1,2,1,2,1,79,67,72768,55929,103,45,79380,55074
161,17,0,2,1,0,0,3,45,46,72768,55931,57,244,79380,55077
162,17,0,0,2,1,2,1,136,126,72768,55931,115,13,79381,55078
163,17,2,1,0,3,1,0,215,213,72770,55932,244,86,79384,55078
164,17,0,2,1,0,0,3,79,66,72770,55934,96,196,79384,55081
165,17,1,2,1,0,0,3,203,174,72771,55936,241,88,79384,55084
166,17,0,1,1,0,0,3,9,11,72771,55937,8,212,79384,55087
167,17,0,2,1,0,0,3,162,127,72771,55939,179,35,79384,55090
168,17,1,0,0,3,1,0,151,117,72772,55939,177,229,79387,55090
169,17,0,3,1,0,0,3,307,258,72772,55942,317,141,79387,55093
170,18,2,1,0,3,1,0,213,220,72774,55943,263,94,79390,55093
171,18,0,0,2,1,2,1,142,142,72774,55943,178,151,79391,55094
172,18,1,0,0,3,1,0,270,231,72775,55943,282,154,79394,55094
173,18,2,2,2,1,2,1,17,5,72777,55945,18,51,79395,55095
174,18,1,0,0,3,1,0,47,46,72778,55945,72,206,79398,55095
175,18,2,0,0,3,1,0,39,22,72780,55945,50,77,79401,55095
176,18,0,1,1,0,0,3,108,107,72780,55946,127,92,79401,55098
177,18,0,2,1,0,0,3,300,277,72780,55948,313,68,79401,55101
178,18,5,0,0,3,1,0,309,239,72785,55948,339,92,79404,55101
179,18,2,0,0,3,1,0,115,119,72787,55948,122,7,79407,55101
180,19,2,1,0,3,1,0,153,118,72789,55949,180,45,79410,55101
181,19,0,0,2,1,2,1,215,213,72789,55949,245,197,79411,55102
182,19,0,0,2,1,2,1,45,46,72789,55949,58,36,79412,55103
183,19,1,1,2,1,2,1,204,175,72790,55950,242,87,79413,55104
184,19,2,1,0,3,1,0,11,12,72792,55951,11,141,79416,55104
185,19,1,0,0,3,1,0,80,67,72793,55951,106,229,79419,55104
186,19,2,0,0,3,1,0,164,127,72795,55951,182,212,79422,55104
187,19,2,2,2,1,2,1,138,128,72797,55953,116,245,79423,55105
188,19,1,1,2,1,2,1,80,67,72798,55954,97,89,79424,55106
189,19,0,1,1,0,0,3,307,259,72798,55955,317,16,79424,55109
190,20,0,0,2,1,2,1,142,142,72798,55955,179,78,79425,55110
191,20,2,1,0,3,1,0,217,214,72800,55956,248,206,79428,55110
192,20,1,2,1,0,0,3,154,120,72801,55958,180,54,79428,55113
193,20,3,1,0,3,1,0,312,240,72804,55959,342,151,79431,55113
194,20,1,1,2,1,2,1,40,23,72805,55960,51,93,79432,55114
195,20,1,0,0,3,1,0,48,46,72806,55960,75,7,79435,55114
196,20,3,1,0,3,1,0,216,221,72809,55961,266,212,79438,55114
197,20,1,1,2,1,2,1,116,120,72810,55962,123,17,79439,55115
198,20,1,1,2,1,2,1,271,232,72811,55963,283,69,79440,55116
199,20,0,0,2,1,2,1,108,107,72811,55963,128,93,79441,55117
200,21,1,2,1,0,0,3,139,130,72812,55965,116,157,79441,55120
201,21,1,1,2,1,2,1,165,128,72813,55966,183,198,79442,55121
202,21,3,3,2,1,2,1,310,262,72816,55969,318,230,79443,55122
203,21,2,1,0,3,1,0,82,68,72818,55970,100,45,79446,55122
204,21,0,2,1,0,0,3,300,279,72818,55972,313,90,79446,55125
205,21,1,1,2,1,2,1,46,47,72819,55973,59,90,79447,55126
206,21,1,2,1,0,0,3,205,177,72820,55975,242,81,79447,55129
207,21,1,1,2,1,2,1,18,6,72821,55976,19,246,79448,55130
208,21,1,2,1,0,0,3,41,25,72822,55978,51,144,79448,55133
209,21,2,1,0,3,1,0,13,13,72824,55979,14,94,79451,55133
210,22,2,2,2,1,2,1,141,132,72826,55981,117,207,79452,55134
211,22,1,1,2,1,2,1,272,233,72827,55982,284,55,79453,55135
212,22,3,1,0,3,1,0,83,68,72830,55983,109,69,79456,55135
213,22,1,2,1,0,0,3,143,144,72831,55985,179,20,79456,55138
214,22,2,2,2,1,2,1,314,242,72833,55987,343,213,79457,55139
215,22,1,3,1,0,0,3,117,123,72834,55990,123,39,79457,55142
216,22,2,2,2,1,2,1,50,48,72836,55992,76,94,79458,55143
217,22,1,1,2,1,2,1,218,215,72837,55993,249,152,79459,55144
218,22,1,0,0,3,1,0,109,107,72838,55993,131,94,79462,55144
219,22,1,0,0,3,1,0,217,221,72839,55993,269,7,79465,55144
220,23,0,2,1,0,0,3,18,8,72839,55995,19,48,79465,55147
221,23,1,1,2,1,2,1,166,129,72840,55996,184,145,79466,55148
222,23,0,1,1,0,0,3,41,26,72840,55997,51,233,79466,55151
223,23,1,2,1,0,0,3,83,70,72841,55999,100,96,79466,55154
224,23,0,2,1,0,0,3,300,281,72841,56001,313,84,79466,55157
225,23,1,1,2,1,2,1,118,124,72842,56002,124,247,79467,55158
226,23,2,3,1,0,0,3,156,123,72844,56005,180,155,79467,55161
227,23,1,0,0,3,1,0,14,13,72845,56005,17,157,79470,55161
228,23,1,0,0,3,1,0,311,262,72846,56005,321,198,79473,55161
229,23,2,2,2,1,2,1,48,49,72848,56007,60,91,79474,55162
230,24,0,0,2,1,2,1,205,177,72848,56007,243,214,79475,55163
231,24,1,2,1,0,0,3,312,264,72849,56009,321,72,79475,55166
232,24,0,3,1,0,0,3,272,236,72849,56012,284,10,79475,55169
233,24,0,2,1,0,0,3,218,217,72849,56014,249,97,79475,55172
234,24,2,2,2,1,2,1,145,146,72851,56016,180,91,79476,55173
235,24,3,2,0,3,1,0,86,70,72854,56018,112,94,79479,55173
236,24,0,1,1,0,0,3,217,222,72854,56019,269,23,79479,55176
237,24,1,1,2,1,2,1,51,49,72855,56020,77,248,79480,55177
238,24,1,0,0,3,1,0,110,107,72856,56020,134,39,79483,55177
239,24,3,1,0,3,1,0,144,133,72859,56021,120,55,79486,55177
240,25,0,0,2,1,2,1,14,13,72859,56021,18,98,79487,55178
241,25,1,1,2,1,2,1,315,243,72860,56022,344,85,79488,55179
242,25,1,1,2,1,2,1,42,27,72861,56023,52,158,79489,55180
243,25,1,0,0,3,1,0,49,49,72862,56023,63,198,79492,55180
244,25,4,0,0,3,1,0,87,70,72866,56023,103,155,79495,55180
245,25,2,2,2,1,2,1,53,51,72868,56025,78,146,79496,55181
246,25,1,1,2,1,2,1,301,282,72869,56026,314,97,79497,55182
247,25,1,4,1,0,0,3,119,128,72870,56030,124,94,79497,55185
248,25,0,0,2,1,2,1,18,8,72870,56030,20,234,79498,55186
249,25,1,1,2,1,2,1,157,124,72871,56031,181,208,79499,55187
250,26,2,1,0,3,1,0,88,71,72873,56032,115,10,79502,55187
251,26,2,2,2,1,2,1,207,179,72875,56034,244,24,79503,55188
252,26,2,0,0,3,1,0,314,264,72877,56034,324,55,79506,55188
253,26,0,3,1,0,0,3,110,110,72877,56037,134,251,79506,55191
254,26,0,1,1,0,0,3,272,237,72877,56038,284,217,79506,55194
255,26,0,2,1,0,0,3,218,219,72877,56040,249,51,79506,55197
256,26,3,0,0,3,1,0,220,222,72880,56040,272,39,79509,55197
257,26,0,0,2,1,2,1,166,129,72880,56040,185,92,79510,55198
258,26,0,0,2,1,2,1,144,133,72880,56040,121,95,79511,55199
259,26,3,1,0,3,1,0,148,147,72883,56041,183,72,79514,55199
260,27,0,0,2,1,2,1,157,124,72883,56041,182,159,79515,55200
261,27,1,2,1,0,0,3,50,51,72884,56043,63,158,79515,55203
262,27,0,0,2,1,2,1,53,51,72884,56043,79,95,79516,55204
263,27,0,1,1,0,0,3,87,71,72884,56044,103,101,79516,55207
264,27,0,1,1,0,0,3,301,283,72884,56045,314,95,79516,55210
265,27,0,1,1,0,0,3,88,72,72884,56046,115,211,79516,55213
266,27,2,0,0,3,1,0,20,8,72886,56046,23,39,79519,55213
267,27,1,1,2,1,2,1,316,244,72887,56047,345,235,79520,55214
268,27,0,4,1,0,0,3,14,17,72887,56051,18,100,79520,55217
269,27,1,2,1,0,0,3,221,224,72888,56053,272,149,79520,55220
270,28,2,0,0,3,1,0,274,237,72890,56053,287,51,79523,55220
271,28,0,0,2,1,2,1,119,128,72890,56053,125,96,79524,55221
272,28,0,1,1,0,0,3,207,180,72890,56054,244,214,79524,55224
273,28,4,2,0,3,1,0,148,135,72894,56056,124,198,79527,55224
274,28,1,0,0,3,1,0,111,110,72895,56056,137,24,79530,55224
275,28,0,0,2,1,2,1,42,27,72895,56056,53,218,79531,55225
276,28,3,0,0,3,1,0,90,71,72898,56056,106,10,79534,55225
277,28,1,1,2,1,2,1,219,220,72899,56057,250,86,79535,55226
278,28,0,0,2,1,2,1,166,129,72899,56057,186,56,79536,55227
279,28,0,2,1,0,0,3,148,149,72899,56059,183,254,79536,55230
280,29,3,0,0,3,1,0,56,51,72902,56059,82,95,79539,55230
281,29,0,2,1,0,0,3,157,126,72902,56061,182,75,79539,55233
282,29,1,1,2,1,2,1,51,52,72903,56062,64,150,79540,55234
283,29,2,3,1,0,0,3,90,75,72905,56065,115,103,79540,55237
284,29,0,0,2,1,2,1,221,224,72905,56065,273,159,79541,55238
285,29,1,0,0,3,1,0,317,244,72906,56065,348,39,79544,55238
286,29,2,0,0,3,1,0,22,8,72908,56065,26,10,79547,55238
287,29,1,0,0,3,1,0,315,264,72909,56065,327,95,79550,55238
288,29,0,0,2,1,2,1,274,237,72909,56065,288,102,79551,55239
289,29,2,3,1,0,0,3,303,286,72911,56068,314,162,79551,55242
290,30,0,0,2,1,2,1,219,220,72911,56068,251,76,79552,55243
291,30,1,1,2,1,2,1,15,18,72912,56069,19,57,79553,55244
292,30,0,3,1,0,0,3,207,183,72912,56072,244,106,79553,55247
293,30,1,0,0,3,1,0,149,149,72913,56072,186,218,79556,55247
294,30,1,0,0,3,1,0,318,244,72914,56072,351,96,79559,55247
295,30,1,4,1,0,0,3,23,12,72915,56076,26,89,79559,55250
296,30,1,0,0,3,1,0,120,128,72916,56076,128,235,79562,55250
297,30,1,1,2,1,2,1,112,111,72917,56077,138,199,79563,55251
298,30,1,0,0,3,1,0,167,129,72918,56077,189,214,79566,55251
299,31,2,1,0,3,1,0,53,53,72920,56078,67,162,79569,55251
300,31,3,1,0,3,1,0,306,287,72923,56079,317,51,79572,55251
301,31,0,0,2,1,2,1,207,183,72923,56079,245,11,79573,55252
302,31,1,0,0,3,1,0,150,149,72924,56079,189,235,79576,55252
303,31,1,1,2,1,2,1,158,127,72925,56080,183,25,79577,55253
304,31,4,1,0,3,1,0,319,265,72929,56081,330,39,79580,55253
305,31,0,2,1,0,0,3,90,77,72929,56083,115,98,79580,55256
306,31,2,0,0,3,1,0,150,135,72931,56083,127,102,79583,55256
307,31,1,1,2,1,2,1,222,225,72932,56084,274,96,79584,55257
308,31,2,2,2,1,2,1,92,73,72934,56086,107,255,79585,55258
309,32,3,0,0,3,1,0,45,27,72937,56086,56,96,79588,55258
310,32,0,1,1,0,0,3,53,54,72937,56087,67,79,79588,55261
311,32,2,1,0,3,1,0,221,221,72939,56088,254,150,79591,55261
312,32,0,1,1,0,0,3,56,52,72939,56089,82,109,79591,55264
313,32,1,1,2,1,2,1,24,13,72940,56090,27,219,79592,55265
314,32,1,1,2,1,2,1,275,238,72941,56091,289,99,79593,55266
315,32,2,2,2,1,2,1,17,20,72943,56093,20,215,79594,55267
316,32,1,1,2,1,2,1,121,129,72944,56094,129,90,79595,55268
317,32,1,0,0,3,1,0,168,129,72945,56094,192,159,79598,55268
318,33,0,1,1,0,0,3,17,21,72945,56095,20,258,79598,55271
319,33,1,0,0,3,1,0,222,221,72946,56095,257,25,79601,55271
320,33,1,1,2,1,2,1,320,266,72947,56096,331,220,79602,55272
321,33,2,1,0,3,1,0,94,74,72949,56097,110,39,79605,55272
322,33,0,3,1,0,0,3,158,130,72949,56100,183,105,79605,55275
323,33,1,2,1,0,0,3,151,137,72950,56102,127,99,79605,55278
324,33,1,1,2,1,2,1,208,184,72951,56103,246,236,79606,55279
325,33,3,0,0,3,1,0,115,111,72954,56103,141,150,79609,55279
326,33,3,0,0,3,1,0,93,77,72957,56103,118,57,79612,55279
327,33,2,0,0,3,1,0,224,225,72959,56103,277,51,79615,55279
